index,Scratched,Breakage,Separated,Crushed,total_anns,ran_var,dataset
0506233_sc-202337.jpg,0,1,1,0,2,,test
0506234_sc-202337.jpg,0,0,3,0,3,,train
0506235_sc-202337.jpg,1,0,2,0,3,,train
0506236_sc-202337.jpg,1,0,1,0,2,,train
0506237_sc-202337.jpg,2,0,1,0,3,,train
0506238_as-3203576.jpg,2,0,0,0,2,,train
0506239_as-3483186.jpg,0,0,1,0,1,,train
0506240_as-7962812.jpg,1,1,1,1,4,,train
0506241_sc-190131.jpg,2,0,1,0,3,,val
0506245_sc-198049.jpg,1,0,0,1,2,,val
0506246_sc-198049.jpg,5,0,1,1,7,,test
0506247_sc-198049.jpg,2,0,0,1,3,,train
0506248_sc-221145.jpg,1,0,2,0,3,,train
0506249_sc-131618.jpg,1,0,0,0,1,,train
0506250_sc-131618.jpg,1,0,0,1,2,,train
0506251_sc-131618.jpg,1,0,0,1,2,,train
0506252_sc-131618.jpg,1,0,0,0,1,,train
0506253_sc-131618.jpg,2,0,1,1,4,,train
0506254_sc-124992.jpg,1,0,0,0,1,,val
0506256_sc-124992.jpg,1,0,0,0,1,,val
0506257_sc-145679.jpg,1,0,0,0,1,,test
0506258_sc-145679.jpg,1,0,0,0,1,,train
0506259_sc-224820.jpg,5,0,1,1,7,,train
0506260_sc-1024333.jpg,5,0,0,0,5,,train
0506261_sc-1024333.jpg,4,0,0,0,4,,train
0506262_as-9091727.jpg,1,1,0,0,2,,train
0506263_sc-222093.jpg,2,0,0,1,3,,train
0506264_as-2700163.jpg,7,0,1,1,9,,train
0506266_sc-227628.jpg,3,0,0,0,3,,val
0506268_as-2719480.jpg,0,1,0,0,1,,val
0506271_sc-147905.jpg,2,0,0,1,3,,test
0506272_as-2836626.jpg,1,0,0,1,2,,train
0506273_sc-1006409.jpg,2,0,0,0,2,,train
0506274_sc-1006409.jpg,0,0,1,0,1,,train
0506275_sc-1006409.jpg,1,0,0,0,1,,train
0506276_as-7545067.jpg,2,0,0,0,2,,train
0506278_as-0017846.jpg,1,0,0,0,1,,train
0506279_as-0033822.jpg,1,0,0,1,2,,train
0506280_as-0034254.jpg,1,0,0,2,3,,val
0506281_as-0034254.jpg,1,0,0,0,1,,val
0506282_as-0034254.jpg,1,0,0,0,1,,test
0506283_as-0034254.jpg,2,0,0,0,2,,train
0506284_as-0034254.jpg,1,0,0,0,1,,train
0506285_as-0034254.jpg,1,0,0,0,1,,train
0506286_sc-109140.jpg,4,0,0,0,4,,train
0506287_sc-109140.jpg,1,0,0,0,1,,train
0506288_as-2842853.jpg,1,0,0,0,1,,train
0506289_sc-182108.jpg,5,1,0,0,6,,train
0506290_sc-182108.jpg,4,0,1,1,6,,val
0506291_sc-182108.jpg,5,1,1,0,7,,val
0506292_sc-182108.jpg,1,0,1,1,3,,test
0506293_sc-182108.jpg,6,0,0,1,7,,train
0506294_sc-121119.jpg,1,0,0,0,1,,train
0506295_sc-121119.jpg,1,0,0,0,1,,train
0506298_sc-121119.jpg,1,0,0,0,1,,train
0506300_sc-121119.jpg,1,0,0,0,1,,train
0506301_sc-1037108.jpg,1,0,0,0,1,,train
0506302_sc-1037108.jpg,0,0,1,1,2,,train
0506303_as-0052356.jpg,1,0,0,0,1,,val
0506304_as-0052356.jpg,1,0,0,0,1,,val
0506305_as-0052356.jpg,1,0,0,0,1,,test
0506306_as-0052356.jpg,2,0,0,0,2,,train
0506307_as-0052356.jpg,1,0,0,0,1,,train
0506308_sc-166817.jpg,7,1,1,1,10,,train
0506309_sc-166817.jpg,3,1,1,0,5,,train
0506310_sc-166817.jpg,3,0,3,0,6,,train
0506311_sc-166817.jpg,1,1,1,0,3,,train
0506312_as-2802924.jpg,1,0,0,0,1,,train
0506313_as-2983482.jpg,2,0,1,0,3,,val
0506315_sc-108254.jpg,1,0,0,0,1,,val
0506316_sc-108254.jpg,3,0,0,0,3,,test
0506317_as-3036474.jpg,0,2,0,0,2,,train
0506318_sc-1011208.jpg,3,1,0,0,4,,train
0506320_sc-1028706.jpg,2,0,0,0,2,,train
0506321_sc-1028706.jpg,3,0,0,0,3,,train
0506323_as-0001319.jpg,5,0,0,0,5,,train
0506324_as-0001319.jpg,1,0,1,2,4,,train
0506325_as-0001319.jpg,5,2,0,1,8,,train
0506327_as-3067857.jpg,0,1,0,0,1,,val
0506329_as-0076827.jpg,1,0,0,0,1,,val
0506330_sc-188707.jpg,1,0,1,0,2,,test
0506331_sc-188707.jpg,1,0,0,0,1,,train
0506332_sc-188707.jpg,1,0,0,0,1,,train
0506333_sc-188707.jpg,1,0,0,0,1,,train
0506334_sc-193542.jpg,2,0,0,2,4,,train
0506335_sc-193542.jpg,1,0,0,3,4,,train
0506336_sc-193542.jpg,2,0,0,2,4,,train
0506337_sc-193542.jpg,2,0,0,0,2,,train
0506338_sc-193542.jpg,2,0,0,0,2,,val
0506339_as-7970735.jpg,1,0,0,0,1,,val
0506340_as-0088062.jpg,4,0,0,0,4,,test
0506342_as-0088062.jpg,0,0,1,0,1,,train
0506344_as-0040055.jpg,0,1,1,0,2,,train
0506345_as-0040055.jpg,1,0,2,1,4,,train
0506346_as-0040055.jpg,0,0,3,0,3,,train
0506347_as-0040055.jpg,1,0,1,1,3,,train
0506348_as-0040055.jpg,3,1,1,1,6,,train
0506349_as-0040055.jpg,2,0,1,1,4,,train
0506350_as-0040055.jpg,0,1,0,0,1,,val
0506351_as-0040055.jpg,0,1,0,0,1,,val
0506352_as-0040055.jpg,0,1,0,0,1,,test
0506353_as-0040055.jpg,2,0,0,0,2,,train
0506354_as-0040055.jpg,2,0,1,0,3,,train
0506359_as-0027398.jpg,2,1,1,0,4,,train
0506360_as-0027398.jpg,3,1,1,0,5,,train
0506361_as-0027398.jpg,0,0,1,0,1,,train
0506362_sc-142205.jpg,11,0,0,0,11,,train
0506365_as-0020965.jpg,2,0,0,0,2,,train
0506366_as-0020965.jpg,4,1,1,1,7,,val
0506367_as-0020965.jpg,0,0,2,0,2,,val
0506368_sc-194775.jpg,1,0,2,1,4,,test
0506369_sc-1036355.jpg,0,1,0,0,1,,train
0506370_sc-1036355.jpg,1,0,0,0,1,,train
0506371_as-4660351.jpg,0,1,0,1,2,,train
0506372_sc-225312.jpg,2,0,1,1,4,,train
0506373_sc-225312.jpg,0,1,2,0,3,,train
0506374_sc-225312.jpg,0,0,2,0,2,,train
0506375_sc-225312.jpg,0,0,1,0,1,,train
0506376_sc-225312.jpg,6,0,1,0,7,,val
0506377_as-2655907.jpg,1,0,0,0,1,,val
0506378_sc-198819.jpg,2,0,0,1,3,,test
0506379_sc-198819.jpg,3,0,1,0,4,,train
0506380_sc-198819.jpg,4,0,1,0,5,,train
0506381_sc-198819.jpg,7,0,1,0,8,,train
0506382_sc-198819.jpg,6,0,1,1,8,,train
0506383_sc-198819.jpg,5,0,1,0,6,,train
0506384_as-0009706.jpg,1,0,0,0,1,,train
0506385_as-0009706.jpg,2,0,0,0,2,,train
0506386_as-0009706.jpg,1,0,0,0,1,,val
0506387_as-0009706.jpg,1,0,0,0,1,,val
0506389_as-0049821.jpg,0,0,1,1,2,,test
0506390_as-0049821.jpg,0,0,0,1,1,,train
0506393_as-0049821.jpg,1,0,1,1,3,,train
0506394_as-0049821.jpg,2,0,1,1,4,,train
0506395_as-0049821.jpg,0,0,1,0,1,,train
0506396_as-0049821.jpg,1,0,0,0,1,,train
0506398_as-0067334.jpg,2,0,0,0,2,,train
0506400_as-0067334.jpg,2,0,0,0,2,,train
0506401_as-0067334.jpg,2,0,0,0,2,,val
0506402_as-0067334.jpg,1,0,0,0,1,,val
0506403_as-0067334.jpg,1,0,0,0,1,,test
0506404_sc-147276.jpg,2,1,1,1,5,,train
0506406_sc-147276.jpg,1,1,1,1,4,,train
0506408_sc-111021.jpg,2,1,0,0,3,,train
0506409_sc-111021.jpg,1,0,0,0,1,,train
0506410_sc-201032.jpg,4,0,0,0,4,,train
0506411_sc-201032.jpg,2,0,0,0,2,,train
0506412_sc-201032.jpg,2,0,0,0,2,,train
0506413_sc-201032.jpg,1,0,0,0,1,,val
0506414_sc-201032.jpg,1,0,0,0,1,,val
0506415_sc-201032.jpg,1,0,0,0,1,,test
0506416_sc-201032.jpg,0,1,0,0,1,,train
0506417_sc-201032.jpg,3,0,0,1,4,,train
0506418_sc-201032.jpg,3,0,0,1,4,,train
0506419_sc-201032.jpg,2,0,0,1,3,,train
0506420_sc-201032.jpg,2,0,0,0,2,,train
0506421_sc-201032.jpg,2,0,0,0,2,,train
0506422_as-0093056.jpg,1,0,0,0,1,,train
0506423_sc-160700.jpg,1,0,0,0,1,,val
0506424_as-7008961.jpg,1,0,0,0,1,,val
0506425_as-2938861.jpg,4,1,2,0,7,,test
0506428_sc-123479.jpg,3,0,0,0,3,,train
0506432_as-0015798.jpg,9,1,1,0,11,,train
0506433_sc-200938.jpg,2,0,0,2,4,,train
0506434_sc-200938.jpg,1,0,0,0,1,,train
0506435_as-3045299.jpg,6,0,0,0,6,,train
0506436_as-3074917.jpg,1,0,0,0,1,,train
0506437_as-3199886.jpg,2,1,0,0,3,,train
0506438_sc-185453.jpg,2,0,0,0,2,,val
0506439_sc-185453.jpg,5,0,0,0,5,,val
0506443_as-0078573.jpg,1,0,0,0,1,,test
0506444_as-0078573.jpg,1,0,0,0,1,,train
0506448_as-3292878.jpg,3,0,0,0,3,,train
0506449_sc-155167.jpg,0,0,1,0,1,,train
0506450_sc-155167.jpg,0,0,1,0,1,,train
0506451_sc-155167.jpg,0,0,1,0,1,,train
0506452_sc-155167.jpg,0,0,1,0,1,,train
0506453_sc-155167.jpg,0,0,1,0,1,,train
0506454_sc-115132.jpg,1,0,0,1,2,,val
0506455_sc-115132.jpg,1,0,0,1,2,,val
0506457_sc-115132.jpg,0,0,0,1,1,,test
0506458_sc-115132.jpg,1,0,0,1,2,,train
0506462_as-3279903.jpg,2,1,2,1,6,,train
0506464_as-2977436.jpg,0,0,1,0,1,,train
0506465_as-3335986.jpg,2,1,0,0,3,,train
0506467_as-0042089.jpg,1,0,0,0,1,,train
0506468_as-0042089.jpg,1,0,0,0,1,,train
0506469_as-7525238.jpg,2,0,0,0,2,,train
0506470_as-2612397.jpg,2,2,1,2,7,,val
0506471_as-3407360.jpg,2,0,2,0,4,,val
0506473_sc-1014003.jpg,2,0,0,0,2,,test
0506476_sc-1014003.jpg,2,0,0,0,2,,train
0506477_as-5217561.jpg,1,0,1,1,3,,train
0506478_as-0004338.jpg,2,1,3,0,6,,train
0506479_as-0004338.jpg,2,0,1,0,3,,train
0506480_as-0004338.jpg,3,1,1,0,5,,train
0506481_as-0004338.jpg,1,1,1,0,3,,train
0506482_as-2592949.jpg,1,0,0,1,2,,train
0506483_as-0024654.jpg,1,0,0,0,1,,val
0506485_as-0050825.jpg,2,1,1,1,5,,val
0506486_as-0050825.jpg,3,1,1,1,6,,test
0506487_as-0050825.jpg,3,1,2,1,7,,train
0506488_as-0050825.jpg,3,1,2,1,7,,train
0506489_as-3317669.jpg,1,0,1,0,2,,train
0506490_sc-201578.jpg,1,0,0,0,1,,train
0506491_sc-201578.jpg,2,0,0,0,2,,train
0506492_sc-201578.jpg,5,1,0,0,6,,train
0506493_sc-226951.jpg,2,0,0,1,3,,train
0506494_sc-226951.jpg,1,0,0,1,2,,val
0506495_sc-226951.jpg,2,0,0,0,2,,val
0506496_sc-226951.jpg,2,0,0,1,3,,test
0506497_sc-226951.jpg,2,0,0,1,3,,train
0506498_sc-226951.jpg,2,0,0,1,3,,train
0506499_sc-226951.jpg,2,0,0,1,3,,train
0506500_as-3278386.jpg,1,0,0,0,1,,train
0506501_sc-205780.jpg,1,0,0,1,2,,train
0506502_sc-205780.jpg,6,0,0,0,6,,train
0506503_sc-205780.jpg,2,0,0,0,2,,train
0506504_sc-205780.jpg,4,0,0,0,4,,val
0506505_sc-205780.jpg,3,0,0,0,3,,val
0506506_sc-205780.jpg,1,0,0,1,2,,test
0506507_sc-205780.jpg,2,0,0,1,3,,train
0506508_sc-205780.jpg,6,0,0,0,6,,train
0506509_sc-205780.jpg,2,0,1,2,5,,train
0506510_sc-205780.jpg,2,0,1,1,4,,train
0506511_sc-205780.jpg,5,0,1,0,6,,train
0506512_sc-205780.jpg,3,0,0,0,3,,train
0506513_sc-205780.jpg,2,0,1,0,3,,train
0506514_sc-221241.jpg,1,0,1,0,2,,val
0506515_sc-1007334.jpg,1,0,1,0,2,,val
0506516_sc-1007334.jpg,1,0,1,0,2,,test
0506517_sc-1007334.jpg,3,0,1,0,4,,train
0506518_as-0014058.jpg,1,0,0,0,1,,train
0506519_as-0014058.jpg,1,0,0,0,1,,train
0506520_as-0014058.jpg,1,0,0,0,1,,train
0506521_as-0014058.jpg,1,0,0,0,1,,train
0506522_as-0014058.jpg,3,0,0,0,3,,train
0506523_as-0014058.jpg,1,0,0,0,1,,train
0506524_as-0014058.jpg,2,0,0,0,2,,val
0506525_as-0040959.jpg,3,0,0,0,3,,val
0506526_as-0040959.jpg,2,0,0,0,2,,test
0506527_sc-1030807.jpg,1,0,0,0,1,,train
0506528_sc-1030807.jpg,2,0,0,0,2,,train
0506529_as-0056810.jpg,1,0,0,0,1,,train
0506530_sc-1018730.jpg,1,1,1,0,3,,train
0506531_sc-1018730.jpg,3,0,1,0,4,,train
0506532_as-2865263.jpg,1,0,0,0,1,,train
0506533_as-2929830.jpg,5,0,0,1,6,,train
0506534_as-7790648.jpg,2,0,0,1,3,,val
0506536_as-2754848.jpg,0,1,0,0,1,,val
0506537_sc-215744.jpg,2,0,0,0,2,,test
0506538_sc-215744.jpg,2,0,0,1,3,,train
0506541_as-3272509.jpg,1,0,0,0,1,,train
0506542_as-0070722.jpg,2,0,0,0,2,,train
0506543_as-0070722.jpg,3,0,0,0,3,,train
0506544_as-0070722.jpg,2,0,0,0,2,,train
0506545_as-0070722.jpg,2,0,0,0,2,,train
0506547_as-0072206.jpg,0,0,1,0,1,,train
0506548_as-0072206.jpg,2,0,1,0,3,,val
0506549_as-0072206.jpg,4,0,1,0,5,,val
0506551_as-7375932.jpg,1,1,1,0,3,,test
0506552_as-0098773.jpg,1,0,0,1,2,,train
0506553_as-0098773.jpg,2,0,0,0,2,,train
0506554_as-3339519.jpg,1,0,1,0,2,,train
0506555_as-2508616.jpg,9,0,0,0,9,,train
0506556_sc-1015960.jpg,2,0,1,0,3,,train
0506557_sc-1015960.jpg,4,0,0,0,4,,train
0506559_sc-1015960.jpg,4,1,1,0,6,,train
0506560_sc-1015960.jpg,6,1,1,0,8,,val
0506561_sc-1015960.jpg,2,2,2,0,6,,val
0506562_sc-1015960.jpg,1,0,0,0,1,,test
0506563_sc-1015960.jpg,4,2,3,0,9,,train
0506565_as-7670685.jpg,3,0,1,0,4,,train
0506566_as-3133348.jpg,1,1,0,0,2,,train
0506567_as-0039478.jpg,1,0,2,0,3,,train
0506569_as-0074481.jpg,1,0,0,0,1,,train
0506570_as-0074481.jpg,1,0,0,0,1,,train
0506571_as-0074481.jpg,1,0,0,0,1,,train
0506572_as-0074481.jpg,1,0,0,0,1,,val
0506573_sc-1000981.jpg,2,0,2,0,4,,val
0506575_sc-1039844.jpg,3,0,1,1,5,,test
0506576_sc-1039844.jpg,1,0,0,0,1,,train
0506577_as-2620439.jpg,1,0,1,0,2,,train
0506578_sc-222001.jpg,1,0,0,0,1,,train
0506579_sc-222001.jpg,2,0,0,0,2,,train
0506580_as-2952999.jpg,1,0,0,1,2,,train
0506581_as-2556127.jpg,2,0,0,0,2,,train
0506582_as-3109845.jpg,1,0,1,0,2,,train
0506584_as-0095833.jpg,2,1,3,2,8,,val
0506585_as-0095833.jpg,1,0,2,1,4,,val
0506586_as-0095833.jpg,9,0,0,1,10,,test
0506587_as-0095833.jpg,2,1,0,1,4,,train
0506588_as-0095833.jpg,2,0,1,1,4,,train
0506590_sc-214054.jpg,2,0,0,0,2,,train
0506591_sc-214054.jpg,2,0,1,1,4,,train
0506592_sc-214054.jpg,2,0,2,1,5,,train
0506593_sc-214054.jpg,3,1,2,0,6,,train
0506594_sc-214054.jpg,3,0,0,1,4,,train
0506595_sc-214054.jpg,1,0,1,1,3,,val
0506596_sc-214054.jpg,1,0,1,0,2,,val
0506597_sc-214054.jpg,1,0,0,0,1,,test
0506598_sc-205430.jpg,4,0,0,0,4,,train
0506599_sc-205430.jpg,9,0,0,0,9,,train
0506601_sc-227195.jpg,1,2,0,0,3,,train
0506602_as-2550252.jpg,3,0,0,0,3,,train
0506603_as-0084763.jpg,1,1,0,0,2,,train
0506604_as-0084763.jpg,0,2,1,2,5,,train
0506606_as-0084763.jpg,0,3,1,1,5,,train
0506608_as-0084763.jpg,0,2,0,2,4,,val
0506609_as-0084763.jpg,2,2,2,0,6,,val
0506610_as-0084763.jpg,3,2,1,0,6,,test
0506612_sc-226931.jpg,1,0,1,0,2,,train
0506613_sc-226931.jpg,1,0,1,0,2,,train
0506614_as-2657071.jpg,2,0,1,0,3,,train
0506615_sc-213526.jpg,1,1,0,0,2,,train
0506617_as-3248130.jpg,1,0,0,0,1,,train
0506618_as-2920252.jpg,1,0,0,0,1,,train
0506619_as-3118136.jpg,2,0,0,0,2,,train
0506620_sc-156338.jpg,1,0,0,1,2,,val
0506621_sc-156338.jpg,4,0,0,0,4,,val
0506622_sc-156338.jpg,2,0,0,0,2,,test
0506623_sc-156338.jpg,3,0,0,1,4,,train
0506624_sc-113646.jpg,1,1,1,0,3,,train
0506625_sc-113646.jpg,1,0,0,0,1,,train
0506626_sc-113646.jpg,2,2,1,0,5,,train
0506629_sc-113646.jpg,1,1,1,0,3,,train
0506630_sc-113646.jpg,1,0,0,0,1,,train
0506631_sc-118329.jpg,1,1,0,2,4,,train
0506632_sc-118329.jpg,1,2,0,0,3,,val
0506633_sc-118329.jpg,4,1,0,2,7,,val
0506634_sc-118329.jpg,1,1,0,0,2,,test
0506635_sc-118329.jpg,1,1,0,1,3,,train
0506636_as-3274455.jpg,0,1,0,0,1,,train
0506637_sc-166048.jpg,1,0,1,0,2,,train
0506638_sc-166048.jpg,1,0,0,0,1,,train
0506639_sc-166048.jpg,1,0,1,0,2,,train
0506640_sc-166048.jpg,2,0,1,0,3,,train
0506645_as-0076066.jpg,3,0,1,1,5,,train
0506646_sc-213708.jpg,4,0,1,0,5,,val
0506647_sc-213708.jpg,5,0,1,0,6,,val
0506648_sc-213708.jpg,5,1,0,0,6,,test
0506649_sc-190600.jpg,1,0,0,1,2,,train
0506650_as-0048299.jpg,2,0,1,0,3,,train
0506651_as-0048299.jpg,1,0,0,0,1,,train
0506652_as-0048299.jpg,1,0,1,0,2,,train
0506653_as-0048299.jpg,1,0,1,0,2,,train
0506654_as-0048299.jpg,1,0,1,0,2,,train
0506655_as-0048299.jpg,1,0,1,0,2,,train
0506656_as-0048299.jpg,1,0,1,0,2,,val
0506657_sc-221057.jpg,2,1,0,1,4,,val
0506659_as-2749988.jpg,1,0,0,0,1,,test
0506660_sc-224410.jpg,1,0,0,0,1,,train
0506661_sc-224410.jpg,3,0,0,0,3,,train
0506662_sc-224410.jpg,4,0,0,0,4,,train
0506663_sc-224410.jpg,7,0,1,0,8,,train
0506664_sc-224410.jpg,10,0,1,0,11,,train
0506665_sc-224410.jpg,5,0,0,0,5,,train
0506666_sc-224410.jpg,3,0,0,0,3,,train
0506667_sc-224410.jpg,1,0,0,0,1,,val
0506668_sc-1038548.jpg,0,0,1,0,1,,val
0506669_sc-1038548.jpg,3,0,0,0,3,,test
0506670_sc-1016158.jpg,1,0,0,0,1,,train
0506671_sc-1016158.jpg,1,0,0,0,1,,train
0506672_sc-1016158.jpg,1,0,0,0,1,,train
0506673_sc-1016158.jpg,1,0,1,1,3,,train
0506674_sc-1016158.jpg,3,0,0,0,3,,train
0506675_sc-1016158.jpg,3,0,1,2,6,,train
0506676_sc-1016158.jpg,1,0,0,0,1,,train
0506677_sc-1016158.jpg,1,0,0,1,2,,val
0506679_sc-185412.jpg,5,0,0,0,5,,val
0506680_sc-185412.jpg,2,0,2,0,4,,test
0506681_as-2608556.jpg,2,0,0,0,2,,train
0506682_sc-198155.jpg,1,0,0,0,1,,train
0506683_sc-198155.jpg,1,0,0,0,1,,train
0506685_as-0044756.jpg,1,0,0,0,1,,train
0506686_as-0044756.jpg,0,0,1,1,2,,train
0506687_sc-192385.jpg,5,0,1,0,6,,train
0506688_sc-192385.jpg,4,0,1,0,5,,train
0506689_sc-104147.jpg,6,0,0,0,6,,val
0506690_sc-104147.jpg,6,0,0,0,6,,val
0506691_sc-104147.jpg,2,0,0,0,2,,test
0506693_sc-104147.jpg,1,0,0,0,1,,train
0506694_sc-104147.jpg,0,1,1,0,2,,train
0506695_sc-104147.jpg,0,1,1,0,2,,train
0506696_sc-130374.jpg,1,1,2,0,4,,train
0506697_sc-130374.jpg,0,1,0,0,1,,train
0506698_sc-156261.jpg,0,0,1,0,1,,train
0506699_as-0033012.jpg,1,0,0,0,1,,train
0506702_sc-158709.jpg,1,0,0,0,1,,val
0506703_sc-158709.jpg,4,0,0,0,4,,val
0506704_sc-158709.jpg,3,0,0,0,3,,test
0506705_as-2767913.jpg,2,1,1,2,6,,train
0506706_as-0083030.jpg,2,0,0,0,2,,train
0506707_as-0083030.jpg,3,0,0,0,3,,train
0506709_as-0083030.jpg,6,0,1,0,7,,train
0506710_as-0083030.jpg,4,0,0,0,4,,train
0506711_as-0083030.jpg,2,0,0,0,2,,train
0506712_as-0083030.jpg,1,0,0,0,1,,train
0506713_as-0083030.jpg,1,0,0,0,1,,val
0506714_as-0083030.jpg,1,0,0,0,1,,val
0506716_sc-126782.jpg,3,1,0,0,4,,test
0506717_sc-126782.jpg,1,1,0,0,2,,train
0506719_as-0028348.jpg,2,0,0,0,2,,train
0506720_as-0029856.jpg,1,0,0,0,1,,train
0506721_as-0035117.jpg,1,0,0,0,1,,train
0506723_as-0030259.jpg,2,0,0,0,2,,train
0506724_as-0030259.jpg,1,0,0,0,1,,train
0506725_as-0030259.jpg,1,0,0,0,1,,train
0506726_as-0030259.jpg,1,0,0,0,1,,val
0506727_as-0030259.jpg,1,1,0,0,2,,val
0506729_sc-1004947.jpg,1,0,0,0,1,,test
0506730_sc-1004947.jpg,1,0,0,0,1,,train
0506732_as-0083086.jpg,1,0,0,0,1,,train
0506733_as-0083086.jpg,1,0,0,0,1,,train
0506734_as-2820984.jpg,1,0,0,1,2,,train
0506735_as-3118816.jpg,1,1,0,0,2,,train
0506739_as-0066257.jpg,1,0,3,4,8,,train
0506740_as-0066257.jpg,1,0,2,4,7,,train
0506744_as-0066257.jpg,1,0,4,2,7,,val
0506745_as-0066257.jpg,1,0,1,4,6,,val
0506746_sc-201177.jpg,4,0,0,0,4,,test
0506747_sc-201177.jpg,2,0,0,0,2,,train
0506748_sc-201177.jpg,3,0,1,0,4,,train
0506749_sc-201177.jpg,4,0,0,0,4,,train
0506750_sc-201177.jpg,3,0,0,0,3,,train
0506751_sc-223960.jpg,5,0,0,0,5,,train
0506752_sc-223960.jpg,1,0,0,0,1,,train
0506753_sc-223960.jpg,2,0,0,0,2,,train
0506754_sc-223960.jpg,4,0,0,0,4,,val
0506755_as-7723773.jpg,0,1,1,0,2,,val
0506757_as-0055624.jpg,1,0,2,0,3,,test
0506758_as-0055624.jpg,0,0,2,0,2,,train
0506759_as-0055624.jpg,3,0,0,1,4,,train
0506760_as-0055624.jpg,3,0,1,1,5,,train
0506761_as-0055624.jpg,1,2,2,0,5,,train
0506762_as-3307539.jpg,2,0,0,0,2,,train
0506763_as-3386001.jpg,2,0,1,0,3,,train
0506764_as-3386001.jpg,3,0,0,1,4,,train
0506765_sc-162829.jpg,4,1,1,0,6,,val
0506766_sc-162829.jpg,3,1,0,0,4,,val
0506769_as-0065857.jpg,2,1,0,0,3,,test
0506770_as-0065857.jpg,2,0,0,0,2,,train
0506771_as-0065857.jpg,2,1,0,0,3,,train
0506772_as-0065857.jpg,1,0,0,0,1,,train
0506775_as-0065857.jpg,2,0,0,0,2,,train
0506776_as-3126906.jpg,0,1,0,0,1,,train
0506781_as-0084692.jpg,4,0,0,0,4,,train
0506782_as-0084692.jpg,1,0,0,0,1,,train
0506783_as-0084692.jpg,1,0,0,0,1,,val
0506784_as-9039802.jpg,1,0,0,0,1,,val
0506785_as-3070840.jpg,1,0,1,0,2,,test
0506786_sc-193868.jpg,2,0,0,0,2,,train
0506787_as-3356715.jpg,3,0,0,0,3,,train
0506788_as-0032904.jpg,1,0,1,0,2,,train
0506789_as-0032904.jpg,3,0,0,0,3,,train
0506790_as-0032904.jpg,3,0,0,0,3,,train
0506792_as-3056158.jpg,3,0,0,0,3,,train
0506794_sc-196222.jpg,2,0,0,0,2,,train
0506796_sc-196222.jpg,1,0,1,1,3,,val
0506798_as-3424738.jpg,1,0,0,0,1,,val
0506799_sc-205765.jpg,1,1,0,0,2,,test
0506800_sc-205765.jpg,1,1,0,0,2,,train
0506801_sc-205765.jpg,1,1,0,0,2,,train
0506802_sc-205765.jpg,0,1,0,0,1,,train
0506805_sc-193597.jpg,5,0,1,0,6,,train
0506806_sc-193597.jpg,5,0,1,0,6,,train
0506807_sc-193597.jpg,3,0,1,0,4,,train
0506809_as-2817789.jpg,1,0,0,0,1,,train
0506810_as-9013373.jpg,5,0,0,0,5,,val
0506811_sc-1022938.jpg,1,2,0,0,3,,val
0506812_as-3469891.jpg,0,0,1,0,1,,test
0506813_sc-145547.jpg,0,1,0,0,1,,train
0506814_sc-145547.jpg,1,1,0,1,3,,train
0506815_sc-104631.jpg,3,0,0,0,3,,train
0506816_sc-104631.jpg,1,0,0,0,1,,train
0506817_sc-104631.jpg,3,0,0,0,3,,train
0506818_as-0049604.jpg,1,0,0,0,1,,train
0506819_as-0049604.jpg,1,0,0,0,1,,train
0506820_as-0049604.jpg,2,0,0,0,2,,val
0506821_as-0049604.jpg,3,0,0,0,3,,val
0506822_as-0049604.jpg,4,0,0,0,4,,test
0506823_as-0049604.jpg,2,0,0,0,2,,train
0506826_as-0049604.jpg,1,0,1,0,2,,train
0506827_as-0049604.jpg,1,0,1,0,2,,train
0506829_sc-192326.jpg,1,1,0,1,3,,train
0506830_sc-192326.jpg,1,1,0,1,3,,train
0506832_sc-1022391.jpg,0,0,1,0,1,,train
0506834_as-7254572.jpg,1,0,0,0,1,,train
0506835_as-3437606.jpg,0,0,1,2,3,,val
0506837_sc-157608.jpg,1,0,0,0,1,,val
0506838_sc-157608.jpg,1,0,0,0,1,,test
0506840_sc-157608.jpg,1,0,0,0,1,,train
0506841_sc-157608.jpg,1,0,0,0,1,,train
0506842_sc-157608.jpg,1,0,0,0,1,,train
0506843_sc-129609.jpg,1,0,1,0,2,,train
0506845_as-3442508.jpg,1,0,0,0,1,,train
0506846_as-2643929.jpg,0,0,1,0,1,,train
0506848_as-0031154.jpg,4,0,0,3,7,,train
0506849_as-0031154.jpg,1,1,1,1,4,,val
0506850_as-0031154.jpg,2,2,3,0,7,,val
0506852_sc-213030.jpg,8,0,0,0,8,,test
0506853_sc-213030.jpg,6,0,0,1,7,,train
0506854_sc-213030.jpg,4,0,0,0,4,,train
0506855_sc-213030.jpg,1,0,0,1,2,,train
0506856_sc-213030.jpg,3,0,1,0,4,,train
0506857_as-0049006.jpg,2,0,0,0,2,,train
0506858_as-3032887.jpg,2,0,1,0,3,,train
0506859_as-2539738.jpg,1,0,0,1,2,,train
0506863_as-0064582.jpg,1,0,0,0,1,,val
0506864_sc-1014354.jpg,2,0,0,0,2,,val
0506865_sc-1014354.jpg,2,0,0,0,2,,test
0506866_sc-1014354.jpg,1,1,0,0,2,,train
0506867_as-3313834.jpg,1,0,0,0,1,,train
0506868_sc-111961.jpg,1,1,0,1,3,,train
0506870_as-0063304.jpg,2,0,0,0,2,,train
0506871_as-0063304.jpg,2,0,0,0,2,,train
0506872_as-0063304.jpg,1,0,0,0,1,,train
0506873_as-0013004.jpg,1,0,1,0,2,,train
0506874_as-0013004.jpg,1,0,1,0,2,,val
0506875_as-0013004.jpg,1,0,1,0,2,,val
0506876_as-0013004.jpg,2,0,1,0,3,,test
0506877_sc-206219.jpg,3,1,0,0,4,,train
0506879_as-0021699.jpg,2,0,2,1,5,,train
0506880_as-0021699.jpg,1,0,1,1,3,,train
0506881_as-0021699.jpg,1,0,1,1,3,,train
0506882_as-0021699.jpg,1,0,0,1,2,,train
0506883_as-0021699.jpg,1,0,0,0,1,,train
0506884_as-0021699.jpg,1,0,0,0,1,,train
0506885_as-2740740.jpg,1,0,0,0,1,,val
0506886_sc-1024054.jpg,1,0,0,0,1,,val
0506887_sc-1024054.jpg,2,0,0,0,2,,test
0506888_as-9089332.jpg,5,0,1,0,6,,train
0506890_as-3011553.jpg,5,0,0,0,5,,train
0506891_as-0034411.jpg,1,0,1,0,2,,train
0506892_as-0034411.jpg,2,0,0,1,3,,train
0506893_as-0034411.jpg,1,0,0,0,1,,train
0506894_as-0034411.jpg,2,0,0,1,3,,train
0506895_as-0034411.jpg,3,0,0,1,4,,train
0506896_as-2923369.jpg,0,0,0,1,1,,val
0506898_as-0035777.jpg,0,0,1,0,1,,val
0506901_as-7344758.jpg,1,1,0,0,2,,test
0506903_sc-226409.jpg,1,1,0,1,3,,train
0506904_as-0037132.jpg,3,0,0,0,3,,train
0506905_as-0037132.jpg,1,0,1,0,2,,train
0506906_as-0037132.jpg,2,0,1,0,3,,train
0506907_as-0037132.jpg,1,0,3,0,4,,train
0506908_as-0037132.jpg,1,0,0,0,1,,train
0506909_sc-1035602.jpg,0,0,0,1,1,,train
0506910_as-0027365.jpg,1,0,1,1,3,,val
0506911_as-0027365.jpg,3,0,1,2,6,,val
0506912_as-0027365.jpg,1,0,1,1,3,,test
0506913_as-0027365.jpg,1,0,0,1,2,,train
0506914_as-3467234.jpg,2,1,1,0,4,,train
0506915_sc-144371.jpg,0,0,1,0,1,,train
0506916_sc-144371.jpg,3,0,0,0,3,,train
0506917_sc-144371.jpg,2,0,0,0,2,,train
0506918_sc-144371.jpg,3,0,0,0,3,,train
0506919_sc-144371.jpg,2,0,0,0,2,,train
0506920_sc-144371.jpg,0,0,1,0,1,,val
0506921_as-0078111.jpg,1,0,0,1,2,,val
0506922_as-0078111.jpg,3,3,1,0,7,,test
0506923_as-0078111.jpg,2,2,1,0,5,,train
0506926_as-0085223.jpg,1,0,2,0,3,,train
0506927_as-0085223.jpg,1,0,2,0,3,,train
0506928_as-0085223.jpg,1,0,1,0,2,,train
0506929_as-0085223.jpg,0,1,0,0,1,,train
0506930_as-0020240.jpg,1,0,0,0,1,,train
0506932_as-0020240.jpg,1,0,0,0,1,,train
0506933_as-0020240.jpg,1,0,1,0,2,,val
0506934_as-0020240.jpg,1,0,0,0,1,,val
0506936_sc-1039950.jpg,1,1,0,0,2,,test
0506937_sc-1039950.jpg,1,0,1,0,2,,train
0506939_sc-1039950.jpg,3,0,0,0,3,,train
0506940_sc-1039950.jpg,2,0,1,0,3,,train
0506941_sc-1015806.jpg,1,2,2,0,5,,train
0506942_as-3471430.jpg,5,1,2,1,9,,train
0506943_as-9011591.jpg,1,1,1,0,3,,train
0506944_as-0045534.jpg,1,1,0,0,2,,train
0506945_as-0078065.jpg,4,0,1,0,5,,val
0506946_as-0078065.jpg,2,0,1,0,3,,val
0506948_as-0078065.jpg,1,0,2,0,3,,test
0506949_as-0078065.jpg,0,0,2,1,3,,train
0506950_as-0078065.jpg,3,2,5,1,11,,train
0506952_sc-185760.jpg,1,0,0,1,2,,train
0506953_sc-185760.jpg,2,0,0,1,3,,train
0506954_sc-185760.jpg,1,0,0,1,2,,train
0506955_as-3129111.jpg,1,0,2,2,5,,train
0506956_sc-175866.jpg,7,0,3,1,11,,train
0506957_sc-175866.jpg,5,0,2,2,9,,val
0506958_sc-175866.jpg,5,0,3,1,9,,val
0506959_sc-175866.jpg,5,0,1,0,6,,test
0506960_sc-175866.jpg,5,0,2,0,7,,train
0506961_as-3176631.jpg,0,0,0,1,1,,train
0506962_sc-1038436.jpg,3,0,0,0,3,,train
0506963_sc-1038436.jpg,3,0,0,0,3,,train
0506966_as-0030869.jpg,1,0,0,0,1,,train
0506967_as-0030869.jpg,2,0,0,0,2,,train
0506968_as-0030869.jpg,1,0,0,1,2,,train
0506969_as-0001486.jpg,2,0,0,0,2,,val
0506970_as-0001486.jpg,1,0,0,0,1,,val
0506974_sc-209670.jpg,2,0,0,0,2,,test
0506975_as-0069378.jpg,5,0,0,0,5,,train
0506976_as-0069378.jpg,2,0,0,0,2,,train
0506977_as-0069378.jpg,1,0,0,0,1,,train
0506978_as-0069378.jpg,3,0,0,0,3,,train
0506979_sc-161470.jpg,4,1,1,0,6,,train
0506980_sc-161470.jpg,3,0,0,0,3,,train
0506981_sc-1020740.jpg,3,0,1,2,6,,train
0506982_sc-1020740.jpg,1,0,0,0,1,,val
0506983_sc-1020740.jpg,4,0,0,0,4,,val
0506984_sc-1021418.jpg,1,1,1,0,3,,test
0506985_as-2601681.jpg,3,0,0,0,3,,train
0506986_sc-1035998.jpg,4,0,0,0,4,,train
0506987_sc-1035998.jpg,3,0,0,0,3,,train
0506989_sc-215700.jpg,1,0,0,0,1,,train
0506990_sc-215700.jpg,1,0,0,0,1,,train
0506991_sc-215700.jpg,1,0,0,0,1,,train
0506992_sc-215700.jpg,1,0,0,0,1,,train
0506996_as-0038330.jpg,3,1,1,2,7,,val
0506997_as-0038330.jpg,5,1,1,1,8,,val
0506998_as-0038330.jpg,4,2,1,2,9,,test
0506999_as-0038330.jpg,2,2,1,1,6,,train
0507000_as-0038330.jpg,2,1,1,1,5,,train
0507001_as-0038330.jpg,0,1,0,0,1,,train
0507002_as-0038330.jpg,2,1,0,0,3,,train
0507003_as-0038330.jpg,0,1,1,1,3,,train
0507004_as-0038330.jpg,1,1,1,1,4,,train
0507006_as-0011668.jpg,0,0,0,2,2,,train
0507007_as-0011668.jpg,0,0,0,2,2,,val
0507008_as-0011668.jpg,0,0,0,2,2,,val
0507009_as-0011668.jpg,0,0,0,1,1,,test
0507010_as-0011668.jpg,0,0,0,1,1,,train
0507011_as-0011668.jpg,1,0,0,0,1,,train
0507012_as-0011668.jpg,0,0,0,1,1,,train
0507013_sc-202640.jpg,1,0,1,1,3,,train
0507014_sc-202640.jpg,1,0,1,1,3,,train
0507015_sc-202640.jpg,1,0,1,1,3,,train
0507016_sc-202640.jpg,2,0,1,1,4,,train
0507018_as-0035190.jpg,2,0,0,0,2,,val
0507019_as-0035190.jpg,1,0,0,0,1,,val
0507020_as-0035190.jpg,1,0,0,0,1,,test
0507021_sc-181497.jpg,1,0,0,1,2,,train
0507022_sc-164215.jpg,0,0,1,0,1,,train
0507023_sc-164215.jpg,0,0,1,0,1,,train
0507024_sc-164215.jpg,2,0,0,0,2,,train
0507025_sc-167902.jpg,1,0,0,1,2,,train
0507026_sc-167902.jpg,1,0,0,1,2,,train
0507027_as-0036522.jpg,8,4,2,3,17,,train
0507028_as-0036522.jpg,8,3,1,1,13,,val
0507031_as-7483844.jpg,2,0,0,0,2,,val
0507032_as-0018518.jpg,1,0,0,0,1,,test
0507033_as-0018518.jpg,1,0,0,1,2,,train
0507034_as-0018518.jpg,1,0,0,0,1,,train
0507035_as-0018518.jpg,3,0,0,1,4,,train
0507036_as-0018518.jpg,2,0,0,1,3,,train
0507037_sc-125564.jpg,3,1,0,0,4,,train
0507039_sc-1017999.jpg,0,1,0,0,1,,train
0507040_sc-1003046.jpg,4,0,0,0,4,,train
0507042_sc-1003046.jpg,1,0,0,0,1,,val
0507043_sc-1003046.jpg,1,0,0,0,1,,val
0507044_sc-1003046.jpg,1,0,0,0,1,,test
0507046_sc-205837.jpg,5,0,1,0,6,,train
0507047_sc-205837.jpg,2,0,0,0,2,,train
0507048_sc-205837.jpg,1,0,0,1,2,,train
0507049_sc-161450.jpg,4,0,0,0,4,,train
0507050_sc-161450.jpg,5,0,0,0,5,,train
0507051_sc-161450.jpg,8,0,0,0,8,,train
0507052_sc-161450.jpg,7,0,0,0,7,,train
0507053_sc-161450.jpg,1,0,0,0,1,,val
0507054_as-7513378.jpg,1,1,2,0,4,,val
0507055_sc-108794.jpg,4,1,0,0,5,,test
0507056_sc-108794.jpg,3,1,0,0,4,,train
0507057_sc-108794.jpg,3,1,0,0,4,,train
0507058_sc-108794.jpg,0,1,0,0,1,,train
0507059_as-3313969.jpg,2,0,0,0,2,,train
0507061_as-2547412.jpg,3,0,1,1,5,,train
0507062_sc-113737.jpg,0,0,1,2,3,,train
0507064_sc-113737.jpg,2,0,1,4,7,,train
0507066_as-0098237.jpg,3,1,1,1,6,,val
0507071_as-0098237.jpg,6,1,2,2,11,,val
0507072_as-0098237.jpg,2,1,0,1,4,,test
0507073_as-0098237.jpg,1,0,2,1,4,,train
0507074_as-0098237.jpg,1,0,0,0,1,,train
0507078_as-0054270.jpg,1,0,0,0,1,,train
0507079_as-0054270.jpg,7,0,0,0,7,,train
0507080_as-0054270.jpg,3,0,0,0,3,,train
0507081_as-0054270.jpg,5,0,0,0,5,,train
0507082_as-0054270.jpg,6,0,0,0,6,,train
0507084_as-0054270.jpg,3,0,0,0,3,,val
0507085_sc-102956.jpg,4,0,0,0,4,,val
0507086_sc-102956.jpg,4,0,0,0,4,,test
0507087_sc-102956.jpg,3,0,0,0,3,,train
0507088_as-2948095.jpg,3,0,1,1,5,,train
0507089_as-3477494.jpg,1,1,0,0,2,,train
0507090_as-7618415.jpg,2,0,0,0,2,,train
0507091_as-2760585.jpg,3,0,0,1,4,,train
0507092_sc-225891.jpg,2,0,0,0,2,,train
0507093_sc-225891.jpg,2,0,0,0,2,,train
0507094_sc-225891.jpg,2,0,0,0,2,,val
0507095_sc-225891.jpg,2,0,0,0,2,,val
0507096_sc-225891.jpg,1,0,0,1,2,,test
0507097_sc-225891.jpg,1,0,0,1,2,,train
0507098_sc-225891.jpg,1,0,0,0,1,,train
0507099_sc-225891.jpg,2,0,0,0,2,,train
0507100_sc-225891.jpg,3,0,0,0,3,,train
0507101_sc-225891.jpg,1,0,0,0,1,,train
0507102_sc-225891.jpg,0,0,1,0,1,,train
0507103_sc-225891.jpg,0,0,1,0,1,,train
0507106_as-0057881.jpg,3,0,0,0,3,,val
0507107_as-0057881.jpg,2,0,0,0,2,,val
0507108_sc-131226.jpg,3,0,0,1,4,,test
0507109_sc-131226.jpg,1,0,0,0,1,,train
0507111_sc-131226.jpg,3,0,0,1,4,,train
0507112_sc-131226.jpg,1,0,0,0,1,,train
0507113_as-0029031.jpg,1,0,0,0,1,,train
0507114_as-0029031.jpg,2,0,0,0,2,,train
0507115_as-0029031.jpg,3,0,0,0,3,,train
0507117_as-0030851.jpg,3,1,1,1,6,,train
0507118_as-0030851.jpg,3,1,1,1,6,,val
0507119_as-3438913.jpg,1,0,1,0,2,,val
0507120_as-0023676.jpg,1,0,0,1,2,,test
0507121_as-0085943.jpg,3,0,0,2,5,,train
0507125_sc-105354.jpg,4,1,0,0,5,,train
0507126_as-3086522.jpg,3,0,2,0,5,,train
0507127_as-2555199.jpg,1,0,0,0,1,,train
0507128_as-0012442.jpg,0,0,1,0,1,,train
0507129_as-0012442.jpg,0,1,1,0,2,,train
0507130_as-0012442.jpg,0,0,1,0,1,,train
0507133_as-0012442.jpg,1,0,1,0,2,,val
0507134_as-0012442.jpg,0,0,1,0,1,,val
0507135_sc-1020660.jpg,0,0,1,0,1,,test
0507136_sc-1020660.jpg,3,2,2,1,8,,train
0507137_sc-1020660.jpg,1,0,1,0,2,,train
0507138_sc-1020660.jpg,2,1,1,0,4,,train
0507139_sc-1003335.jpg,1,1,1,1,4,,train
0507140_sc-1003335.jpg,2,0,1,0,3,,train
0507143_as-0004572.jpg,1,0,1,0,2,,train
0507144_as-0004572.jpg,1,0,0,0,1,,train
0507145_as-0004572.jpg,2,0,2,0,4,,val
0507146_as-0004572.jpg,1,0,3,0,4,,val
0507147_as-0004572.jpg,1,1,1,0,3,,test
0507148_as-7268062.jpg,5,0,1,0,6,,train
0507149_as-2855946.jpg,3,0,0,0,3,,train
0507150_sc-222425.jpg,5,0,1,0,6,,train
0507151_sc-222425.jpg,3,0,0,0,3,,train
0507152_sc-115684.jpg,3,0,1,0,4,,train
0507153_as-0097944.jpg,1,0,0,0,1,,train
0507154_as-0097944.jpg,1,0,0,0,1,,train
0507155_as-0097944.jpg,4,0,1,0,5,,val
0507156_sc-219275.jpg,0,0,1,2,3,,val
0507157_sc-219275.jpg,1,0,1,1,3,,test
0507158_sc-219275.jpg,1,0,1,1,3,,train
0507159_sc-219275.jpg,2,0,1,0,3,,train
0507160_sc-219275.jpg,1,0,0,0,1,,train
0507162_as-0088944.jpg,1,0,0,0,1,,train
0507163_as-2822327.jpg,1,0,1,0,2,,train
0507164_sc-143197.jpg,1,0,0,0,1,,train
0507166_as-0044617.jpg,1,0,0,0,1,,train
0507169_sc-192514.jpg,2,1,0,0,3,,val
0507170_sc-181661.jpg,4,0,0,0,4,,val
0507171_sc-181661.jpg,2,0,0,1,3,,test
0507173_sc-181661.jpg,1,0,0,0,1,,train
0507174_sc-181661.jpg,2,0,0,1,3,,train
0507175_as-3316063.jpg,1,1,1,0,3,,train
0507179_as-0020237.jpg,0,0,0,1,1,,train
0507181_as-0020237.jpg,0,1,0,2,3,,train
0507183_as-0012038.jpg,2,1,1,2,6,,train
0507184_as-0012038.jpg,2,1,1,2,6,,train
0507185_as-0012038.jpg,0,0,1,0,1,,val
0507186_as-0012038.jpg,1,0,1,0,2,,val
0507187_as-0012038.jpg,4,2,4,1,11,,test
0507188_as-0012038.jpg,0,1,1,0,2,,train
0507189_as-0012038.jpg,1,0,1,0,2,,train
0507190_as-0012038.jpg,1,0,2,0,3,,train
0507191_as-0012038.jpg,1,1,1,0,3,,train
0507192_sc-157527.jpg,1,0,0,0,1,,train
0507193_sc-157527.jpg,1,0,0,0,1,,train
0507194_sc-221342.jpg,1,0,1,2,4,,train
0507195_sc-221342.jpg,0,0,1,2,3,,val
0507196_sc-221342.jpg,2,0,0,1,3,,val
0507197_as-3131363.jpg,1,0,0,1,2,,test
0507198_as-3120896.jpg,3,0,0,1,4,,train
0507199_as-0034308.jpg,3,1,1,0,5,,train
0507200_as-0034308.jpg,1,0,0,0,1,,train
0507201_as-0034308.jpg,1,0,1,1,3,,train
0507202_as-0034308.jpg,1,1,1,2,5,,train
0507205_as-0053635.jpg,2,0,0,0,2,,train
0507206_as-0053635.jpg,2,0,0,1,3,,train
0507207_as-0053635.jpg,3,0,0,1,4,,val
0507209_as-7525719.jpg,1,0,0,0,1,,val
0507210_sc-207731.jpg,1,2,0,0,3,,test
0507211_sc-207731.jpg,2,1,0,0,3,,train
0507212_sc-207731.jpg,0,2,0,0,2,,train
0507213_sc-207731.jpg,0,1,0,0,1,,train
0507214_sc-207731.jpg,1,4,0,0,5,,train
0507215_as-2603312.jpg,3,1,0,0,4,,train
0507216_as-0061709.jpg,5,1,0,1,7,,train
0507217_as-0061709.jpg,4,1,0,1,6,,train
0507218_as-0061709.jpg,1,2,1,1,5,,val
0507219_as-0061709.jpg,6,1,0,1,8,,val
0507220_as-0008906.jpg,1,1,0,1,3,,test
0507221_as-0008906.jpg,1,0,0,1,2,,train
0507224_as-0015270.jpg,2,0,0,1,3,,train
0507225_as-0015270.jpg,3,0,0,2,5,,train
0507226_as-0015270.jpg,1,0,0,1,2,,train
0507227_as-0015270.jpg,1,0,0,1,2,,train
0507228_as-0015270.jpg,2,0,0,1,3,,train
0507230_as-0015270.jpg,2,0,0,1,3,,train
0507232_as-0082354.jpg,2,0,1,1,4,,val
0507233_as-0082354.jpg,3,0,1,0,4,,val
0507234_as-0082354.jpg,2,0,1,1,4,,test
0507235_sc-219409.jpg,4,0,0,0,4,,train
0507236_sc-219409.jpg,4,0,0,0,4,,train
0507237_sc-219409.jpg,0,0,1,1,2,,train
0507238_sc-219409.jpg,2,0,0,0,2,,train
0507241_as-0056774.jpg,3,0,2,2,7,,train
0507242_as-0056774.jpg,1,0,1,1,3,,train
0507243_as-0080684.jpg,1,1,0,0,2,,train
0507246_sc-127322.jpg,2,0,0,4,6,,val
0507247_sc-127322.jpg,1,1,0,0,2,,val
0507249_sc-127322.jpg,3,0,2,1,6,,test
0507250_sc-127322.jpg,1,0,1,2,4,,train
0507251_sc-127322.jpg,2,0,1,3,6,,train
0507252_sc-127322.jpg,1,0,1,2,4,,train
0507253_sc-127322.jpg,1,0,1,1,3,,train
0507254_sc-127322.jpg,0,1,0,0,1,,train
0507255_sc-127322.jpg,2,0,0,0,2,,train
0507256_sc-127322.jpg,3,0,1,0,4,,train
0507257_sc-119603.jpg,1,0,0,0,1,,val
0507258_sc-119603.jpg,1,0,1,1,3,,val
0507259_as-0068511.jpg,0,0,0,1,1,,test
0507260_as-0068511.jpg,0,0,0,1,1,,train
0507262_as-0061212.jpg,2,0,0,0,2,,train
0507263_sc-169433.jpg,0,0,1,0,1,,train
0507264_as-9027200.jpg,2,0,0,0,2,,train
0507265_as-9021068.jpg,1,1,0,0,2,,train
0507266_sc-210554.jpg,7,0,1,2,10,,train
0507267_sc-210554.jpg,5,0,1,2,8,,train
0507268_sc-210554.jpg,2,0,1,1,4,,val
0507269_sc-210554.jpg,2,0,1,1,4,,val
0507272_as-0014377.jpg,3,0,0,0,3,,test
0507273_as-0014377.jpg,3,0,0,0,3,,train
0507274_as-0014377.jpg,3,0,0,0,3,,train
0507275_as-0014377.jpg,2,0,0,0,2,,train
0507276_as-0014377.jpg,2,0,0,0,2,,train
0507277_as-0014377.jpg,1,0,0,0,1,,train
0507280_as-0001966.jpg,3,0,0,0,3,,train
0507281_as-0001966.jpg,3,0,0,0,3,,train
0507282_sc-210528.jpg,1,0,3,1,5,,val
0507283_sc-210528.jpg,2,0,3,1,6,,val
0507284_sc-210528.jpg,2,0,4,2,8,,test
0507285_sc-210528.jpg,1,1,1,0,3,,train
0507286_sc-210528.jpg,2,0,0,0,2,,train
0507287_sc-210528.jpg,1,0,4,1,6,,train
0507288_sc-210528.jpg,2,0,3,2,7,,train
0507289_sc-210528.jpg,2,0,5,2,9,,train
0507290_sc-210528.jpg,2,1,4,2,9,,train
0507291_sc-210528.jpg,2,0,3,2,7,,train
0507292_sc-210528.jpg,2,0,3,2,7,,val
0507293_sc-210528.jpg,2,2,3,2,9,,val
0507294_as-0093041.jpg,1,0,1,0,2,,test
0507295_as-0093041.jpg,1,0,1,0,2,,train
0507296_as-0093041.jpg,2,0,0,0,2,,train
0507297_as-0093041.jpg,2,1,0,0,3,,train
0507298_as-0093041.jpg,5,1,0,0,6,,train
0507299_as-9079647.jpg,1,1,0,0,2,,train
0507300_as-7112692.jpg,0,1,1,0,2,,train
0507301_as-2595274.jpg,2,0,2,1,5,,train
0507306_as-0027460.jpg,1,0,0,0,1,,val
0507307_as-0027460.jpg,1,0,0,0,1,,val
0507309_sc-119385.jpg,0,2,1,0,3,,test
0507310_sc-119385.jpg,0,2,1,0,3,,train
0507311_sc-119385.jpg,0,0,1,0,1,,train
0507312_sc-119385.jpg,1,0,1,0,2,,train
0507313_as-0046051.jpg,0,1,1,0,2,,train
0507314_as-0046051.jpg,4,1,2,1,8,,train
0507315_as-0046051.jpg,1,1,0,0,2,,train
0507316_as-0046051.jpg,5,0,0,0,5,,train
0507318_sc-120678.jpg,0,0,0,1,1,,val
0507321_as-0032183.jpg,5,0,0,0,5,,val
0507322_sc-171619.jpg,1,0,0,0,1,,test
0507324_sc-171619.jpg,1,0,0,0,1,,train
0507325_sc-171619.jpg,2,0,0,0,2,,train
0507326_sc-171619.jpg,2,0,0,0,2,,train
0507327_sc-171619.jpg,0,1,0,0,1,,train
0507328_sc-171619.jpg,1,0,0,0,1,,train
0507329_sc-171619.jpg,1,0,0,0,1,,train
0507330_sc-171619.jpg,1,0,0,0,1,,train
0507331_sc-171619.jpg,2,0,1,0,3,,val
0507332_sc-183407.jpg,1,0,1,0,2,,val
0507333_sc-183407.jpg,3,0,0,0,3,,test
0507334_sc-183407.jpg,1,1,1,0,3,,train
0507337_as-0018375.jpg,0,0,2,1,3,,train
0507338_as-7102788.jpg,1,1,0,0,2,,train
0507339_as-0037402.jpg,3,0,1,0,4,,train
0507340_as-0037402.jpg,1,0,1,0,2,,train
0507341_as-0037402.jpg,1,0,1,0,2,,train
0507342_as-0037402.jpg,2,0,1,0,3,,train
0507343_as-0037402.jpg,1,0,0,0,1,,val
0507344_sc-151225.jpg,1,0,0,0,1,,val
0507345_sc-151225.jpg,2,0,0,1,3,,test
0507346_sc-151225.jpg,6,0,0,0,6,,train
0507347_sc-145404.jpg,2,0,1,0,3,,train
0507348_sc-145404.jpg,0,0,1,0,1,,train
0507349_sc-177585.jpg,1,1,1,0,3,,train
0507350_sc-220371.jpg,5,0,0,0,5,,train
0507352_sc-116568.jpg,1,3,1,0,5,,train
0507353_sc-116568.jpg,1,0,1,0,2,,train
0507354_sc-116568.jpg,1,0,1,0,2,,val
0507355_sc-116568.jpg,1,0,1,0,2,,val
0507356_sc-116568.jpg,1,0,0,0,1,,test
0507357_as-2761295.jpg,1,1,0,0,2,,train
0507359_sc-131182.jpg,1,0,1,1,3,,train
0507360_sc-131182.jpg,2,0,0,0,2,,train
0507362_sc-177039.jpg,4,0,2,0,6,,train
0507363_sc-177039.jpg,4,0,2,0,6,,train
0507364_as-7412639.jpg,0,0,1,0,1,,train
0507365_sc-119819.jpg,9,0,0,1,10,,train
0507366_sc-119819.jpg,14,0,0,0,14,,val
0507368_as-0072623.jpg,3,0,0,0,3,,val
0507369_as-0072623.jpg,1,0,0,1,2,,test
0507370_as-0072623.jpg,1,0,0,0,1,,train
0507371_as-0072623.jpg,1,0,0,0,1,,train
0507372_as-0072623.jpg,1,0,0,0,1,,train
0507373_sc-201297.jpg,2,0,0,0,2,,train
0507374_sc-201297.jpg,1,0,1,0,2,,train
0507375_sc-201297.jpg,2,0,0,0,2,,train
0507376_sc-201297.jpg,2,0,0,0,2,,train
0507377_sc-201297.jpg,0,0,1,0,1,,val
0507378_as-3358810.jpg,0,1,0,0,1,,val
0507382_as-0041940.jpg,2,0,1,1,4,,test
0507383_as-0041940.jpg,1,0,1,0,2,,train
0507384_as-0041940.jpg,0,0,1,0,1,,train
0507385_as-0041940.jpg,0,0,1,0,1,,train
0507386_as-0041940.jpg,1,0,2,0,3,,train
0507387_as-0041940.jpg,2,0,2,0,4,,train
0507388_as-0041940.jpg,1,0,1,0,2,,train
0507389_as-0041940.jpg,0,0,1,1,2,,train
0507390_as-0041940.jpg,0,0,2,1,3,,val
0507391_as-0041940.jpg,1,0,1,1,3,,val
0507392_as-0041940.jpg,1,0,1,0,2,,test
0507393_as-0041940.jpg,2,0,1,0,3,,train
0507394_as-0041940.jpg,3,0,0,0,3,,train
0507395_as-0041940.jpg,1,0,1,0,2,,train
0507396_sc-1032424.jpg,0,0,1,0,1,,train
0507397_sc-1032424.jpg,2,0,1,1,4,,train
0507399_as-0070152.jpg,3,2,0,0,5,,train
0507400_as-0070152.jpg,2,1,0,0,3,,train
0507401_sc-207687.jpg,1,1,0,0,2,,val
0507402_sc-207687.jpg,1,1,0,0,2,,val
0507403_sc-207687.jpg,0,1,0,0,1,,test
0507404_sc-207687.jpg,1,0,1,0,2,,train
0507405_sc-207687.jpg,1,0,0,0,1,,train
0507406_sc-207687.jpg,1,0,0,0,1,,train
0507407_as-2559165.jpg,1,1,1,1,4,,train
0507408_sc-1023808.jpg,2,0,0,1,3,,train
0507409_sc-1023808.jpg,2,0,0,0,2,,train
0507410_sc-1023808.jpg,3,0,0,1,4,,train
0507411_sc-1023808.jpg,2,0,0,0,2,,val
0507412_sc-1023808.jpg,2,0,0,1,3,,val
0507416_sc-104825.jpg,0,0,1,0,1,,test
0507417_sc-196460.jpg,0,0,1,0,1,,train
0507418_sc-196460.jpg,4,0,1,0,5,,train
0507419_as-0067779.jpg,2,0,0,0,2,,train
0507420_sc-1040741.jpg,1,1,3,1,6,,train
0507421_sc-1040741.jpg,2,0,1,0,3,,train
0507423_sc-1040741.jpg,1,1,1,1,4,,train
0507424_as-9098118.jpg,2,0,0,0,2,,train
0507425_sc-181541.jpg,4,0,1,0,5,,val
0507426_sc-181541.jpg,5,0,1,0,6,,val
0507428_sc-181541.jpg,4,0,1,0,5,,test
0507429_sc-181541.jpg,4,1,1,0,6,,train
0507430_as-7372848.jpg,2,0,0,0,2,,train
0507431_as-3128259.jpg,5,0,0,0,5,,train
0507432_as-3314287.jpg,2,0,0,0,2,,train
0507433_sc-194890.jpg,11,0,0,0,11,,train
0507434_sc-194890.jpg,12,1,0,0,13,,train
0507435_sc-194890.jpg,7,1,0,0,8,,train
0507436_sc-194890.jpg,2,0,0,0,2,,val
0507437_as-3194988.jpg,1,0,0,0,1,,val
0507438_as-2529589.jpg,0,0,1,1,2,,test
0507440_sc-1038127.jpg,2,0,0,0,2,,train
0507441_sc-1038127.jpg,2,0,0,0,2,,train
0507442_as-0011294.jpg,2,0,0,0,2,,train
0507443_as-0011294.jpg,2,0,0,0,2,,train
0507445_as-0046949.jpg,9,1,4,2,16,,train
0507446_as-0046949.jpg,1,0,1,0,2,,train
0507447_as-0046949.jpg,12,1,1,0,14,,train
0507448_as-0046949.jpg,5,1,0,0,6,,val
0507449_as-0046949.jpg,5,1,1,1,8,,val
0507450_as-0046949.jpg,4,0,0,1,5,,test
0507451_as-0046949.jpg,1,0,0,0,1,,train
0507452_as-0046949.jpg,1,0,0,0,1,,train
0507453_as-0046949.jpg,1,0,0,0,1,,train
0507455_as-0046949.jpg,1,1,2,0,4,,train
0507456_as-0030535.jpg,0,0,1,0,1,,train
0507457_as-7223104.jpg,1,0,0,0,1,,train
0507459_sc-151779.jpg,2,0,1,1,4,,train
0507460_sc-227088.jpg,2,0,1,2,5,,val
0507461_sc-227088.jpg,3,0,1,1,5,,val
0507462_sc-227088.jpg,1,0,1,1,3,,test
0507464_as-0093959.jpg,5,0,0,0,5,,train
0507465_as-0093959.jpg,1,0,0,0,1,,train
0507466_as-0093959.jpg,2,0,0,0,2,,train
0507467_as-7627054.jpg,5,0,1,2,8,,train
0507468_as-7373159.jpg,1,1,0,0,2,,train
0507469_sc-116500.jpg,2,0,0,0,2,,train
0507470_sc-1021680.jpg,4,0,0,1,5,,train
0507471_sc-1021680.jpg,2,0,0,1,3,,val
0507472_sc-1021680.jpg,4,0,0,1,5,,val
0507473_sc-1021680.jpg,2,0,0,0,2,,test
0507474_as-2837617.jpg,1,0,1,0,2,,train
0507475_as-3388360.jpg,0,1,0,0,1,,train
0507476_sc-196898.jpg,2,1,0,0,3,,train
0507477_sc-196898.jpg,2,0,1,1,4,,train
0507478_as-3147515.jpg,0,0,0,2,2,,train
0507479_sc-217764.jpg,1,0,1,0,2,,train
0507480_as-0037985.jpg,1,0,0,0,1,,train
0507481_as-0037985.jpg,2,0,0,0,2,,val
0507483_as-0083338.jpg,1,0,0,0,1,,val
0507484_as-2767377.jpg,1,0,1,0,2,,test
0507485_sc-229757.jpg,1,3,1,1,6,,train
0507486_sc-179050.jpg,1,0,0,1,2,,train
0507487_sc-179050.jpg,1,0,1,2,4,,train
0507488_sc-179050.jpg,1,0,1,2,4,,train
0507489_sc-179050.jpg,1,0,0,2,3,,train
0507490_sc-179050.jpg,1,0,0,0,1,,train
0507491_sc-179050.jpg,1,0,1,0,2,,train
0507492_sc-179050.jpg,1,0,1,0,2,,val
0507493_sc-179050.jpg,1,1,0,0,2,,val
0507494_sc-179050.jpg,2,0,0,0,2,,test
0507495_sc-179050.jpg,1,0,1,0,2,,train
0507496_sc-179050.jpg,0,0,0,1,1,,train
0507497_sc-179050.jpg,1,0,0,0,1,,train
0507498_sc-179050.jpg,1,0,1,0,2,,train
0507499_sc-179050.jpg,1,0,1,0,2,,train
0507503_as-0016093.jpg,2,0,1,1,4,,train
0507504_as-0016093.jpg,0,0,2,0,2,,train
0507505_as-0016093.jpg,1,0,1,1,3,,val
0507506_as-0016093.jpg,3,0,1,1,5,,val
0507507_as-0016093.jpg,2,0,1,1,4,,test
0507508_as-0016093.jpg,1,0,2,1,4,,train
0507509_sc-127519.jpg,0,0,2,1,3,,train
0507511_as-0098013.jpg,5,0,3,1,9,,train
0507513_as-0098013.jpg,4,0,3,0,7,,train
0507514_as-0098013.jpg,10,0,2,1,13,,train
0507515_as-0098013.jpg,1,0,0,1,2,,train
0507516_as-0098013.jpg,3,1,0,0,4,,train
0507517_as-0098013.jpg,6,0,3,0,9,,val
0507518_as-0098013.jpg,1,0,0,0,1,,val
0507519_sc-195094.jpg,1,0,0,0,1,,test
0507520_sc-195094.jpg,1,0,0,0,1,,train
0507521_sc-195094.jpg,2,0,0,0,2,,train
0507522_sc-195094.jpg,1,0,0,0,1,,train
0507524_sc-125416.jpg,1,0,0,0,1,,train
0507525_sc-125416.jpg,2,0,0,1,3,,train
0507526_sc-125416.jpg,5,0,0,0,5,,train
0507527_sc-1022589.jpg,2,1,0,0,3,,train
0507528_sc-191272.jpg,4,1,1,0,6,,val
0507529_sc-191272.jpg,4,2,2,0,8,,val
0507530_sc-191272.jpg,0,0,1,0,1,,test
0507531_sc-191272.jpg,0,0,1,0,1,,train
0507532_sc-169363.jpg,1,0,0,0,1,,train
0507535_as-0074354.jpg,2,0,1,0,3,,train
0507536_as-0074354.jpg,1,0,1,1,3,,train
0507537_as-0074354.jpg,1,0,0,0,1,,train
0507538_as-0074354.jpg,1,0,0,0,1,,train
0507539_as-0074354.jpg,1,0,1,1,3,,train
0507540_as-0074354.jpg,1,0,0,0,1,,val
0507541_as-0074354.jpg,1,0,0,1,2,,val
0507542_sc-136096.jpg,4,0,0,1,5,,test
0507544_sc-219462.jpg,2,3,1,1,7,,train
0507548_sc-1005830.jpg,0,0,2,0,2,,train
0507549_sc-1005830.jpg,2,1,0,0,3,,train
0507550_as-7883012.jpg,1,0,0,0,1,,train
0507553_sc-1012726.jpg,2,0,0,0,2,,train
0507555_sc-228092.jpg,1,0,0,0,1,,train
0507556_sc-228092.jpg,1,0,0,0,1,,train
0507557_sc-228092.jpg,2,0,0,0,2,,val
0507558_sc-228092.jpg,1,0,0,0,1,,val
0507559_sc-228092.jpg,3,0,0,0,3,,test
0507560_sc-228092.jpg,4,0,0,0,4,,train
0507561_sc-228092.jpg,3,0,0,0,3,,train
0507562_sc-228092.jpg,1,0,0,0,1,,train
0507563_sc-228092.jpg,2,0,0,0,2,,train
0507564_sc-228092.jpg,5,0,0,0,5,,train
0507565_sc-228092.jpg,1,1,1,0,3,,train
0507566_sc-228092.jpg,1,0,0,0,1,,train
0507567_sc-228092.jpg,2,0,0,0,2,,val
0507568_sc-228092.jpg,1,0,0,0,1,,val
0507569_sc-228092.jpg,1,0,0,0,1,,test
0507570_sc-228092.jpg,1,0,0,0,1,,train
0507571_as-5017435.jpg,3,0,0,0,3,,train
0507572_as-2889967.jpg,3,1,0,0,4,,train
0507573_as-0029853.jpg,1,0,0,1,2,,train
0507574_as-0029853.jpg,0,0,1,0,1,,train
0507575_as-0025103.jpg,6,0,1,0,7,,train
0507576_as-0085061.jpg,4,0,0,0,4,,train
0507577_as-0085061.jpg,1,0,1,0,2,,val
0507578_as-0085061.jpg,2,0,0,0,2,,val
0507579_as-0085061.jpg,2,0,0,0,2,,test
0507580_as-0085061.jpg,2,0,1,0,3,,train
0507581_as-0085061.jpg,5,0,1,0,6,,train
0507582_as-3345558.jpg,2,0,0,0,2,,train
0507583_as-3345558.jpg,1,0,0,0,1,,train
0507584_sc-1020260.jpg,7,0,0,0,7,,train
0507585_sc-1020260.jpg,9,0,0,0,9,,train
0507586_sc-1020260.jpg,5,0,0,0,5,,train
0507587_sc-1020260.jpg,9,0,0,0,9,,val
0507588_sc-1038480.jpg,5,0,0,0,5,,val
0507589_as-2992217.jpg,1,0,0,0,1,,test
0507591_as-0099538.jpg,1,0,0,0,1,,train
0507593_as-0056635.jpg,1,0,0,0,1,,train
0507595_as-0056635.jpg,1,0,1,0,2,,train
0507599_as-0053769.jpg,2,0,0,0,2,,train
0507600_as-0053769.jpg,4,1,0,0,5,,train
0507601_as-0053769.jpg,1,0,0,0,1,,train
0507604_as-0096102.jpg,1,0,0,0,1,,train
0507605_sc-184600.jpg,2,0,0,0,2,,val
0507607_sc-162996.jpg,1,0,1,0,2,,val
0507608_sc-162996.jpg,1,0,1,0,2,,test
0507609_sc-162996.jpg,4,0,1,0,5,,train
0507611_sc-1029401.jpg,5,0,0,0,5,,train
0507612_as-0097321.jpg,1,0,0,0,1,,train
0507614_as-0097321.jpg,3,0,2,1,6,,train
0507615_as-0097321.jpg,1,0,0,1,2,,train
0507616_as-0097321.jpg,4,0,1,1,6,,train
0507617_as-0097321.jpg,1,0,1,0,2,,train
0507619_as-0097321.jpg,1,0,0,0,1,,val
0507620_as-0097321.jpg,8,0,0,0,8,,val
0507621_as-9022671.jpg,2,0,0,0,2,,test
0507623_as-0034309.jpg,2,0,1,0,3,,train
0507624_as-2633454.jpg,4,0,0,0,4,,train
0507625_as-0030134.jpg,3,0,0,0,3,,train
0507626_as-0030134.jpg,1,0,0,0,1,,train
0507627_as-2883202.jpg,1,0,1,1,3,,train
0507628_as-0034117.jpg,0,0,2,0,2,,train
0507629_as-0034117.jpg,0,1,2,0,3,,train
0507630_as-0034117.jpg,0,2,2,0,4,,val
0507631_as-0034117.jpg,1,4,2,2,9,,val
0507632_as-0034117.jpg,0,0,1,0,1,,test
0507635_as-0099954.jpg,1,0,0,0,1,,train
0507636_sc-120120.jpg,2,1,1,1,5,,train
0507638_as-5152886.jpg,0,0,2,0,2,,train
0507639_as-0022571.jpg,2,0,1,0,3,,train
0507640_as-0022571.jpg,1,0,0,0,1,,train
0507641_as-0022571.jpg,1,0,0,0,1,,train
0507642_as-0022571.jpg,1,0,0,0,1,,train
0507643_as-0022571.jpg,6,0,0,0,6,,val
0507646_as-0063030.jpg,1,0,2,0,3,,val
0507647_as-0063030.jpg,1,1,0,0,2,,test
0507648_as-0008483.jpg,3,0,0,0,3,,train
0507649_as-0008483.jpg,3,0,0,0,3,,train
0507651_as-0033471.jpg,1,1,0,0,2,,train
0507652_as-3417657.jpg,3,0,0,0,3,,train
0507654_sc-189766.jpg,1,0,0,0,1,,train
0507655_as-3292236.jpg,1,0,0,0,1,,train
0507656_as-3292236.jpg,2,0,0,0,2,,train
0507657_as-3292236.jpg,3,2,3,0,8,,val
0507658_as-9025484.jpg,1,0,0,0,1,,val
0507661_as-0094420.jpg,2,1,1,1,5,,test
0507663_as-0094420.jpg,0,0,1,1,2,,train
0507665_sc-221901.jpg,3,0,0,0,3,,train
0507666_sc-221901.jpg,3,0,0,0,3,,train
0507667_sc-221901.jpg,6,0,0,0,6,,train
0507668_sc-221901.jpg,4,1,1,0,6,,train
0507669_sc-221901.jpg,8,0,0,0,8,,train
0507670_sc-221901.jpg,6,0,0,0,6,,train
0507671_sc-221901.jpg,4,0,1,0,5,,val
0507672_as-2838725.jpg,0,1,0,0,1,,val
0507675_as-0089445.jpg,2,2,2,0,6,,test
0507676_as-0089445.jpg,1,1,1,0,3,,train
0507677_as-0089445.jpg,1,0,2,0,3,,train
0507678_as-2945897.jpg,3,0,0,0,3,,train
0507679_as-0095073.jpg,4,0,0,0,4,,train
0507680_as-0095073.jpg,3,0,0,0,3,,train
0507683_as-0093379.jpg,1,0,3,2,6,,train
0507684_as-0093379.jpg,1,0,1,0,2,,train
0507685_as-0093379.jpg,1,0,1,0,2,,val
0507687_as-0069098.jpg,3,0,0,0,3,,val
0507688_as-0069098.jpg,8,0,0,0,8,,test
0507689_as-0069098.jpg,8,0,0,0,8,,train
0507690_as-0069098.jpg,2,0,0,0,2,,train
0507691_as-0069098.jpg,4,0,0,0,4,,train
0507693_as-2663423.jpg,2,0,0,0,2,,train
0507694_as-0071271.jpg,1,0,0,0,1,,train
0507695_as-3139073.jpg,1,2,1,0,4,,train
0507696_as-3139073.jpg,3,1,2,0,6,,train
0507698_as-0013597.jpg,0,0,0,1,1,,val
0507699_as-0013597.jpg,2,1,1,1,5,,val
0507700_sc-133005.jpg,3,0,0,0,3,,test
0507701_sc-133005.jpg,1,0,0,0,1,,train
0507702_sc-1000449.jpg,2,0,2,1,5,,train
0507705_as-2714596.jpg,3,0,0,0,3,,train
0507706_as-3307381.jpg,2,0,1,0,3,,train
0507708_sc-1015942.jpg,4,0,0,0,4,,train
0507709_sc-1015942.jpg,4,0,0,0,4,,train
0507711_sc-1032776.jpg,3,0,0,0,3,,train
0507712_sc-1032776.jpg,2,0,0,0,2,,val
0507714_sc-1032776.jpg,1,0,0,0,1,,val
0507716_sc-1032776.jpg,1,0,0,0,1,,test
0507717_sc-1026128.jpg,0,0,1,0,1,,train
0507718_sc-1026128.jpg,0,0,1,0,1,,train
0507719_sc-1026128.jpg,0,1,1,0,2,,train
0507720_sc-1026128.jpg,0,0,1,0,1,,train
0507721_sc-1026128.jpg,0,1,1,0,2,,train
0507723_as-0000043.jpg,1,1,0,0,2,,train
0507724_as-0077541.jpg,1,0,0,0,1,,train
0507725_as-0077541.jpg,1,0,0,0,1,,val
0507726_as-0077541.jpg,1,0,0,0,1,,val
0507728_as-2601998.jpg,2,0,1,0,3,,test
0507729_as-7544730.jpg,2,0,4,0,6,,train
0507731_as-0014971.jpg,0,0,1,0,1,,train
0507734_as-0014971.jpg,1,0,1,2,4,,train
0507736_as-0014971.jpg,0,0,1,0,1,,train
0507737_as-0014971.jpg,0,0,2,0,2,,train
0507739_as-9051387.jpg,1,0,0,1,2,,train
0507741_as-9028103.jpg,4,0,0,0,4,,train
0507744_as-0052549.jpg,2,1,0,0,3,,val
0507745_as-0052549.jpg,1,1,0,0,2,,val
0507746_as-0052549.jpg,1,0,0,1,2,,test
0507747_as-0052549.jpg,1,0,0,0,1,,train
0507748_as-0052549.jpg,2,0,0,1,3,,train
0507749_as-0052549.jpg,1,0,0,0,1,,train
0507750_as-0052549.jpg,3,0,0,0,3,,train
0507751_as-0052549.jpg,2,0,1,0,3,,train
0507752_as-7350847.jpg,2,1,1,1,5,,train
0507753_sc-225693.jpg,3,0,0,0,3,,train
0507754_sc-225693.jpg,4,0,0,0,4,,val
0507755_sc-225693.jpg,4,0,0,0,4,,val
0507756_sc-225693.jpg,2,0,0,0,2,,test
0507757_sc-225693.jpg,3,0,0,0,3,,train
0507758_sc-225693.jpg,1,0,0,0,1,,train
0507759_sc-214359.jpg,1,0,0,0,1,,train
0507760_sc-214359.jpg,1,0,0,0,1,,train
0507761_sc-214359.jpg,1,0,0,0,1,,train
0507762_sc-214359.jpg,1,0,0,0,1,,train
0507763_sc-214359.jpg,1,0,1,0,2,,train
0507764_sc-214359.jpg,1,0,0,0,1,,val
0507765_sc-217825.jpg,1,1,1,0,3,,val
0507766_sc-217825.jpg,0,1,1,0,2,,test
0507767_sc-122938.jpg,5,0,2,1,8,,train
0507768_sc-122938.jpg,5,0,1,1,7,,train
0507769_as-3367568.jpg,0,0,1,0,1,,train
0507771_as-0029426.jpg,4,2,0,0,6,,train
0507772_as-0029426.jpg,3,2,0,0,5,,train
0507775_sc-173877.jpg,2,0,0,0,2,,train
0507779_sc-107882.jpg,3,0,0,1,4,,train
0507780_sc-107882.jpg,2,0,1,1,4,,val
0507781_sc-107882.jpg,2,0,0,1,3,,val
0507782_sc-107882.jpg,2,0,1,1,4,,test
0507783_sc-107882.jpg,3,0,1,1,5,,train
0507784_sc-107882.jpg,1,0,0,1,2,,train
0507787_as-0059788.jpg,4,0,0,0,4,,train
0507790_sc-126720.jpg,1,0,0,0,1,,train
0507791_as-0087899.jpg,3,0,0,0,3,,train
0507792_as-0087899.jpg,3,0,0,0,3,,train
0507793_as-0033096.jpg,3,0,0,0,3,,train
0507794_as-0033096.jpg,2,1,1,0,4,,val
0507797_sc-156319.jpg,2,0,1,3,6,,val
0507798_sc-156319.jpg,0,0,0,1,1,,test
0507801_as-9078963.jpg,1,0,0,0,1,,train
0507803_sc-153240.jpg,2,0,0,0,2,,train
0507804_sc-153240.jpg,2,0,0,0,2,,train
0507806_sc-153240.jpg,4,0,0,0,4,,train
0507811_sc-190525.jpg,7,1,0,1,9,,train
0507812_sc-190525.jpg,6,1,1,0,8,,train
0507813_sc-190525.jpg,1,0,1,0,2,,train
0507814_as-2619641.jpg,1,0,0,0,1,,val
0507815_as-0026471.jpg,0,1,0,1,2,,val
0507816_as-0026471.jpg,0,1,0,1,2,,test
0507817_as-0026471.jpg,1,1,0,1,3,,train
0507818_as-0026471.jpg,2,1,0,1,4,,train
0507819_as-0026471.jpg,1,1,0,1,3,,train
0507820_sc-230513.jpg,2,0,0,2,4,,train
0507821_sc-230513.jpg,2,0,0,1,3,,train
0507822_sc-230513.jpg,1,0,0,0,1,,train
0507823_sc-230513.jpg,3,0,1,2,6,,train
0507824_sc-230513.jpg,3,0,1,0,4,,val
0507825_sc-106887.jpg,3,0,0,0,3,,val
0507826_sc-106887.jpg,0,0,1,0,1,,test
0507827_sc-106887.jpg,0,1,1,0,2,,train
0507828_sc-106887.jpg,2,0,0,0,2,,train
0507829_as-3289072.jpg,8,0,0,0,8,,train
0507830_sc-160275.jpg,1,0,1,0,2,,train
0507835_as-0078182.jpg,1,1,1,0,3,,train
0507836_as-0078182.jpg,0,1,1,0,2,,train
0507837_as-0078182.jpg,0,0,1,0,1,,train
0507840_as-0074172.jpg,1,0,2,2,5,,val
0507841_as-0074172.jpg,1,0,0,1,2,,val
0507842_as-0074172.jpg,5,1,3,2,11,,test
0507843_as-0074172.jpg,6,0,2,0,8,,train
0507844_as-0074172.jpg,1,1,0,0,2,,train
0507847_as-0074172.jpg,2,0,0,0,2,,train
0507850_as-0015877.jpg,5,0,0,0,5,,train
0507851_as-0015877.jpg,5,0,0,0,5,,train
0507852_as-0015877.jpg,1,0,0,0,1,,train
0507853_as-0015877.jpg,7,0,0,0,7,,train
0507854_as-0015877.jpg,5,0,0,0,5,,val
0507855_as-0015877.jpg,5,0,0,0,5,,val
0507856_as-0015877.jpg,1,0,1,0,2,,test
0507857_as-0015877.jpg,4,0,0,0,4,,train
0507858_as-0015877.jpg,7,0,0,0,7,,train
0507859_as-0015877.jpg,5,0,0,0,5,,train
0507860_sc-224580.jpg,5,1,0,0,6,,train
0507861_sc-224580.jpg,3,2,0,0,5,,train
0507862_sc-224580.jpg,2,2,1,1,6,,train
0507863_as-0062125.jpg,1,0,0,0,1,,train
0507866_as-0011702.jpg,1,0,1,1,3,,val
0507867_as-0011702.jpg,1,0,1,1,3,,val
0507868_as-0011702.jpg,1,0,1,0,2,,test
0507869_as-0011702.jpg,1,0,0,0,1,,train
0507870_as-0011702.jpg,5,1,1,0,7,,train
0507871_as-0011702.jpg,2,0,0,0,2,,train
0507872_as-0011702.jpg,3,0,0,0,3,,train
0507873_as-0011702.jpg,3,0,0,0,3,,train
0507875_as-2923865.jpg,1,0,0,0,1,,train
0507877_sc-125392.jpg,2,0,0,0,2,,train
0507878_sc-125392.jpg,5,0,0,0,5,,val
0507879_as-5256633.jpg,1,0,0,0,1,,val
0507880_as-0031052.jpg,1,0,0,0,1,,test
0507881_as-0031052.jpg,2,0,0,0,2,,train
0507882_as-0031052.jpg,1,0,0,0,1,,train
0507883_as-2976605.jpg,2,0,1,1,4,,train
0507886_sc-126832.jpg,0,1,0,0,1,,train
0507887_sc-126832.jpg,0,1,0,0,1,,train
0507888_as-3305111.jpg,2,0,1,0,3,,train
0507890_sc-106099.jpg,0,1,0,0,1,,train
0507892_sc-106099.jpg,0,2,1,0,3,,val
0507893_sc-106099.jpg,2,0,0,0,2,,val
0507894_as-0075828.jpg,2,0,0,1,3,,test
0507895_as-0075828.jpg,2,0,0,0,2,,train
0507896_as-0075828.jpg,0,0,0,1,1,,train
0507897_as-0075828.jpg,3,0,0,1,4,,train
0507898_as-0042631.jpg,1,0,0,0,1,,train
0507901_as-0040857.jpg,2,0,0,0,2,,train
0507902_as-0040857.jpg,5,0,0,0,5,,train
0507903_as-0040857.jpg,3,0,0,0,3,,train
0507904_as-0040857.jpg,2,0,0,0,2,,val
0507905_as-0040857.jpg,3,0,0,1,4,,val
0507906_as-0040857.jpg,2,0,0,1,3,,test
0507907_as-0040857.jpg,3,0,0,2,5,,train
0507909_as-0031587.jpg,1,1,1,0,3,,train
0507910_as-0031587.jpg,1,1,1,0,3,,train
0507911_as-0031587.jpg,1,0,1,0,2,,train
0507912_as-0031587.jpg,2,1,2,0,5,,train
0507913_as-0031587.jpg,1,1,1,0,3,,train
0507914_as-0076119.jpg,1,0,0,0,1,,train
0507915_as-0018473.jpg,1,0,0,0,1,,val
0507917_as-0018473.jpg,3,0,0,0,3,,val
0507918_as-0018473.jpg,4,0,0,0,4,,test
0507919_as-0018473.jpg,0,0,1,0,1,,train
0507920_as-3390682.jpg,1,0,0,0,1,,train
0507921_sc-196709.jpg,3,0,0,0,3,,train
0507922_sc-196709.jpg,4,0,0,0,4,,train
0507923_as-2993594.jpg,3,0,0,1,4,,train
0507924_as-0027917.jpg,2,0,0,0,2,,train
0507927_as-0027917.jpg,2,1,1,0,4,,train
0507929_as-0027917.jpg,0,1,5,0,6,,val
0507930_sc-133088.jpg,2,0,0,0,2,,val
0507931_as-2675705.jpg,5,0,0,0,5,,test
0507932_as-7268442.jpg,1,0,1,0,2,,train
0507933_as-0004347.jpg,2,0,0,0,2,,train
0507934_as-0051594.jpg,1,0,1,0,2,,train
0507935_as-0051594.jpg,1,0,1,0,2,,train
0507936_sc-1033533.jpg,1,0,0,1,2,,train
0507938_sc-1033533.jpg,1,0,0,0,1,,train
0507939_as-2868317.jpg,1,0,0,0,1,,train
0507940_sc-122573.jpg,1,1,0,0,2,,val
0507942_as-0075007.jpg,1,0,0,0,1,,val
0507943_as-0075007.jpg,1,0,0,0,1,,test
0507944_as-0075007.jpg,2,0,0,0,2,,train
0507946_as-0075007.jpg,1,1,0,0,2,,train
0507947_as-0075007.jpg,1,1,0,0,2,,train
0507948_as-0075007.jpg,1,0,0,0,1,,train
0507949_as-0075007.jpg,2,0,0,0,2,,train
0507950_as-0075007.jpg,1,0,0,0,1,,train
0507951_as-0075007.jpg,1,0,0,0,1,,train
0507952_as-3400234.jpg,2,0,0,0,2,,val
0507954_as-0053714.jpg,1,0,1,0,2,,val
0507955_as-0053714.jpg,1,0,0,0,1,,test
0507956_sc-1018280.jpg,0,1,0,0,1,,train
0507958_as-2683295.jpg,1,0,1,1,3,,train
0507959_sc-153318.jpg,1,1,0,0,2,,train
0507960_sc-153318.jpg,1,0,0,0,1,,train
0507961_sc-153318.jpg,1,1,0,0,2,,train
0507962_sc-153318.jpg,1,1,0,0,2,,train
0507964_as-0070786.jpg,1,0,0,0,1,,train
0507965_as-0070786.jpg,1,0,0,0,1,,val
0507966_as-2695683.jpg,1,0,1,0,2,,val
0507967_sc-211221.jpg,2,0,2,2,6,,test
0507968_sc-211221.jpg,3,0,2,1,6,,train
0507969_sc-211221.jpg,4,0,2,1,7,,train
0507970_sc-147643.jpg,2,0,0,0,2,,train
0507973_sc-117452.jpg,0,1,0,0,1,,train
0507975_as-0012711.jpg,3,0,0,0,3,,train
0507976_as-0012711.jpg,5,0,0,0,5,,train
0507977_as-0012711.jpg,3,0,0,0,3,,train
0507978_as-0012711.jpg,1,0,0,0,1,,val
0507979_as-0012711.jpg,2,0,0,0,2,,val
0507980_as-0012711.jpg,2,0,0,0,2,,test
0507981_as-0012711.jpg,1,0,0,0,1,,train
0507982_as-0012711.jpg,1,0,0,0,1,,train
0507983_as-0012711.jpg,3,0,0,0,3,,train
0507984_as-0012711.jpg,3,0,0,0,3,,train
0507985_as-0012711.jpg,2,0,0,0,2,,train
0507986_as-0012711.jpg,3,0,0,0,3,,train
0507987_as-0012711.jpg,1,0,0,0,1,,train
0507988_as-0012711.jpg,2,0,0,0,2,,val
0507989_as-0012711.jpg,2,0,0,0,2,,val
0507990_as-0012711.jpg,2,0,0,0,2,,test
0507991_as-0012711.jpg,6,0,0,0,6,,train
0507993_as-0057693.jpg,1,0,3,1,5,,train
0507994_as-0057693.jpg,2,0,3,1,6,,train
0507995_as-0057693.jpg,1,0,1,0,2,,train
0507996_sc-230125.jpg,2,0,0,0,2,,train
0507997_sc-230125.jpg,1,0,0,0,1,,train
0507998_sc-230125.jpg,4,0,0,0,4,,train
0507999_sc-230125.jpg,1,0,0,0,1,,val
0508000_sc-230125.jpg,1,0,0,1,2,,val
0508001_sc-230125.jpg,1,0,0,1,2,,test
0508002_sc-230125.jpg,1,0,0,1,2,,train
0508003_sc-230125.jpg,1,0,0,1,2,,train
0508004_as-0045523.jpg,0,0,0,1,1,,train
0508005_as-0045523.jpg,1,0,0,0,1,,train
0508006_as-0045523.jpg,0,0,0,1,1,,train
0508009_as-0086818.jpg,1,0,1,1,3,,train
0508010_as-0086818.jpg,3,0,1,0,4,,train
0508012_as-0086818.jpg,6,1,2,1,10,,val
0508013_as-0086818.jpg,1,0,4,0,5,,val
0508016_sc-196624.jpg,2,0,0,0,2,,test
0508017_sc-196624.jpg,6,0,1,0,7,,train
0508018_sc-196624.jpg,4,0,0,0,4,,train
0508019_sc-187412.jpg,1,0,0,0,1,,train
0508021_sc-187412.jpg,1,0,0,1,2,,train
0508022_sc-187412.jpg,1,0,0,1,2,,train
0508023_sc-187412.jpg,1,0,0,1,2,,train
0508025_sc-180747.jpg,2,1,0,0,3,,train
0508028_as-7221675.jpg,2,0,0,0,2,,val
0508030_sc-1022741.jpg,0,2,2,2,6,,val
0508031_sc-1022741.jpg,0,3,2,2,7,,test
0508032_sc-124485.jpg,1,0,0,0,1,,train
0508033_sc-124485.jpg,2,0,0,0,2,,train
0508034_sc-124485.jpg,10,0,0,0,10,,train
0508035_sc-1037905.jpg,1,0,1,2,4,,train
0508036_sc-1037905.jpg,2,0,1,2,5,,train
0508037_sc-1037905.jpg,2,0,1,4,7,,train
0508038_sc-1037905.jpg,1,1,0,1,3,,train
0508039_sc-1037905.jpg,1,0,1,3,5,,val
0508041_sc-195478.jpg,2,0,1,1,4,,val
0508042_sc-195478.jpg,1,0,1,1,3,,test
0508043_sc-195478.jpg,2,0,1,1,4,,train
0508045_sc-1036311.jpg,1,0,0,0,1,,train
0508046_sc-1036311.jpg,2,0,0,1,3,,train
0508047_sc-1036311.jpg,2,0,0,1,3,,train
0508049_as-0018795.jpg,7,0,2,2,11,,train
0508050_as-0018795.jpg,1,0,0,1,2,,train
0508051_as-0018795.jpg,4,0,1,1,6,,train
0508052_as-0018795.jpg,3,0,1,1,5,,val
0508053_as-0018795.jpg,2,2,0,0,4,,val
0508054_as-0018795.jpg,1,2,0,0,3,,test
0508055_as-0018795.jpg,2,1,0,0,3,,train
0508056_as-0018795.jpg,0,1,0,0,1,,train
0508057_as-3239105.jpg,1,0,0,0,1,,train
0508060_as-0052151.jpg,2,0,0,0,2,,train
0508061_as-2999967.jpg,0,1,0,0,1,,train
0508063_sc-206823.jpg,2,0,0,0,2,,train
0508064_sc-206823.jpg,2,0,0,0,2,,train
0508065_sc-206823.jpg,2,0,0,0,2,,val
0508066_sc-206823.jpg,3,0,0,0,3,,val
0508067_sc-206823.jpg,1,0,0,0,1,,test
0508068_sc-206823.jpg,2,0,0,1,3,,train
0508069_sc-206823.jpg,3,0,0,0,3,,train
0508070_as-0036677.jpg,2,0,1,0,3,,train
0508071_as-0036677.jpg,1,0,0,0,1,,train
0508073_as-0036677.jpg,9,0,0,0,9,,train
0508074_as-0036677.jpg,6,0,0,0,6,,train
0508075_as-0036677.jpg,2,0,0,0,2,,train
0508076_as-0036677.jpg,0,0,1,0,1,,val
0508077_as-0045763.jpg,1,0,0,0,1,,val
0508078_as-0045763.jpg,1,0,0,0,1,,test
0508079_sc-152419.jpg,1,1,1,0,3,,train
0508080_sc-152419.jpg,2,1,0,0,3,,train
0508081_sc-152419.jpg,0,1,1,1,3,,train
0508082_sc-152419.jpg,0,0,2,0,2,,train
0508085_sc-143953.jpg,4,0,0,0,4,,train
0508086_sc-1002308.jpg,2,0,0,0,2,,train
0508087_sc-1002308.jpg,2,0,0,0,2,,train
0508088_as-3034253.jpg,2,0,0,1,3,,val
0508090_as-0022625.jpg,1,0,1,1,3,,val
0508091_as-0022625.jpg,1,0,0,0,1,,test
0508092_as-0022625.jpg,1,0,0,0,1,,train
0508093_as-0022625.jpg,1,0,0,0,1,,train
0508094_as-2661246.jpg,2,0,0,0,2,,train
0508096_sc-199341.jpg,1,0,0,0,1,,train
0508097_as-3082408.jpg,1,0,2,2,5,,train
0508100_sc-155469.jpg,5,0,0,0,5,,train
0508101_sc-155469.jpg,3,0,0,0,3,,train
0508102_sc-155469.jpg,3,2,0,0,5,,val
0508103_sc-155469.jpg,2,0,2,0,4,,val
0508104_sc-155469.jpg,2,0,0,0,2,,test
0508105_sc-155469.jpg,5,0,1,1,7,,train
0508106_sc-155469.jpg,1,0,1,1,3,,train
0508107_sc-155469.jpg,1,2,0,0,3,,train
0508108_sc-155469.jpg,3,0,0,1,4,,train
0508109_sc-155469.jpg,4,0,0,1,5,,train
0508110_sc-155469.jpg,4,0,0,1,5,,train
0508111_sc-155469.jpg,2,0,1,1,4,,train
0508112_sc-155469.jpg,2,0,0,0,2,,val
0508113_sc-155469.jpg,2,0,0,0,2,,val
0508114_as-3497309.jpg,1,0,0,0,1,,test
0508115_as-3161396.jpg,1,1,1,1,4,,train
0508117_as-2688869.jpg,1,0,1,0,2,,train
0508119_as-0048398.jpg,6,1,0,0,7,,train
0508120_as-0048398.jpg,4,0,1,0,5,,train
0508122_sc-1033015.jpg,2,0,0,1,3,,train
0508123_sc-1033015.jpg,3,0,0,0,3,,train
0508124_sc-1033015.jpg,1,0,0,1,2,,train
0508125_sc-1033015.jpg,4,0,0,0,4,,val
0508126_sc-1033015.jpg,7,0,0,0,7,,val
0508127_as-0018845.jpg,1,0,0,0,1,,test
0508129_sc-1026643.jpg,6,0,0,0,6,,train
0508130_sc-1026643.jpg,4,0,0,0,4,,train
0508131_sc-207267.jpg,3,0,0,0,3,,train
0508132_as-0057740.jpg,1,0,0,0,1,,train
0508133_as-0057740.jpg,1,0,0,0,1,,train
0508134_as-0057740.jpg,2,0,0,1,3,,train
0508135_as-0057740.jpg,0,0,0,1,1,,train
0508136_as-0057740.jpg,0,0,0,1,1,,val
0508138_sc-1035185.jpg,2,0,1,0,3,,val
0508139_as-0065627.jpg,0,0,0,1,1,,test
0508141_as-0065627.jpg,1,0,0,0,1,,train
0508142_as-0065627.jpg,1,0,0,0,1,,train
0508143_sc-1024471.jpg,1,0,0,0,1,,train
0508145_as-0032649.jpg,1,1,0,0,2,,train
0508146_as-0032649.jpg,1,1,0,0,2,,train
0508147_as-0032649.jpg,1,1,0,0,2,,train
0508149_as-0091038.jpg,1,1,1,2,5,,train
0508150_as-0091038.jpg,0,0,2,0,2,,val
0508151_as-0091038.jpg,0,0,1,0,1,,val
0508152_as-0091038.jpg,0,0,1,1,2,,test
0508153_as-0091038.jpg,1,0,0,0,1,,train
0508156_sc-103051.jpg,5,0,0,0,5,,train
0508157_sc-103051.jpg,2,0,0,0,2,,train
0508158_sc-103051.jpg,5,0,0,0,5,,train
0508162_as-0059219.jpg,1,0,0,0,1,,train
0508163_as-0059219.jpg,2,0,0,0,2,,train
0508164_as-0059219.jpg,1,0,0,0,1,,train
0508165_as-0059219.jpg,1,0,0,0,1,,val
0508167_as-0059219.jpg,2,0,0,0,2,,val
0508168_as-0059219.jpg,2,0,0,0,2,,test
0508169_as-0059219.jpg,2,0,0,0,2,,train
0508170_as-0059219.jpg,4,0,0,0,4,,train
0508171_as-0059219.jpg,2,0,1,0,3,,train
0508172_as-0059219.jpg,1,0,1,0,2,,train
0508173_as-0059219.jpg,1,0,0,0,1,,train
0508174_as-0059219.jpg,2,0,0,0,2,,train
0508175_as-3378780.jpg,2,0,1,0,3,,train
0508176_as-7308144.jpg,5,0,0,0,5,,val
0508177_sc-225646.jpg,4,0,0,0,4,,val
0508178_as-3115329.jpg,2,0,0,0,2,,test
0508179_as-0009508.jpg,1,0,0,0,1,,train
0508180_sc-128826.jpg,0,0,1,0,1,,train
0508182_sc-107666.jpg,1,0,0,0,1,,train
0508183_sc-107666.jpg,1,0,0,0,1,,train
0508184_sc-107666.jpg,2,0,1,0,3,,train
0508185_sc-196273.jpg,2,1,3,1,7,,train
0508186_sc-196273.jpg,2,1,4,1,8,,train
0508187_sc-1017331.jpg,4,2,1,1,8,,val
0508189_sc-1017331.jpg,2,0,0,0,2,,val
0508190_sc-1017331.jpg,5,0,0,0,5,,test
0508194_as-0084837.jpg,1,0,1,0,2,,train
0508195_as-0084837.jpg,0,0,1,0,1,,train
0508196_as-0084837.jpg,0,0,1,0,1,,train
0508197_as-0084837.jpg,0,0,1,0,1,,train
0508198_as-0084837.jpg,1,0,1,0,2,,train
0508199_as-0084837.jpg,1,2,0,0,3,,train
0508200_as-2611730.jpg,2,0,1,0,3,,train
0508201_sc-206972.jpg,2,0,0,1,3,,val
0508202_sc-206972.jpg,3,0,0,0,3,,val
0508203_sc-206972.jpg,2,0,0,0,2,,test
0508204_sc-206972.jpg,2,0,0,1,3,,train
0508205_sc-206972.jpg,2,0,0,0,2,,train
0508206_sc-206972.jpg,1,0,0,0,1,,train
0508207_sc-206972.jpg,3,0,0,0,3,,train
0508208_sc-206972.jpg,3,0,0,0,3,,train
0508209_sc-206972.jpg,2,0,0,0,2,,train
0508210_sc-206972.jpg,0,0,1,1,2,,train
0508211_sc-206972.jpg,0,0,1,1,2,,val
0508212_sc-206972.jpg,1,0,1,2,4,,val
0508213_sc-206972.jpg,0,0,0,1,1,,test
0508214_sc-206972.jpg,0,0,0,1,1,,train
0508215_sc-206972.jpg,1,0,0,0,1,,train
0508216_sc-1013406.jpg,3,2,2,0,7,,train
0508217_sc-1013406.jpg,5,1,2,0,8,,train
0508219_as-0038959.jpg,3,0,1,3,7,,train
0508220_as-0038959.jpg,2,0,1,2,5,,train
0508221_as-0038959.jpg,3,0,1,3,7,,train
0508222_as-0038959.jpg,2,0,1,3,6,,val
0508223_as-0038959.jpg,1,0,1,2,4,,val
0508224_as-0038959.jpg,1,0,1,2,4,,test
0508225_as-0038959.jpg,2,0,1,1,4,,train
0508227_as-0038959.jpg,1,2,0,0,3,,train
0508228_as-0038959.jpg,3,1,1,2,7,,train
0508229_as-0038959.jpg,2,0,0,0,2,,train
0508230_as-0038959.jpg,1,0,0,0,1,,train
0508231_as-0038959.jpg,2,0,0,1,3,,train
0508232_as-0038959.jpg,1,0,0,1,2,,train
0508234_as-2917729.jpg,1,0,1,0,2,,val
0508235_as-2729452.jpg,1,0,0,0,1,,val
0508236_sc-140457.jpg,1,0,0,0,1,,test
0508237_as-7351110.jpg,0,0,1,0,1,,train
0508238_as-9074483.jpg,1,0,1,1,3,,train
0508239_sc-169857.jpg,1,0,1,0,2,,train
0508240_as-0030864.jpg,2,0,1,0,3,,train
0508241_as-2746979.jpg,4,0,1,0,5,,train
0508242_sc-118386.jpg,3,0,1,0,4,,train
0508243_sc-118386.jpg,1,0,0,0,1,,train
0508244_sc-118386.jpg,2,0,1,0,3,,val
0508246_sc-195256.jpg,1,0,0,0,1,,val
0508247_sc-195256.jpg,3,0,0,0,3,,test
0508248_sc-195256.jpg,4,0,0,0,4,,train
0508249_as-2578688.jpg,1,0,0,0,1,,train
0508250_as-3415654.jpg,1,0,0,1,2,,train
0508251_as-7986004.jpg,3,0,0,0,3,,train
0508253_sc-154874.jpg,2,1,0,1,4,,train
0508254_sc-154874.jpg,1,1,0,1,3,,train
0508255_sc-197462.jpg,3,0,1,2,6,,train
0508258_as-0079539.jpg,0,1,0,0,1,,val
0508259_sc-1014719.jpg,1,0,0,1,2,,val
0508260_sc-1014719.jpg,2,0,0,1,3,,test
0508261_as-3439527.jpg,1,0,1,0,2,,train
0508263_as-0057616.jpg,1,0,0,1,2,,train
0508264_as-0057616.jpg,1,0,0,1,2,,train
0508265_as-0057616.jpg,1,0,0,2,3,,train
0508266_as-0057616.jpg,1,0,0,1,2,,train
0508267_as-0057616.jpg,2,1,0,1,4,,train
0508268_as-0057616.jpg,1,1,0,0,2,,train
0508269_as-0071706.jpg,2,0,0,0,2,,val
0508270_as-7003521.jpg,0,0,1,0,1,,val
0508271_sc-159694.jpg,1,0,1,0,2,,test
0508272_sc-159694.jpg,1,0,0,0,1,,train
0508273_sc-159694.jpg,1,0,0,0,1,,train
0508274_sc-159694.jpg,1,0,0,0,1,,train
0508277_as-0072917.jpg,5,0,0,0,5,,train
0508278_as-0072917.jpg,2,1,0,1,4,,train
0508279_as-0072917.jpg,2,1,0,1,4,,train
0508280_sc-103827.jpg,3,0,0,0,3,,train
0508281_sc-103827.jpg,2,0,0,0,2,,val
0508282_sc-149865.jpg,4,0,0,0,4,,val
0508283_sc-149865.jpg,2,0,0,0,2,,test
0508284_sc-149865.jpg,5,0,1,0,6,,train
0508286_sc-149865.jpg,2,0,0,0,2,,train
0508287_sc-1031554.jpg,1,1,1,0,3,,train
0508288_sc-1031554.jpg,1,0,0,0,1,,train
0508292_sc-1031554.jpg,6,0,3,2,11,,train
0508294_as-0078362.jpg,4,3,2,0,9,,train
0508295_as-0078362.jpg,2,0,1,0,3,,train
0508296_as-0078362.jpg,2,2,1,0,5,,val
0508297_as-0078362.jpg,1,1,0,0,2,,val
0508298_as-0073130.jpg,0,0,1,0,1,,test
0508299_sc-168196.jpg,2,0,0,0,2,,train
0508301_sc-1025887.jpg,8,0,0,0,8,,train
0508303_as-2823111.jpg,1,0,0,1,2,,train
0508304_as-2823111.jpg,1,0,0,0,1,,train
0508305_sc-150209.jpg,3,0,1,1,5,,train
0508306_sc-150209.jpg,6,0,1,1,8,,train
0508307_sc-150209.jpg,3,0,0,1,4,,train
0508308_sc-150209.jpg,1,0,1,1,3,,val
0508310_as-0036960.jpg,3,0,0,0,3,,val
0508311_as-0036960.jpg,2,0,0,0,2,,test
0508312_as-0036960.jpg,3,0,0,0,3,,train
0508313_as-2813344.jpg,2,0,0,1,3,,train
0508314_as-2813344.jpg,1,0,2,0,3,,train
0508316_sc-130483.jpg,1,0,0,0,1,,train
0508317_sc-130483.jpg,1,0,0,0,1,,train
0508318_sc-130483.jpg,1,0,1,0,2,,train
0508319_sc-130483.jpg,1,0,1,0,2,,train
0508320_sc-130483.jpg,1,0,0,0,1,,val
0508321_sc-130483.jpg,1,0,1,0,2,,val
0508324_sc-1009833.jpg,2,0,0,0,2,,test
0508325_sc-1009833.jpg,3,0,1,0,4,,train
0508326_sc-1009833.jpg,2,0,1,0,3,,train
0508327_sc-1009833.jpg,1,0,1,1,3,,train
0508328_as-0047197.jpg,1,0,1,0,2,,train
0508330_as-2705990.jpg,1,0,1,0,2,,train
0508333_as-0045089.jpg,1,1,1,0,3,,train
0508334_as-0045089.jpg,1,1,0,0,2,,train
0508335_as-3487890.jpg,0,0,0,1,1,,val
0508337_as-0070891.jpg,1,0,0,2,3,,val
0508338_as-0070891.jpg,1,0,0,2,3,,test
0508339_as-0070891.jpg,1,0,0,0,1,,train
0508340_as-0070891.jpg,3,0,0,1,4,,train
0508341_as-0008202.jpg,1,0,0,0,1,,train
0508342_as-0008202.jpg,1,0,0,0,1,,train
0508343_as-0008202.jpg,1,0,0,0,1,,train
0508344_sc-1024003.jpg,1,0,0,0,1,,train
0508345_sc-1024003.jpg,1,0,0,0,1,,train
0508346_sc-1024003.jpg,3,0,0,0,3,,val
0508347_as-3303949.jpg,1,1,0,0,2,,val
0508349_as-0039084.jpg,1,1,1,1,4,,test
0508350_as-0039084.jpg,1,2,1,0,4,,train
0508351_as-0039084.jpg,0,1,0,0,1,,train
0508352_as-0039084.jpg,1,1,1,1,4,,train
0508353_as-0039084.jpg,1,1,0,0,2,,train
0508354_as-0039084.jpg,2,1,1,1,5,,train
0508355_as-0039084.jpg,2,2,0,0,4,,train
0508356_as-0039084.jpg,2,2,0,0,4,,train
0508357_as-0039084.jpg,1,0,0,0,1,,val
0508358_as-9033091.jpg,3,0,0,0,3,,val
0508359_sc-208301.jpg,0,1,2,0,3,,test
0508360_sc-133015.jpg,1,0,1,1,3,,train
0508361_sc-133015.jpg,1,0,1,1,3,,train
0508362_sc-133015.jpg,1,0,2,1,4,,train
0508363_sc-133015.jpg,1,1,0,3,5,,train
0508364_as-0068746.jpg,1,0,0,1,2,,train
0508365_as-0068746.jpg,1,0,0,1,2,,train
0508366_as-0068746.jpg,1,0,0,1,2,,train
0508367_as-2727869.jpg,0,1,0,0,1,,val
0508368_as-7655491.jpg,2,0,0,0,2,,val
0508369_sc-216267.jpg,3,2,1,0,6,,test
0508370_sc-216267.jpg,2,2,1,0,5,,train
0508372_sc-125264.jpg,3,0,0,0,3,,train
0508373_sc-195120.jpg,2,0,0,0,2,,train
0508377_as-2950843.jpg,1,0,1,1,3,,train
0508378_as-0041703.jpg,0,1,1,1,3,,train
0508380_as-0001286.jpg,11,1,2,0,14,,train
0508381_sc-195570.jpg,3,0,0,0,3,,train
0508382_as-2680476.jpg,0,1,0,0,1,,val
0508383_as-2680713.jpg,2,0,0,0,2,,val
0508385_as-0071893.jpg,0,0,2,0,2,,test
0508386_as-0071893.jpg,1,0,0,0,1,,train
0508387_as-0071893.jpg,4,0,0,0,4,,train
0508389_sc-111363.jpg,0,1,0,0,1,,train
0508390_sc-1040921.jpg,1,0,0,0,1,,train
0508391_sc-1040921.jpg,1,0,0,0,1,,train
0508394_as-0009864.jpg,0,1,1,0,2,,train
0508395_as-0009864.jpg,0,1,1,0,2,,train
0508396_as-0034744.jpg,2,0,0,0,2,,val
0508397_as-0034744.jpg,1,0,0,0,1,,val
0508398_as-0034744.jpg,1,0,0,0,1,,test
0508399_sc-157478.jpg,1,0,0,0,1,,train
0508401_sc-104358.jpg,0,1,0,0,1,,train
0508402_sc-104358.jpg,0,1,1,0,2,,train
0508403_sc-104358.jpg,1,0,0,0,1,,train
0508404_sc-104358.jpg,1,0,0,0,1,,train
0508406_sc-104358.jpg,1,0,1,0,2,,train
0508407_sc-104358.jpg,1,0,1,0,2,,train
0508411_sc-104358.jpg,1,0,0,0,1,,val
0508413_as-2988300.jpg,3,0,0,0,3,,val
0508414_as-2988300.jpg,1,0,0,0,1,,test
0508415_as-7923356.jpg,0,1,0,0,1,,train
0508416_sc-219360.jpg,0,1,0,0,1,,train
0508417_as-3370933.jpg,2,0,0,0,2,,train
0508418_sc-125437.jpg,1,1,0,0,2,,train
0508419_sc-125437.jpg,1,0,0,1,2,,train
0508420_sc-125437.jpg,1,0,0,0,1,,train
0508421_sc-125437.jpg,2,0,0,0,2,,train
0508422_sc-125437.jpg,1,0,0,0,1,,val
0508423_sc-125437.jpg,1,1,0,0,2,,val
0508424_sc-125437.jpg,1,1,0,0,2,,test
0508426_as-0070253.jpg,0,0,0,1,1,,train
0508427_as-0070253.jpg,1,0,0,1,2,,train
0508428_as-0070253.jpg,1,0,0,0,1,,train
0508429_sc-213082.jpg,0,0,1,0,1,,train
0508434_as-0017854.jpg,1,0,1,0,2,,train
0508435_as-0017854.jpg,2,0,0,0,2,,train
0508437_as-0017854.jpg,1,0,0,0,1,,train
0508438_as-0017854.jpg,1,0,0,0,1,,val
0508440_as-0017854.jpg,3,0,0,0,3,,val
0508441_as-0017854.jpg,1,0,0,0,1,,test
0508443_as-0017854.jpg,3,0,0,0,3,,train
0508444_as-0017854.jpg,1,0,0,0,1,,train
0508445_as-0017854.jpg,6,0,0,0,6,,train
0508447_sc-116793.jpg,8,0,0,0,8,,train
0508454_as-0024871.jpg,3,1,0,0,4,,train
0508455_as-0024871.jpg,3,1,0,0,4,,train
0508457_sc-1013701.jpg,4,0,0,0,4,,train
0508458_sc-1013701.jpg,1,0,0,0,1,,val
0508459_sc-1013701.jpg,3,0,0,0,3,,val
0508460_sc-1030080.jpg,4,0,1,0,5,,test
0508461_sc-1030080.jpg,2,0,1,0,3,,train
0508462_sc-1030080.jpg,1,0,0,0,1,,train
0508463_sc-1030080.jpg,3,0,1,0,4,,train
0508464_sc-1030080.jpg,3,0,0,2,5,,train
0508465_sc-185337.jpg,1,0,0,0,1,,train
0508466_sc-185337.jpg,2,0,0,0,2,,train
0508467_sc-185337.jpg,1,0,0,0,1,,train
0508468_sc-185337.jpg,1,0,0,0,1,,val
0508470_sc-165516.jpg,3,0,1,0,4,,val
0508471_sc-165516.jpg,4,0,1,0,5,,test
0508472_sc-165516.jpg,0,0,1,0,1,,train
0508473_sc-165516.jpg,6,0,1,1,8,,train
0508474_sc-165516.jpg,5,0,1,0,6,,train
0508475_sc-165516.jpg,2,0,0,0,2,,train
0508476_sc-165516.jpg,8,0,0,0,8,,train
0508477_sc-165516.jpg,0,1,0,0,1,,train
0508478_as-2679221.jpg,6,0,0,0,6,,train
0508479_as-2643086.jpg,0,0,1,0,1,,val
0508481_as-0050053.jpg,1,0,0,0,1,,val
0508482_as-0050053.jpg,1,0,0,0,1,,test
0508483_as-2882941.jpg,1,1,0,1,3,,train
0508484_as-9052575.jpg,1,0,2,0,3,,train
0508485_sc-1001125.jpg,1,0,0,0,1,,train
0508486_sc-1001125.jpg,2,0,0,0,2,,train
0508487_as-0004639.jpg,0,0,2,1,3,,train
0508488_as-0004639.jpg,1,1,2,0,4,,train
0508489_as-0004639.jpg,0,1,2,0,3,,train
0508490_as-0004639.jpg,1,1,2,0,4,,val
0508491_as-0004639.jpg,4,1,0,0,5,,val
0508492_as-0004639.jpg,2,0,0,0,2,,test
0508493_as-0004639.jpg,3,0,0,0,3,,train
0508494_as-3136789.jpg,1,0,0,0,1,,train
0508495_sc-195928.jpg,0,1,0,0,1,,train
0508498_sc-195928.jpg,1,0,0,0,1,,train
0508499_sc-195928.jpg,3,0,0,0,3,,train
0508500_sc-195928.jpg,2,0,0,0,2,,train
0508502_as-0078585.jpg,2,0,1,0,3,,train
0508503_sc-176211.jpg,1,1,0,0,2,,val
0508504_sc-176211.jpg,1,0,0,0,1,,val
0508506_as-0075890.jpg,2,1,1,0,4,,test
0508507_as-0075890.jpg,2,1,2,1,6,,train
0508509_sc-165404.jpg,2,0,0,0,2,,train
0508510_sc-165404.jpg,1,1,0,0,2,,train
0508512_sc-165404.jpg,1,2,2,0,5,,train
0508513_sc-165404.jpg,3,0,0,0,3,,train
0508514_sc-165404.jpg,3,0,0,0,3,,train
0508515_sc-116358.jpg,3,1,2,0,6,,train
0508516_sc-116358.jpg,2,1,2,0,5,,val
0508517_sc-116358.jpg,1,0,0,1,2,,val
0508520_as-0057380.jpg,1,0,0,0,1,,test
0508521_as-0057380.jpg,1,0,0,0,1,,train
0508522_as-0057380.jpg,1,0,0,0,1,,train
0508523_sc-144510.jpg,2,0,0,0,2,,train
0508524_as-7973154.jpg,2,2,3,1,8,,train
0508525_as-2911171.jpg,4,0,0,0,4,,train
0508527_sc-1035882.jpg,4,1,2,2,9,,train
0508530_as-0058642.jpg,1,0,1,0,2,,train
0508531_sc-228240.jpg,3,0,0,0,3,,val
0508532_sc-220180.jpg,1,0,0,0,1,,val
0508533_sc-220180.jpg,1,0,0,0,1,,test
0508534_sc-220180.jpg,1,0,0,0,1,,train
0508535_sc-220180.jpg,1,0,0,0,1,,train
0508536_sc-220180.jpg,1,0,0,0,1,,train
0508537_sc-220180.jpg,2,0,1,0,3,,train
0508538_as-2657476.jpg,1,0,0,0,1,,train
0508541_as-0066779.jpg,2,1,0,1,4,,train
0508542_as-0006709.jpg,4,0,0,1,5,,train
0508543_as-0006709.jpg,4,0,0,1,5,,val
0508544_as-0006709.jpg,5,0,0,1,6,,val
0508545_as-3080802.jpg,2,1,0,1,4,,test
0508546_as-2528486.jpg,1,0,1,0,2,,train
0508547_as-0080366.jpg,4,2,2,1,9,,train
0508551_sc-1019590.jpg,2,0,0,0,2,,train
0508552_sc-1019590.jpg,3,0,0,0,3,,train
0508553_sc-191891.jpg,1,0,0,0,1,,train
0508554_sc-191891.jpg,4,0,0,0,4,,train
0508555_sc-191891.jpg,1,0,0,0,1,,train
0508557_sc-191891.jpg,1,0,0,0,1,,val
0508558_sc-191891.jpg,4,0,0,0,4,,val
0508559_as-3000711.jpg,0,0,1,0,1,,test
0508561_as-3205828.jpg,3,2,0,1,6,,train
0508562_as-3258636.jpg,1,0,0,0,1,,train
0508565_as-0052807.jpg,4,0,1,0,5,,train
0508566_as-0052807.jpg,3,0,0,0,3,,train
0508568_sc-119000.jpg,1,0,0,0,1,,train
0508569_sc-119000.jpg,4,0,1,0,5,,train
0508571_as-0040498.jpg,1,0,0,1,2,,train
0508572_as-0040498.jpg,1,0,1,1,3,,val
0508573_as-0040498.jpg,1,1,0,0,2,,val
0508574_as-0040498.jpg,1,1,0,0,2,,test
0508575_as-0040498.jpg,0,1,0,0,1,,train
0508576_as-2714244.jpg,1,0,1,0,2,,train
0508577_as-3436422.jpg,2,0,0,0,2,,train
0508578_sc-229048.jpg,1,0,1,0,2,,train
0508579_sc-191171.jpg,2,0,0,0,2,,train
0508580_sc-191171.jpg,1,0,0,0,1,,train
0508582_sc-191171.jpg,1,0,0,0,1,,train
0508583_sc-194262.jpg,0,0,1,0,1,,val
0508584_as-0092695.jpg,1,0,0,0,1,,val
0508585_sc-218712.jpg,0,1,0,0,1,,test
0508586_sc-1036160.jpg,3,1,1,1,6,,train
0508587_sc-1036160.jpg,4,1,1,0,6,,train
0508588_sc-1036160.jpg,1,0,0,0,1,,train
0508589_sc-1036160.jpg,2,2,0,0,4,,train
0508590_sc-108800.jpg,1,0,0,0,1,,train
0508591_sc-108800.jpg,1,0,0,0,1,,train
0508593_sc-108800.jpg,2,0,0,0,2,,train
0508594_sc-108800.jpg,1,0,0,0,1,,val
0508595_as-9092452.jpg,2,0,0,0,2,,val
0508596_as-7584562.jpg,4,0,1,1,6,,test
0508597_as-0096215.jpg,0,0,1,1,2,,train
0508600_as-0096215.jpg,4,0,0,0,4,,train
0508603_as-3280129.jpg,2,1,1,1,5,,train
0508604_as-7995112.jpg,1,0,0,0,1,,train
0508605_sc-1000752.jpg,2,0,0,0,2,,train
0508606_sc-1000752.jpg,1,0,0,1,2,,train
0508607_sc-1000752.jpg,1,0,0,0,1,,train
0508608_as-0078091.jpg,3,0,0,0,3,,val
0508609_as-0078091.jpg,1,0,0,0,1,,val
0508611_as-3463135.jpg,1,0,0,0,1,,test
0508614_sc-191963.jpg,4,0,1,0,5,,train
0508616_sc-220540.jpg,1,0,0,1,2,,train
0508617_sc-220540.jpg,1,0,0,0,1,,train
0508618_as-7203231.jpg,2,0,1,0,3,,train
0508619_sc-105543.jpg,0,1,0,0,1,,train
0508620_sc-105543.jpg,0,1,0,0,1,,train
0508621_sc-105543.jpg,8,1,0,1,10,,train
0508622_sc-105543.jpg,4,0,0,0,4,,val
0508623_sc-105543.jpg,1,0,0,0,1,,val
0508624_sc-105364.jpg,2,0,0,0,2,,test
0508625_sc-105364.jpg,1,0,0,0,1,,train
0508626_sc-105364.jpg,2,0,0,0,2,,train
0508628_as-0008521.jpg,5,0,1,0,6,,train
0508629_as-0008521.jpg,4,0,1,1,6,,train
0508630_as-0008521.jpg,4,0,1,0,5,,train
0508631_as-0085637.jpg,1,0,0,0,1,,train
0508632_as-2802631.jpg,2,0,1,1,4,,train
0508633_sc-136679.jpg,1,0,0,1,2,,val
0508634_sc-136679.jpg,1,0,0,1,2,,val
0508635_as-2700982.jpg,2,1,0,0,3,,test
0508637_sc-121212.jpg,1,1,0,1,3,,train
0508638_sc-1007311.jpg,8,0,0,1,9,,train
0508639_sc-1007311.jpg,4,0,0,1,5,,train
0508640_sc-1007311.jpg,9,0,0,3,12,,train
0508642_as-0094221.jpg,2,0,0,0,2,,train
0508643_as-0094221.jpg,3,0,0,1,4,,train
0508648_sc-150343.jpg,4,0,2,1,7,,train
0508650_as-2816697.jpg,1,0,0,0,1,,val
0508651_sc-107520.jpg,2,0,0,0,2,,val
0508652_sc-107520.jpg,4,0,0,0,4,,test
0508653_as-2857477.jpg,6,1,0,1,8,,train
0508654_as-3447153.jpg,1,1,0,0,2,,train
0508655_sc-197280.jpg,1,0,1,1,3,,train
0508656_sc-197280.jpg,1,0,1,1,3,,train
0508657_sc-197280.jpg,1,0,1,1,3,,train
0508659_as-0026676.jpg,9,0,1,0,10,,train
0508660_as-0026676.jpg,7,0,0,0,7,,train
0508665_sc-186084.jpg,1,0,0,1,2,,val
0508666_sc-186084.jpg,1,0,0,1,2,,val
0508667_sc-186084.jpg,1,0,0,1,2,,test
0508668_sc-135942.jpg,1,2,1,0,4,,train
0508670_sc-135942.jpg,1,0,0,0,1,,train
0508671_sc-135942.jpg,1,0,0,0,1,,train
0508672_sc-135942.jpg,1,0,0,1,2,,train
0508673_as-7657588.jpg,2,0,0,0,2,,train
0508674_sc-164811.jpg,3,0,2,1,6,,train
0508675_sc-164811.jpg,7,0,1,1,9,,train
0508676_sc-164811.jpg,5,0,2,0,7,,val
0508677_sc-164811.jpg,3,0,2,1,6,,val
0508679_as-0064788.jpg,1,1,1,0,3,,test
0508681_as-0064788.jpg,0,1,2,0,3,,train
0508682_as-0064788.jpg,0,1,2,0,3,,train
0508683_as-0064788.jpg,0,1,1,0,2,,train
0508685_as-0064788.jpg,0,0,2,0,2,,train
0508687_sc-145033.jpg,2,0,0,0,2,,train
0508688_sc-145033.jpg,2,0,0,0,2,,train
0508689_sc-145033.jpg,2,0,0,0,2,,train
0508690_sc-145033.jpg,2,0,0,0,2,,val
0508692_sc-145033.jpg,1,0,0,0,1,,val
0508693_as-0074766.jpg,1,0,0,0,1,,test
0508694_as-3382746.jpg,1,1,1,1,4,,train
0508696_sc-159346.jpg,5,0,2,0,7,,train
0508697_as-2887306.jpg,1,0,0,0,1,,train
0508698_as-0044548.jpg,2,3,0,0,5,,train
0508699_as-0044548.jpg,1,2,1,1,5,,train
0508700_as-0044548.jpg,0,2,0,0,2,,train
0508701_sc-117704.jpg,2,0,0,0,2,,train
0508703_sc-175070.jpg,1,0,0,0,1,,val
0508704_sc-175070.jpg,1,0,4,1,6,,val
0508705_sc-175070.jpg,1,0,2,1,4,,test
0508706_sc-175070.jpg,2,0,1,0,3,,train
0508708_as-0010865.jpg,1,0,0,1,2,,train
0508709_as-0010865.jpg,1,0,0,1,2,,train
0508710_as-0010865.jpg,3,1,0,0,4,,train
0508711_as-0010865.jpg,3,0,0,2,5,,train
0508713_as-0010865.jpg,2,0,0,1,3,,train
0508717_sc-104852.jpg,2,1,3,1,7,,train
0508720_sc-104852.jpg,2,1,2,1,6,,val
0508722_sc-210056.jpg,3,0,0,0,3,,val
0508723_sc-210056.jpg,0,0,0,1,1,,test
0508725_sc-210056.jpg,1,0,0,0,1,,train
0508727_as-0056219.jpg,2,1,0,1,4,,train
0508728_as-0056219.jpg,2,1,0,0,3,,train
0508729_as-0001947.jpg,2,1,0,0,3,,train
0508730_as-0001947.jpg,1,0,0,0,1,,train
0508731_sc-172158.jpg,0,1,0,1,2,,train
0508732_sc-172158.jpg,0,1,0,0,1,,train
0508733_sc-172158.jpg,0,1,0,0,1,,val
0508734_as-0048908.jpg,3,1,1,0,5,,val
0508735_as-0048908.jpg,4,1,0,1,6,,test
0508736_as-0048908.jpg,0,1,0,1,2,,train
0508737_as-0048908.jpg,0,1,0,1,2,,train
0508738_as-0048908.jpg,3,1,0,1,5,,train
0508739_as-0018374.jpg,1,0,0,0,1,,train
0508740_as-0018374.jpg,1,0,0,0,1,,train
0508741_as-0018374.jpg,1,0,0,0,1,,train
0508743_as-0061375.jpg,1,0,0,0,1,,train
0508744_as-0061375.jpg,0,1,1,0,2,,val
0508745_as-0061375.jpg,0,1,1,1,3,,val
0508746_as-0061375.jpg,1,1,0,0,2,,test
0508748_as-0099795.jpg,1,0,0,0,1,,train
0508749_as-0099795.jpg,1,0,0,0,1,,train
0508750_as-0099795.jpg,1,0,0,0,1,,train
0508751_as-0099795.jpg,1,0,0,0,1,,train
0508752_sc-221176.jpg,6,0,1,0,7,,train
0508753_sc-146206.jpg,1,0,0,1,2,,train
0508754_sc-146206.jpg,2,0,0,1,3,,train
0508755_sc-146206.jpg,1,0,1,1,3,,val
0508756_sc-146206.jpg,1,0,1,1,3,,val
0508757_sc-230159.jpg,2,0,0,0,2,,test
0508758_sc-230159.jpg,2,0,0,0,2,,train
0508759_sc-230159.jpg,2,0,0,0,2,,train
0508760_sc-230159.jpg,4,0,0,0,4,,train
0508761_sc-161507.jpg,4,0,2,1,7,,train
0508762_sc-161507.jpg,5,0,2,1,8,,train
0508763_sc-161507.jpg,3,0,2,2,7,,train
0508764_sc-161507.jpg,2,0,2,2,6,,train
0508765_sc-161507.jpg,2,0,3,2,7,,val
0508767_sc-140996.jpg,1,1,0,0,2,,val
0508768_sc-140996.jpg,0,1,1,0,2,,test
0508770_as-0030217.jpg,3,2,1,0,6,,train
0508772_sc-197198.jpg,3,1,0,1,5,,train
0508773_sc-197198.jpg,4,1,0,1,6,,train
0508774_sc-216282.jpg,4,0,0,0,4,,train
0508775_sc-216282.jpg,4,0,0,0,4,,train
0508776_sc-193262.jpg,1,0,0,0,1,,train
0508777_sc-193262.jpg,1,0,0,0,1,,train
0508778_sc-193262.jpg,1,0,0,0,1,,val
0508779_sc-193262.jpg,1,0,0,0,1,,val
0508781_as-0044844.jpg,2,0,0,1,3,,test
0508782_sc-170721.jpg,1,0,0,1,2,,train
0508787_sc-170721.jpg,1,0,0,0,1,,train
0508788_sc-170721.jpg,1,0,0,1,2,,train
0508789_as-0068960.jpg,1,0,0,0,1,,train
0508790_as-0068960.jpg,1,0,0,0,1,,train
0508791_as-7719976.jpg,1,0,2,1,4,,train
0508792_as-0099350.jpg,4,1,0,0,5,,train
0508793_as-2832341.jpg,2,0,0,1,3,,val
0508794_as-2768850.jpg,1,0,0,0,1,,val
0508795_as-0036134.jpg,1,1,0,0,2,,test
0508796_as-0036134.jpg,1,1,0,0,2,,train
0508797_as-0036134.jpg,1,1,0,0,2,,train
0508798_as-0036134.jpg,1,1,0,0,2,,train
0508799_as-0036134.jpg,2,0,1,0,3,,train
0508800_as-0036134.jpg,6,0,1,0,7,,train
0508801_as-0036134.jpg,7,0,1,0,8,,train
0508802_as-0036134.jpg,6,1,1,1,9,,train
0508803_sc-111392.jpg,1,0,1,1,3,,val
0508804_sc-111392.jpg,1,0,0,1,2,,val
0508805_sc-124828.jpg,1,0,0,2,3,,test
0508806_sc-124828.jpg,3,0,0,1,4,,train
0508807_sc-124828.jpg,0,0,1,1,2,,train
0508808_sc-124828.jpg,0,0,1,2,3,,train
0508809_sc-124828.jpg,1,0,1,0,2,,train
0508810_sc-124828.jpg,3,0,0,0,3,,train
0508811_sc-124828.jpg,2,0,0,0,2,,train
0508812_sc-201826.jpg,3,0,1,0,4,,train
0508813_sc-201826.jpg,2,0,1,0,3,,val
0508814_sc-201826.jpg,1,0,0,0,1,,val
0508815_sc-201826.jpg,1,0,0,0,1,,test
0508816_sc-201826.jpg,2,0,0,0,2,,train
0508817_sc-201826.jpg,1,0,0,0,1,,train
0508818_sc-201826.jpg,2,0,0,0,2,,train
0508819_sc-201826.jpg,1,0,1,0,2,,train
0508820_sc-201826.jpg,1,0,1,0,2,,train
0508821_sc-201826.jpg,2,0,1,0,3,,train
0508822_sc-201826.jpg,2,0,1,0,3,,train
0508823_sc-201826.jpg,2,0,0,0,2,,val
0508826_as-0048928.jpg,0,2,1,0,3,,val
0508827_as-3006179.jpg,1,0,1,1,3,,test
0508828_as-7031458.jpg,2,0,0,0,2,,train
0508829_sc-149002.jpg,1,0,1,0,2,,train
0508830_sc-149002.jpg,4,2,2,0,8,,train
0508833_sc-174250.jpg,1,0,0,1,2,,train
0508834_sc-174250.jpg,1,0,1,0,2,,train
0508837_sc-174250.jpg,2,0,1,1,4,,train
0508838_sc-174250.jpg,2,0,1,0,3,,train
0508839_sc-174250.jpg,0,0,1,0,1,,val
0508840_sc-174250.jpg,0,0,1,0,1,,val
0508841_sc-174250.jpg,0,0,1,0,1,,test
0508842_sc-174250.jpg,1,1,0,0,2,,train
0508843_sc-174250.jpg,4,1,0,0,5,,train
0508844_sc-174250.jpg,4,0,0,0,4,,train
0508845_sc-174250.jpg,1,0,0,0,1,,train
0508847_sc-174250.jpg,0,1,1,1,3,,train
0508848_sc-174250.jpg,0,1,1,0,2,,train
0508849_sc-174250.jpg,0,0,1,0,1,,train
0508850_sc-174250.jpg,1,0,2,0,3,,val
0508851_sc-174250.jpg,2,0,0,0,2,,val
0508852_sc-174250.jpg,0,1,1,0,2,,test
0508853_sc-174250.jpg,2,0,0,0,2,,train
0508854_as-3033952.jpg,4,1,0,0,5,,train
0508856_as-0086469.jpg,2,1,0,0,3,,train
0508857_as-0086469.jpg,1,1,0,0,2,,train
0508861_as-0080912.jpg,2,1,2,1,6,,train
0508863_as-0080912.jpg,2,1,3,1,7,,train
0508864_as-0080912.jpg,0,2,2,0,4,,train
0508866_as-0080912.jpg,3,0,0,0,3,,val
0508867_as-0017541.jpg,1,0,2,0,3,,val
0508868_as-0020931.jpg,6,0,0,0,6,,test
0508869_as-0020931.jpg,1,0,0,0,1,,train
0508870_as-7534026.jpg,1,0,0,0,1,,train
0508871_as-2831909.jpg,2,0,0,0,2,,train
0508872_as-2615015.jpg,1,0,0,0,1,,train
0508877_as-0037082.jpg,1,0,0,0,1,,train
0508878_as-0037082.jpg,1,0,0,0,1,,train
0508879_as-0037082.jpg,1,1,0,0,2,,train
0508880_as-0037082.jpg,2,0,0,0,2,,val
0508881_as-0037082.jpg,1,1,0,0,2,,val
0508882_as-0037082.jpg,2,1,0,0,3,,test
0508885_as-0037082.jpg,1,0,0,0,1,,train
0508886_as-3188655.jpg,1,0,0,0,1,,train
0508887_sc-153902.jpg,1,0,1,0,2,,train
0508888_sc-153902.jpg,0,0,1,0,1,,train
0508890_as-0018294.jpg,1,1,1,0,3,,train
0508891_as-0018294.jpg,1,1,0,0,2,,train
0508892_as-0018294.jpg,3,0,0,0,3,,train
0508893_as-0018294.jpg,0,1,1,1,3,,val
0508895_sc-1035787.jpg,1,0,0,0,1,,val
0508896_sc-1035787.jpg,3,0,0,0,3,,test
0508897_as-9094488.jpg,2,0,0,0,2,,train
0508898_sc-216251.jpg,1,0,0,0,1,,train
0508899_sc-216251.jpg,1,0,0,0,1,,train
0508900_as-7771632.jpg,2,0,1,0,3,,train
0508902_as-0015380.jpg,1,0,1,1,3,,train
0508903_as-0015380.jpg,1,0,1,1,3,,train
0508904_as-0015380.jpg,1,0,1,0,2,,train
0508905_as-0015380.jpg,1,0,1,0,2,,val
0508906_as-0015380.jpg,1,0,1,0,2,,val
0508907_as-0015380.jpg,1,0,0,0,1,,test
0508908_as-0015380.jpg,1,0,1,0,2,,train
0508909_sc-120568.jpg,3,0,0,0,3,,train
0508910_sc-120568.jpg,1,0,0,0,1,,train
0508911_as-9054636.jpg,3,1,0,0,4,,train
0508915_as-0056845.jpg,1,0,0,0,1,,train
0508916_sc-198433.jpg,1,0,0,1,2,,train
0508917_sc-198433.jpg,1,0,0,1,2,,train
0508919_as-0012673.jpg,3,0,0,2,5,,val
0508920_as-0012673.jpg,3,1,1,2,7,,val
0508921_as-0012673.jpg,0,1,1,0,2,,test
0508922_as-0012673.jpg,0,1,1,0,2,,train
0508923_as-0012673.jpg,1,1,1,0,3,,train
0508924_sc-199032.jpg,3,0,2,0,5,,train
0508925_sc-199032.jpg,4,0,1,0,5,,train
0508926_sc-172561.jpg,1,0,0,0,1,,train
0508927_sc-172561.jpg,1,0,0,0,1,,train
0508928_sc-172561.jpg,0,1,0,0,1,,train
0508931_as-0014346.jpg,1,1,1,0,3,,val
0508932_as-0014346.jpg,1,1,1,0,3,,val
0508933_as-0014346.jpg,0,1,1,0,2,,test
0508934_as-0014346.jpg,0,1,0,0,1,,train
0508935_as-0018469.jpg,3,0,2,0,5,,train
0508937_as-2630114.jpg,2,0,0,0,2,,train
0508938_sc-1023095.jpg,2,0,0,0,2,,train
0508939_sc-1023095.jpg,2,0,0,0,2,,train
0508940_sc-110055.jpg,5,0,1,3,9,,train
0508941_as-3455144.jpg,2,0,0,0,2,,train
0508942_sc-217693.jpg,2,0,1,1,4,,val
0508943_sc-217693.jpg,2,0,1,1,4,,val
0508944_as-0054953.jpg,3,0,0,0,3,,test
0508945_as-0054953.jpg,2,0,0,0,2,,train
0508946_as-0054953.jpg,2,0,0,0,2,,train
0508947_as-0054953.jpg,2,0,0,0,2,,train
0508948_as-0054953.jpg,2,0,0,0,2,,train
0508949_as-0054953.jpg,2,0,0,0,2,,train
0508952_as-0076887.jpg,3,1,1,2,7,,train
0508953_as-0076887.jpg,3,1,1,2,7,,train
0508954_as-3039765.jpg,1,0,1,0,2,,val
0508955_as-2636210.jpg,3,0,0,1,4,,val
0508956_as-2789986.jpg,3,0,0,0,3,,test
0508957_as-0013233.jpg,1,0,0,0,1,,train
0508958_as-0013233.jpg,1,0,0,0,1,,train
0508959_as-0013233.jpg,2,0,0,0,2,,train
0508960_as-0013233.jpg,2,0,0,0,2,,train
0508961_as-0013233.jpg,4,0,0,0,4,,train
0508962_as-7020234.jpg,0,0,0,1,1,,train
0508965_as-0090688.jpg,0,0,1,1,2,,train
0508966_as-7490275.jpg,1,0,0,0,1,,val
0508967_sc-198989.jpg,3,0,0,0,3,,val
0508968_sc-217324.jpg,0,1,0,0,1,,test
0508969_sc-174858.jpg,0,1,1,0,2,,train
0508970_sc-174858.jpg,1,0,1,0,2,,train
0508971_as-0035159.jpg,2,0,0,0,2,,train
0508973_as-3292442.jpg,5,3,0,0,8,,train
0508974_sc-114395.jpg,3,0,0,0,3,,train
0508975_sc-114395.jpg,3,0,0,0,3,,train
0508976_sc-114395.jpg,3,0,0,0,3,,train
0508977_as-0043025.jpg,1,0,0,0,1,,val
0508978_as-0043025.jpg,3,0,0,1,4,,val
0508979_as-2625587.jpg,2,0,0,0,2,,test
0508980_as-3259717.jpg,2,0,0,0,2,,train
0508981_as-3291236.jpg,3,0,0,0,3,,train
0508982_as-2848494.jpg,1,0,0,0,1,,train
0508984_as-2612051.jpg,1,0,1,0,2,,train
0508985_as-2971311.jpg,1,0,1,0,2,,train
0508986_sc-112064.jpg,3,0,1,0,4,,train
0508987_sc-112064.jpg,4,0,0,0,4,,train
0508988_sc-112064.jpg,1,0,0,0,1,,val
0508990_sc-112064.jpg,3,0,0,0,3,,val
0508992_sc-112064.jpg,1,0,0,0,1,,test
0508993_sc-112064.jpg,4,0,0,0,4,,train
0508995_as-2639513.jpg,0,0,1,0,1,,train
0508996_as-2776786.jpg,2,0,0,0,2,,train
0508997_as-2776786.jpg,2,0,0,0,2,,train
0508998_sc-211223.jpg,3,0,0,0,3,,train
0508999_sc-211223.jpg,4,0,0,0,4,,train
0509000_sc-105039.jpg,4,0,0,0,4,,train
0509001_sc-105039.jpg,3,0,2,0,5,,val
0509002_sc-105039.jpg,4,0,1,0,5,,val
0509003_sc-105039.jpg,2,0,2,0,4,,test
0509004_sc-105039.jpg,2,0,2,0,4,,train
0509005_sc-105039.jpg,3,0,1,0,4,,train
0509006_sc-105039.jpg,0,0,1,0,1,,train
0509007_sc-105039.jpg,4,0,0,0,4,,train
0509012_sc-105039.jpg,3,1,0,0,4,,train
0509013_sc-105039.jpg,2,1,0,0,3,,train
0509014_sc-105039.jpg,2,0,0,0,2,,train
0509015_sc-1002650.jpg,7,1,0,0,8,,val
0509016_sc-1002650.jpg,5,1,0,0,6,,val
0509018_sc-229258.jpg,1,0,0,0,1,,test
0509019_sc-220566.jpg,1,0,0,0,1,,train
0509020_sc-220566.jpg,1,0,0,0,1,,train
0509021_sc-220566.jpg,2,0,0,0,2,,train
0509022_as-0076611.jpg,1,0,1,1,3,,train
0509023_as-0076611.jpg,1,0,1,1,3,,train
0509024_as-0076611.jpg,1,0,0,1,2,,train
0509025_as-0076611.jpg,1,0,0,0,1,,train
0509026_sc-210590.jpg,2,0,0,0,2,,val
0509027_sc-210590.jpg,3,0,0,1,4,,val
0509028_sc-173895.jpg,4,0,1,0,5,,test
0509029_sc-173895.jpg,6,0,3,2,11,,train
0509030_sc-173895.jpg,2,0,1,0,3,,train
0509031_sc-173895.jpg,6,2,1,0,9,,train
0509035_as-0028245.jpg,1,0,0,0,1,,train
0509036_sc-1013447.jpg,3,0,0,0,3,,train
0509037_sc-1013447.jpg,1,0,0,0,1,,train
0509038_sc-1013447.jpg,1,0,0,0,1,,train
0509039_as-3340882.jpg,1,0,0,0,1,,val
0509040_as-2639043.jpg,1,0,0,0,1,,val
0509042_as-0083629.jpg,2,3,1,2,8,,test
0509045_sc-123594.jpg,2,0,0,0,2,,train
0509046_sc-123594.jpg,2,0,0,0,2,,train
0509047_sc-153763.jpg,2,0,0,1,3,,train
0509049_as-7896693.jpg,1,0,0,0,1,,train
0509050_sc-146335.jpg,1,0,0,0,1,,train
0509051_sc-146335.jpg,2,0,0,0,2,,train
0509052_as-9085884.jpg,0,2,1,1,4,,train
0509053_sc-1041522.jpg,2,0,0,0,2,,val
0509054_as-7340185.jpg,3,1,1,1,6,,val
0509055_as-0000630.jpg,2,0,0,0,2,,test
0509056_as-0000630.jpg,2,0,0,0,2,,train
0509057_as-2818712.jpg,1,4,1,1,7,,train
0509059_sc-1002666.jpg,1,0,0,0,1,,train
0509060_sc-1002666.jpg,1,0,0,0,1,,train
0509061_sc-1002666.jpg,1,0,2,0,3,,train
0509065_as-0085484.jpg,1,0,0,1,2,,train
0509066_as-0085484.jpg,1,0,0,0,1,,train
0509068_as-3081702.jpg,2,0,0,0,2,,val
0509070_sc-1010150.jpg,1,0,0,0,1,,val
0509071_sc-1010150.jpg,1,0,0,0,1,,test
0509074_sc-149851.jpg,5,0,0,0,5,,train
0509078_as-0077479.jpg,4,2,0,0,6,,train
0509079_as-0077479.jpg,0,1,1,0,2,,train
0509080_as-0077479.jpg,1,1,0,0,2,,train
0509082_as-7299325.jpg,3,1,2,2,8,,train
0509085_as-0086570.jpg,0,0,0,1,1,,train
0509086_as-0086570.jpg,0,0,0,1,1,,train
0509087_sc-196040.jpg,1,4,2,0,7,,val
0509088_sc-196040.jpg,0,2,3,0,5,,val
0509089_sc-196040.jpg,1,3,2,0,6,,test
0509090_as-7621656.jpg,1,0,0,1,2,,train
0509091_sc-178221.jpg,8,0,2,0,10,,train
0509092_sc-178221.jpg,4,0,1,0,5,,train
0509093_sc-178221.jpg,4,0,1,0,5,,train
0509094_sc-178221.jpg,5,0,0,0,5,,train
0509098_sc-1003750.jpg,0,1,0,0,1,,train
0509099_sc-1003750.jpg,0,0,1,0,1,,train
0509100_sc-1003750.jpg,0,2,1,0,3,,val
0509101_sc-1003750.jpg,0,0,1,0,1,,val
0509102_as-0034172.jpg,3,0,0,0,3,,test
0509103_as-0034172.jpg,1,0,1,0,2,,train
0509104_as-0034172.jpg,1,0,0,0,1,,train
0509105_as-0034172.jpg,4,2,1,0,7,,train
0509106_as-0034172.jpg,5,2,1,0,8,,train
0509107_sc-209335.jpg,0,1,0,0,1,,train
0509108_as-3331875.jpg,1,0,0,0,1,,train
0509110_as-3262237.jpg,4,1,2,3,10,,train
0509112_sc-220841.jpg,2,0,0,0,2,,val
0509113_sc-220841.jpg,1,1,0,0,2,,val
0509114_as-3072609.jpg,1,1,0,0,2,,test
0509116_as-0019807.jpg,3,1,0,1,5,,train
0509117_as-0019807.jpg,1,1,1,1,4,,train
0509118_as-0019807.jpg,5,1,1,1,8,,train
0509119_as-0019807.jpg,1,0,0,1,2,,train
0509122_as-7338086.jpg,0,0,2,0,2,,train
0509123_sc-225915.jpg,1,0,1,0,2,,train
0509124_as-3232158.jpg,1,0,1,0,2,,train
0509125_sc-228904.jpg,1,0,0,0,1,,val
0509126_sc-228904.jpg,1,0,0,0,1,,val
0509127_sc-228904.jpg,1,0,1,1,3,,test
0509128_as-3284364.jpg,1,1,0,0,2,,train
0509129_sc-219953.jpg,5,0,0,0,5,,train
0509133_as-2688856.jpg,1,2,0,0,3,,train
0509134_sc-154195.jpg,1,0,0,0,1,,train
0509135_sc-154195.jpg,3,0,0,0,3,,train
0509136_sc-154195.jpg,1,0,0,0,1,,train
0509137_sc-154195.jpg,3,0,0,0,3,,train
0509138_sc-154195.jpg,1,0,0,0,1,,val
0509141_sc-103089.jpg,1,0,1,1,3,,val
0509142_sc-103089.jpg,1,0,1,1,3,,test
0509143_sc-103089.jpg,1,0,1,1,3,,train
0509146_as-0000367.jpg,2,1,1,1,5,,train
0509147_as-0000367.jpg,8,0,0,0,8,,train
0509149_as-0051443.jpg,3,0,1,0,4,,train
0509150_as-0051443.jpg,2,0,0,0,2,,train
0509151_as-0051443.jpg,6,0,1,0,7,,train
0509152_as-0051443.jpg,11,0,1,0,12,,train
0509153_as-0051443.jpg,11,0,1,0,12,,val
0509154_as-0051443.jpg,6,0,0,0,6,,val
0509155_as-0051443.jpg,3,0,1,0,4,,test
0509156_as-0051443.jpg,3,0,1,0,4,,train
0509159_as-3031939.jpg,1,0,0,0,1,,train
0509160_as-3230541.jpg,1,0,0,0,1,,train
0509161_as-3387127.jpg,1,0,0,0,1,,train
0509163_as-0000295.jpg,1,0,0,0,1,,train
0509164_as-3130067.jpg,4,3,2,1,10,,train
0509166_sc-135975.jpg,6,0,0,0,6,,train
0509167_sc-135975.jpg,3,0,0,0,3,,val
0509168_sc-1033629.jpg,1,0,0,1,2,,val
0509169_sc-1028900.jpg,0,1,0,0,1,,test
0509170_as-9089897.jpg,3,1,0,0,4,,train
0509171_sc-1026932.jpg,1,0,0,0,1,,train
0509172_sc-1026932.jpg,1,0,1,0,2,,train
0509175_as-0049642.jpg,1,0,0,1,2,,train
0509176_as-0049642.jpg,1,0,0,1,2,,train
0509177_as-0049642.jpg,1,0,0,1,2,,train
0509178_as-3354330.jpg,1,0,0,1,2,,train
0509180_as-0064157.jpg,5,0,0,0,5,,val
0509181_as-0064157.jpg,6,0,0,0,6,,val
0509183_as-7420768.jpg,1,0,0,1,2,,test
0509184_as-7896568.jpg,5,1,2,1,9,,train
0509186_sc-145408.jpg,2,0,0,0,2,,train
0509187_sc-145408.jpg,2,0,1,0,3,,train
0509188_sc-145408.jpg,1,0,1,0,2,,train
0509189_sc-145408.jpg,2,0,2,0,4,,train
0509190_as-3193959.jpg,1,0,1,0,2,,train
0509191_sc-201067.jpg,1,0,1,1,3,,train
0509192_sc-201067.jpg,4,0,0,0,4,,val
0509193_sc-201067.jpg,4,0,1,0,5,,val
0509194_sc-201067.jpg,1,0,1,0,2,,test
0509195_sc-201067.jpg,1,0,1,0,2,,train
0509196_sc-201067.jpg,1,0,1,0,2,,train
0509199_as-3360174.jpg,2,1,0,0,3,,train
0509201_as-7038356.jpg,2,0,0,0,2,,train
0509203_as-2524764.jpg,2,0,0,0,2,,train
0509204_as-3497234.jpg,1,0,0,0,1,,train
0509205_as-2746011.jpg,2,0,0,0,2,,train
0509206_as-2818620.jpg,1,0,0,0,1,,val
0509207_as-0032951.jpg,1,0,0,0,1,,val
0509208_as-0032951.jpg,1,0,0,1,2,,test
0509209_as-0032951.jpg,1,0,0,0,1,,train
0509210_sc-206301.jpg,1,0,1,0,2,,train
0509211_sc-206301.jpg,1,0,1,0,2,,train
0509212_sc-206301.jpg,0,0,0,2,2,,train
0509213_sc-206301.jpg,2,0,1,0,3,,train
0509214_sc-206301.jpg,0,0,0,1,1,,train
0509215_sc-206301.jpg,1,0,0,1,2,,train
0509216_sc-206301.jpg,1,0,0,1,2,,val
0509217_sc-206301.jpg,1,0,0,0,1,,val
0509218_sc-206301.jpg,0,0,0,1,1,,test
0509219_sc-206301.jpg,1,0,0,1,2,,train
0509220_sc-157681.jpg,4,0,0,0,4,,train
0509221_as-2711945.jpg,0,1,0,0,1,,train
0509222_sc-1021585.jpg,1,0,0,0,1,,train
0509223_sc-1021585.jpg,2,0,0,0,2,,train
0509225_sc-142815.jpg,3,1,0,3,7,,train
0509226_sc-142815.jpg,1,1,0,3,5,,train
0509227_sc-142815.jpg,1,1,0,3,5,,val
0509228_as-5039638.jpg,1,0,0,0,1,,val
0509229_sc-1029510.jpg,6,0,0,1,7,,test
0509230_sc-1029510.jpg,1,1,1,0,3,,train
0509231_sc-1029510.jpg,3,0,0,1,4,,train
0509235_sc-205159.jpg,1,1,0,0,2,,train
0509236_as-2541497.jpg,3,0,1,0,4,,train
0509237_sc-161128.jpg,3,0,0,1,4,,train
0509238_sc-161128.jpg,1,0,0,0,1,,train
0509239_sc-161128.jpg,4,0,0,1,5,,train
0509240_sc-161128.jpg,2,0,0,1,3,,val
0509241_sc-161128.jpg,3,0,0,1,4,,val
0509242_sc-161128.jpg,1,0,0,0,1,,test
0509243_sc-161128.jpg,4,0,0,0,4,,train
0509244_as-2792568.jpg,1,0,1,0,2,,train
0509245_as-7562931.jpg,1,0,2,0,3,,train
0509246_as-7153728.jpg,1,0,1,0,2,,train
0509250_as-0098836.jpg,3,2,2,0,7,,train
0509251_as-0098836.jpg,2,1,2,0,5,,train
0509252_as-0098836.jpg,4,0,1,1,6,,train
0509253_as-0098836.jpg,0,0,2,0,2,,val
0509254_sc-133718.jpg,0,1,1,0,2,,val
0509256_as-0076853.jpg,5,0,1,1,7,,test
0509257_as-0076853.jpg,1,0,1,1,3,,train
0509259_as-2636267.jpg,10,0,0,1,11,,train
0509260_sc-124619.jpg,8,0,0,0,8,,train
0509261_sc-1017706.jpg,0,1,0,0,1,,train
0509263_sc-1017706.jpg,0,1,0,0,1,,train
0509264_as-0053526.jpg,0,1,0,0,1,,train
0509265_as-0053526.jpg,0,1,0,0,1,,train
0509266_as-0053526.jpg,0,1,0,0,1,,val
0509267_as-0053526.jpg,0,1,0,0,1,,val
0509268_sc-223162.jpg,1,0,0,0,1,,test
0509269_sc-223162.jpg,4,0,1,0,5,,train
0509270_sc-223162.jpg,4,0,1,0,5,,train
0509271_sc-223162.jpg,1,0,1,1,3,,train
0509272_sc-223162.jpg,2,0,1,1,4,,train
0509273_as-0046427.jpg,3,0,0,0,3,,train
0509274_as-0046427.jpg,2,0,0,0,2,,train
0509275_as-0046427.jpg,2,0,0,0,2,,train
0509276_as-0046427.jpg,2,0,0,0,2,,val
0509277_as-0046427.jpg,1,0,0,0,1,,val
0509278_as-0046427.jpg,2,0,0,0,2,,test
0509279_as-0046427.jpg,1,0,0,0,1,,train
0509280_as-0099772.jpg,2,0,0,0,2,,train
0509281_as-0099772.jpg,1,0,0,0,1,,train
0509282_as-0099772.jpg,1,0,0,0,1,,train
0509283_as-0099772.jpg,1,0,0,0,1,,train
0509284_as-3196157.jpg,1,1,0,1,3,,train
0509285_as-2972561.jpg,3,2,1,0,6,,train
0509286_sc-196515.jpg,2,0,1,0,3,,val
0509288_as-7222855.jpg,2,1,0,0,3,,val
0509289_sc-222506.jpg,1,1,0,0,2,,test
0509290_sc-222506.jpg,1,1,0,0,2,,train
0509291_as-9010659.jpg,5,0,0,0,5,,train
0509292_as-2702652.jpg,2,0,0,0,2,,train
0509293_sc-151511.jpg,1,1,0,0,2,,train
0509294_sc-151511.jpg,1,1,0,0,2,,train
0509295_sc-151511.jpg,0,0,1,0,1,,train
0509296_sc-151511.jpg,1,1,0,0,2,,train
0509297_as-0054044.jpg,1,0,0,0,1,,val
0509298_as-0054044.jpg,1,0,0,0,1,,val
0509299_as-0054044.jpg,1,0,0,0,1,,test
0509300_as-0054044.jpg,2,0,0,0,2,,train
0509301_as-0054044.jpg,1,0,0,0,1,,train
0509302_as-0054044.jpg,1,0,0,0,1,,train
0509303_as-0054044.jpg,1,0,0,0,1,,train
0509304_as-0054044.jpg,1,0,0,0,1,,train
0509305_sc-1033023.jpg,5,1,0,0,6,,train
0509306_sc-1033023.jpg,2,0,1,0,3,,train
0509307_as-3050263.jpg,2,0,0,1,3,,val
0509308_as-3052081.jpg,2,0,0,0,2,,val
0509309_as-2777087.jpg,0,0,1,0,1,,test
0509314_sc-118922.jpg,1,0,1,0,2,,train
0509315_sc-137720.jpg,2,0,1,0,3,,train
0509316_sc-137720.jpg,7,0,2,1,10,,train
0509318_sc-137720.jpg,6,0,3,1,10,,train
0509319_sc-137720.jpg,5,0,1,0,6,,train
0509320_sc-187429.jpg,1,0,1,0,2,,train
0509322_sc-187429.jpg,1,0,0,0,1,,train
0509323_sc-187429.jpg,1,0,0,0,1,,val
0509325_sc-187429.jpg,2,0,0,0,2,,val
0509326_sc-187429.jpg,2,0,0,0,2,,test
0509327_sc-187429.jpg,0,0,1,0,1,,train
0509328_as-7050444.jpg,4,3,0,2,9,,train
0509329_as-3245561.jpg,1,0,0,0,1,,train
0509330_sc-195846.jpg,7,5,1,1,14,,train
0509331_sc-195846.jpg,5,3,1,1,10,,train
0509332_sc-195846.jpg,6,1,3,1,11,,train
0509333_sc-195846.jpg,5,1,1,1,8,,train
0509334_sc-195846.jpg,1,1,0,0,2,,val
0509336_as-0000109.jpg,2,0,1,0,3,,val
0509337_sc-199050.jpg,0,1,0,0,1,,test
0509338_sc-207188.jpg,5,0,0,0,5,,train
0509339_sc-207188.jpg,4,0,1,0,5,,train
0509340_sc-207188.jpg,3,0,0,0,3,,train
0509341_sc-207188.jpg,4,0,1,0,5,,train
0509342_sc-207188.jpg,3,0,0,0,3,,train
0509343_sc-207188.jpg,2,0,1,0,3,,train
0509345_sc-117630.jpg,1,0,0,0,1,,train
0509346_sc-117630.jpg,3,0,0,0,3,,val
0509348_as-0074101.jpg,1,0,0,0,1,,val
0509349_as-0074101.jpg,5,0,0,0,5,,test
0509350_as-0074101.jpg,4,0,0,0,4,,train
0509351_as-0074101.jpg,1,0,0,0,1,,train
0509352_as-0074101.jpg,3,1,0,0,4,,train
0509353_sc-159515.jpg,5,0,0,0,5,,train
0509354_sc-159515.jpg,4,0,0,1,5,,train
0509355_sc-159515.jpg,0,0,1,1,2,,train
0509356_sc-159515.jpg,4,0,1,1,6,,train
0509358_as-0062751.jpg,0,0,0,1,1,,val
0509359_as-0062751.jpg,1,0,0,0,1,,val
0509360_as-0062751.jpg,1,0,1,0,2,,test
0509362_as-0062751.jpg,2,0,0,0,2,,train
0509363_as-2599788.jpg,0,1,0,1,2,,train
0509364_sc-216443.jpg,5,1,0,0,6,,train
0509365_sc-216443.jpg,8,1,0,0,9,,train
0509366_sc-216443.jpg,3,1,0,0,4,,train
0509368_sc-1023536.jpg,2,0,0,0,2,,train
0509369_sc-1023536.jpg,3,0,0,0,3,,train
0509370_sc-1023536.jpg,3,0,0,0,3,,val
0509371_sc-1023536.jpg,2,0,0,0,2,,val
0509372_sc-1023536.jpg,2,0,0,0,2,,test
0509373_sc-199690.jpg,4,0,0,0,4,,train
0509374_sc-199690.jpg,6,0,0,0,6,,train
0509375_sc-228112.jpg,3,1,1,1,6,,train
0509376_sc-228112.jpg,1,1,0,1,3,,train
0509377_sc-228112.jpg,4,0,0,0,4,,train
0509378_as-2698672.jpg,2,0,0,0,2,,train
0509379_sc-213460.jpg,1,0,0,1,2,,train
0509380_sc-134061.jpg,0,0,1,0,1,,val
0509381_sc-134061.jpg,0,0,1,0,1,,val
0509382_sc-134061.jpg,0,0,1,0,1,,test
0509383_sc-110196.jpg,3,0,0,0,3,,train
0509384_sc-110196.jpg,1,0,0,0,1,,train
0509385_sc-110196.jpg,2,0,0,0,2,,train
0509388_as-0058958.jpg,1,0,2,0,3,,train
0509389_as-0058958.jpg,1,1,1,1,4,,train
0509391_as-0058958.jpg,1,0,1,0,2,,train
0509392_as-0058958.jpg,0,1,0,0,1,,train
0509396_sc-207001.jpg,1,0,0,0,1,,val
0509397_sc-207001.jpg,2,0,0,0,2,,val
0509398_sc-207001.jpg,2,0,0,0,2,,test
0509399_sc-207001.jpg,4,0,1,0,5,,train
0509400_sc-207001.jpg,3,0,0,0,3,,train
0509401_sc-207001.jpg,3,0,0,0,3,,train
0509402_as-0036851.jpg,0,1,0,0,1,,train
0509403_as-0036851.jpg,0,1,0,0,1,,train
0509404_as-0036851.jpg,1,1,1,0,3,,train
0509406_as-0036851.jpg,2,0,1,0,3,,train
0509407_as-0036851.jpg,1,0,1,0,2,,val
0509408_as-0036851.jpg,1,1,2,0,4,,val
0509411_sc-210689.jpg,2,0,1,0,3,,test
0509412_sc-142809.jpg,1,0,0,0,1,,train
0509413_sc-142754.jpg,2,1,1,0,4,,train
0509414_as-2654676.jpg,1,1,0,0,2,,train
0509415_sc-1026295.jpg,1,0,0,0,1,,train
0509416_sc-1026295.jpg,0,0,1,0,1,,train
0509417_as-7555427.jpg,1,3,0,0,4,,train
0509418_as-2687334.jpg,1,0,1,1,3,,train
0509421_as-7332819.jpg,0,0,1,0,1,,val
0509423_as-3306112.jpg,2,0,1,1,4,,val
0509424_as-0078137.jpg,1,1,0,0,2,,test
0509425_as-0078137.jpg,0,1,0,0,1,,train
0509426_as-0078137.jpg,0,0,1,0,1,,train
0509430_as-0078137.jpg,0,2,2,0,4,,train
0509431_as-0078137.jpg,0,2,1,0,3,,train
0509432_as-0078137.jpg,0,0,1,0,1,,train
0509433_as-0078137.jpg,0,0,1,0,1,,train
0509434_as-0078137.jpg,0,1,2,0,3,,train
0509435_as-0078137.jpg,0,0,1,0,1,,val
0509436_as-9078062.jpg,1,1,0,0,2,,val
0509437_sc-129718.jpg,1,2,1,0,4,,test
0509438_sc-129718.jpg,2,2,0,2,6,,train
0509439_sc-129718.jpg,1,0,2,1,4,,train
0509440_as-3435957.jpg,2,0,0,0,2,,train
0509441_sc-1026393.jpg,5,0,0,0,5,,train
0509442_sc-133579.jpg,0,1,1,0,2,,train
0509443_sc-133579.jpg,2,2,2,0,6,,train
0509444_sc-133579.jpg,1,0,0,1,2,,train
0509445_sc-133579.jpg,1,1,2,0,4,,val
0509446_sc-1020902.jpg,5,0,0,0,5,,val
0509447_sc-1020902.jpg,2,0,0,0,2,,test
0509449_sc-1020902.jpg,7,0,0,1,8,,train
0509450_sc-1020902.jpg,4,0,0,0,4,,train
0509451_sc-1020902.jpg,3,0,1,0,4,,train
0509454_sc-141219.jpg,1,0,0,0,1,,train
0509455_sc-141219.jpg,1,0,0,0,1,,train
0509456_as-0047356.jpg,2,0,0,1,3,,train
0509457_as-0047356.jpg,2,0,0,0,2,,train
0509458_as-0047356.jpg,2,0,0,1,3,,val
0509459_as-0047356.jpg,1,0,0,0,1,,val
0509460_as-0047356.jpg,1,0,2,0,3,,test
0509461_as-0082108.jpg,2,0,0,0,2,,train
0509462_as-0082108.jpg,3,1,2,0,6,,train
0509463_as-0082108.jpg,5,0,2,1,8,,train
0509464_as-3090933.jpg,1,0,0,0,1,,train
0509465_sc-107377.jpg,5,0,0,0,5,,train
0509466_sc-107377.jpg,10,0,0,0,10,,train
0509467_as-7699686.jpg,1,0,0,1,2,,train
0509468_sc-147723.jpg,3,0,0,0,3,,val
0509469_sc-1009709.jpg,0,1,0,0,1,,val
0509471_sc-215567.jpg,0,0,0,1,1,,test
0509472_as-3499765.jpg,1,0,1,0,2,,train
0509473_as-0000871.jpg,0,0,1,0,1,,train
0509474_as-0000871.jpg,0,0,1,0,1,,train
0509475_as-0000871.jpg,0,1,0,0,1,,train
0509476_as-0000871.jpg,1,0,0,0,1,,train
0509477_sc-135153.jpg,1,0,0,0,1,,train
0509478_sc-135153.jpg,1,0,0,0,1,,train
0509480_sc-135153.jpg,1,0,0,0,1,,val
0509483_as-0052320.jpg,2,0,3,2,7,,val
0509484_as-0052320.jpg,7,0,1,1,9,,test
0509485_as-0052320.jpg,7,0,1,1,9,,train
0509486_as-0052320.jpg,10,0,3,1,14,,train
0509487_as-0052320.jpg,5,0,1,0,6,,train
0509488_as-0052320.jpg,4,0,0,0,4,,train
0509489_as-0052320.jpg,6,0,1,0,7,,train
0509490_as-0052320.jpg,3,1,0,0,4,,train
0509492_as-0052320.jpg,5,0,0,1,6,,train
0509493_as-0052320.jpg,3,0,0,2,5,,val
0509494_as-0052320.jpg,9,0,0,1,10,,val
0509495_as-0052320.jpg,1,0,2,1,4,,test
0509496_as-0052320.jpg,0,0,1,0,1,,train
0509497_as-0052320.jpg,1,0,1,0,2,,train
0509499_as-0043537.jpg,1,0,0,0,1,,train
0509500_as-0043537.jpg,1,0,0,0,1,,train
0509501_as-2562097.jpg,2,0,0,0,2,,train
0509504_sc-190657.jpg,4,2,3,0,9,,train
0509505_sc-190657.jpg,5,3,3,0,11,,train
0509507_as-2502088.jpg,1,1,0,0,2,,val
0509508_as-0087854.jpg,2,0,0,0,2,,val
0509509_as-0087854.jpg,2,0,0,0,2,,test
0509510_as-7555926.jpg,0,0,1,0,1,,train
0509512_as-0052777.jpg,1,1,1,0,3,,train
0509513_as-0052777.jpg,2,0,0,0,2,,train
0509514_as-0052777.jpg,2,0,0,0,2,,train
0509516_as-0016732.jpg,1,0,1,0,2,,train
0509517_as-0016732.jpg,1,2,1,0,4,,train
0509518_as-0016732.jpg,1,2,1,0,4,,train
0509519_as-0016732.jpg,1,2,1,0,4,,val
0509521_as-2919313.jpg,5,1,0,0,6,,val
0509522_as-3281207.jpg,1,0,0,1,2,,test
0509523_sc-160823.jpg,1,0,0,0,1,,train
0509524_sc-160823.jpg,1,0,0,0,1,,train
0509525_sc-160823.jpg,1,0,0,0,1,,train
0509526_as-3324906.jpg,2,0,0,0,2,,train
0509527_as-2613253.jpg,0,2,0,0,2,,train
0509528_sc-1034211.jpg,4,1,2,0,7,,train
0509529_sc-1034211.jpg,8,1,2,0,11,,train
0509530_sc-130081.jpg,4,0,1,2,7,,val
0509531_sc-211503.jpg,1,1,0,0,2,,val
0509532_sc-211503.jpg,15,0,0,0,15,,test
0509533_sc-220147.jpg,0,0,1,0,1,,train
0509535_sc-211017.jpg,3,0,0,0,3,,train
0509538_as-0016325.jpg,1,0,0,0,1,,train
0509539_as-0016325.jpg,1,0,0,0,1,,train
0509540_as-2789136.jpg,0,1,0,0,1,,train
0509541_as-7541011.jpg,1,0,1,0,2,,train
0509544_as-0093159.jpg,1,0,0,0,1,,train
0509545_as-0093159.jpg,2,0,0,0,2,,val
0509546_as-0093159.jpg,3,0,0,0,3,,val
0509547_as-0093159.jpg,1,0,0,0,1,,test
0509548_as-0022756.jpg,1,0,0,0,1,,train
0509549_as-0022756.jpg,1,0,0,0,1,,train
0509551_as-3262471.jpg,2,0,0,0,2,,train
0509553_as-7855948.jpg,2,2,2,1,7,,train
0509554_sc-109694.jpg,7,0,0,0,7,,train
0509555_sc-109694.jpg,2,0,0,0,2,,train
0509556_sc-109694.jpg,6,0,0,0,6,,train
0509559_sc-109694.jpg,11,0,0,0,11,,val
0509560_sc-109694.jpg,3,0,0,0,3,,val
0509561_as-3384235.jpg,1,0,2,1,4,,test
0509562_as-3063192.jpg,5,0,0,0,5,,train
0509565_as-0063070.jpg,1,0,0,0,1,,train
0509567_as-0021062.jpg,1,0,0,0,1,,train
0509569_as-9008081.jpg,2,0,1,0,3,,train
0509573_as-0017060.jpg,2,0,0,0,2,,train
0509574_as-0066735.jpg,2,0,0,0,2,,train
0509575_sc-159155.jpg,4,1,1,1,7,,train
0509576_as-7547193.jpg,5,1,0,0,6,,val
0509577_sc-175194.jpg,1,2,1,1,5,,val
0509578_sc-175194.jpg,1,2,1,1,5,,test
0509580_sc-175194.jpg,2,2,1,1,6,,train
0509581_sc-175194.jpg,4,2,1,1,8,,train
0509582_as-7971811.jpg,0,1,1,2,4,,train
0509583_as-2779831.jpg,2,0,0,0,2,,train
0509584_as-2969334.jpg,1,0,0,0,1,,train
0509585_as-2967348.jpg,1,1,2,0,4,,train
0509586_as-3048941.jpg,4,0,0,0,4,,train
0509587_sc-191362.jpg,5,0,0,0,5,,val
0509588_as-9002795.jpg,1,0,0,0,1,,val
0509589_as-2852406.jpg,1,0,0,0,1,,test
0509590_sc-221183.jpg,2,0,0,0,2,,train
0509591_sc-221183.jpg,2,0,0,0,2,,train
0509592_sc-221183.jpg,1,0,0,0,1,,train
0509593_sc-221183.jpg,2,0,0,0,2,,train
0509595_sc-221183.jpg,1,0,0,0,1,,train
0509596_sc-221183.jpg,1,0,0,0,1,,train
0509597_sc-221183.jpg,1,0,0,0,1,,train
0509598_as-0065844.jpg,2,0,0,1,3,,val
0509599_as-0065844.jpg,0,1,0,0,1,,val
0509601_sc-176051.jpg,5,3,1,0,9,,test
0509602_sc-176051.jpg,3,2,0,0,5,,train
0509604_sc-176051.jpg,4,3,1,1,9,,train
0509605_sc-176051.jpg,5,2,1,0,8,,train
0509606_sc-176051.jpg,7,0,0,1,8,,train
0509607_sc-176051.jpg,4,2,0,1,7,,train
0509608_sc-176051.jpg,5,0,0,0,5,,train
0509609_sc-1020630.jpg,6,1,0,0,7,,train
0509611_sc-139049.jpg,1,0,0,0,1,,val
0509612_sc-139049.jpg,1,0,1,1,3,,val
0509613_sc-1031476.jpg,0,1,1,1,3,,test
0509614_sc-1031476.jpg,0,1,1,1,3,,train
0509616_sc-186811.jpg,4,0,0,1,5,,train
0509617_as-9084041.jpg,1,1,1,1,4,,train
0509618_sc-198844.jpg,1,0,0,1,2,,train
0509620_sc-198844.jpg,1,0,0,0,1,,train
0509621_sc-198844.jpg,1,0,1,1,3,,train
0509622_sc-198844.jpg,1,0,1,1,3,,train
0509623_sc-198844.jpg,2,0,1,1,4,,val
0509625_sc-140410.jpg,1,0,0,0,1,,val
0509627_sc-140410.jpg,1,0,0,0,1,,test
0509628_sc-140410.jpg,1,0,0,0,1,,train
0509629_sc-215532.jpg,1,0,0,1,2,,train
0509630_sc-215532.jpg,1,0,0,1,2,,train
0509631_as-3166381.jpg,2,0,0,0,2,,train
0509632_as-2554988.jpg,1,0,1,0,2,,train
0509633_sc-205326.jpg,1,0,1,2,4,,train
0509634_as-7354264.jpg,2,0,2,1,5,,train
0509636_as-0089152.jpg,1,0,0,0,1,,val
0509638_sc-1014656.jpg,1,0,0,0,1,,val
0509639_sc-1014656.jpg,7,0,0,0,7,,test
0509640_sc-1014656.jpg,1,0,0,0,1,,train
0509642_sc-1032155.jpg,2,0,1,0,3,,train
0509643_sc-1032155.jpg,2,0,1,0,3,,train
0509644_sc-1032155.jpg,1,0,1,0,2,,train
0509645_as-0043184.jpg,0,0,1,0,1,,train
0509648_sc-209321.jpg,1,0,0,0,1,,train
0509649_sc-209321.jpg,1,0,0,0,1,,train
0509650_sc-209321.jpg,2,0,0,0,2,,val
0509651_sc-200476.jpg,2,0,0,0,2,,val
0509652_sc-200476.jpg,1,0,0,0,1,,test
0509653_sc-200476.jpg,1,0,0,0,1,,train
0509654_sc-200476.jpg,1,0,0,0,1,,train
0509655_sc-200476.jpg,2,0,0,0,2,,train
0509656_sc-200476.jpg,4,0,0,0,4,,train
0509657_sc-200476.jpg,2,0,0,0,2,,train
0509658_sc-200476.jpg,2,0,0,0,2,,train
0509659_sc-200476.jpg,3,0,1,0,4,,train
0509660_sc-200476.jpg,3,0,0,0,3,,val
0509661_as-3447337.jpg,2,0,0,4,6,,val
0509662_sc-140591.jpg,4,0,0,0,4,,test
0509663_sc-140591.jpg,2,0,0,0,2,,train
0509667_as-0085105.jpg,3,2,0,0,5,,train
0509668_as-0085105.jpg,2,3,1,1,7,,train
0509669_as-0085105.jpg,2,2,0,0,4,,train
0509670_as-0034349.jpg,1,2,0,0,3,,train
0509671_as-0034349.jpg,1,0,0,0,1,,train
0509672_as-0034349.jpg,2,1,0,0,3,,train
0509673_as-0034349.jpg,2,1,0,0,3,,val
0509674_as-0034349.jpg,2,1,0,0,3,,val
0509675_as-0034349.jpg,4,0,0,0,4,,test
0509676_as-0034349.jpg,2,1,0,0,3,,train
0509678_as-0049070.jpg,1,0,0,0,1,,train
0509679_as-0049070.jpg,1,0,0,0,1,,train
0509680_as-0049070.jpg,1,0,0,0,1,,train
0509681_as-0049070.jpg,1,0,0,0,1,,train
0509683_as-2991854.jpg,1,1,0,1,3,,train
0509685_as-0005709.jpg,1,0,0,0,1,,train
0509686_as-2531637.jpg,2,0,1,0,3,,val
0509688_sc-196347.jpg,2,0,0,0,2,,val
0509689_sc-196347.jpg,3,0,0,0,3,,test
0509690_sc-196347.jpg,1,0,0,0,1,,train
0509691_sc-196347.jpg,3,0,0,0,3,,train
0509692_sc-196347.jpg,1,1,0,0,2,,train
0509693_sc-196347.jpg,1,1,0,0,2,,train
0509694_as-7892588.jpg,1,0,0,0,1,,train
0509695_as-2707284.jpg,1,0,1,0,2,,train
0509696_as-2990491.jpg,2,0,0,0,2,,train
0509697_as-0044064.jpg,0,0,0,2,2,,val
0509698_as-0044064.jpg,0,0,0,2,2,,val
0509699_sc-1037374.jpg,2,0,0,0,2,,test
0509701_sc-1037374.jpg,3,1,0,0,4,,train
0509702_sc-1037374.jpg,4,0,0,0,4,,train
0509703_as-2632279.jpg,0,0,0,1,1,,train
0509704_as-0073739.jpg,4,2,0,1,7,,train
0509705_as-0073739.jpg,0,1,0,0,1,,train
0509706_as-0077751.jpg,2,0,1,0,3,,train
0509711_as-2652350.jpg,3,0,0,0,3,,train
0509713_sc-144906.jpg,4,0,0,0,4,,val
0509714_sc-144906.jpg,3,0,0,0,3,,val
0509715_sc-144906.jpg,3,0,0,0,3,,test
0509716_sc-144906.jpg,1,0,0,0,1,,train
0509717_sc-144906.jpg,2,0,0,0,2,,train
0509718_sc-144906.jpg,2,0,0,0,2,,train
0509719_sc-218850.jpg,17,0,0,0,17,,train
0509720_sc-218850.jpg,7,0,1,0,8,,train
0509721_sc-218850.jpg,2,0,1,0,3,,train
0509722_sc-218850.jpg,4,0,0,0,4,,train
0509723_sc-218850.jpg,1,0,0,0,1,,val
0509724_sc-218850.jpg,14,0,0,0,14,,val
0509725_sc-218850.jpg,2,0,0,0,2,,test
0509727_sc-163991.jpg,3,0,0,0,3,,train
0509728_sc-163991.jpg,6,0,0,0,6,,train
0509729_sc-1029266.jpg,0,0,0,1,1,,train
0509730_sc-1029266.jpg,2,0,1,1,4,,train
0509731_sc-1029266.jpg,1,0,0,3,4,,train
0509735_as-0072130.jpg,0,2,0,0,2,,train
0509736_as-0072130.jpg,0,1,4,1,6,,train
0509737_as-0072130.jpg,0,2,1,0,3,,val
0509738_as-0072130.jpg,0,1,1,0,2,,val
0509739_as-0072130.jpg,0,1,0,0,1,,test
0509741_sc-151860.jpg,1,0,0,0,1,,train
0509742_sc-151860.jpg,2,0,0,0,2,,train
0509743_sc-151860.jpg,2,0,0,0,2,,train
0509745_as-2711641.jpg,1,0,0,0,1,,train
0509746_sc-1003696.jpg,1,0,1,0,2,,train
0509747_sc-1003696.jpg,1,0,0,0,1,,train
0509748_sc-1003696.jpg,3,0,0,0,3,,train
0509749_sc-1003696.jpg,3,0,0,0,3,,val
0509750_as-0029461.jpg,1,0,1,0,2,,val
0509751_as-0029461.jpg,1,0,1,0,2,,test
0509753_as-3297265.jpg,1,1,0,0,2,,train
0509754_as-7433792.jpg,2,0,0,0,2,,train
0509756_sc-107799.jpg,2,0,1,1,4,,train
0509759_as-0059580.jpg,2,0,0,0,2,,train
0509761_as-0059580.jpg,1,0,0,0,1,,train
0509762_as-2742915.jpg,2,0,0,0,2,,train
0509763_as-3018870.jpg,0,0,0,1,1,,train
0509765_sc-226572.jpg,3,0,0,1,4,,val
0509766_sc-130880.jpg,2,0,0,1,3,,val
0509767_sc-130880.jpg,1,0,2,0,3,,test
0509768_sc-1023503.jpg,1,0,0,0,1,,train
0509770_sc-182476.jpg,18,0,0,0,18,,train
0509771_sc-182476.jpg,4,0,1,0,5,,train
0509772_as-7289508.jpg,2,0,0,0,2,,train
0509773_sc-106014.jpg,3,1,0,0,4,,train
0509774_sc-106014.jpg,4,1,0,0,5,,train
0509775_sc-106014.jpg,0,1,0,0,1,,train
0509777_sc-106014.jpg,2,3,0,0,5,,val
0509778_sc-106014.jpg,2,0,0,0,2,,val
0509779_sc-106014.jpg,1,1,1,0,3,,test
0509781_sc-106014.jpg,1,0,0,0,1,,train
0509782_sc-106014.jpg,1,0,0,0,1,,train
0509783_sc-106014.jpg,1,0,0,0,1,,train
0509784_as-0063998.jpg,1,0,0,1,2,,train
0509785_as-0063998.jpg,1,0,0,1,2,,train
0509787_as-0060234.jpg,3,0,0,0,3,,train
0509788_as-2985956.jpg,1,0,0,0,1,,train
0509789_as-0015227.jpg,0,0,2,0,2,,val
0509790_as-0015227.jpg,1,0,1,0,2,,val
0509791_as-0015227.jpg,1,0,1,0,2,,test
0509792_as-0015227.jpg,2,0,0,0,2,,train
0509793_as-7652342.jpg,1,0,0,0,1,,train
0509794_as-9057455.jpg,1,0,0,0,1,,train
0509795_sc-213575.jpg,1,0,0,1,2,,train
0509796_sc-213575.jpg,1,0,0,1,2,,train
0509797_sc-213575.jpg,1,0,0,0,1,,train
0509798_as-2991440.jpg,1,0,1,0,2,,train
0509800_sc-1013367.jpg,1,0,0,0,1,,val
0509801_sc-1013367.jpg,1,0,0,0,1,,val
0509802_sc-1013367.jpg,1,0,1,0,2,,test
0509803_sc-1013367.jpg,1,0,0,0,1,,train
0509804_as-3232074.jpg,2,0,0,0,2,,train
0509807_as-7294668.jpg,0,1,0,0,1,,train
0509808_sc-200534.jpg,1,0,0,0,1,,train
0509809_sc-200534.jpg,1,0,0,0,1,,train
0509811_as-7054447.jpg,2,0,1,0,3,,train
0509812_as-0009277.jpg,1,0,0,0,1,,train
0509813_as-0009277.jpg,1,0,0,0,1,,val
0509814_as-0009277.jpg,1,0,0,0,1,,val
0509815_sc-199508.jpg,1,0,0,1,2,,test
0509816_sc-199508.jpg,1,0,0,0,1,,train
0509817_sc-199508.jpg,1,0,0,0,1,,train
0509818_sc-199508.jpg,1,0,1,0,2,,train
0509819_sc-199508.jpg,1,0,0,0,1,,train
0509820_sc-199508.jpg,1,0,1,0,2,,train
0509821_sc-199508.jpg,1,0,1,0,2,,train
0509823_sc-1038872.jpg,2,0,0,1,3,,train
0509824_sc-1038872.jpg,2,0,0,0,2,,val
0509825_sc-208670.jpg,2,1,0,0,3,,val
0509826_sc-208670.jpg,2,1,0,0,3,,test
0509827_sc-107784.jpg,2,0,0,0,2,,train
0509828_sc-107784.jpg,2,0,0,0,2,,train
0509829_sc-107784.jpg,1,0,0,0,1,,train
0509830_sc-193491.jpg,1,0,0,0,1,,train
0509831_sc-193491.jpg,1,0,0,0,1,,train
0509833_sc-193491.jpg,1,0,0,0,1,,train
0509834_as-3355977.jpg,1,0,0,0,1,,train
0509835_as-7082124.jpg,5,3,3,0,11,,val
0509837_as-0046157.jpg,0,0,1,1,2,,val
0509838_as-0046157.jpg,1,1,1,0,3,,test
0509839_as-0046157.jpg,1,0,0,0,1,,train
0509840_as-0046157.jpg,2,2,1,0,5,,train
0509841_as-0046157.jpg,1,0,0,0,1,,train
0509842_as-0046157.jpg,3,1,0,0,4,,train
0509843_as-0046157.jpg,0,1,2,0,3,,train
0509844_as-0046157.jpg,3,1,2,0,6,,train
0509847_as-0046157.jpg,0,2,1,0,3,,train
0509850_sc-181645.jpg,1,0,0,0,1,,val
0509851_as-0087929.jpg,1,0,0,1,2,,val
0509852_as-0087929.jpg,1,0,0,1,2,,test
0509853_as-0087929.jpg,1,0,1,0,2,,train
0509854_as-0087929.jpg,1,0,0,1,2,,train
0509855_as-0087929.jpg,1,0,0,0,1,,train
0509856_sc-195955.jpg,1,1,2,1,5,,train
0509857_sc-195955.jpg,1,0,1,0,2,,train
0509858_sc-195955.jpg,1,1,2,1,5,,train
0509860_sc-195955.jpg,2,0,0,0,2,,train
0509862_as-3274160.jpg,0,0,1,0,1,,val
0509864_as-0010059.jpg,4,0,0,1,5,,val
0509865_as-0010059.jpg,2,0,0,1,3,,test
0509866_as-0010059.jpg,3,0,0,1,4,,train
0509867_as-0010059.jpg,4,0,0,1,5,,train
0509868_as-0010059.jpg,5,0,0,1,6,,train
0509869_as-0010059.jpg,2,0,0,0,2,,train
0509874_as-0016032.jpg,1,1,0,0,2,,train
0509875_as-0016032.jpg,1,1,1,0,3,,train
0509876_as-0016032.jpg,1,1,0,0,2,,train
0509877_sc-1004296.jpg,1,0,0,0,1,,val
0509878_sc-1004296.jpg,1,0,0,0,1,,val
0509879_sc-210078.jpg,2,0,0,0,2,,test
0509880_sc-210078.jpg,4,0,0,0,4,,train
0509881_sc-210078.jpg,4,0,0,0,4,,train
0509882_sc-210078.jpg,1,0,0,0,1,,train
0509883_sc-210078.jpg,6,0,0,0,6,,train
0509884_sc-210078.jpg,0,2,0,0,2,,train
0509885_sc-210078.jpg,4,0,0,0,4,,train
0509886_as-2995863.jpg,2,0,1,0,3,,train
0509887_sc-1026356.jpg,1,2,0,0,3,,val
0509888_sc-1026356.jpg,2,2,0,0,4,,val
0509889_sc-167439.jpg,1,0,0,1,2,,test
0509890_sc-167439.jpg,2,0,0,0,2,,train
0509891_sc-167439.jpg,0,0,0,1,1,,train
0509896_sc-112257.jpg,1,0,0,0,1,,train
0509897_sc-112257.jpg,1,0,0,0,1,,train
0509898_as-0085701.jpg,1,1,0,1,3,,train
0509900_as-0085701.jpg,3,0,2,1,6,,train
0509901_as-0085701.jpg,2,0,0,1,3,,train
0509902_as-0085701.jpg,2,1,0,2,5,,val
0509903_as-0085701.jpg,1,2,0,1,4,,val
0509904_as-0085701.jpg,2,1,0,1,4,,test
0509905_as-0085701.jpg,2,1,2,1,6,,train
0509906_as-0085701.jpg,2,0,0,0,2,,train
0509907_as-0085701.jpg,1,1,1,1,4,,train
0509908_as-0085701.jpg,1,2,1,1,5,,train
0509909_as-0085701.jpg,2,2,1,1,6,,train
0509911_as-0085701.jpg,1,0,0,0,1,,train
0509912_as-9072759.jpg,2,0,0,0,2,,train
0509913_sc-1034127.jpg,6,0,0,0,6,,val
0509914_sc-1034127.jpg,4,0,0,0,4,,val
0509915_sc-1034127.jpg,12,0,0,0,12,,test
0509917_sc-178241.jpg,2,0,0,0,2,,train
0509918_sc-178241.jpg,1,0,0,0,1,,train
0509919_sc-178241.jpg,3,0,0,0,3,,train
0509920_sc-178241.jpg,1,0,0,0,1,,train
0509921_sc-178241.jpg,1,0,0,0,1,,train
0509922_sc-178241.jpg,2,0,0,0,2,,train
0509923_sc-178241.jpg,2,0,0,0,2,,train
0509924_sc-178241.jpg,1,0,0,0,1,,val
0509925_sc-178241.jpg,3,0,0,0,3,,val
0509926_sc-178241.jpg,2,0,0,0,2,,test
0509927_sc-178241.jpg,1,0,0,0,1,,train
0509928_sc-178241.jpg,4,0,0,0,4,,train
0509929_sc-178241.jpg,3,0,0,0,3,,train
0509930_sc-178241.jpg,2,0,0,0,2,,train
0509931_sc-178241.jpg,2,0,0,0,2,,train
0509932_sc-178241.jpg,4,0,0,0,4,,train
0509934_as-0031858.jpg,1,0,1,0,2,,train
0509935_as-0067255.jpg,0,2,1,0,3,,val
0509937_sc-1035783.jpg,2,0,0,0,2,,val
0509938_sc-1035783.jpg,2,0,0,0,2,,test
0509939_as-0046043.jpg,4,1,3,0,8,,train
0509941_as-0046043.jpg,4,2,2,0,8,,train
0509942_as-0046043.jpg,3,2,2,0,7,,train
0509943_as-0046043.jpg,4,1,1,0,6,,train
0509944_as-0046043.jpg,1,1,1,0,3,,train
0509945_as-0046043.jpg,0,1,1,0,2,,train
0509947_sc-189975.jpg,1,0,0,0,1,,train
0509948_sc-189975.jpg,1,0,0,0,1,,val
0509949_sc-189975.jpg,1,0,0,0,1,,val
0509950_sc-189975.jpg,1,1,0,0,2,,test
0509951_as-3008639.jpg,1,0,0,0,1,,train
0509953_as-0073235.jpg,10,0,1,0,11,,train
0509955_as-0073235.jpg,1,0,2,0,3,,train
0509956_as-0073235.jpg,3,0,0,1,4,,train
0509957_as-0073235.jpg,2,0,0,1,3,,train
0509958_as-0073235.jpg,1,0,0,1,2,,train
0509960_as-0073235.jpg,2,0,1,0,3,,train
0509961_as-0073235.jpg,4,0,1,0,5,,val
0509963_as-0073235.jpg,3,1,0,2,6,,val
0509964_as-0073235.jpg,2,0,1,1,4,,test
0509965_as-0073235.jpg,4,3,0,3,10,,train
0509966_as-0073235.jpg,5,0,1,1,7,,train
0509967_as-0073235.jpg,3,0,0,2,5,,train
0509968_as-0073235.jpg,9,0,0,3,12,,train
0509970_as-0073235.jpg,9,0,0,0,9,,train
0509971_as-0073235.jpg,2,0,4,3,9,,train
0509975_as-0073235.jpg,1,0,1,2,4,,train
0509976_as-0073235.jpg,2,0,1,0,3,,val
0509977_sc-1024723.jpg,2,0,0,1,3,,val
0509980_as-2871966.jpg,2,0,0,0,2,,test
0509981_as-0000866.jpg,1,0,2,2,5,,train
0509982_as-0000866.jpg,0,0,1,0,1,,train
0509983_as-0000866.jpg,1,0,2,0,3,,train
0509984_as-0000866.jpg,1,0,1,1,3,,train
0509985_as-0000866.jpg,1,0,0,1,2,,train
0509986_as-9095403.jpg,17,0,3,0,20,,train
0509991_as-0078110.jpg,3,1,0,0,4,,train
0509992_as-0078110.jpg,4,2,0,0,6,,val
0509993_sc-137043.jpg,2,1,0,0,3,,val
0509994_sc-137043.jpg,1,1,0,1,3,,test
0509995_sc-137043.jpg,0,0,1,0,1,,train
0509996_sc-137043.jpg,3,0,0,0,3,,train
0509997_sc-137043.jpg,3,2,0,1,6,,train
0509998_sc-137043.jpg,2,1,0,1,4,,train
0509999_sc-137043.jpg,2,1,0,0,3,,train
0510000_sc-137043.jpg,1,0,0,0,1,,train
0510001_sc-137043.jpg,1,1,0,0,2,,train
0510002_sc-137043.jpg,2,0,0,0,2,,val
0510004_sc-113461.jpg,4,0,0,0,4,,val
0510005_as-0087637.jpg,0,1,1,0,2,,test
0510006_as-0087637.jpg,0,1,0,0,1,,train
0510007_sc-1026724.jpg,2,0,0,0,2,,train
0510009_as-0055011.jpg,4,0,1,0,5,,train
0510010_as-0055011.jpg,4,0,2,1,7,,train
0510011_as-0055011.jpg,3,0,1,2,6,,train
0510015_as-0010068.jpg,1,0,0,0,1,,train
0510016_sc-1021968.jpg,1,1,0,0,2,,train
0510020_sc-1021968.jpg,1,0,0,0,1,,val
0510022_as-0058323.jpg,2,0,0,0,2,,val
0510023_sc-185186.jpg,2,0,0,0,2,,test
0510024_sc-185186.jpg,6,0,0,0,6,,train
0510027_as-0009436.jpg,0,0,1,1,2,,train
0510028_sc-114326.jpg,3,0,0,0,3,,train
0510029_as-0000057.jpg,2,0,0,0,2,,train
0510030_as-0000057.jpg,1,0,0,0,1,,train
0510031_as-0000057.jpg,1,0,0,0,1,,train
0510032_as-0000057.jpg,1,0,0,0,1,,train
0510033_as-0000057.jpg,1,0,0,0,1,,val
0510034_as-0000057.jpg,2,0,0,0,2,,val
0510035_as-0000057.jpg,0,0,0,1,1,,test
0510036_as-0000057.jpg,1,0,0,1,2,,train
0510038_as-0077065.jpg,2,1,1,0,4,,train
0510039_as-0077065.jpg,1,1,0,0,2,,train
0510040_as-0077065.jpg,0,1,0,1,2,,train
0510041_as-0065202.jpg,3,1,0,0,4,,train
0510042_as-0065202.jpg,1,0,0,0,1,,train
0510044_as-0065202.jpg,1,0,0,0,1,,train
0510045_sc-203069.jpg,1,0,0,0,1,,val
0510046_sc-203069.jpg,2,2,1,0,5,,val
0510047_as-2855548.jpg,4,1,2,0,7,,test
0510048_sc-214665.jpg,3,1,0,0,4,,train
0510049_sc-214665.jpg,6,1,1,0,8,,train
0510050_sc-214665.jpg,2,1,0,0,3,,train
0510051_as-0067057.jpg,0,0,0,1,1,,train
0510053_as-0072737.jpg,1,0,1,1,3,,train
0510054_as-0072737.jpg,1,0,1,1,3,,train
0510055_as-0072737.jpg,1,0,1,1,3,,train
0510056_sc-214940.jpg,0,0,1,0,1,,val
0510057_sc-214940.jpg,0,0,1,0,1,,val
0510060_as-0073452.jpg,2,0,0,1,3,,test
0510062_as-0073452.jpg,2,0,0,1,3,,train
0510063_sc-161151.jpg,1,0,0,2,3,,train
0510064_sc-161151.jpg,1,0,0,2,3,,train
0510065_sc-161151.jpg,10,0,0,3,13,,train
0510066_sc-161151.jpg,4,0,2,1,7,,train
0510068_sc-161151.jpg,3,0,0,1,4,,train
0510069_sc-161151.jpg,5,0,0,1,6,,train
0510071_sc-161151.jpg,2,0,1,0,3,,val
0510072_as-3333480.jpg,1,0,0,0,1,,val
0510077_as-9048801.jpg,0,1,0,0,1,,test
0510078_sc-1033716.jpg,2,0,0,0,2,,train
0510080_sc-1033716.jpg,4,0,1,3,8,,train
0510081_sc-1033716.jpg,1,0,0,0,1,,train
0510082_sc-1033716.jpg,3,0,1,2,6,,train
0510084_as-2918519.jpg,1,0,0,0,1,,train
0510086_as-3145667.jpg,2,2,2,1,7,,train
0510088_as-0076021.jpg,2,0,0,2,4,,train
0510089_as-2832716.jpg,0,0,1,0,1,,val
0510090_as-2520130.jpg,2,2,0,1,5,,val
0510091_as-0017167.jpg,1,0,0,0,1,,test
0510092_as-0017167.jpg,1,0,0,0,1,,train
0510093_as-0017167.jpg,2,0,0,0,2,,train
0510094_as-2599621.jpg,4,0,0,0,4,,train
0510096_sc-190011.jpg,1,0,0,0,1,,train
0510097_sc-197234.jpg,1,0,0,0,1,,train
0510098_sc-107254.jpg,5,0,0,0,5,,train
0510099_sc-107254.jpg,5,0,0,1,6,,train
0510103_as-0006435.jpg,0,0,2,0,2,,val
0510104_sc-207575.jpg,3,0,0,0,3,,val
0510105_sc-207575.jpg,7,0,1,1,9,,test
0510106_sc-207575.jpg,8,0,1,1,10,,train
0510107_sc-207575.jpg,2,0,1,1,4,,train
0510108_sc-141399.jpg,1,1,0,0,2,,train
0510109_sc-141778.jpg,2,0,0,1,3,,train
0510110_sc-141778.jpg,3,0,0,1,4,,train
0510111_sc-119291.jpg,0,1,0,0,1,,train
0510113_sc-1008558.jpg,7,0,0,0,7,,train
0510114_sc-1008558.jpg,8,0,0,0,8,,val
0510115_as-2652263.jpg,2,0,1,0,3,,val
0510116_sc-216347.jpg,1,0,0,0,1,,test
0510118_as-3092881.jpg,0,0,2,0,2,,train
0510119_sc-214980.jpg,5,0,0,0,5,,train
0510120_sc-214980.jpg,5,0,0,0,5,,train
0510121_sc-214980.jpg,1,0,0,0,1,,train
0510122_sc-214980.jpg,3,0,2,0,5,,train
0510123_sc-214980.jpg,1,0,1,1,3,,train
0510124_sc-214980.jpg,3,0,1,0,4,,train
0510125_sc-214980.jpg,3,0,2,0,5,,val
0510126_sc-214980.jpg,1,1,1,0,3,,val
0510127_sc-214980.jpg,2,0,1,0,3,,test
0510128_sc-214980.jpg,4,1,0,0,5,,train
0510129_sc-214980.jpg,7,0,0,0,7,,train
0510130_sc-214980.jpg,3,0,0,0,3,,train
0510131_sc-214980.jpg,4,0,0,0,4,,train
0510132_sc-227221.jpg,1,0,0,0,1,,train
0510133_sc-227221.jpg,8,0,0,0,8,,train
0510134_sc-227221.jpg,1,0,0,0,1,,train
0510135_as-0079871.jpg,1,0,0,0,1,,val
0510136_as-0079871.jpg,1,0,0,0,1,,val
0510137_as-0079871.jpg,1,0,0,0,1,,test
0510139_as-0079871.jpg,8,0,0,0,8,,train
0510140_as-0079871.jpg,1,0,0,0,1,,train
0510142_sc-1007005.jpg,5,0,0,0,5,,train
0510143_sc-1007005.jpg,5,0,0,0,5,,train
0510144_sc-223802.jpg,1,0,1,0,2,,train
0510145_sc-223802.jpg,3,0,0,1,4,,train
0510146_sc-223802.jpg,3,0,1,0,4,,train
0510147_sc-223802.jpg,1,0,2,0,3,,val
0510148_sc-223802.jpg,1,0,0,0,1,,val
0510149_as-0068061.jpg,3,0,0,0,3,,test
0510152_as-0068061.jpg,2,0,0,0,2,,train
0510153_as-0068061.jpg,1,1,2,0,4,,train
0510154_as-0068061.jpg,1,1,2,0,4,,train
0510156_as-0020099.jpg,1,1,0,0,2,,train
0510158_sc-125822.jpg,3,0,1,1,5,,train
0510159_as-0094895.jpg,1,0,0,0,1,,train
0510160_as-0067788.jpg,2,0,0,1,3,,train
0510161_as-0067788.jpg,2,0,0,1,3,,val
0510162_as-0067788.jpg,2,0,0,1,3,,val
0510164_as-7215585.jpg,0,0,2,0,2,,test
0510166_sc-1033410.jpg,0,0,1,0,1,,train
0510167_sc-1033410.jpg,3,0,2,0,5,,train
0510168_sc-1033410.jpg,1,0,1,0,2,,train
0510169_sc-1033410.jpg,4,1,5,0,10,,train
0510170_sc-1033410.jpg,1,2,1,0,4,,train
0510171_as-3373567.jpg,2,0,0,0,2,,train
0510172_sc-213650.jpg,3,3,0,0,6,,train
0510173_sc-213650.jpg,8,0,0,1,9,,val
0510174_sc-205207.jpg,4,0,0,0,4,,val
0510175_sc-205207.jpg,1,0,0,0,1,,test
0510176_sc-205207.jpg,2,0,1,1,4,,train
0510177_sc-205207.jpg,1,0,0,1,2,,train
0510179_as-0083183.jpg,2,1,1,0,4,,train
0510180_as-0083183.jpg,3,2,1,0,6,,train
0510181_as-0083183.jpg,3,1,1,0,5,,train
0510182_as-0083183.jpg,2,2,1,0,5,,train
0510183_as-3195924.jpg,2,0,0,1,3,,train
0510184_sc-187364.jpg,1,0,0,4,5,,val
0510185_sc-193661.jpg,11,0,2,0,13,,val
0510186_sc-193661.jpg,10,0,0,0,10,,test
0510187_sc-193661.jpg,8,0,0,0,8,,train
0510188_sc-193661.jpg,3,0,1,0,4,,train
0510189_as-3429785.jpg,1,0,0,1,2,,train
0510192_as-0018761.jpg,1,1,1,1,4,,train
0510193_as-0018761.jpg,3,3,2,1,9,,train
0510194_as-0018761.jpg,3,2,1,1,7,,train
0510195_as-0018761.jpg,1,1,0,0,2,,train
0510196_as-0047697.jpg,1,0,2,0,3,,val
0510197_as-0047697.jpg,1,0,1,0,2,,val
0510198_as-0047697.jpg,1,0,1,1,3,,test
0510199_as-0047697.jpg,1,0,1,1,3,,train
0510205_as-0073463.jpg,1,1,2,1,5,,train
0510206_sc-212816.jpg,1,1,1,0,3,,train
0510207_sc-212816.jpg,2,1,0,0,3,,train
0510208_sc-212816.jpg,1,1,0,0,2,,train
0510209_sc-212816.jpg,2,1,1,0,4,,train
0510213_as-0015909.jpg,2,0,0,0,2,,train
0510214_as-0015909.jpg,2,0,0,0,2,,val
0510215_as-0015909.jpg,1,0,0,0,1,,val
0510216_as-0015909.jpg,2,0,0,0,2,,test
0510217_as-0015909.jpg,2,0,0,0,2,,train
0510218_as-0015909.jpg,3,0,0,0,3,,train
0510219_as-0015909.jpg,5,0,0,0,5,,train
0510220_as-0015909.jpg,3,0,0,0,3,,train
0510221_sc-1022129.jpg,4,0,2,1,7,,train
0510222_sc-1022129.jpg,1,1,0,0,2,,train
0510223_sc-1022129.jpg,3,0,1,0,4,,train
0510224_sc-1022129.jpg,1,1,1,0,3,,val
0510226_sc-1022129.jpg,1,0,1,0,2,,val
0510228_sc-1022129.jpg,3,0,1,1,5,,test
0510231_as-0013813.jpg,1,0,0,0,1,,train
0510232_as-0013813.jpg,2,0,0,0,2,,train
0510233_as-0013813.jpg,2,0,0,0,2,,train
0510234_as-0013813.jpg,2,0,0,0,2,,train
0510235_as-0013813.jpg,2,0,0,0,2,,train
0510236_as-0013813.jpg,1,0,0,0,1,,train
0510237_as-0013813.jpg,1,0,0,0,1,,train
0510238_as-0013813.jpg,1,0,0,0,1,,val
0510239_as-0013813.jpg,1,0,0,0,1,,val
0510240_as-0013813.jpg,1,0,0,0,1,,test
0510241_sc-187267.jpg,0,1,0,0,1,,train
0510242_sc-187267.jpg,0,1,0,0,1,,train
0510243_as-7250211.jpg,7,0,1,0,8,,train
0510244_sc-109284.jpg,1,0,0,0,1,,train
0510245_sc-106690.jpg,5,5,2,0,12,,train
0510246_sc-106690.jpg,1,0,0,0,1,,train
0510247_sc-106690.jpg,2,1,0,0,3,,train
0510248_sc-106690.jpg,1,3,0,0,4,,val
0510249_sc-106690.jpg,1,0,0,0,1,,val
0510250_sc-106690.jpg,1,1,0,0,2,,test
0510251_sc-106690.jpg,2,3,0,0,5,,train
0510252_sc-106690.jpg,1,0,0,0,1,,train
0510253_sc-106690.jpg,2,0,0,0,2,,train
0510254_sc-106690.jpg,2,3,0,0,5,,train
0510255_sc-106690.jpg,7,4,3,2,16,,train
0510256_sc-106690.jpg,7,1,3,0,11,,train
0510257_sc-182654.jpg,3,0,0,0,3,,train
0510259_as-0046020.jpg,7,0,2,0,9,,val
0510260_as-0046020.jpg,3,1,2,2,8,,val
0510262_as-0046020.jpg,3,0,1,0,4,,test
0510263_as-2552879.jpg,2,0,0,0,2,,train
0510267_as-0042050.jpg,1,1,0,0,2,,train
0510268_as-0042050.jpg,1,1,1,0,3,,train
0510270_as-0042050.jpg,1,1,1,0,3,,train
0510271_as-0043893.jpg,2,0,0,0,2,,train
0510272_as-0043893.jpg,3,0,0,0,3,,train
0510273_as-0043893.jpg,1,0,0,0,1,,train
0510274_as-0069034.jpg,1,0,0,0,1,,val
0510275_as-0069034.jpg,1,0,0,0,1,,val
0510276_as-2805965.jpg,4,2,1,1,8,,test
0510277_as-3308746.jpg,2,0,0,0,2,,train
0510278_as-2788983.jpg,1,1,1,0,3,,train
0510279_as-2953372.jpg,2,0,0,0,2,,train
0510280_sc-1003199.jpg,2,0,2,1,5,,train
0510281_sc-1003199.jpg,2,0,1,1,4,,train
0510283_sc-1023264.jpg,1,0,0,0,1,,train
0510284_sc-1023264.jpg,1,0,0,0,1,,train
0510285_sc-1023264.jpg,1,0,0,0,1,,val
0510287_sc-1023264.jpg,1,0,0,0,1,,val
0510288_sc-1023264.jpg,1,2,0,0,3,,test
0510289_sc-1023264.jpg,1,1,0,0,2,,train
0510291_sc-192619.jpg,2,0,1,1,4,,train
0510292_sc-192619.jpg,1,0,1,1,3,,train
0510293_sc-192619.jpg,2,0,1,1,4,,train
0510294_as-3369090.jpg,1,0,0,1,2,,train
0510296_sc-174845.jpg,2,0,0,0,2,,train
0510297_as-3321495.jpg,1,0,0,0,1,,train
0510298_sc-104578.jpg,2,0,0,0,2,,val
0510299_sc-104578.jpg,1,0,0,0,1,,val
0510300_sc-104578.jpg,4,0,0,0,4,,test
0510302_as-0096586.jpg,3,1,2,4,10,,train
0510304_as-0096586.jpg,2,0,0,0,2,,train
0510305_as-0096586.jpg,9,3,2,0,14,,train
0510306_as-0096586.jpg,1,0,0,0,1,,train
0510307_as-0034364.jpg,2,0,0,1,3,,train
0510308_as-0034364.jpg,1,0,0,1,2,,train
0510309_as-0034364.jpg,3,0,0,0,3,,train
0510310_as-0070146.jpg,1,0,0,0,1,,val
0510311_as-3001061.jpg,1,0,1,1,3,,val
0510312_as-3001061.jpg,1,0,4,1,6,,test
0510313_as-0039822.jpg,5,2,1,2,10,,train
0510316_as-0039822.jpg,2,1,1,1,5,,train
0510317_as-3150902.jpg,1,0,0,0,1,,train
0510318_as-2613257.jpg,5,3,0,0,8,,train
0510319_as-2980376.jpg,1,0,2,1,4,,train
0510320_as-0072653.jpg,2,0,0,0,2,,train
0510321_as-0072653.jpg,2,0,0,0,2,,train
0510322_as-0072653.jpg,3,0,1,0,4,,val
0510323_as-0072653.jpg,3,0,1,0,4,,val
0510324_as-0036577.jpg,1,0,0,0,1,,test
0510325_as-0036577.jpg,6,0,0,0,6,,train
0510326_as-0036577.jpg,1,0,0,0,1,,train
0510327_as-0036577.jpg,1,0,0,0,1,,train
0510328_as-0036577.jpg,1,0,0,0,1,,train
0510330_as-0036577.jpg,0,1,1,1,3,,train
0510331_as-0036577.jpg,3,1,1,0,5,,train
0510332_as-0036577.jpg,4,0,1,0,5,,train
0510333_as-0036577.jpg,3,2,1,0,6,,val
0510337_as-0073388.jpg,3,0,1,1,5,,val
0510338_as-0073388.jpg,1,0,1,1,3,,test
0510339_as-2631427.jpg,2,0,0,0,2,,train
0510340_as-2516567.jpg,1,0,1,0,2,,train
0510341_as-3451655.jpg,2,0,0,1,3,,train
0510342_sc-222018.jpg,2,2,1,0,5,,train
0510343_sc-222018.jpg,5,0,0,0,5,,train
0510344_sc-222018.jpg,1,0,0,0,1,,train
0510345_sc-222018.jpg,3,1,0,0,4,,train
0510346_sc-222018.jpg,2,0,0,0,2,,val
0510347_sc-222018.jpg,2,1,2,0,5,,val
0510348_sc-224047.jpg,0,2,2,0,4,,test
0510349_sc-224047.jpg,0,1,1,0,2,,train
0510350_sc-224047.jpg,0,1,1,0,2,,train
0510351_sc-224047.jpg,2,0,0,0,2,,train
0510352_sc-224047.jpg,1,0,0,0,1,,train
0510353_as-0092530.jpg,1,0,0,0,1,,train
0510354_as-0092530.jpg,1,0,0,0,1,,train
0510355_as-0092530.jpg,1,0,0,0,1,,train
0510356_as-0092530.jpg,1,0,0,0,1,,val
0510357_sc-133013.jpg,1,0,1,0,2,,val
0510361_sc-133013.jpg,2,2,1,1,6,,test
0510363_sc-133013.jpg,0,0,2,1,3,,train
0510364_sc-133013.jpg,1,0,2,0,3,,train
0510365_sc-133013.jpg,0,0,1,0,1,,train
0510366_as-7273141.jpg,2,0,0,0,2,,train
0510367_as-0001977.jpg,0,0,0,1,1,,train
0510368_as-0001977.jpg,0,0,1,1,2,,train
0510369_as-0001977.jpg,0,0,1,1,2,,train
0510370_sc-141322.jpg,2,0,0,1,3,,val
0510371_sc-141322.jpg,1,0,0,0,1,,val
0510372_sc-141322.jpg,1,0,0,0,1,,test
0510373_sc-141322.jpg,3,0,0,0,3,,train
0510374_sc-141322.jpg,3,0,0,0,3,,train
0510375_sc-141322.jpg,1,0,0,0,1,,train
0510377_as-2826718.jpg,1,0,0,1,2,,train
0510382_as-0019006.jpg,0,0,3,0,3,,train
0510383_as-0019006.jpg,1,0,3,1,5,,train
0510384_as-0019006.jpg,3,0,1,0,4,,train
0510385_as-0019006.jpg,2,0,3,0,5,,val
0510386_sc-156424.jpg,3,0,0,0,3,,val
0510387_sc-156424.jpg,4,0,0,0,4,,test
0510388_sc-156424.jpg,1,0,0,0,1,,train
0510389_sc-156424.jpg,3,0,0,0,3,,train
0510390_sc-156424.jpg,1,0,0,0,1,,train
0510391_sc-156424.jpg,1,0,0,0,1,,train
0510392_sc-156424.jpg,1,0,0,0,1,,train
0510393_sc-1004931.jpg,2,0,0,1,3,,train
0510394_sc-1004931.jpg,1,0,0,0,1,,train
0510395_sc-1004931.jpg,0,0,0,1,1,,val
0510396_sc-1004931.jpg,0,0,0,1,1,,val
0510397_sc-195957.jpg,0,0,2,0,2,,test
0510398_sc-195957.jpg,1,0,0,0,1,,train
0510399_sc-195957.jpg,3,0,0,0,3,,train
0510400_sc-195957.jpg,1,1,0,1,3,,train
0510401_sc-195957.jpg,3,2,1,0,6,,train
0510403_as-0006051.jpg,3,1,2,0,6,,train
0510404_as-0006051.jpg,2,1,0,0,3,,train
0510408_as-2512122.jpg,1,0,0,0,1,,train
0510409_sc-205872.jpg,2,0,0,1,3,,val
0510410_sc-205872.jpg,1,0,0,1,2,,val
0510411_sc-205872.jpg,2,0,0,0,2,,test
0510412_sc-1006781.jpg,1,1,0,0,2,,train
0510414_sc-150270.jpg,3,0,0,1,4,,train
0510415_sc-150270.jpg,1,0,0,1,2,,train
0510417_as-0026101.jpg,1,0,0,0,1,,train
0510419_as-0026101.jpg,1,1,0,0,2,,train
0510420_as-0026101.jpg,1,0,0,0,1,,train
0510421_as-4618439.jpg,0,0,1,1,2,,train
0510423_as-0058563.jpg,1,0,0,0,1,,val
0510424_as-2628653.jpg,3,0,0,0,3,,val
0510425_as-2799240.jpg,0,0,1,0,1,,test
0510426_sc-222149.jpg,1,0,0,0,1,,train
0510427_sc-222149.jpg,1,0,0,0,1,,train
0510428_sc-222149.jpg,1,0,0,0,1,,train
0510429_as-0049645.jpg,1,1,1,2,5,,train
0510433_sc-1041768.jpg,1,1,0,0,2,,train
0510434_as-0006689.jpg,6,0,0,0,6,,train
0510436_as-0006689.jpg,1,0,0,1,2,,train
0510437_as-0006689.jpg,1,0,0,1,2,,val
0510442_as-0001901.jpg,1,2,0,0,3,,val
0510443_as-0001901.jpg,1,2,2,0,5,,test
0510444_as-7328681.jpg,5,0,0,0,5,,train
0510445_as-7328681.jpg,1,0,0,0,1,,train
0510446_as-9067729.jpg,0,1,0,0,1,,train
0510447_as-9045921.jpg,2,0,2,0,4,,train
0510448_as-2897650.jpg,2,0,1,0,3,,train
0510449_sc-1005082.jpg,1,0,0,0,1,,train
0510450_sc-1005082.jpg,1,0,0,0,1,,train
0510451_sc-1005082.jpg,1,0,0,0,1,,val
0510452_sc-1005082.jpg,1,0,0,0,1,,val
0510453_sc-209152.jpg,0,1,0,0,1,,test
0510454_sc-209152.jpg,1,0,0,0,1,,train
0510455_sc-209152.jpg,1,0,0,0,1,,train
0510456_sc-209152.jpg,1,0,0,0,1,,train
0510457_sc-209152.jpg,1,0,0,0,1,,train
0510458_sc-209152.jpg,1,0,0,0,1,,train
0510459_sc-209152.jpg,1,0,0,0,1,,train
0510460_as-2623229.jpg,2,0,0,1,3,,train
0510461_as-0041411.jpg,4,0,0,0,4,,val
0510462_as-0041411.jpg,1,0,0,0,1,,val
0510463_sc-156205.jpg,1,0,0,0,1,,test
0510464_sc-156205.jpg,1,0,0,0,1,,train
0510465_sc-156205.jpg,1,0,0,0,1,,train
0510466_as-7322572.jpg,1,0,0,0,1,,train
0510468_sc-216054.jpg,1,0,0,0,1,,train
0510469_sc-216054.jpg,1,0,0,0,1,,train
0510470_as-0080056.jpg,1,0,2,1,4,,train
0510471_as-0080056.jpg,1,1,1,1,4,,train
0510472_as-0080056.jpg,1,0,2,1,4,,val
0510473_as-0080056.jpg,0,0,2,1,3,,val
0510474_as-0080056.jpg,1,0,1,0,2,,test
0510476_as-0080056.jpg,2,0,1,0,3,,train
0510477_sc-165943.jpg,2,1,0,0,3,,train
0510479_as-9096804.jpg,1,0,0,0,1,,train
0510480_sc-199232.jpg,5,2,3,1,11,,train
0510481_sc-199232.jpg,6,2,3,1,12,,train
0510483_sc-186553.jpg,4,1,1,0,6,,train
0510484_sc-186553.jpg,3,1,1,0,5,,train
0510485_sc-186553.jpg,4,1,0,0,5,,val
0510486_sc-186553.jpg,5,2,1,0,8,,val
0510489_as-2618232.jpg,1,0,0,0,1,,test
0510490_sc-221105.jpg,2,0,0,0,2,,train
0510491_sc-221105.jpg,1,0,1,0,2,,train
0510492_sc-221105.jpg,2,0,2,0,4,,train
0510493_sc-221105.jpg,1,0,1,0,2,,train
0510494_sc-221105.jpg,1,0,0,0,1,,train
0510495_sc-221105.jpg,1,0,0,0,1,,train
0510496_sc-221105.jpg,2,0,0,0,2,,train
0510497_sc-221105.jpg,1,0,1,0,2,,val
0510498_sc-1017013.jpg,3,0,0,1,4,,val
0510499_sc-1017013.jpg,7,2,0,0,9,,test
0510500_sc-180055.jpg,3,1,0,1,5,,train
0510501_sc-180055.jpg,2,1,0,1,4,,train
0510502_as-0055493.jpg,0,1,1,0,2,,train
0510503_as-0055493.jpg,0,1,1,0,2,,train
0510504_sc-151954.jpg,3,1,1,1,6,,train
0510505_sc-151954.jpg,5,1,1,1,8,,train
0510506_sc-151954.jpg,3,1,1,0,5,,train
0510507_sc-151954.jpg,6,1,1,1,9,,val
0510508_as-2925829.jpg,1,0,0,0,1,,val
0510510_as-0038905.jpg,1,0,0,0,1,,test
0510511_as-0038905.jpg,1,0,0,0,1,,train
0510512_as-0038905.jpg,1,0,0,0,1,,train
0510513_as-0038905.jpg,1,0,0,0,1,,train
0510514_sc-1028898.jpg,2,0,1,1,4,,train
0510515_sc-1028898.jpg,2,0,1,0,3,,train
0510516_sc-1028898.jpg,3,1,1,0,5,,train
0510518_sc-1028898.jpg,4,1,2,1,8,,train
0510519_sc-1028898.jpg,1,0,1,0,2,,val
0510523_sc-126167.jpg,0,1,0,0,1,,val
0510524_sc-126167.jpg,0,1,1,0,2,,test
0510525_as-2809223.jpg,1,0,0,0,1,,train
0510526_sc-187164.jpg,1,0,0,0,1,,train
0510528_sc-187164.jpg,2,0,0,1,3,,train
0510529_sc-187164.jpg,1,0,0,1,2,,train
0510531_as-0094917.jpg,2,0,0,0,2,,train
0510532_as-0094917.jpg,1,0,0,1,2,,train
0510533_as-0094917.jpg,1,1,0,0,2,,train
0510534_as-0094917.jpg,0,0,0,1,1,,val
0510536_as-0094917.jpg,1,0,0,1,2,,val
0510537_as-3325363.jpg,1,0,0,0,1,,test
0510540_sc-104707.jpg,1,0,0,0,1,,train
0510541_sc-104707.jpg,1,0,0,0,1,,train
0510542_sc-1020339.jpg,0,0,1,0,1,,train
0510543_sc-1020339.jpg,0,0,1,2,3,,train
0510544_sc-1022312.jpg,2,1,2,0,5,,train
0510545_sc-1022312.jpg,2,1,2,0,5,,train
0510546_sc-1022312.jpg,4,1,2,0,7,,train
0510548_as-7941818.jpg,0,0,0,2,2,,val
0510552_as-0029819.jpg,2,1,1,1,5,,val
0510553_sc-120647.jpg,1,0,0,0,1,,test
0510554_sc-120647.jpg,2,0,0,0,2,,train
0510555_sc-120647.jpg,1,0,0,0,1,,train
0510556_sc-120647.jpg,1,0,0,0,1,,train
0510557_as-7606057.jpg,1,0,2,0,3,,train
0510558_sc-222421.jpg,5,0,0,0,5,,train
0510559_sc-222421.jpg,1,0,1,0,2,,train
0510560_sc-222421.jpg,3,0,1,0,4,,train
0510561_as-3440053.jpg,4,1,0,0,5,,val
0510562_sc-204377.jpg,2,0,0,0,2,,val
0510566_as-0079293.jpg,2,0,0,0,2,,test
0510567_as-0010501.jpg,4,2,0,0,6,,train
0510568_as-0010501.jpg,5,1,0,0,6,,train
0510569_as-0010501.jpg,2,0,1,0,3,,train
0510570_as-0078603.jpg,2,1,0,0,3,,train
0510572_as-0078603.jpg,3,0,0,0,3,,train
0510573_as-0078603.jpg,4,0,0,0,4,,train
0510575_sc-180355.jpg,2,1,0,0,3,,train
0510576_sc-180355.jpg,2,1,0,0,3,,val
0510577_sc-180355.jpg,1,1,0,0,2,,val
0510578_sc-211889.jpg,1,1,1,1,4,,test
0510579_sc-211889.jpg,1,0,1,1,3,,train
0510580_sc-211889.jpg,1,1,1,0,3,,train
0510581_sc-211889.jpg,2,0,0,1,3,,train
0510582_sc-211889.jpg,1,0,1,1,3,,train
0510583_sc-211889.jpg,0,0,1,0,1,,train
0510584_sc-211889.jpg,0,0,1,1,2,,train
0510586_sc-195444.jpg,3,0,0,0,3,,train
0510587_sc-195444.jpg,3,0,1,0,4,,val
0510588_sc-195444.jpg,2,0,1,0,3,,val
0510589_sc-195444.jpg,1,0,0,0,1,,test
0510590_sc-195444.jpg,1,0,0,0,1,,train
0510591_sc-205812.jpg,3,1,1,0,5,,train
0510592_sc-205812.jpg,0,0,1,0,1,,train
0510593_sc-205812.jpg,3,1,1,0,5,,train
0510594_sc-205812.jpg,3,1,2,0,6,,train
0510595_sc-205812.jpg,1,1,1,0,3,,train
0510596_sc-205812.jpg,1,0,2,0,3,,train
0510597_as-0055123.jpg,1,0,0,0,1,,val
0510598_as-0055123.jpg,1,0,0,0,1,,val
0510599_as-0055123.jpg,0,1,0,0,1,,test
0510600_as-0055123.jpg,0,1,0,0,1,,train
0510601_as-0055123.jpg,1,1,0,0,2,,train
0510602_as-0055123.jpg,1,1,0,1,3,,train
0510603_as-0055123.jpg,1,1,0,0,2,,train
0510605_as-0055123.jpg,0,1,0,0,1,,train
0510606_as-0055123.jpg,1,0,0,0,1,,train
0510607_as-0055123.jpg,0,1,0,0,1,,train
0510608_sc-154984.jpg,14,2,1,0,17,,val
0510609_sc-131237.jpg,4,0,1,0,5,,val
0510610_sc-131237.jpg,7,0,0,0,7,,test
0510611_sc-131237.jpg,1,0,0,0,1,,train
0510613_as-2513524.jpg,1,0,0,1,2,,train
0510614_sc-1026209.jpg,1,0,1,1,3,,train
0510615_sc-1026209.jpg,2,0,1,1,4,,train
0510616_sc-1026209.jpg,1,0,1,1,3,,train
0510617_sc-1026209.jpg,1,0,0,1,2,,train
0510618_sc-1026209.jpg,1,0,1,1,3,,train
0510620_sc-1026209.jpg,1,0,0,1,2,,val
0510621_sc-1026209.jpg,1,0,1,1,3,,val
0510624_as-0013371.jpg,0,1,0,0,1,,test
0510625_as-0013371.jpg,0,1,0,0,1,,train
0510626_as-0013371.jpg,0,1,0,1,2,,train
0510627_as-0013371.jpg,0,1,0,1,2,,train
0510628_as-0013371.jpg,1,0,2,0,3,,train
0510629_as-0013371.jpg,1,0,0,0,1,,train
0510630_sc-154169.jpg,0,0,1,2,3,,train
0510631_sc-154169.jpg,1,0,0,1,2,,train
0510632_sc-154169.jpg,0,0,0,1,1,,val
0510633_sc-154169.jpg,1,0,1,1,3,,val
0510635_as-3308362.jpg,1,0,0,0,1,,test
0510636_sc-124490.jpg,0,0,0,1,1,,train
0510637_sc-124490.jpg,1,0,0,1,2,,train
0510638_sc-124490.jpg,0,0,0,1,1,,train
0510639_as-0004665.jpg,1,0,0,0,1,,train
0510640_as-0004665.jpg,1,0,1,0,2,,train
0510641_as-0004665.jpg,0,0,1,0,1,,train
0510642_as-0004665.jpg,0,0,1,0,1,,train
0510643_sc-118110.jpg,3,1,0,0,4,,val
0510644_sc-118110.jpg,1,0,1,0,2,,val
0510645_sc-118110.jpg,0,0,2,0,2,,test
0510646_sc-118110.jpg,0,0,1,1,2,,train
0510647_as-3329567.jpg,3,0,0,0,3,,train
0510652_as-0060224.jpg,1,0,1,0,2,,train
0510653_as-0060224.jpg,4,0,0,1,5,,train
0510654_as-9056099.jpg,0,0,1,0,1,,train
0510655_as-0095552.jpg,2,0,0,0,2,,train
0510656_sc-1012669.jpg,1,0,0,0,1,,train
0510657_sc-1012669.jpg,1,1,0,0,2,,val
0510658_sc-1012669.jpg,1,1,0,0,2,,val
0510659_sc-1012669.jpg,1,0,0,0,1,,test
0510661_as-0020149.jpg,1,1,1,1,4,,train
0510662_as-0020149.jpg,1,0,0,0,1,,train
0510663_sc-191327.jpg,26,0,1,0,27,,train
0510664_sc-191327.jpg,0,0,1,0,1,,train
0510667_sc-191327.jpg,24,1,1,0,26,,train
0510668_sc-191327.jpg,13,0,0,0,13,,train
0510669_as-2938367.jpg,2,0,0,0,2,,train
0510670_as-7895418.jpg,2,2,0,0,4,,val
0510672_as-0059393.jpg,1,0,0,0,1,,val
0510675_as-0059393.jpg,1,0,0,0,1,,test
0510677_sc-171840.jpg,1,0,0,1,2,,train
0510678_as-3453965.jpg,3,0,0,1,4,,train
0510679_as-2582106.jpg,4,0,1,1,6,,train
0510680_sc-1002816.jpg,2,0,0,0,2,,train
0510682_sc-1002816.jpg,1,0,1,0,2,,train
0510683_as-3108951.jpg,2,0,2,0,4,,train
0510684_as-0079008.jpg,1,1,0,0,2,,train
0510685_sc-133717.jpg,3,0,1,1,5,,val
0510686_as-5373628.jpg,1,0,0,0,1,,val
0510688_sc-1013515.jpg,1,0,1,0,2,,test
0510690_sc-1013515.jpg,0,0,1,0,1,,train
0510691_sc-224078.jpg,3,0,1,0,4,,train
0510692_sc-224078.jpg,3,0,1,0,4,,train
0510693_sc-224078.jpg,1,0,1,0,2,,train
0510694_sc-224078.jpg,1,0,1,0,2,,train
0510695_sc-224078.jpg,3,0,1,0,4,,train
0510696_sc-224078.jpg,1,1,1,1,4,,train
0510697_as-3322100.jpg,4,0,0,0,4,,val
0510698_sc-198010.jpg,2,1,0,0,3,,val
0510700_sc-122481.jpg,1,0,1,0,2,,test
0510701_sc-122481.jpg,2,0,0,0,2,,train
0510702_sc-122481.jpg,2,0,0,0,2,,train
0510705_as-7400404.jpg,2,0,1,0,3,,train
0510708_as-9067183.jpg,2,0,0,0,2,,train
0510709_as-0017442.jpg,1,0,0,0,1,,train
0510710_as-0049068.jpg,1,0,0,1,2,,train
0510711_as-0049068.jpg,1,0,2,0,3,,train
0510712_as-0049068.jpg,1,0,2,0,3,,val
0510713_as-0049068.jpg,1,0,1,0,2,,val
0510714_as-0049068.jpg,1,0,0,0,1,,test
0510715_as-0049068.jpg,1,0,0,0,1,,train
0510717_sc-172496.jpg,2,0,0,0,2,,train
0510718_as-3117175.jpg,1,0,0,0,1,,train
0510721_as-0081465.jpg,3,0,0,0,3,,train
0510722_as-0081465.jpg,3,1,1,0,5,,train
0510724_as-0008149.jpg,3,0,0,1,4,,train
0510725_as-0008149.jpg,3,0,0,1,4,,train
0510726_as-0008149.jpg,3,0,0,1,4,,val
0510727_as-0008149.jpg,2,0,0,0,2,,val
0510728_as-0008149.jpg,1,0,1,0,2,,test
0510729_as-0008149.jpg,3,2,1,1,7,,train
0510730_as-0008149.jpg,2,1,1,1,5,,train
0510731_as-2991733.jpg,0,0,1,0,1,,train
0510733_sc-1035641.jpg,4,3,1,0,8,,train
0510734_sc-1035641.jpg,1,0,0,0,1,,train
0510737_as-7043235.jpg,1,0,0,1,2,,train
0510738_sc-189366.jpg,0,2,1,0,3,,train
0510739_as-7885760.jpg,3,1,2,0,6,,val
0510741_as-0009402.jpg,1,1,0,0,2,,val
0510742_as-0009402.jpg,1,1,0,0,2,,test
0510744_sc-1024977.jpg,3,1,2,1,7,,train
0510745_sc-1024977.jpg,1,0,0,0,1,,train
0510746_sc-1024977.jpg,8,1,1,1,11,,train
0510747_sc-136271.jpg,1,0,0,0,1,,train
0510748_sc-136271.jpg,1,0,0,1,2,,train
0510749_sc-136271.jpg,3,0,0,1,4,,train
0510750_sc-136271.jpg,1,0,0,1,2,,train
0510752_as-0074365.jpg,3,2,2,1,8,,val
0510753_as-0074365.jpg,2,1,1,0,4,,val
0510754_as-0074365.jpg,2,2,2,1,7,,test
0510755_as-0074365.jpg,1,0,0,0,1,,train
0510756_as-0074365.jpg,0,0,1,0,1,,train
0510757_as-0074365.jpg,1,0,0,0,1,,train
0510758_as-0074365.jpg,2,0,0,0,2,,train
0510760_sc-105935.jpg,1,0,0,0,1,,train
0510761_as-3070949.jpg,1,1,0,0,2,,train
0510762_as-0095501.jpg,9,1,0,1,11,,train
0510763_as-0095501.jpg,2,0,0,0,2,,val
0510765_as-7119879.jpg,1,0,1,1,3,,val
0510766_sc-219853.jpg,3,1,2,1,7,,test
0510767_sc-219853.jpg,2,0,0,0,2,,train
0510768_sc-1003164.jpg,2,1,0,0,3,,train
0510770_sc-1003164.jpg,3,1,2,0,6,,train
0510771_as-2619008.jpg,1,1,0,0,2,,train
0510773_as-0030794.jpg,0,2,2,0,4,,train
0510774_as-0030794.jpg,2,1,1,0,4,,train
0510775_as-0066454.jpg,0,1,0,0,1,,train
0510776_as-0066454.jpg,0,1,0,0,1,,val
0510777_as-0065608.jpg,1,0,0,1,2,,val
0510778_as-0065608.jpg,1,0,0,1,2,,test
0510779_as-0065608.jpg,1,0,0,1,2,,train
0510780_as-0065608.jpg,1,0,0,1,2,,train
0510781_as-0065608.jpg,1,0,0,0,1,,train
0510783_sc-186373.jpg,1,0,0,0,1,,train
0510784_sc-186373.jpg,1,0,1,0,2,,train
0510785_sc-186373.jpg,1,0,1,0,2,,train
0510786_sc-186373.jpg,1,1,2,0,4,,train
0510787_sc-186373.jpg,1,0,0,0,1,,val
0510788_as-2639814.jpg,1,0,0,0,1,,val
0510789_as-2900621.jpg,1,0,0,0,1,,test
0510790_as-2626962.jpg,1,1,0,0,2,,train
0510791_as-3237466.jpg,2,0,0,0,2,,train
0510793_as-0075542.jpg,2,0,1,0,3,,train
0510794_sc-212220.jpg,1,0,0,0,1,,train
0510795_as-3251191.jpg,1,0,0,0,1,,train
0510796_as-0057076.jpg,1,0,0,0,1,,train
0510797_as-0057076.jpg,1,0,0,0,1,,train
0510798_as-0057076.jpg,2,0,0,0,2,,val
0510799_as-0057076.jpg,0,0,0,1,1,,val
0510800_as-0057076.jpg,1,0,0,0,1,,test
0510801_as-0057076.jpg,0,0,0,1,1,,train
0510802_as-0057076.jpg,1,0,0,0,1,,train
0510803_sc-211087.jpg,2,0,0,0,2,,train
0510804_sc-211087.jpg,2,0,0,2,4,,train
0510805_sc-211087.jpg,1,0,1,1,3,,train
0510806_as-3069035.jpg,2,0,0,0,2,,train
0510809_as-0088910.jpg,3,0,0,0,3,,train
0510810_as-0088910.jpg,1,0,0,0,1,,val
0510813_as-0088910.jpg,3,1,1,1,6,,val
0510814_as-0088910.jpg,1,0,0,0,1,,test
0510815_as-0088910.jpg,1,0,0,0,1,,train
0510817_as-0085192.jpg,2,0,2,1,5,,train
0510818_as-0085192.jpg,2,0,1,1,4,,train
0510819_as-0085192.jpg,2,0,1,2,5,,train
0510823_as-0024464.jpg,3,0,0,1,4,,train
0510824_as-0027914.jpg,1,0,0,0,1,,train
0510825_as-0029759.jpg,3,0,1,0,4,,train
0510826_as-0029759.jpg,2,0,1,0,3,,val
0510827_as-0029759.jpg,5,1,2,0,8,,val
0510829_sc-214765.jpg,9,0,1,0,10,,test
0510833_as-0027668.jpg,1,0,0,1,2,,train
0510834_as-0027668.jpg,1,0,0,1,2,,train
0510835_as-0027668.jpg,1,0,0,1,2,,train
0510836_sc-1023572.jpg,0,0,0,1,1,,train
0510837_sc-1023572.jpg,1,1,0,0,2,,train
0510838_sc-1023572.jpg,0,0,0,1,1,,train
0510840_sc-143406.jpg,3,0,0,0,3,,train
0510841_as-7323839.jpg,2,1,2,1,6,,val
0510845_as-0082585.jpg,4,1,3,1,9,,val
0510846_as-0082585.jpg,0,0,2,1,3,,test
0510848_as-0082585.jpg,0,1,2,0,3,,train
0510849_as-0082585.jpg,2,1,2,0,5,,train
0510850_as-0082585.jpg,2,1,1,1,5,,train
0510851_as-0082585.jpg,0,0,2,1,3,,train
0510852_as-0082585.jpg,0,0,1,0,1,,train
0510853_as-3401671.jpg,2,0,0,0,2,,train
0510854_as-0014293.jpg,3,0,0,0,3,,train
0510855_as-0014293.jpg,1,0,0,0,1,,val
0510856_as-0014293.jpg,1,0,0,0,1,,val
0510857_as-0014293.jpg,1,0,0,0,1,,test
0510858_as-0014293.jpg,1,0,0,0,1,,train
0510859_as-0014293.jpg,2,0,0,0,2,,train
0510860_as-0014293.jpg,2,0,0,0,2,,train
0510862_as-0070196.jpg,3,0,0,0,3,,train
0510863_as-0070196.jpg,0,2,0,0,2,,train
0510864_as-0070196.jpg,0,4,0,0,4,,train
0510865_as-0070196.jpg,1,0,0,0,1,,train
0510866_as-0070196.jpg,2,0,0,0,2,,val
0510867_sc-214047.jpg,7,0,0,0,7,,val
0510868_sc-103579.jpg,1,0,1,0,2,,test
0510869_as-2526484.jpg,1,0,3,2,6,,train
0510870_as-2526484.jpg,4,0,0,0,4,,train
0510874_sc-128038.jpg,5,0,1,1,7,,train
0510875_sc-128038.jpg,5,0,1,0,6,,train
0510876_sc-128038.jpg,2,0,1,1,4,,train
0510877_as-0071330.jpg,1,0,0,0,1,,train
0510878_as-7695866.jpg,0,0,0,1,1,,train
0510879_as-2509263.jpg,1,0,0,0,1,,val
0510880_sc-119241.jpg,1,1,0,0,2,,val
0510881_sc-119241.jpg,3,2,0,0,5,,test
0510882_sc-119241.jpg,1,1,0,0,2,,train
0510883_as-3046088.jpg,2,0,2,1,5,,train
0510884_as-2804714.jpg,1,1,0,0,2,,train
0510885_sc-173177.jpg,3,1,2,0,6,,train
0510886_sc-173177.jpg,1,1,2,0,4,,train
0510887_as-0061522.jpg,1,2,0,0,3,,train
0510888_as-0061522.jpg,3,0,0,0,3,,train
0510889_as-0061522.jpg,1,1,0,0,2,,val
0510890_as-0061522.jpg,1,0,0,0,1,,val
0510891_as-0061522.jpg,3,0,1,0,4,,test
0510892_as-0061522.jpg,3,0,1,1,5,,train
0510893_as-0061522.jpg,1,0,1,1,3,,train
0510894_as-0061522.jpg,2,0,0,0,2,,train
0510895_as-0061522.jpg,1,0,0,1,2,,train
0510896_as-0061522.jpg,1,0,0,0,1,,train
0510897_as-0061522.jpg,3,0,1,1,5,,train
0510898_as-0061522.jpg,2,0,1,1,4,,train
0510900_as-0068421.jpg,1,0,0,0,1,,val
0510901_as-0070887.jpg,1,0,1,1,3,,val
0510902_as-0070887.jpg,1,0,1,1,3,,test
0510903_as-0070887.jpg,1,1,1,0,3,,train
0510904_as-0070887.jpg,1,1,0,0,2,,train
0510905_as-0070887.jpg,1,0,1,1,3,,train
0510906_sc-137831.jpg,1,0,0,0,1,,train
0510908_sc-159577.jpg,1,1,0,0,2,,train
0510910_as-3348845.jpg,2,0,1,0,3,,train
0510912_sc-1017112.jpg,6,0,1,1,8,,train
0510913_sc-1017112.jpg,4,0,0,0,4,,val
0510914_sc-1017112.jpg,5,0,1,1,7,,val
0510915_sc-1017112.jpg,2,0,0,0,2,,test
0510916_sc-211761.jpg,2,0,0,1,3,,train
0510919_as-0027561.jpg,2,1,1,0,4,,train
0510920_as-0027561.jpg,2,1,0,0,3,,train
0510921_as-0027561.jpg,3,1,0,0,4,,train
0510922_as-0027561.jpg,3,2,1,0,6,,train
0510923_sc-1003141.jpg,3,0,0,0,3,,train
0510924_as-0057469.jpg,0,0,0,1,1,,train
0510925_as-0057469.jpg,3,0,0,0,3,,val
0510926_sc-219204.jpg,1,0,1,2,4,,val
0510927_sc-219204.jpg,4,0,1,0,5,,test
0510928_sc-219204.jpg,0,0,2,2,4,,train
0510929_sc-219204.jpg,1,0,0,0,1,,train
0510930_as-3030691.jpg,1,0,1,0,2,,train
0510931_as-2982800.jpg,1,0,0,0,1,,train
0510932_as-3471137.jpg,0,1,0,0,1,,train
0510933_sc-198030.jpg,4,0,0,1,5,,train
0510934_sc-198030.jpg,1,0,0,0,1,,train
0510935_sc-198030.jpg,3,0,0,1,4,,val
0510936_sc-198030.jpg,5,0,0,1,6,,val
0510938_as-3075767.jpg,1,0,0,0,1,,test
0510939_as-2772838.jpg,1,0,0,0,1,,train
0510940_sc-166553.jpg,2,0,0,0,2,,train
0510941_as-9080379.jpg,0,2,0,0,2,,train
0510943_sc-134473.jpg,2,0,1,1,4,,train
0510944_sc-1009106.jpg,0,2,0,1,3,,train
0510945_sc-1009106.jpg,0,0,2,0,2,,train
0510946_sc-1009106.jpg,0,1,0,0,1,,train
0510947_sc-1009106.jpg,0,0,1,0,1,,val
0510948_sc-1009106.jpg,0,2,0,0,2,,val
0510949_sc-1009106.jpg,0,2,0,1,3,,test
0510950_sc-1009106.jpg,0,2,0,1,3,,train
0510951_sc-1009106.jpg,0,1,0,0,1,,train
0510952_sc-1009106.jpg,0,1,0,0,1,,train
0510954_as-0055935.jpg,7,0,0,1,8,,train
0510955_as-0055935.jpg,7,0,0,1,8,,train
0510956_as-0055935.jpg,9,0,0,0,9,,train
0510957_as-0055935.jpg,2,0,0,0,2,,train
0510958_as-0055935.jpg,8,1,0,0,9,,val
0510959_as-7973383.jpg,3,0,1,0,4,,val
0510960_as-3089395.jpg,1,0,0,0,1,,test
0510962_as-7809769.jpg,3,0,0,0,3,,train
0510963_as-0082485.jpg,2,0,0,2,4,,train
0510964_as-0082485.jpg,1,0,0,1,2,,train
0510965_as-0086756.jpg,2,0,1,1,4,,train
0510966_as-0086756.jpg,1,0,1,1,3,,train
0510967_as-3279115.jpg,1,1,1,1,4,,train
0510970_as-0028077.jpg,1,0,0,0,1,,train
0510971_as-0028077.jpg,1,0,0,0,1,,val
0510972_as-0028077.jpg,1,1,0,0,2,,val
0510973_as-0028077.jpg,1,0,0,0,1,,test
0510975_as-0028077.jpg,2,0,0,0,2,,train
0510976_as-0028077.jpg,2,0,0,0,2,,train
0510981_as-7285632.jpg,5,0,0,0,5,,train
0510982_sc-1038632.jpg,0,0,1,0,1,,train
0510983_sc-1038632.jpg,1,0,1,0,2,,train
0510987_as-0082401.jpg,1,0,1,0,2,,train
0510988_as-0082401.jpg,4,1,1,1,7,,train
0510989_as-0082401.jpg,1,0,1,1,3,,val
0510990_as-0082401.jpg,2,0,0,0,2,,val
0510992_as-0082401.jpg,1,3,4,2,10,,test
0510994_sc-211356.jpg,1,0,0,0,1,,train
0510995_sc-153564.jpg,2,0,0,0,2,,train
0510996_sc-153564.jpg,2,0,0,0,2,,train
0510997_sc-153564.jpg,3,0,0,0,3,,train
0510998_as-0036525.jpg,3,0,0,1,4,,train
0510999_as-0036525.jpg,1,0,1,0,2,,train
0511000_as-0036525.jpg,2,0,0,0,2,,train
0511001_as-0036525.jpg,5,0,1,0,6,,val
0511004_sc-112676.jpg,2,0,0,0,2,,val
0511005_sc-112676.jpg,1,0,1,0,2,,test
0511006_as-7518274.jpg,1,0,0,0,1,,train
0511007_sc-192085.jpg,2,0,0,0,2,,train
0511008_sc-192085.jpg,2,0,0,0,2,,train
0511009_sc-192085.jpg,1,0,1,1,3,,train
0511010_sc-192085.jpg,0,0,1,1,2,,train
0511011_sc-192085.jpg,3,0,0,0,3,,train
0511012_as-2562395.jpg,1,1,0,0,2,,train
0511013_sc-107791.jpg,4,0,0,0,4,,val
0511014_sc-107791.jpg,1,1,0,0,2,,val
0511015_sc-107791.jpg,4,0,0,0,4,,test
0511017_sc-222969.jpg,3,0,0,1,4,,train
0511020_sc-1015832.jpg,0,0,1,0,1,,train
0511021_sc-1015832.jpg,1,2,1,0,4,,train
0511022_sc-130997.jpg,2,0,0,1,3,,train
0511023_as-7281634.jpg,1,2,1,0,4,,train
0511024_as-3191395.jpg,1,0,0,0,1,,train
0511025_as-0047050.jpg,1,1,0,0,2,,train
0511026_as-0047050.jpg,0,1,0,0,1,,val
0511027_as-0047050.jpg,0,1,0,0,1,,val
0511028_as-0047050.jpg,0,1,0,0,1,,test
0511029_as-0047050.jpg,0,1,0,0,1,,train
0511030_as-0047050.jpg,0,1,0,0,1,,train
0511031_as-0100102.jpg,5,1,1,1,8,,train
0511032_as-0100102.jpg,3,0,2,0,5,,train
0511033_as-0100102.jpg,2,2,1,0,5,,train
0511035_as-0014064.jpg,2,0,2,0,4,,train
0511036_as-0014064.jpg,3,0,2,0,5,,train
0511037_as-0014064.jpg,2,0,0,0,2,,val
0511038_as-0014064.jpg,3,0,0,0,3,,val
0511043_sc-1006170.jpg,3,1,0,0,4,,test
0511044_as-3302073.jpg,1,0,0,0,1,,train
0511045_sc-1032546.jpg,2,0,0,0,2,,train
0511046_sc-1032546.jpg,2,0,1,1,4,,train
0511047_sc-1032546.jpg,4,1,0,0,5,,train
0511048_sc-1032546.jpg,4,1,1,1,7,,train
0511049_sc-1032546.jpg,6,1,1,2,10,,train
0511050_sc-1032546.jpg,3,0,1,4,8,,train
0511052_sc-1032546.jpg,0,0,1,0,1,,val
0511053_sc-1032546.jpg,0,0,1,0,1,,val
0511054_sc-1032546.jpg,0,0,1,0,1,,test
0511055_sc-1027338.jpg,1,0,0,0,1,,train
0511056_sc-1027338.jpg,1,0,0,0,1,,train
0511057_sc-1027338.jpg,1,0,0,0,1,,train
0511060_as-0050950.jpg,1,0,0,1,2,,train
0511061_as-0050950.jpg,0,0,0,4,4,,train
0511062_as-0050950.jpg,1,0,0,0,1,,train
0511063_as-0050950.jpg,1,0,0,2,3,,train
0511064_as-2595009.jpg,2,1,0,0,3,,val
0511066_sc-135556.jpg,3,0,0,0,3,,val
0511067_sc-135556.jpg,2,0,0,0,2,,test
0511068_sc-135556.jpg,2,0,0,0,2,,train
0511069_sc-135556.jpg,2,0,0,0,2,,train
0511070_as-7658400.jpg,1,0,0,0,1,,train
0511071_sc-196012.jpg,3,0,1,0,4,,train
0511072_sc-196012.jpg,2,0,1,0,3,,train
0511073_sc-196012.jpg,1,0,1,0,2,,train
0511074_sc-196012.jpg,0,0,1,0,1,,train
0511075_sc-196012.jpg,1,0,1,0,2,,val
0511076_sc-196012.jpg,2,1,0,0,3,,val
0511077_sc-135406.jpg,3,0,0,0,3,,test
0511078_sc-135406.jpg,2,0,0,0,2,,train
0511079_as-0090438.jpg,1,0,0,1,2,,train
0511080_as-0090438.jpg,1,0,0,1,2,,train
0511081_as-9058629.jpg,1,0,0,0,1,,train
0511082_as-0097146.jpg,1,0,0,0,1,,train
0511083_as-0097146.jpg,2,0,0,0,2,,train
0511085_as-0043361.jpg,7,0,0,0,7,,train
0511089_sc-194644.jpg,4,0,1,0,5,,val
0511090_sc-194644.jpg,5,0,1,0,6,,val
0511091_sc-194644.jpg,2,0,1,0,3,,test
0511092_sc-209279.jpg,1,0,0,0,1,,train
0511093_sc-209279.jpg,0,0,0,1,1,,train
0511095_as-0065098.jpg,5,1,0,0,6,,train
0511096_as-0065098.jpg,3,2,0,0,5,,train
0511097_as-0065098.jpg,2,1,0,0,3,,train
0511098_as-0065098.jpg,2,1,0,0,3,,train
0511099_as-0065098.jpg,2,1,1,0,4,,train
0511100_as-0065098.jpg,0,1,0,0,1,,val
0511101_as-0065098.jpg,1,0,1,0,2,,val
0511102_as-0065098.jpg,1,0,0,0,1,,test
0511105_as-0072540.jpg,1,0,0,2,3,,train
0511106_as-0072540.jpg,1,0,0,1,2,,train
0511107_as-0072540.jpg,1,1,0,1,3,,train
0511108_sc-113765.jpg,1,0,1,1,3,,train
0511109_sc-113765.jpg,1,0,1,1,3,,train
0511110_sc-113765.jpg,2,0,1,0,3,,train
0511111_sc-113765.jpg,1,1,0,0,2,,train
0511112_sc-113765.jpg,1,0,1,1,3,,val
0511114_as-2738069.jpg,0,0,1,1,2,,val
0511115_sc-214452.jpg,4,0,1,0,5,,test
0511116_sc-214452.jpg,2,0,1,0,3,,train
0511117_as-3448458.jpg,1,0,0,2,3,,train
0511118_sc-215383.jpg,1,1,1,0,3,,train
0511119_sc-215383.jpg,0,0,1,0,1,,train
0511120_sc-1016950.jpg,4,0,0,2,6,,train
0511121_sc-1016950.jpg,2,0,0,1,3,,train
0511122_sc-1016950.jpg,3,0,0,2,5,,train
0511123_sc-1023271.jpg,2,0,0,0,2,,val
0511124_sc-1023271.jpg,0,1,0,0,1,,val
0511126_as-2890457.jpg,1,0,0,0,1,,test
0511127_as-2600661.jpg,1,0,0,0,1,,train
0511129_sc-224741.jpg,2,3,6,1,12,,train
0511130_sc-224741.jpg,0,0,1,1,2,,train
0511131_sc-224741.jpg,2,3,3,2,10,,train
0511132_sc-126518.jpg,0,0,1,0,1,,train
0511133_sc-126518.jpg,0,0,3,0,3,,train
0511134_sc-126518.jpg,0,0,3,0,3,,train
0511135_sc-126518.jpg,2,0,0,0,2,,val
0511136_sc-125950.jpg,1,0,0,0,1,,val
0511137_as-3398721.jpg,4,0,0,0,4,,test
0511138_as-0075131.jpg,1,0,0,0,1,,train
0511139_as-3202182.jpg,1,0,0,0,1,,train
0511140_as-0076667.jpg,1,0,0,0,1,,train
0511141_as-0076667.jpg,1,0,0,1,2,,train
0511142_sc-119865.jpg,2,0,0,0,2,,train
0511143_sc-119865.jpg,2,0,0,0,2,,train
0511144_sc-119865.jpg,2,0,0,0,2,,train
0511145_as-7316055.jpg,1,0,0,0,1,,val
0511146_as-0004002.jpg,2,0,0,0,2,,val
0511147_as-0004002.jpg,1,0,0,0,1,,test
0511148_as-0004002.jpg,0,0,1,1,2,,train
0511149_as-0004002.jpg,0,0,1,1,2,,train
0511151_sc-198696.jpg,3,0,1,0,4,,train
0511153_sc-198696.jpg,6,0,1,0,7,,train
0511154_as-0014012.jpg,2,0,0,0,2,,train
0511155_as-0005117.jpg,2,0,0,0,2,,train
0511156_as-3424853.jpg,0,0,1,0,1,,train
0511157_sc-116621.jpg,3,0,0,0,3,,val
0511158_sc-200143.jpg,1,0,0,0,1,,val
0511159_sc-200143.jpg,3,0,0,0,3,,test
0511161_sc-221163.jpg,3,0,0,0,3,,train
0511162_sc-1017125.jpg,7,2,4,1,14,,train
0511165_sc-1017125.jpg,3,1,3,2,9,,train
0511166_sc-1017125.jpg,6,2,3,2,13,,train
0511167_sc-1017125.jpg,2,0,1,2,5,,train
0511168_sc-192464.jpg,5,0,0,0,5,,train
0511169_sc-192464.jpg,3,0,0,0,3,,train
0511170_sc-192464.jpg,2,0,0,0,2,,val
0511171_sc-192464.jpg,1,0,0,1,2,,val
0511172_sc-192464.jpg,1,0,0,0,1,,test
0511173_sc-192464.jpg,1,0,0,0,1,,train
0511174_sc-192464.jpg,7,0,0,0,7,,train
0511175_sc-192464.jpg,1,0,0,0,1,,train
0511177_as-0051716.jpg,1,0,0,1,2,,train
0511179_as-0077733.jpg,1,0,1,0,2,,train
0511180_as-0077733.jpg,4,0,0,0,4,,train
0511182_as-0077733.jpg,2,1,1,0,4,,train
0511183_as-0077733.jpg,2,0,0,0,2,,val
0511184_as-3296591.jpg,0,0,1,0,1,,val
0511186_sc-203492.jpg,3,0,0,0,3,,test
0511187_sc-203492.jpg,1,0,0,0,1,,train
0511188_sc-203492.jpg,3,0,0,0,3,,train
0511189_sc-217381.jpg,0,0,1,0,1,,train
0511190_sc-217381.jpg,3,2,0,0,5,,train
0511191_sc-217381.jpg,2,2,0,0,4,,train
0511192_sc-217381.jpg,3,2,0,0,5,,train
0511193_sc-217381.jpg,3,0,0,0,3,,train
0511194_as-2730978.jpg,0,0,0,1,1,,val
0511195_as-2879290.jpg,1,0,0,0,1,,val
0511196_sc-211880.jpg,2,0,0,0,2,,test
0511199_sc-155638.jpg,4,0,0,0,4,,train
0511201_sc-155638.jpg,6,1,0,0,7,,train
0511202_sc-155638.jpg,3,2,2,0,7,,train
0511205_as-0054290.jpg,6,0,0,0,6,,train
0511206_as-0054290.jpg,9,0,0,0,9,,train
0511207_as-0054290.jpg,5,0,0,0,5,,train
0511208_as-0054290.jpg,9,0,0,0,9,,train
0511209_as-0082638.jpg,1,0,0,0,1,,val
0511210_as-0082638.jpg,1,0,0,0,1,,val
0511211_as-0082638.jpg,1,0,0,0,1,,test
0511212_as-0082638.jpg,1,0,0,0,1,,train
0511213_as-0082638.jpg,1,0,0,0,1,,train
0511214_as-0082638.jpg,1,0,0,0,1,,train
0511215_as-0082638.jpg,2,0,0,0,2,,train
0511216_as-0082638.jpg,1,0,0,0,1,,train
0511217_as-0082638.jpg,1,0,0,0,1,,train
0511218_as-0082638.jpg,1,0,0,0,1,,train
0511219_as-7381374.jpg,3,1,1,0,5,,val
0511220_as-2688921.jpg,6,0,2,0,8,,val
0511223_sc-182237.jpg,1,0,0,1,2,,test
0511224_sc-136821.jpg,1,0,0,1,2,,train
0511225_sc-136821.jpg,1,0,0,1,2,,train
0511226_sc-136821.jpg,2,0,0,1,3,,train
0511227_as-2996837.jpg,0,0,2,0,2,,train
0511228_sc-214570.jpg,8,0,2,0,10,,train
0511229_sc-214570.jpg,5,2,1,1,9,,train
0511230_sc-214570.jpg,2,2,1,1,6,,train
0511231_sc-214570.jpg,1,0,1,1,3,,val
0511232_sc-214570.jpg,4,0,1,1,6,,val
0511233_sc-214570.jpg,0,0,1,1,2,,test
0511234_sc-214570.jpg,4,0,2,0,6,,train
0511235_as-3272864.jpg,2,0,1,0,3,,train
0511236_as-3315463.jpg,1,0,0,0,1,,train
0511237_as-0046406.jpg,1,0,0,0,1,,train
0511238_as-0046406.jpg,1,0,0,0,1,,train
0511239_as-0046406.jpg,1,0,0,0,1,,train
0511240_as-0046406.jpg,2,0,0,0,2,,train
0511241_as-0046406.jpg,1,0,0,0,1,,val
0511242_as-0046406.jpg,1,0,0,0,1,,val
0511245_as-0080078.jpg,14,3,1,0,18,,test
0511246_as-0080078.jpg,5,3,0,0,8,,train
0511248_as-0054460.jpg,1,0,0,0,1,,train
0511249_as-0054460.jpg,4,0,1,0,5,,train
0511250_as-0054460.jpg,1,0,0,0,1,,train
0511252_sc-112625.jpg,3,0,0,1,4,,train
0511253_sc-112625.jpg,2,0,1,0,3,,train
0511254_sc-112625.jpg,1,0,1,1,3,,train
0511255_sc-112625.jpg,2,0,1,1,4,,val
0511256_sc-112625.jpg,3,0,0,0,3,,val
0511258_sc-1020653.jpg,3,0,0,2,5,,test
0511259_as-3206944.jpg,0,0,1,0,1,,train
0511262_as-0082452.jpg,3,0,0,0,3,,train
0511264_as-0082452.jpg,0,0,1,0,1,,train
0511265_sc-114923.jpg,1,0,0,1,2,,train
0511266_as-2967126.jpg,1,0,0,0,1,,train
0511267_as-2761276.jpg,1,1,0,0,2,,train
0511268_sc-154971.jpg,6,0,0,0,6,,train
0511269_sc-154971.jpg,4,1,0,0,5,,val
0511270_sc-154971.jpg,2,3,0,0,5,,val
0511271_sc-172716.jpg,1,1,0,1,3,,test
0511272_sc-172716.jpg,1,0,0,1,2,,train
0511273_sc-172716.jpg,1,0,0,1,2,,train
0511274_as-0087672.jpg,1,1,1,0,3,,train
0511275_as-0087672.jpg,1,1,1,0,3,,train
0511276_as-0087672.jpg,1,1,1,0,3,,train
0511278_as-7998033.jpg,3,0,0,0,3,,train
0511279_sc-126958.jpg,2,1,1,0,4,,train
0511280_sc-146127.jpg,4,0,1,0,5,,val
0511281_sc-146127.jpg,3,0,0,0,3,,val
0511282_sc-146127.jpg,1,0,1,0,2,,test
0511283_as-3126696.jpg,1,0,1,0,2,,train
0511285_sc-1032134.jpg,3,0,0,2,5,,train
0511286_sc-1032134.jpg,3,0,0,2,5,,train
0511287_sc-1032134.jpg,3,0,0,1,4,,train
0511288_sc-1032134.jpg,2,0,0,2,4,,train
0511289_sc-226642.jpg,0,1,1,0,2,,train
0511290_sc-142089.jpg,1,0,0,0,1,,train
0511291_sc-142089.jpg,1,1,0,0,2,,val
0511292_sc-142089.jpg,1,0,0,0,1,,val
0511293_sc-142089.jpg,2,0,0,0,2,,test
0511294_sc-142089.jpg,2,0,0,0,2,,train
0511296_sc-142089.jpg,1,0,0,0,1,,train
0511297_as-0071482.jpg,1,0,0,0,1,,train
0511298_as-0071482.jpg,2,0,0,0,2,,train
0511299_as-0071482.jpg,2,0,0,0,2,,train
0511300_sc-187075.jpg,4,0,0,1,5,,train
0511301_sc-187075.jpg,0,0,0,1,1,,train
0511302_sc-187075.jpg,5,2,1,0,8,,val
0511303_sc-187075.jpg,3,2,1,0,6,,val
0511304_sc-187075.jpg,4,2,1,0,7,,test
0511305_sc-204311.jpg,5,0,0,0,5,,train
0511306_sc-204311.jpg,1,0,0,0,1,,train
0511308_as-9049081.jpg,1,0,0,0,1,,train
0511309_as-0003618.jpg,4,0,0,0,4,,train
0511312_as-0003618.jpg,4,0,0,2,6,,train
0511313_as-3312720.jpg,1,0,1,0,2,,train
0511314_sc-209067.jpg,3,0,1,0,4,,train
0511315_sc-209067.jpg,2,0,1,0,3,,val
0511319_as-0039096.jpg,3,0,1,0,4,,val
0511320_as-0039096.jpg,1,0,2,0,3,,test
0511321_as-0039096.jpg,0,0,1,0,1,,train
0511322_as-0039096.jpg,0,2,1,0,3,,train
0511323_as-0039096.jpg,0,2,0,0,2,,train
0511324_as-0039096.jpg,0,2,0,0,2,,train
0511325_as-9027389.jpg,2,0,0,0,2,,train
0511326_as-2510411.jpg,1,0,0,0,1,,train
0511327_as-2976667.jpg,2,0,0,0,2,,train
0511328_sc-139827.jpg,3,0,0,0,3,,val
0511329_sc-139827.jpg,4,0,0,0,4,,val
0511330_sc-139827.jpg,5,0,0,3,8,,test
0511331_sc-139827.jpg,3,0,0,2,5,,train
0511332_sc-139827.jpg,2,0,0,0,2,,train
0511338_as-0017206.jpg,0,1,2,3,6,,train
0511339_as-0017206.jpg,0,1,2,3,6,,train
0511340_as-0017206.jpg,0,1,2,2,5,,train
0511341_as-9048875.jpg,3,0,0,1,4,,train
0511342_sc-190875.jpg,0,0,1,0,1,,train
0511343_as-0059553.jpg,3,0,0,0,3,,val
0511350_as-0023698.jpg,1,1,0,0,2,,val
0511351_sc-150375.jpg,2,0,0,1,3,,test
0511353_sc-156051.jpg,5,0,0,0,5,,train
0511354_as-3027844.jpg,2,1,1,0,4,,train
0511355_sc-117197.jpg,0,0,1,0,1,,train
0511356_sc-117197.jpg,0,0,1,0,1,,train
0511357_sc-117197.jpg,0,4,0,0,4,,train
0511358_sc-117197.jpg,0,5,1,0,6,,train
0511359_sc-117197.jpg,0,5,1,0,6,,train
0511360_as-3337181.jpg,1,0,0,0,1,,val
0511361_as-2700255.jpg,1,1,1,0,3,,val
0511363_as-0079060.jpg,2,0,0,1,3,,test
0511365_as-0079060.jpg,1,0,1,0,2,,train
0511366_as-0079060.jpg,2,0,0,0,2,,train
0511367_sc-121219.jpg,7,0,1,1,9,,train
0511368_sc-121219.jpg,6,0,1,0,7,,train
0511369_sc-118274.jpg,5,2,0,0,7,,train
0511371_sc-118274.jpg,0,1,1,1,3,,train
0511372_sc-118274.jpg,3,0,1,0,4,,train
0511373_sc-118274.jpg,2,0,0,0,2,,val
0511374_as-7454269.jpg,2,0,0,0,2,,val
0511375_sc-217240.jpg,1,0,0,0,1,,test
0511376_sc-217240.jpg,1,0,0,0,1,,train
0511378_sc-217240.jpg,1,0,0,0,1,,train
0511379_sc-179459.jpg,2,0,0,1,3,,train
0511380_sc-179459.jpg,1,0,0,1,2,,train
0511381_sc-179459.jpg,1,0,0,1,2,,train
0511382_sc-179459.jpg,2,0,0,1,3,,train
0511385_sc-112264.jpg,4,2,1,0,7,,train
0511390_as-0033736.jpg,2,0,0,1,3,,val
0511391_as-0033736.jpg,2,0,0,1,3,,val
0511392_as-0033736.jpg,2,0,0,0,2,,test
0511393_as-0033736.jpg,3,0,0,0,3,,train
0511394_as-0033736.jpg,1,0,0,1,2,,train
0511397_sc-133527.jpg,3,1,0,0,4,,train
0511398_sc-133527.jpg,1,0,0,0,1,,train
0511399_sc-133527.jpg,2,0,0,0,2,,train
0511400_sc-133527.jpg,3,0,0,0,3,,train
0511401_as-0032686.jpg,2,0,0,0,2,,train
0511402_as-3136696.jpg,1,1,0,0,2,,val
0511403_as-2996801.jpg,2,0,1,1,4,,val
0511404_as-2996801.jpg,1,0,0,0,1,,test
0511405_sc-1011704.jpg,3,0,0,0,3,,train
0511406_sc-1011704.jpg,4,0,1,0,5,,train
0511407_as-7460032.jpg,1,0,1,0,2,,train
0511408_as-2972074.jpg,1,0,0,2,3,,train
0511409_as-0082076.jpg,2,0,0,0,2,,train
0511410_as-0082076.jpg,2,0,0,0,2,,train
0511411_sc-1023369.jpg,2,0,0,0,2,,train
0511413_sc-1023369.jpg,2,0,0,0,2,,val
0511415_sc-161222.jpg,1,0,1,0,2,,val
0511416_sc-161222.jpg,1,0,1,0,2,,test
0511417_sc-161222.jpg,0,0,1,1,2,,train
0511418_sc-161222.jpg,1,0,0,0,1,,train
0511419_sc-161222.jpg,1,0,0,0,1,,train
0511420_sc-161222.jpg,4,0,0,0,4,,train
0511421_sc-161222.jpg,4,0,0,0,4,,train
0511422_sc-161222.jpg,2,0,1,0,3,,train
0511423_sc-212959.jpg,1,0,0,1,2,,train
0511424_sc-212959.jpg,3,0,0,1,4,,val
0511425_sc-212959.jpg,1,0,0,0,1,,val
0511427_as-3097969.jpg,6,0,1,1,8,,test
0511428_as-0033026.jpg,1,0,0,0,1,,train
0511429_as-0033026.jpg,1,0,0,0,1,,train
0511430_sc-221297.jpg,3,0,0,1,4,,train
0511431_sc-221297.jpg,1,1,0,0,2,,train
0511432_sc-1017355.jpg,1,0,0,0,1,,train
0511433_sc-1017355.jpg,1,0,2,0,3,,train
0511435_sc-132942.jpg,2,0,1,0,3,,train
0511436_sc-132942.jpg,2,0,1,0,3,,val
0511437_sc-132942.jpg,1,0,1,0,2,,val
0511438_sc-132942.jpg,1,0,1,0,2,,test
0511440_as-2963897.jpg,3,0,0,0,3,,train
0511441_sc-227219.jpg,2,1,0,0,3,,train
0511443_sc-158084.jpg,2,0,0,1,3,,train
0511447_as-0075663.jpg,2,1,0,4,7,,train
0511448_as-0075663.jpg,8,3,2,3,16,,train
0511450_as-0075663.jpg,2,2,1,0,5,,train
0511452_as-0057927.jpg,1,0,1,1,3,,train
0511453_as-0057927.jpg,1,0,1,1,3,,val
0511454_as-0057927.jpg,1,0,0,1,2,,val
0511455_as-0010823.jpg,0,0,0,2,2,,test
0511456_sc-179043.jpg,1,0,0,0,1,,train
0511457_sc-188615.jpg,1,0,0,0,1,,train
0511458_as-9042320.jpg,5,0,1,2,8,,train
0511460_sc-108457.jpg,1,0,0,1,2,,train
0511461_sc-108457.jpg,1,0,1,1,3,,train
0511462_sc-108457.jpg,1,0,2,1,4,,train
0511463_sc-108457.jpg,1,0,1,0,2,,train
0511464_as-2908971.jpg,1,1,1,1,4,,val
0511465_as-2855691.jpg,0,0,1,0,1,,val
0511466_sc-123311.jpg,0,1,0,0,1,,test
0511467_sc-185190.jpg,2,0,0,0,2,,train
0511468_sc-185190.jpg,1,0,2,0,3,,train
0511471_as-0041123.jpg,0,0,1,0,1,,train
0511472_sc-130978.jpg,1,0,1,0,2,,train
0511473_sc-130978.jpg,2,0,0,0,2,,train
0511474_sc-130978.jpg,1,0,1,0,2,,train
0511475_sc-130978.jpg,5,0,1,0,6,,train
0511477_as-2854463.jpg,3,0,1,0,4,,val
0511479_as-0077838.jpg,4,0,1,0,5,,val
0511482_as-0077838.jpg,2,0,0,0,2,,test
0511483_as-0077838.jpg,3,0,2,1,6,,train
0511484_as-0077838.jpg,3,0,2,0,5,,train
0511485_sc-108896.jpg,2,0,1,2,5,,train
0511486_sc-183235.jpg,0,0,0,1,1,,train
0511487_sc-183235.jpg,1,0,0,1,2,,train
0511488_sc-183235.jpg,0,0,0,1,1,,train
0511489_sc-183235.jpg,0,0,0,1,1,,train
0511490_sc-183235.jpg,0,0,0,1,1,,val
0511491_sc-183235.jpg,0,0,0,1,1,,val
0511493_sc-1028135.jpg,1,0,0,0,1,,test
0511495_sc-1028135.jpg,1,0,0,0,1,,train
0511496_as-7745686.jpg,1,0,0,0,1,,train
0511497_sc-220554.jpg,1,1,4,1,7,,train
0511498_sc-220554.jpg,1,0,0,0,1,,train
0511499_as-9004061.jpg,5,1,2,1,9,,train
0511500_sc-151605.jpg,2,0,0,1,3,,train
0511501_sc-151605.jpg,2,0,0,1,3,,train
0511502_sc-151605.jpg,1,0,0,0,1,,val
0511503_sc-151605.jpg,1,0,0,1,2,,val
0511504_sc-151605.jpg,1,0,0,1,2,,test
0511505_sc-151605.jpg,2,0,0,1,3,,train
0511508_sc-180776.jpg,2,0,0,0,2,,train
0511510_as-0060657.jpg,2,0,1,0,3,,train
0511513_as-0060258.jpg,1,0,0,0,1,,train
0511514_sc-126715.jpg,0,0,1,0,1,,train
0511515_sc-126715.jpg,0,0,1,1,2,,train
0511516_sc-126715.jpg,0,0,1,1,2,,train
0511517_sc-126715.jpg,0,0,1,0,1,,val
0511518_sc-198199.jpg,2,1,1,1,5,,val
0511519_sc-229442.jpg,2,0,0,0,2,,test
0511520_as-3239645.jpg,1,0,0,0,1,,train
0511522_as-2726856.jpg,7,0,2,0,9,,train
0511523_as-0048589.jpg,1,1,0,1,3,,train
0511524_as-0048589.jpg,1,0,0,1,2,,train
0511525_as-0048589.jpg,1,0,1,0,2,,train
0511526_as-3292495.jpg,4,1,0,0,5,,train
0511528_as-0011947.jpg,4,0,2,1,7,,train
0511529_as-0011947.jpg,2,0,1,1,4,,val
0511530_as-0011947.jpg,2,0,1,0,3,,val
0511531_as-0011947.jpg,1,0,1,0,2,,test
0511532_as-0011947.jpg,2,0,2,0,4,,train
0511533_as-0011947.jpg,0,0,1,0,1,,train
0511535_sc-1000192.jpg,1,0,0,0,1,,train
0511536_sc-1000192.jpg,1,0,0,1,2,,train
0511537_sc-177583.jpg,1,0,0,0,1,,train
0511539_sc-177583.jpg,1,0,0,0,1,,train
0511540_as-0001597.jpg,2,0,0,1,3,,train
0511541_as-0001597.jpg,0,0,1,1,2,,val
0511542_as-0032722.jpg,3,0,0,0,3,,val
0511543_as-0032722.jpg,1,0,0,0,1,,test
0511545_sc-152006.jpg,3,0,0,0,3,,train
0511547_sc-152006.jpg,1,0,0,0,1,,train
0511548_sc-202452.jpg,2,0,1,0,3,,train
0511549_sc-202452.jpg,3,1,1,1,6,,train
0511550_sc-202452.jpg,1,3,1,1,6,,train
0511552_sc-202452.jpg,4,0,0,0,4,,train
0511556_as-0065315.jpg,1,0,0,0,1,,train
0511557_as-0065315.jpg,2,0,0,0,2,,val
0511558_as-0065315.jpg,5,0,0,0,5,,val
0511559_as-0065315.jpg,2,0,0,0,2,,test
0511560_as-0065315.jpg,2,0,0,0,2,,train
0511562_as-0065315.jpg,1,0,0,0,1,,train
0511566_as-0065315.jpg,5,0,0,0,5,,train
0511567_sc-1035855.jpg,1,0,0,0,1,,train
0511568_sc-1035855.jpg,3,0,0,1,4,,train
0511569_sc-1035855.jpg,2,0,1,1,4,,train
0511571_sc-1035855.jpg,1,0,0,0,1,,train
0511572_sc-1035855.jpg,1,0,0,0,1,,val
0511573_sc-225810.jpg,1,1,2,0,4,,val
0511574_sc-225810.jpg,1,1,0,1,3,,test
0511575_sc-225810.jpg,0,1,0,0,1,,train
0511576_sc-225810.jpg,0,1,0,0,1,,train
0511577_sc-225810.jpg,0,1,0,0,1,,train
0511578_sc-225810.jpg,1,1,0,0,2,,train
0511579_sc-225810.jpg,0,1,0,0,1,,train
0511580_sc-225810.jpg,1,1,1,0,3,,train
0511581_as-9043184.jpg,0,0,1,0,1,,train
0511583_as-0059463.jpg,2,0,1,0,3,,val
0511585_as-0059463.jpg,0,0,1,0,1,,val
0511586_as-0059463.jpg,0,0,1,0,1,,test
0511587_as-0059463.jpg,1,0,1,0,2,,train
0511588_as-0059463.jpg,2,0,2,0,4,,train
0511589_as-0090264.jpg,0,1,1,0,2,,train
0511590_as-0090264.jpg,0,0,1,0,1,,train
0511591_as-0090264.jpg,1,0,0,0,1,,train
0511592_as-0090264.jpg,2,1,1,0,4,,train
0511593_sc-224147.jpg,1,0,0,0,1,,train
0511594_sc-224147.jpg,1,0,0,0,1,,val
0511595_sc-224147.jpg,2,0,1,2,5,,val
0511596_sc-224147.jpg,1,0,1,0,2,,test
0511597_as-0020743.jpg,0,0,0,1,1,,train
0511598_as-0020743.jpg,0,0,0,1,1,,train
0511599_as-0020743.jpg,1,0,0,0,1,,train
0511600_as-0020743.jpg,0,0,1,1,2,,train
0511601_sc-1023235.jpg,1,1,0,0,2,,train
0511603_sc-189305.jpg,2,4,1,0,7,,train
0511604_sc-189305.jpg,2,2,1,0,5,,train
0511606_as-0078944.jpg,2,0,1,0,3,,val
0511607_as-0078944.jpg,4,0,0,0,4,,val
0511611_as-0078944.jpg,1,0,0,1,2,,test
0511612_sc-1021445.jpg,1,0,0,0,1,,train
0511613_sc-1021445.jpg,1,1,0,0,2,,train
0511614_sc-1021445.jpg,5,1,0,1,7,,train
0511615_as-0023992.jpg,4,0,0,1,5,,train
0511616_as-0023992.jpg,3,0,0,1,4,,train
0511617_as-0090504.jpg,6,2,0,1,9,,train
0511618_as-2540417.jpg,5,0,0,0,5,,train
0511619_as-3463829.jpg,0,1,0,0,1,,val
0511620_as-3460455.jpg,0,0,3,0,3,,val
0511621_as-7082107.jpg,2,0,0,0,2,,test
0511622_as-3393148.jpg,0,1,0,0,1,,train
0511623_as-7289336.jpg,2,0,0,2,4,,train
0511624_sc-208138.jpg,2,0,0,0,2,,train
0511625_sc-208138.jpg,1,0,0,0,1,,train
0511626_sc-208138.jpg,1,0,0,0,1,,train
0511627_sc-208138.jpg,1,0,0,0,1,,train
0511629_sc-1025878.jpg,2,0,0,1,3,,train
0511630_sc-1025878.jpg,3,0,0,1,4,,val
0511631_sc-1025878.jpg,2,0,0,1,3,,val
0511632_sc-1025878.jpg,2,0,0,1,3,,test
0511635_sc-138966.jpg,0,1,0,0,1,,train
0511636_sc-185839.jpg,1,0,1,0,2,,train
0511637_sc-1002857.jpg,1,0,0,1,2,,train
0511638_sc-1002857.jpg,3,0,0,1,4,,train
0511640_as-0010398.jpg,0,0,2,0,2,,train
0511641_as-0010398.jpg,0,0,1,0,1,,train
0511646_sc-178610.jpg,8,0,0,0,8,,train
0511647_sc-178610.jpg,9,0,0,1,10,,val
0511648_sc-171257.jpg,5,0,0,0,5,,val
0511649_sc-171257.jpg,6,0,2,1,9,,test
0511650_as-2577834.jpg,2,0,1,0,3,,train
0511651_as-2955063.jpg,3,0,0,0,3,,train
0511652_sc-197635.jpg,6,0,0,1,7,,train
0511653_sc-197635.jpg,1,0,0,0,1,,train
0511654_sc-197635.jpg,1,0,0,0,1,,train
0511655_as-0092272.jpg,0,0,2,0,2,,train
0511656_as-0092272.jpg,0,0,1,0,1,,train
0511659_sc-124911.jpg,2,0,0,0,2,,val
0511660_sc-124911.jpg,2,0,0,0,2,,val
0511661_sc-124911.jpg,2,0,0,0,2,,test
0511662_sc-189303.jpg,3,3,2,0,8,,train
0511664_sc-146436.jpg,1,0,1,0,2,,train
0511665_sc-146436.jpg,2,0,1,0,3,,train
0511666_sc-146436.jpg,1,0,1,0,2,,train
0511667_sc-146436.jpg,1,0,1,0,2,,train
0511668_sc-146436.jpg,1,1,1,0,3,,train
0511669_sc-146436.jpg,2,1,1,0,4,,train
0511670_sc-146436.jpg,2,1,1,0,4,,val
0511671_sc-146436.jpg,2,1,1,0,4,,val
0511672_sc-146436.jpg,2,1,1,0,4,,test
0511673_sc-202082.jpg,4,0,1,1,6,,train
0511679_as-0041988.jpg,2,1,0,0,3,,train
0511680_as-0041988.jpg,4,3,1,0,8,,train
0511682_as-0041988.jpg,4,0,1,0,5,,train
0511684_as-0041988.jpg,2,0,1,1,4,,train
0511685_as-0041988.jpg,2,0,0,0,2,,train
0511687_as-3474772.jpg,1,0,0,0,1,,train
0511688_as-7962853.jpg,4,0,0,0,4,,val
0511691_as-0028581.jpg,2,1,0,0,3,,val
0511692_as-0028581.jpg,0,0,1,1,2,,test
0511695_as-0078168.jpg,1,0,0,0,1,,train
0511696_as-0078168.jpg,2,0,0,0,2,,train
0511697_as-0078168.jpg,1,0,2,0,3,,train
0511698_as-0078168.jpg,1,1,1,0,3,,train
0511699_as-3214621.jpg,0,0,0,1,1,,train
0511700_as-0052599.jpg,4,1,0,0,5,,train
0511701_as-0052599.jpg,0,1,0,0,1,,train
0511702_as-0052599.jpg,1,1,0,0,2,,val
0511703_as-2806615.jpg,1,0,0,0,1,,val
0511704_as-2866110.jpg,0,0,1,0,1,,test
0511706_sc-163506.jpg,1,0,0,1,2,,train
0511707_sc-163506.jpg,1,0,1,0,2,,train
0511708_sc-163506.jpg,2,0,1,0,3,,train
0511709_sc-163506.jpg,1,0,1,1,3,,train
0511710_sc-163506.jpg,1,0,1,1,3,,train
0511711_sc-163506.jpg,1,0,0,0,1,,train
0511713_sc-163506.jpg,1,0,1,1,3,,train
0511717_as-0084856.jpg,2,0,0,0,2,,val
0511719_as-0084856.jpg,3,0,0,0,3,,val
0511720_as-0084856.jpg,1,0,0,0,1,,test
0511721_as-0084856.jpg,2,0,0,0,2,,train
0511722_sc-216628.jpg,0,1,2,0,3,,train
0511723_sc-185092.jpg,3,0,0,0,3,,train
0511724_sc-185092.jpg,1,0,0,0,1,,train
0511725_sc-185092.jpg,1,0,0,1,2,,train
0511726_as-3198668.jpg,1,0,0,0,1,,train
0511727_as-3412416.jpg,1,4,1,1,7,,train
0511728_sc-125719.jpg,1,0,0,0,1,,val
0511729_sc-125719.jpg,1,0,0,0,1,,val
0511730_as-0069546.jpg,2,0,0,0,2,,test
0511733_as-0042759.jpg,4,0,1,1,6,,train
0511734_sc-199573.jpg,2,0,0,0,2,,train
0511735_sc-199573.jpg,3,0,1,1,5,,train
0511737_sc-199573.jpg,2,1,0,0,3,,train
0511738_sc-199573.jpg,5,0,0,2,7,,train
0511739_sc-199573.jpg,3,0,0,1,4,,train
0511740_sc-199573.jpg,4,0,0,0,4,,train
0511741_sc-199573.jpg,4,0,0,0,4,,val
0511742_sc-199573.jpg,3,0,0,1,4,,val
0511743_sc-199573.jpg,2,0,0,1,3,,test
0511744_sc-214287.jpg,0,0,1,0,1,,train
0511745_sc-1027876.jpg,2,0,0,0,2,,train
0511746_sc-1027876.jpg,1,0,0,0,1,,train
0511749_sc-116133.jpg,2,2,0,0,4,,train
0511751_sc-116133.jpg,1,2,0,0,3,,train
0511752_as-0081035.jpg,1,0,0,0,1,,train
0511753_sc-111066.jpg,7,0,1,2,10,,train
0511754_as-3149677.jpg,1,0,1,1,3,,val
0511755_as-0022775.jpg,1,0,0,0,1,,val
0511756_as-0022775.jpg,1,0,0,0,1,,test
0511757_as-0022775.jpg,1,0,0,0,1,,train
0511758_sc-214650.jpg,2,1,1,0,4,,train
0511759_sc-214650.jpg,7,1,2,0,10,,train
0511760_sc-214650.jpg,4,1,2,0,7,,train
0511761_sc-214650.jpg,5,1,2,0,8,,train
0511762_as-3243153.jpg,0,0,2,2,4,,train
0511763_sc-1035991.jpg,5,0,1,0,6,,train
0511764_sc-1035991.jpg,2,0,0,0,2,,val
0511765_sc-1035991.jpg,4,0,0,0,4,,val
0511766_sc-165617.jpg,1,0,0,0,1,,test
0511767_sc-165617.jpg,1,0,0,0,1,,train
0511769_as-0089717.jpg,0,1,0,0,1,,train
0511770_as-0089717.jpg,0,1,0,0,1,,train
0511772_as-0089717.jpg,0,0,1,1,2,,train
0511773_as-0089717.jpg,0,1,0,1,2,,train
0511779_as-0016105.jpg,1,0,2,0,3,,train
0511780_as-0016105.jpg,0,0,2,0,2,,train
0511781_as-0016105.jpg,1,0,1,0,2,,val
0511782_as-0016105.jpg,0,0,1,0,1,,val
0511783_as-0016105.jpg,3,1,1,1,6,,test
0511784_sc-220172.jpg,6,0,1,0,7,,train
0511785_sc-1013312.jpg,1,0,1,0,2,,train
0511786_sc-1013312.jpg,3,0,0,0,3,,train
0511787_sc-1013312.jpg,2,0,0,0,2,,train
0511788_sc-1013312.jpg,1,0,0,0,1,,train
0511789_sc-1013312.jpg,2,0,0,0,2,,train
0511790_sc-1013312.jpg,3,0,0,0,3,,train
0511791_sc-1013312.jpg,2,0,0,0,2,,val
0511792_sc-1013312.jpg,2,0,0,0,2,,val
0511793_sc-1013312.jpg,4,0,0,0,4,,test
0511794_sc-1013312.jpg,2,0,0,0,2,,train
0511795_as-0058682.jpg,1,0,0,0,1,,train
0511796_as-0058682.jpg,1,0,0,0,1,,train
0511797_as-0040988.jpg,1,0,0,0,1,,train
0511798_as-0040988.jpg,1,0,0,0,1,,train
0511799_as-0040988.jpg,1,0,0,0,1,,train
0511800_as-0040988.jpg,1,0,0,0,1,,train
0511801_as-0040988.jpg,1,0,0,0,1,,val
0511803_as-3405041.jpg,1,0,0,0,1,,val
0511804_as-3405041.jpg,1,0,0,0,1,,test
0511805_as-3405041.jpg,2,2,1,3,8,,train
0511806_as-2711891.jpg,0,1,0,0,1,,train
0511807_as-0030411.jpg,1,0,0,0,1,,train
0511808_as-0030411.jpg,0,0,1,0,1,,train
0511809_as-0030411.jpg,0,0,1,1,2,,train
0511811_as-0030411.jpg,1,0,0,0,1,,train
0511812_as-0030411.jpg,2,0,0,1,3,,train
0511813_as-0030411.jpg,1,0,0,0,1,,val
0511814_as-0030411.jpg,2,0,0,1,3,,val
0511815_as-0030411.jpg,1,0,0,0,1,,test
0511816_as-0030411.jpg,1,0,0,1,2,,train
0511817_as-0028962.jpg,1,0,1,1,3,,train
0511818_as-0028962.jpg,1,0,1,1,3,,train
0511819_sc-176862.jpg,2,0,0,0,2,,train
0511822_as-0092846.jpg,3,5,2,0,10,,train
0511823_as-0092846.jpg,3,2,1,1,7,,train
0511825_as-0092846.jpg,0,1,1,0,2,,train
0511828_as-0092846.jpg,0,1,1,0,2,,val
0511829_as-0092846.jpg,1,2,1,0,4,,val
0511831_as-0078108.jpg,2,0,0,0,2,,test
0511832_as-0010635.jpg,1,0,1,0,2,,train
0511833_as-5437370.jpg,1,1,0,0,2,,train
0511834_as-3098757.jpg,5,0,1,1,7,,train
0511835_sc-1014630.jpg,2,0,1,0,3,,train
0511837_as-0012486.jpg,0,0,1,0,1,,train
0511838_as-0012486.jpg,6,0,0,0,6,,train
0511839_as-0012486.jpg,1,0,0,0,1,,train
0511840_as-0012486.jpg,1,0,0,0,1,,val
0511841_sc-1024792.jpg,4,0,0,0,4,,val
0511842_sc-1024792.jpg,2,0,0,0,2,,test
0511843_sc-1024792.jpg,2,1,0,0,3,,train
0511844_sc-1024792.jpg,1,0,0,0,1,,train
0511845_sc-194759.jpg,1,1,1,0,3,,train
0511846_sc-194759.jpg,2,1,1,0,4,,train
0511847_sc-194759.jpg,2,0,0,0,2,,train
0511849_as-0029142.jpg,1,0,0,0,1,,train
0511850_as-0029142.jpg,1,0,0,0,1,,train
0511852_sc-1012102.jpg,1,1,1,0,3,,val
0511854_sc-1026067.jpg,3,0,0,0,3,,val
0511855_sc-1026067.jpg,3,0,0,0,3,,test
0511856_sc-1026067.jpg,3,0,0,0,3,,train
0511857_sc-1026067.jpg,3,0,0,0,3,,train
0511858_sc-1024121.jpg,5,0,0,0,5,,train
0511859_sc-1024121.jpg,4,0,0,1,5,,train
0511860_as-2641924.jpg,1,0,2,0,3,,train
0511862_sc-138857.jpg,1,1,1,0,3,,train
0511863_sc-170902.jpg,1,0,0,0,1,,train
0511865_sc-1008712.jpg,4,0,0,0,4,,val
0511866_sc-1008712.jpg,5,0,0,0,5,,val
0511867_sc-1008712.jpg,7,0,0,0,7,,test
0511868_sc-1008712.jpg,10,0,0,0,10,,train
0511869_sc-1008712.jpg,5,0,0,0,5,,train
0511870_sc-1013467.jpg,1,0,1,1,3,,train
0511871_sc-1013467.jpg,1,0,0,0,1,,train
0511872_sc-1013467.jpg,0,0,1,1,2,,train
0511874_as-3137758.jpg,1,0,0,0,1,,train
0511875_sc-225607.jpg,3,0,2,0,5,,train
0511876_sc-225607.jpg,4,0,1,0,5,,val
0511877_sc-225607.jpg,5,0,1,0,6,,val
0511878_sc-161358.jpg,1,1,0,0,2,,test
0511880_sc-161358.jpg,1,1,0,0,2,,train
0511881_sc-190707.jpg,2,0,0,0,2,,train
0511882_sc-190707.jpg,2,0,0,0,2,,train
0511883_sc-190707.jpg,1,0,0,0,1,,train
0511885_sc-190707.jpg,1,0,0,0,1,,train
0511886_as-3238023.jpg,1,0,1,0,2,,train
0511889_as-0022765.jpg,3,0,2,2,7,,train
0511890_as-0022765.jpg,4,0,0,0,4,,val
0511891_as-0063846.jpg,1,0,0,0,1,,val
0511892_as-0063846.jpg,3,0,0,0,3,,test
0511894_as-2879409.jpg,2,0,0,1,3,,train
0511896_sc-1036056.jpg,1,0,0,0,1,,train
0511897_as-3073924.jpg,2,0,1,2,5,,train
0511899_as-0049312.jpg,14,3,6,0,23,,train
0511900_as-0049312.jpg,12,3,2,0,17,,train
0511901_as-0049312.jpg,6,0,0,0,6,,train
0511902_as-0049312.jpg,13,0,0,0,13,,train
0511903_as-0049312.jpg,2,0,2,0,4,,val
0511904_as-0049312.jpg,6,0,1,0,7,,val
0511905_as-0049312.jpg,4,0,1,0,5,,test
0511906_as-0049312.jpg,4,0,1,0,5,,train
0511907_as-0049312.jpg,3,1,1,0,5,,train
0511908_as-0049312.jpg,9,4,1,0,14,,train
0511909_as-0049312.jpg,12,5,1,0,18,,train
0511910_as-0049312.jpg,0,0,1,0,1,,train
0511911_as-0049312.jpg,8,4,0,0,12,,train
0511912_as-7975120.jpg,1,0,0,0,1,,train
0511913_as-3354099.jpg,1,0,0,0,1,,val
0511914_sc-1030386.jpg,7,0,3,0,10,,val
0511915_sc-1030386.jpg,6,0,0,0,6,,test
0511916_sc-1030386.jpg,7,0,4,0,11,,train
0511917_sc-1030386.jpg,7,0,2,0,9,,train
0511918_sc-1030386.jpg,8,0,3,0,11,,train
0511919_sc-1030386.jpg,6,0,3,0,9,,train
0511920_sc-138859.jpg,4,0,0,1,5,,train
0511921_sc-138859.jpg,2,0,0,1,3,,train
0511922_sc-107403.jpg,4,0,1,3,8,,train
0511924_sc-107403.jpg,4,1,1,0,6,,val
0511925_sc-107403.jpg,1,1,2,0,4,,val
0511926_as-9081088.jpg,1,0,0,1,2,,test
0511927_as-2820970.jpg,1,0,2,1,4,,train
0511928_as-3293980.jpg,1,0,1,1,3,,train
0511929_as-3291867.jpg,1,1,1,1,4,,train
0511930_sc-1035595.jpg,2,0,0,0,2,,train
0511931_sc-1035595.jpg,1,0,0,0,1,,train
0511932_sc-1035595.jpg,3,0,0,0,3,,train
0511933_sc-1040667.jpg,1,0,0,0,1,,train
0511934_as-2635652.jpg,1,0,1,0,2,,val
0511935_as-3431900.jpg,0,2,0,0,2,,val
0511937_as-2560435.jpg,7,0,1,1,9,,test
0511938_sc-133794.jpg,1,4,0,0,5,,train
0511939_as-2766977.jpg,2,0,0,0,2,,train
0511940_sc-160960.jpg,1,0,0,0,1,,train
0511941_sc-160960.jpg,1,0,0,0,1,,train
0511943_sc-208198.jpg,5,1,1,0,7,,train
0511944_sc-208198.jpg,2,0,0,0,2,,train
0511945_sc-208198.jpg,2,0,0,0,2,,train
0511946_sc-208198.jpg,2,1,1,0,4,,val
0511948_sc-208198.jpg,1,0,1,0,2,,val
0511950_as-0066699.jpg,0,1,1,0,2,,test
0511951_as-0066699.jpg,1,1,2,0,4,,train
0511954_sc-227711.jpg,1,0,0,0,1,,train
0511955_sc-227711.jpg,1,0,0,0,1,,train
0511956_sc-227711.jpg,1,0,0,0,1,,train
0511957_sc-227711.jpg,3,0,0,1,4,,train
0511958_sc-227711.jpg,1,1,0,1,3,,train
0511959_sc-227711.jpg,1,0,1,0,2,,train
0511960_sc-227711.jpg,3,2,0,1,6,,val
0511961_sc-227711.jpg,2,0,1,0,3,,val
0511962_sc-152516.jpg,2,0,0,0,2,,test
0511963_sc-152516.jpg,3,0,0,0,3,,train
0511965_as-9014234.jpg,5,0,1,1,7,,train
0511966_sc-1016241.jpg,2,0,0,0,2,,train
0511967_sc-126008.jpg,1,0,0,0,1,,train
0511968_sc-1035522.jpg,0,0,1,0,1,,train
0511970_sc-209424.jpg,2,0,0,0,2,,train
0511971_sc-209424.jpg,0,0,1,0,1,,train
0511973_sc-124383.jpg,3,0,0,0,3,,val
0511974_sc-124383.jpg,1,0,0,0,1,,val
0511975_sc-184372.jpg,0,0,0,1,1,,test
0511976_sc-184372.jpg,0,0,0,1,1,,train
0511981_sc-129453.jpg,1,0,0,1,2,,train
0511982_sc-129453.jpg,0,1,0,0,1,,train
0511984_sc-129453.jpg,0,3,0,1,4,,train
0511985_sc-1000917.jpg,1,0,0,1,2,,train
0511986_sc-1000917.jpg,2,0,0,0,2,,train
0511987_sc-1000917.jpg,1,1,0,0,2,,train
0511988_sc-1000917.jpg,1,0,0,1,2,,val
0511989_sc-1000917.jpg,1,0,1,1,3,,val
0511990_sc-1000917.jpg,2,0,0,1,3,,test
0511991_sc-1000917.jpg,2,1,0,0,3,,train
0511994_as-7185896.jpg,1,0,1,0,2,,train
0511995_sc-172024.jpg,13,1,1,0,15,,train
0511996_sc-172024.jpg,5,0,0,1,6,,train
0511997_sc-172024.jpg,3,0,0,1,4,,train
0511998_sc-172024.jpg,2,0,0,0,2,,train
0511999_sc-172024.jpg,3,0,0,0,3,,train
0512000_sc-172024.jpg,5,1,0,0,6,,val
0512001_sc-172024.jpg,1,0,0,0,1,,val
0512002_sc-172024.jpg,1,0,0,0,1,,test
0512003_sc-172024.jpg,3,0,0,0,3,,train
0512004_sc-172024.jpg,4,0,0,0,4,,train
0512005_sc-172024.jpg,7,1,1,0,9,,train
0512006_sc-145957.jpg,2,0,0,0,2,,train
0512007_sc-145957.jpg,3,0,0,0,3,,train
0512008_as-2931058.jpg,2,0,1,1,4,,train
0512009_sc-160214.jpg,0,1,0,1,2,,train
0512010_sc-160214.jpg,0,1,0,1,2,,val
0512011_sc-160214.jpg,0,1,0,1,2,,val
0512012_as-2890470.jpg,2,0,0,0,2,,test
0512015_sc-1024132.jpg,2,0,0,0,2,,train
0512016_sc-1024132.jpg,1,0,0,0,1,,train
0512018_as-2708111.jpg,2,1,0,0,3,,train
0512020_as-2850277.jpg,1,0,0,0,1,,train
0512021_as-3350671.jpg,2,0,0,0,2,,train
0512023_as-7458278.jpg,12,0,0,0,12,,train
0512024_as-2741570.jpg,2,0,0,0,2,,train
0512025_sc-105551.jpg,1,0,0,0,1,,val
0512026_sc-105551.jpg,1,0,0,0,1,,val
0512027_sc-105551.jpg,1,0,0,0,1,,test
0512028_sc-207946.jpg,2,0,1,0,3,,train
0512029_sc-207946.jpg,2,0,0,1,3,,train
0512030_sc-207946.jpg,0,0,1,0,1,,train
0512031_sc-207946.jpg,2,0,0,0,2,,train
0512032_sc-207946.jpg,4,0,1,1,6,,train
0512033_sc-207946.jpg,3,0,1,0,4,,train
0512034_as-2666242.jpg,3,0,0,0,3,,train
0512035_sc-135072.jpg,2,0,1,0,3,,val
0512037_as-3332854.jpg,1,0,1,1,3,,val
0512038_as-3013542.jpg,2,0,0,0,2,,test
0512039_as-9086144.jpg,1,0,0,0,1,,train
0512040_sc-138865.jpg,2,0,1,0,3,,train
0512042_sc-138865.jpg,0,1,0,0,1,,train
0512043_as-3163203.jpg,6,1,1,2,10,,train
0512044_sc-139854.jpg,2,0,1,1,4,,train
0512045_sc-139854.jpg,2,0,1,0,3,,train
0512046_sc-139854.jpg,2,0,0,1,3,,train
0512048_sc-139854.jpg,1,0,0,0,1,,val
0512049_as-3055723.jpg,1,0,0,0,1,,val
0512050_sc-1021393.jpg,2,0,1,2,5,,test
0512052_sc-1021393.jpg,2,0,2,1,5,,train
0512055_as-0067520.jpg,2,0,2,1,5,,train
0512058_as-0067520.jpg,3,0,1,2,6,,train
0512059_as-0067520.jpg,1,0,1,0,2,,train
0512061_as-3409138.jpg,1,0,0,0,1,,train
0512062_as-0002427.jpg,2,0,0,0,2,,train
0512064_as-0074341.jpg,2,0,0,1,3,,train
0512065_as-0074341.jpg,7,0,2,1,10,,val
0512066_as-0074341.jpg,5,0,1,1,7,,val
0512067_as-0074341.jpg,8,0,2,1,11,,test
0512068_as-0074341.jpg,1,0,2,1,4,,train
0512069_as-7302335.jpg,1,4,3,2,10,,train
0512072_as-0092199.jpg,7,0,0,0,7,,train
0512073_as-0092199.jpg,6,0,0,0,6,,train
0512074_as-0092199.jpg,6,0,0,0,6,,train
0512076_as-0092199.jpg,8,0,0,0,8,,train
0512077_sc-175276.jpg,5,0,0,2,7,,train
0512078_sc-175276.jpg,4,0,0,2,6,,val
0512079_sc-175276.jpg,6,0,0,1,7,,val
0512083_as-0079533.jpg,1,2,2,0,5,,test
0512084_sc-132188.jpg,0,0,1,0,1,,train
0512085_sc-132188.jpg,0,0,1,0,1,,train
0512086_sc-132188.jpg,0,0,1,0,1,,train
0512087_as-0092786.jpg,3,0,1,0,4,,train
0512088_as-0092786.jpg,1,0,0,0,1,,train
0512089_as-0092786.jpg,2,0,1,1,4,,train
0512091_as-7622827.jpg,1,1,0,0,2,,train
0512092_as-0082903.jpg,1,1,1,0,3,,val
0512093_as-0082903.jpg,1,0,1,0,2,,val
0512096_as-0013985.jpg,1,0,0,0,1,,test
0512097_as-0013985.jpg,2,1,0,0,3,,train
0512098_as-0013985.jpg,1,1,1,0,3,,train
0512099_as-0013985.jpg,1,1,1,0,3,,train
0512100_as-0013985.jpg,1,0,1,0,2,,train
0512101_sc-138391.jpg,6,0,0,0,6,,train
0512102_sc-138391.jpg,5,0,0,0,5,,train
0512104_sc-138391.jpg,3,0,0,0,3,,train
0512105_sc-138391.jpg,4,0,0,0,4,,val
0512107_sc-1024143.jpg,1,0,4,1,6,,val
0512108_sc-1024143.jpg,1,0,2,1,4,,test
0512109_sc-1024143.jpg,5,0,1,0,6,,train
0512111_sc-1024143.jpg,1,0,0,0,1,,train
0512114_as-0081418.jpg,4,0,2,2,8,,train
0512115_as-0081418.jpg,1,0,1,2,4,,train
0512116_as-0081418.jpg,1,0,1,2,4,,train
0512117_as-0081418.jpg,1,0,1,1,3,,train
0512118_as-0081418.jpg,1,0,0,0,1,,train
0512119_as-0081418.jpg,1,0,0,0,1,,val
0512120_as-0081418.jpg,2,0,0,0,2,,val
0512121_as-0081418.jpg,1,0,0,0,1,,test
0512122_sc-179081.jpg,1,1,0,0,2,,train
0512125_as-0039871.jpg,3,0,0,1,4,,train
0512126_as-0039871.jpg,3,1,2,0,6,,train
0512127_as-0039871.jpg,3,2,4,1,10,,train
0512128_as-0039871.jpg,2,0,1,0,3,,train
0512129_as-7258963.jpg,2,0,0,0,2,,train
0512131_as-0038149.jpg,3,0,1,0,4,,train
0512132_as-0038149.jpg,1,0,1,0,2,,val
0512138_as-3032187.jpg,2,0,0,0,2,,val
0512139_as-7206322.jpg,1,1,1,0,3,,test
0512140_sc-111450.jpg,1,1,0,0,2,,train
0512141_sc-111450.jpg,2,0,0,0,2,,train
0512143_sc-111450.jpg,3,0,0,0,3,,train
0512144_sc-111450.jpg,2,0,0,0,2,,train
0512147_sc-111450.jpg,1,0,0,0,1,,train
0512148_as-7915484.jpg,1,3,2,0,6,,train
0512150_sc-1033195.jpg,5,0,0,0,5,,train
0512152_sc-1033195.jpg,4,0,1,0,5,,val
0512153_as-7842202.jpg,2,0,0,0,2,,val
0512155_sc-160814.jpg,1,0,0,1,2,,test
0512156_sc-205378.jpg,1,0,1,0,2,,train
0512157_sc-205378.jpg,1,0,1,0,2,,train
0512158_sc-205378.jpg,9,1,1,0,11,,train
0512159_sc-205378.jpg,6,0,1,0,7,,train
0512160_sc-205378.jpg,7,0,1,0,8,,train
0512161_sc-205378.jpg,5,0,1,1,7,,train
0512162_sc-205378.jpg,6,0,1,1,8,,train
0512164_as-0035047.jpg,2,2,2,0,6,,val
0512165_as-0035047.jpg,0,1,2,0,3,,val
0512166_as-0035047.jpg,0,1,2,0,3,,test
0512167_as-0035047.jpg,1,0,0,0,1,,train
0512169_as-0065126.jpg,1,0,1,0,2,,train
0512170_as-0065126.jpg,1,0,1,0,2,,train
0512171_as-0065126.jpg,1,0,1,0,2,,train
0512172_as-0065126.jpg,1,0,0,0,1,,train
0512173_as-0065126.jpg,1,0,0,0,1,,train
0512174_as-0065126.jpg,1,0,0,0,1,,train
0512175_as-0065126.jpg,1,0,0,0,1,,val
0512176_as-0065126.jpg,3,0,0,0,3,,val
0512177_as-0065126.jpg,1,0,0,0,1,,test
0512179_sc-1001398.jpg,2,0,0,0,2,,train
0512180_as-0055524.jpg,1,0,0,0,1,,train
0512181_as-0055524.jpg,1,0,0,0,1,,train
0512184_as-0058673.jpg,2,0,0,0,2,,train
0512185_as-0058673.jpg,0,0,2,0,2,,train
0512187_sc-142303.jpg,2,0,0,0,2,,train
0512188_sc-142303.jpg,0,0,1,0,1,,train
0512189_sc-142303.jpg,2,0,0,0,2,,val
0512190_as-0087693.jpg,2,0,0,0,2,,val
0512191_as-3365362.jpg,2,0,0,0,2,,test
0512192_as-2918602.jpg,2,0,0,1,3,,train
0512193_as-0094021.jpg,1,0,0,0,1,,train
0512194_as-0094021.jpg,3,0,0,0,3,,train
0512195_as-0094021.jpg,0,0,1,0,1,,train
0512196_as-2662335.jpg,1,0,0,0,1,,train
0512197_as-2912180.jpg,1,0,0,1,2,,train
0512198_sc-221358.jpg,1,0,1,0,2,,train
0512199_sc-161321.jpg,0,1,0,1,2,,val
0512201_sc-161321.jpg,4,1,0,1,6,,val
0512202_sc-161321.jpg,1,3,0,1,5,,test
0512204_sc-161321.jpg,1,1,0,0,2,,train
0512205_as-2578141.jpg,6,1,0,0,7,,train
0512206_as-0070448.jpg,1,0,0,0,1,,train
0512209_sc-188560.jpg,1,0,0,0,1,,train
0512210_as-2996709.jpg,3,0,1,0,4,,train
0512212_as-0072166.jpg,2,1,0,0,3,,train
0512213_as-0072166.jpg,1,1,0,0,2,,train
0512215_sc-151202.jpg,0,1,0,0,1,,val
0512217_as-0075942.jpg,0,0,0,1,1,,val
0512219_sc-204335.jpg,2,1,0,0,3,,test
0512220_sc-194003.jpg,3,0,0,0,3,,train
0512222_sc-194003.jpg,3,0,0,0,3,,train
0512223_sc-194003.jpg,0,1,0,0,1,,train
0512224_sc-194003.jpg,0,1,0,0,1,,train
0512225_sc-194003.jpg,3,0,1,0,4,,train
0512226_sc-1000490.jpg,0,1,0,0,1,,train
0512227_sc-1000490.jpg,5,1,0,1,7,,train
0512228_sc-1000490.jpg,1,0,1,0,2,,val
0512229_sc-1000490.jpg,2,1,0,1,4,,val
0512230_sc-190308.jpg,4,0,1,1,6,,test
0512231_sc-190308.jpg,4,0,0,1,5,,train
0512232_sc-190308.jpg,2,0,1,1,4,,train
0512233_sc-190308.jpg,3,0,0,1,4,,train
0512234_sc-190308.jpg,6,0,0,1,7,,train
0512235_as-0043014.jpg,0,0,0,1,1,,train
0512236_as-0043014.jpg,1,0,0,0,1,,train
0512238_sc-1021823.jpg,2,0,0,0,2,,train
0512239_sc-1021823.jpg,2,0,0,0,2,,val
0512240_sc-1021823.jpg,2,2,1,0,5,,val
0512243_sc-1022927.jpg,2,0,0,1,3,,test
0512244_sc-1022927.jpg,3,0,0,1,4,,train
0512246_sc-144690.jpg,8,0,1,0,9,,train
0512247_sc-144690.jpg,4,0,0,1,5,,train
0512248_sc-144690.jpg,5,1,1,0,7,,train
0512249_sc-144690.jpg,4,0,0,1,5,,train
0512251_sc-1025600.jpg,2,0,0,0,2,,train
0512252_sc-1025600.jpg,1,0,0,0,1,,train
0512253_sc-1025600.jpg,1,0,1,0,2,,val
0512254_as-0047950.jpg,1,0,0,0,1,,val
0512255_as-0047950.jpg,1,0,0,0,1,,test
0512256_as-0047950.jpg,2,0,0,0,2,,train
0512257_as-0047950.jpg,3,0,0,0,3,,train
0512258_as-0047950.jpg,5,0,0,0,5,,train
0512259_as-0047950.jpg,1,0,0,0,1,,train
0512260_as-0047950.jpg,3,0,0,0,3,,train
0512261_as-0047950.jpg,3,0,0,0,3,,train
0512262_as-0047950.jpg,2,0,0,0,2,,train
0512263_as-0047950.jpg,2,0,0,0,2,,val
0512264_as-0047950.jpg,2,0,0,0,2,,val
0512265_as-0047950.jpg,5,0,0,0,5,,test
0512266_as-0047950.jpg,2,0,0,0,2,,train
0512267_as-0047950.jpg,2,0,0,0,2,,train
0512268_as-0047950.jpg,1,0,0,0,1,,train
0512269_as-0047950.jpg,1,0,0,0,1,,train
0512270_as-0047950.jpg,2,0,0,0,2,,train
0512271_sc-204374.jpg,3,1,0,0,4,,train
0512273_sc-119315.jpg,3,0,0,0,3,,train
0512274_sc-119315.jpg,1,0,0,0,1,,val
0512275_as-2648712.jpg,1,2,0,0,3,,val
0512277_as-0077671.jpg,6,2,3,0,11,,test
0512279_as-0077671.jpg,0,1,3,0,4,,train
0512280_as-0077671.jpg,0,0,1,0,1,,train
0512281_as-0004771.jpg,1,0,0,0,1,,train
0512282_as-0004771.jpg,1,0,0,0,1,,train
0512283_as-0004771.jpg,1,0,0,0,1,,train
0512284_as-2507976.jpg,1,0,0,0,1,,train
0512288_as-3113175.jpg,3,0,0,0,3,,train
0512289_as-0008479.jpg,1,0,0,0,1,,val
0512290_as-0008479.jpg,0,0,0,1,1,,val
0512291_as-0008479.jpg,1,0,0,0,1,,test
0512292_as-0008479.jpg,0,0,0,1,1,,train
0512293_as-0008479.jpg,1,0,0,0,1,,train
0512294_sc-121443.jpg,1,0,0,0,1,,train
0512295_sc-121443.jpg,0,0,0,1,1,,train
0512296_sc-121443.jpg,0,0,0,1,1,,train
0512297_sc-121443.jpg,0,0,0,1,1,,train
0512298_sc-1025974.jpg,2,1,0,0,3,,train
0512299_sc-1025974.jpg,1,1,0,0,2,,val
0512301_sc-135774.jpg,3,0,0,0,3,,val
0512302_sc-135774.jpg,2,0,0,0,2,,test
0512303_sc-135774.jpg,2,0,0,0,2,,train
0512304_as-0096341.jpg,7,1,1,0,9,,train
0512305_as-0096341.jpg,7,1,1,0,9,,train
0512306_as-0096341.jpg,1,1,1,0,3,,train
0512307_as-0096341.jpg,2,2,1,0,5,,train
0512308_as-0096341.jpg,2,2,3,0,7,,train
0512309_as-0096341.jpg,8,0,1,0,9,,train
0512310_as-0096341.jpg,5,0,0,0,5,,val
0512311_as-0096341.jpg,3,0,0,0,3,,val
0512312_sc-113999.jpg,2,0,0,1,3,,test
0512315_sc-113999.jpg,2,0,0,1,3,,train
0512316_sc-187280.jpg,2,1,2,0,5,,train
0512317_sc-187280.jpg,3,1,2,0,6,,train
0512319_sc-200272.jpg,4,0,1,2,7,,train
0512320_sc-200272.jpg,3,0,0,2,5,,train
0512321_sc-200272.jpg,3,0,1,2,6,,train
0512322_sc-200272.jpg,5,0,1,2,8,,train
0512323_sc-200272.jpg,3,0,0,2,5,,val
0512324_sc-200272.jpg,4,0,1,2,7,,val
0512325_sc-200272.jpg,2,0,0,0,2,,test
0512326_as-0026408.jpg,1,0,0,0,1,,train
0512327_as-9040753.jpg,1,1,1,0,3,,train
0512328_sc-157740.jpg,14,0,0,1,15,,train
0512329_sc-157740.jpg,2,0,0,0,2,,train
0512330_as-0009161.jpg,1,0,1,0,2,,train
0512331_as-0009161.jpg,1,0,1,0,2,,train
0512332_sc-198775.jpg,1,1,0,0,2,,train
0512334_as-3160276.jpg,1,0,0,0,1,,val
0512335_as-2626967.jpg,1,1,3,0,5,,val
0512337_sc-220964.jpg,1,0,0,0,1,,test
0512339_as-5490485.jpg,2,0,0,0,2,,train
0512340_sc-179579.jpg,8,0,0,1,9,,train
0512341_sc-179579.jpg,5,0,0,1,6,,train
0512342_sc-179579.jpg,2,0,0,0,2,,train
0512343_sc-179579.jpg,5,0,0,1,6,,train
0512344_sc-179579.jpg,4,0,0,0,4,,train
0512345_sc-179579.jpg,2,0,0,0,2,,train
0512347_sc-179579.jpg,2,0,0,1,3,,val
0512348_as-3032140.jpg,3,0,0,0,3,,val
0512349_as-2628589.jpg,2,0,1,0,3,,test
0512350_as-9073490.jpg,3,0,1,0,4,,train
0512353_as-0074707.jpg,2,0,1,0,3,,train
0512354_as-0074707.jpg,0,0,1,0,1,,train
0512355_as-0074707.jpg,1,0,1,0,2,,train
0512356_as-0074707.jpg,1,0,1,0,2,,train
0512357_as-0074707.jpg,1,0,1,0,2,,train
0512358_as-0074707.jpg,2,0,1,0,3,,train
0512359_as-0074707.jpg,0,0,1,0,1,,val
0512360_as-0074707.jpg,0,0,1,0,1,,val
0512361_as-0074707.jpg,0,0,2,0,2,,test
0512363_as-0063960.jpg,1,0,0,0,1,,train
0512364_as-7788134.jpg,1,0,1,1,3,,train
0512365_sc-126967.jpg,1,0,0,1,2,,train
0512366_sc-126967.jpg,1,0,0,1,2,,train
0512367_sc-126967.jpg,1,0,0,1,2,,train
0512369_as-0029896.jpg,1,0,0,0,1,,train
0512370_as-0029896.jpg,1,0,0,0,1,,train
0512371_as-0029896.jpg,0,1,0,0,1,,val
0512372_as-0029896.jpg,1,0,0,0,1,,val
0512373_as-0029896.jpg,3,1,1,1,6,,test
0512374_as-0029896.jpg,1,0,1,0,2,,train
0512375_as-0029896.jpg,1,1,0,0,2,,train
0512378_as-3336391.jpg,9,0,0,0,9,,train
0512380_sc-213746.jpg,1,0,0,0,1,,train
0512381_sc-213746.jpg,3,0,0,0,3,,train
0512382_as-7381435.jpg,1,0,1,0,2,,train
0512384_as-0062392.jpg,0,0,1,0,1,,train
0512385_as-0062392.jpg,2,0,0,0,2,,val
0512386_sc-128370.jpg,1,0,1,1,3,,val
0512387_sc-128370.jpg,2,0,0,0,2,,test
0512388_sc-128370.jpg,1,0,0,0,1,,train
0512390_sc-128370.jpg,1,0,1,1,3,,train
0512391_sc-106101.jpg,5,0,1,0,6,,train
0512392_sc-106101.jpg,3,0,0,0,3,,train
0512393_sc-106101.jpg,2,0,0,1,3,,train
0512394_sc-106101.jpg,5,0,0,0,5,,train
0512396_sc-106101.jpg,4,0,0,0,4,,train
0512397_sc-106101.jpg,2,0,0,0,2,,val
0512398_as-3486386.jpg,1,0,0,0,1,,val
0512399_sc-1030183.jpg,5,0,1,1,7,,test
0512400_sc-1030183.jpg,2,0,0,0,2,,train
0512401_sc-1030183.jpg,4,0,1,1,6,,train
0512402_sc-1030183.jpg,5,0,1,0,6,,train
0512403_sc-1030183.jpg,6,0,0,0,6,,train
0512405_sc-212347.jpg,1,0,0,0,1,,train
0512406_sc-212347.jpg,1,0,0,0,1,,train
0512407_sc-212347.jpg,3,0,0,0,3,,train
0512408_sc-212347.jpg,2,0,1,0,3,,val
0512409_sc-212347.jpg,1,0,0,0,1,,val
0512410_sc-212347.jpg,1,0,0,0,1,,test
0512411_sc-212347.jpg,1,0,0,0,1,,train
0512412_sc-1015567.jpg,2,0,2,0,4,,train
0512413_sc-1015567.jpg,2,0,0,0,2,,train
0512414_sc-1015567.jpg,1,0,1,0,2,,train
0512415_sc-1015567.jpg,2,0,0,0,2,,train
0512417_sc-1015567.jpg,2,0,0,0,2,,train
0512418_sc-1015567.jpg,1,1,0,0,2,,train
0512419_as-0000913.jpg,1,0,1,2,4,,val
0512420_as-0000913.jpg,1,0,1,0,2,,val
0512422_sc-108435.jpg,1,0,0,0,1,,test
0512423_sc-108435.jpg,1,0,0,0,1,,train
0512424_sc-108435.jpg,0,0,2,0,2,,train
0512425_as-7542378.jpg,1,0,0,0,1,,train
0512428_as-0079523.jpg,1,0,1,1,3,,train
0512429_as-0079523.jpg,1,0,1,1,3,,train
0512430_as-0088674.jpg,4,0,0,0,4,,train
0512431_as-0088674.jpg,0,0,1,0,1,,train
0512432_as-0088674.jpg,0,0,1,0,1,,val
0512434_as-0053250.jpg,0,0,1,1,2,,val
0512435_as-0053250.jpg,0,0,1,1,2,,test
0512436_as-0053250.jpg,0,0,1,1,2,,train
0512437_as-0053250.jpg,0,0,1,1,2,,train
0512438_as-0053250.jpg,0,0,1,0,1,,train
0512440_as-2848840.jpg,0,1,1,1,3,,train
0512441_sc-180932.jpg,1,2,0,0,3,,train
0512442_as-5581353.jpg,2,0,0,0,2,,train
0512443_as-0046588.jpg,1,0,0,0,1,,train
0512444_as-0046588.jpg,1,0,2,0,3,,val
0512445_as-0046588.jpg,2,0,2,0,4,,val
0512446_as-0046588.jpg,2,0,1,0,3,,test
0512447_as-0046588.jpg,2,0,1,0,3,,train
0512448_as-0046588.jpg,2,0,1,0,3,,train
0512450_as-0084730.jpg,0,2,5,0,7,,train
0512452_as-0084730.jpg,1,0,0,0,1,,train
0512453_as-0084730.jpg,0,1,0,0,1,,train
0512454_as-0084730.jpg,1,3,0,2,6,,train
0512455_sc-228788.jpg,0,1,0,0,1,,train
0512456_sc-228788.jpg,1,0,1,0,2,,val
0512457_sc-228788.jpg,1,0,1,0,2,,val
0512458_sc-228788.jpg,2,0,0,0,2,,test
0512459_sc-228788.jpg,2,1,1,0,4,,train
0512460_sc-228788.jpg,2,0,0,0,2,,train
0512461_sc-228788.jpg,1,0,1,0,2,,train
0512462_sc-228788.jpg,3,0,2,0,5,,train
0512463_as-0030856.jpg,7,4,1,1,13,,train
0512464_as-0030856.jpg,2,2,1,0,5,,train
0512465_as-0030856.jpg,4,1,1,0,6,,train
0512466_sc-214977.jpg,1,0,1,0,2,,val
0512467_sc-214977.jpg,1,0,0,1,2,,val
0512468_sc-214977.jpg,2,0,0,0,2,,test
0512469_as-3280932.jpg,1,1,1,0,3,,train
0512470_as-2529238.jpg,0,0,2,0,2,,train
0512471_as-7345548.jpg,5,0,1,0,6,,train
0512475_as-3327302.jpg,1,2,2,5,10,,train
0512476_sc-228409.jpg,2,0,1,0,3,,train
0512477_sc-228409.jpg,2,0,0,0,2,,train
0512478_as-3298850.jpg,1,0,1,1,3,,train
0512479_as-0094964.jpg,2,0,0,0,2,,val
0512480_as-0094964.jpg,2,0,0,0,2,,val
0512482_as-7578798.jpg,2,0,1,2,5,,test
0512483_as-0094380.jpg,1,0,1,0,2,,train
0512484_as-0094380.jpg,1,0,2,0,3,,train
0512486_sc-182046.jpg,4,0,0,0,4,,train
0512487_sc-182046.jpg,2,0,2,0,4,,train
0512488_sc-182046.jpg,1,0,0,0,1,,train
0512489_as-3291066.jpg,4,0,0,0,4,,train
0512490_sc-113683.jpg,3,0,0,0,3,,train
0512491_sc-113683.jpg,2,0,0,0,2,,val
0512492_sc-113683.jpg,2,0,0,0,2,,val
0512493_sc-136039.jpg,2,0,0,0,2,,test
0512494_as-0032568.jpg,1,0,0,0,1,,train
0512495_as-0000168.jpg,3,1,0,0,4,,train
0512496_as-0000168.jpg,1,1,0,0,2,,train
0512497_as-0000168.jpg,1,0,0,0,1,,train
0512498_as-0000168.jpg,1,0,1,0,2,,train
0512499_as-0000168.jpg,2,0,0,0,2,,train
0512500_as-0000168.jpg,2,0,0,0,2,,train
0512501_as-0000168.jpg,5,0,0,0,5,,val
0512502_as-0000168.jpg,1,0,0,0,1,,val
0512503_as-0000168.jpg,2,0,0,0,2,,test
0512504_as-0000168.jpg,1,0,0,0,1,,train
0512505_as-0000168.jpg,1,0,0,1,2,,train
0512506_as-0000168.jpg,3,1,0,1,5,,train
0512507_as-0000168.jpg,1,0,0,0,1,,train
0512508_as-0000168.jpg,2,0,0,0,2,,train
0512509_as-0000168.jpg,3,1,0,1,5,,train
0512510_as-0000168.jpg,2,0,0,1,3,,train
0512511_as-0000168.jpg,0,1,0,0,1,,val
0512512_as-0000168.jpg,0,1,0,0,1,,val
0512513_as-0000168.jpg,2,1,0,0,3,,test
0512514_as-0000168.jpg,3,1,0,1,5,,train
0512515_as-0054891.jpg,2,1,0,1,4,,train
0512516_as-0054891.jpg,3,1,0,1,5,,train
0512517_as-0054891.jpg,0,0,1,0,1,,train
0512518_as-0054891.jpg,0,0,1,0,1,,train
0512519_as-0054891.jpg,0,0,1,0,1,,train
0512520_as-0054891.jpg,0,0,1,0,1,,train
0512521_as-0054891.jpg,0,0,1,0,1,,val
0512522_as-2556936.jpg,1,0,0,0,1,,val
0512523_sc-1014129.jpg,2,0,0,1,3,,test
0512524_sc-1014129.jpg,1,0,0,0,1,,train
0512526_sc-1014129.jpg,4,0,0,0,4,,train
0512528_sc-109312.jpg,0,1,0,0,1,,train
0512529_sc-109312.jpg,0,1,0,0,1,,train
0512530_sc-109312.jpg,0,1,0,0,1,,train
0512532_sc-109312.jpg,1,0,0,0,1,,train
0512533_sc-109312.jpg,1,0,0,0,1,,train
0512534_as-9040744.jpg,2,0,0,0,2,,val
0512535_sc-225714.jpg,0,2,2,0,4,,val
0512536_sc-225714.jpg,0,2,1,0,3,,test
0512537_sc-225714.jpg,4,2,1,0,7,,train
0512538_sc-225714.jpg,2,0,0,0,2,,train
0512539_sc-225714.jpg,4,2,1,0,7,,train
0512540_sc-225714.jpg,1,0,1,1,3,,train
0512541_as-3359107.jpg,2,0,1,0,3,,train
0512543_as-0085517.jpg,2,0,0,0,2,,train
0512544_as-0085517.jpg,2,0,0,0,2,,train
0512545_as-0085517.jpg,3,0,0,2,5,,val
0512546_sc-175227.jpg,1,0,0,0,1,,val
0512547_sc-175227.jpg,3,0,1,0,4,,test
0512548_sc-175227.jpg,1,0,1,0,2,,train
0512549_sc-175227.jpg,2,0,2,0,4,,train
0512550_sc-175227.jpg,2,0,0,0,2,,train
0512551_sc-175227.jpg,3,0,0,0,3,,train
0512552_sc-175227.jpg,2,0,0,0,2,,train
0512554_sc-175227.jpg,0,1,0,0,1,,train
0512555_sc-175227.jpg,0,1,0,0,1,,train
0512559_sc-185457.jpg,3,0,0,1,4,,val
0512560_sc-185457.jpg,3,0,0,1,4,,val
0512563_as-3329119.jpg,1,0,0,0,1,,test
0512566_as-2705126.jpg,1,0,1,0,2,,train
0512567_sc-139617.jpg,3,0,0,0,3,,train
0512568_as-0003943.jpg,2,0,1,1,4,,train
0512569_as-0003943.jpg,2,0,1,1,4,,train
0512570_as-0003943.jpg,1,0,1,1,3,,train
0512571_as-0003943.jpg,0,0,1,0,1,,train
0512572_as-9040256.jpg,1,0,3,0,4,,train
0512575_as-0058867.jpg,1,1,0,0,2,,val
0512576_as-0058867.jpg,0,1,0,0,1,,val
0512577_as-0058867.jpg,0,1,0,0,1,,test
0512578_as-3393006.jpg,1,0,0,0,1,,train
0512581_as-3358218.jpg,1,0,0,0,1,,train
0512582_sc-158929.jpg,6,0,0,0,6,,train
0512583_sc-158929.jpg,6,0,0,0,6,,train
0512584_sc-158929.jpg,1,0,0,0,1,,train
0512585_sc-158929.jpg,2,0,0,0,2,,train
0512586_sc-106968.jpg,3,2,0,0,5,,train
0512587_sc-106968.jpg,2,2,0,0,4,,val
0512588_as-2928317.jpg,0,1,1,0,2,,val
0512589_as-3379528.jpg,0,1,0,0,1,,test
0512590_as-7167544.jpg,1,0,0,0,1,,train
0512591_as-0081038.jpg,3,0,0,0,3,,train
0512592_as-0084820.jpg,1,0,0,0,1,,train
0512593_as-0084820.jpg,1,2,0,1,4,,train
0512594_as-0084820.jpg,1,1,0,0,2,,train
0512595_as-0084820.jpg,1,0,0,0,1,,train
0512597_as-2897413.jpg,1,0,0,0,1,,train
0512598_sc-209983.jpg,4,0,0,0,4,,val
0512600_sc-209983.jpg,3,0,0,1,4,,val
0512601_sc-209983.jpg,2,0,0,1,3,,test
0512602_sc-209983.jpg,1,0,1,0,2,,train
0512603_sc-209983.jpg,1,0,1,0,2,,train
0512604_sc-209983.jpg,1,0,1,0,2,,train
0512605_sc-209983.jpg,2,0,0,0,2,,train
0512606_sc-209983.jpg,1,0,0,0,1,,train
0512607_sc-214104.jpg,2,0,0,0,2,,train
0512608_sc-214104.jpg,2,0,1,0,3,,train
0512609_sc-214104.jpg,1,0,0,0,1,,val
0512612_sc-1021170.jpg,2,0,0,1,3,,val
0512613_sc-1021170.jpg,1,0,1,0,2,,test
0512614_sc-1021170.jpg,1,0,0,0,1,,train
0512615_sc-1021170.jpg,2,0,0,0,2,,train
0512616_sc-1021170.jpg,1,0,0,0,1,,train
0512617_sc-123785.jpg,0,1,0,0,1,,train
0512618_sc-123785.jpg,0,0,1,0,1,,train
0512619_as-3102248.jpg,1,0,0,0,1,,train
0512620_sc-113281.jpg,1,0,0,0,1,,train
0512621_as-3263526.jpg,0,0,1,0,1,,val
0512623_sc-201224.jpg,3,0,0,0,3,,val
0512624_sc-201224.jpg,3,0,0,0,3,,test
0512625_sc-201224.jpg,3,0,0,0,3,,train
0512626_sc-201224.jpg,3,0,0,0,3,,train
0512627_sc-201224.jpg,5,0,0,0,5,,train
0512628_sc-1019764.jpg,0,1,0,0,1,,train
0512629_sc-208977.jpg,3,0,0,0,3,,train
0512630_sc-208977.jpg,3,0,0,0,3,,train
0512631_as-2677349.jpg,2,0,1,1,4,,train
0512633_as-0051796.jpg,1,0,1,2,4,,val
0512634_as-0051796.jpg,1,0,2,0,3,,val
0512635_as-0051796.jpg,2,0,0,1,3,,test
0512636_as-2909266.jpg,4,0,0,0,4,,train
0512637_sc-192448.jpg,0,1,0,0,1,,train
0512638_sc-192448.jpg,0,1,0,0,1,,train
0512639_sc-192448.jpg,0,1,0,0,1,,train
0512640_sc-192448.jpg,3,1,1,0,5,,train
0512641_sc-192448.jpg,3,1,2,0,6,,train
0512642_sc-192448.jpg,1,0,0,0,1,,train
0512643_sc-192448.jpg,1,1,0,0,2,,val
0512644_sc-192448.jpg,3,1,0,0,4,,val
0512645_sc-192448.jpg,5,1,0,0,6,,test
0512646_sc-192448.jpg,3,1,0,0,4,,train
0512647_sc-192448.jpg,2,0,0,0,2,,train
0512648_sc-192448.jpg,1,0,0,0,1,,train
0512649_as-3095629.jpg,1,0,0,0,1,,train
0512654_sc-1004080.jpg,5,1,0,0,6,,train
0512655_sc-1004080.jpg,3,1,0,0,4,,train
0512656_sc-1004080.jpg,2,0,0,0,2,,train
0512657_sc-138803.jpg,4,1,1,0,6,,val
0512658_sc-138803.jpg,0,1,1,0,2,,val
0512660_sc-138803.jpg,5,2,3,0,10,,test
0512661_sc-138803.jpg,2,0,1,0,3,,train
0512662_sc-138803.jpg,2,1,1,0,4,,train
0512663_sc-138803.jpg,3,2,0,0,5,,train
0512664_sc-138803.jpg,1,0,0,0,1,,train
0512667_as-0045178.jpg,5,0,1,1,7,,train
0512668_as-0045178.jpg,2,0,1,1,4,,train
0512669_as-0045178.jpg,2,0,1,1,4,,train
0512670_as-0045178.jpg,3,0,1,1,5,,val
0512671_as-0045178.jpg,1,0,0,0,1,,val
0512672_as-0045178.jpg,2,0,0,0,2,,test
0512673_as-0045178.jpg,1,0,0,0,1,,train
0512674_as-3274197.jpg,0,0,1,0,1,,train
0512675_as-2964021.jpg,3,0,0,1,4,,train
0512676_as-7200562.jpg,1,0,0,0,1,,train
0512678_sc-1015656.jpg,7,0,0,0,7,,train
0512679_sc-1015656.jpg,5,0,1,1,7,,train
0512682_as-0002386.jpg,2,0,0,0,2,,train
0512684_as-7412483.jpg,2,0,1,0,3,,val
0512685_sc-229893.jpg,5,0,0,1,6,,val
0512686_sc-229893.jpg,3,0,0,0,3,,test
0512687_sc-229893.jpg,2,0,0,0,2,,train
0512688_as-0094293.jpg,4,0,0,0,4,,train
0512691_as-0004668.jpg,4,0,0,0,4,,train
0512692_as-3380761.jpg,0,0,1,0,1,,train
0512694_as-0054796.jpg,2,2,1,0,5,,train
0512696_as-0054796.jpg,3,0,0,0,3,,train
0512697_sc-1014824.jpg,1,0,0,0,1,,train
0512698_sc-1014824.jpg,1,0,0,0,1,,val
0512699_sc-1014824.jpg,2,0,0,0,2,,val
0512700_as-0082269.jpg,2,0,0,1,3,,test
0512701_as-0082269.jpg,2,0,0,1,3,,train
0512702_as-0082269.jpg,1,0,0,1,2,,train
0512704_sc-216799.jpg,3,0,0,0,3,,train
0512706_sc-152724.jpg,8,0,0,0,8,,train
0512707_sc-152724.jpg,6,0,0,0,6,,train
0512708_sc-152724.jpg,4,0,1,1,6,,train
0512709_sc-152724.jpg,1,0,1,1,3,,train
0512710_sc-1004626.jpg,3,0,0,0,3,,val
0512712_sc-202229.jpg,1,0,0,0,1,,val
0512715_as-0000643.jpg,1,0,0,1,2,,test
0512716_as-0000643.jpg,1,0,0,1,2,,train
0512717_as-2930732.jpg,1,0,1,0,2,,train
0512718_as-3180194.jpg,1,0,1,0,2,,train
0512720_as-0019595.jpg,1,0,0,0,1,,train
0512721_as-0019595.jpg,1,0,0,0,1,,train
0512722_as-0019595.jpg,1,0,0,0,1,,train
0512723_as-0019595.jpg,2,0,1,2,5,,train
0512724_as-0019595.jpg,3,0,0,0,3,,val
0512725_as-0019595.jpg,3,0,0,0,3,,val
0512727_sc-142263.jpg,1,0,0,0,1,,test
0512728_sc-142263.jpg,2,0,0,0,2,,train
0512729_sc-142263.jpg,1,0,0,0,1,,train
0512730_sc-142263.jpg,2,0,0,1,3,,train
0512731_sc-201865.jpg,1,0,0,0,1,,train
0512732_sc-201865.jpg,1,0,0,0,1,,train
0512733_sc-201865.jpg,1,0,0,0,1,,train
0512734_sc-215250.jpg,1,0,0,0,1,,train
0512737_sc-1009215.jpg,2,0,1,0,3,,val
0512738_sc-1009215.jpg,1,0,0,0,1,,val
0512739_sc-1009215.jpg,2,0,0,0,2,,test
0512741_as-0002298.jpg,0,1,1,0,2,,train
0512743_as-0002298.jpg,0,1,1,0,2,,train
0512744_as-0002298.jpg,0,1,1,0,2,,train
0512745_as-7679259.jpg,2,0,0,0,2,,train
0512746_as-2983938.jpg,2,0,0,0,2,,train
0512747_as-9009851.jpg,2,0,0,0,2,,train
0512748_as-2581216.jpg,5,0,0,0,5,,train
0512749_as-7637540.jpg,2,0,1,0,3,,val
0512750_as-2536557.jpg,1,0,1,1,3,,val
0512751_sc-225293.jpg,1,0,0,1,2,,test
0512752_sc-225293.jpg,1,0,0,1,2,,train
0512753_sc-225293.jpg,2,0,0,1,3,,train
0512754_sc-225293.jpg,2,0,0,1,3,,train
0512755_as-0084995.jpg,1,1,1,0,3,,train
0512756_as-0084995.jpg,3,0,1,1,5,,train
0512757_as-0084995.jpg,1,0,1,1,3,,train
0512758_as-0084995.jpg,2,1,0,0,3,,train
0512759_as-2620862.jpg,2,0,0,0,2,,val
0512762_as-0066295.jpg,3,0,0,1,4,,val
0512763_as-0066295.jpg,1,0,0,1,2,,test
0512764_as-0066295.jpg,1,0,0,0,1,,train
0512765_as-0066295.jpg,1,0,0,0,1,,train
0512766_sc-1010501.jpg,1,0,0,1,2,,train
0512767_sc-1010501.jpg,1,0,0,0,1,,train
0512768_sc-1010501.jpg,0,0,0,1,1,,train
0512769_sc-1010501.jpg,1,0,0,0,1,,train
0512770_sc-1010501.jpg,1,0,0,0,1,,train
0512771_as-0055359.jpg,1,0,0,0,1,,val
0512772_as-0055359.jpg,4,0,0,0,4,,val
0512773_as-0055359.jpg,3,0,0,0,3,,test
0512774_as-0055359.jpg,1,0,0,0,1,,train
0512775_as-7522208.jpg,0,0,1,0,1,,train
0512776_sc-134767.jpg,1,1,0,0,2,,train
0512777_sc-134767.jpg,2,1,0,0,3,,train
0512778_sc-134767.jpg,1,1,0,0,2,,train
0512779_sc-134767.jpg,1,1,0,0,2,,train
0512781_sc-1001419.jpg,1,0,0,0,1,,train
0512783_as-0053087.jpg,1,0,1,0,2,,val
0512784_as-0053087.jpg,1,0,1,0,2,,val
0512785_as-0053087.jpg,1,0,1,0,2,,test
0512786_as-0053087.jpg,1,0,2,0,3,,train
0512787_as-3159350.jpg,3,1,0,0,4,,train
0512788_sc-131625.jpg,0,0,0,1,1,,train
0512789_sc-131625.jpg,1,0,0,0,1,,train
0512790_sc-131625.jpg,1,0,0,0,1,,train
0512791_sc-131625.jpg,1,0,0,0,1,,train
0512792_sc-131625.jpg,1,0,0,0,1,,train
0512793_sc-194582.jpg,2,0,0,0,2,,val
0512794_as-0053799.jpg,1,0,0,1,2,,val
0512795_as-0053799.jpg,1,0,0,1,2,,test
0512796_as-0053799.jpg,1,0,0,0,1,,train
0512797_as-0053799.jpg,2,0,0,1,3,,train
0512798_as-0053799.jpg,1,0,0,1,2,,train
0512800_as-0090458.jpg,1,0,0,0,1,,train
0512801_as-0090458.jpg,1,0,0,0,1,,train
0512803_sc-162096.jpg,2,1,0,0,3,,train
0512804_sc-121193.jpg,5,1,2,2,10,,train
0512806_sc-121193.jpg,7,2,2,2,13,,val
0512808_sc-121193.jpg,3,2,0,0,5,,val
0512809_sc-121193.jpg,2,1,4,2,9,,test
0512812_sc-121193.jpg,1,0,0,0,1,,train
0512813_as-3492928.jpg,1,0,0,0,1,,train
0512816_as-0012284.jpg,5,2,0,0,7,,train
0512817_as-0012284.jpg,2,1,0,0,3,,train
0512818_as-0012284.jpg,2,0,0,0,2,,train
0512819_as-0012284.jpg,2,2,0,0,4,,train
0512820_as-0012284.jpg,5,0,1,0,6,,train
0512821_as-0012284.jpg,1,0,0,0,1,,val
0512822_as-7873917.jpg,2,0,0,0,2,,val
0512823_sc-183478.jpg,1,0,0,0,1,,test
0512824_sc-183478.jpg,1,0,0,0,1,,train
0512825_sc-111839.jpg,2,0,0,0,2,,train
0512828_sc-1005788.jpg,4,1,1,1,7,,train
0512830_sc-1005788.jpg,2,1,2,0,5,,train
0512831_sc-1005788.jpg,3,0,0,0,3,,train
0512832_sc-1005788.jpg,2,0,0,0,2,,train
0512833_sc-1005788.jpg,3,0,0,0,3,,train
0512834_sc-180536.jpg,3,1,0,0,4,,val
0512836_sc-1036825.jpg,1,1,0,1,3,,val
0512837_sc-1036825.jpg,3,1,1,1,6,,test
0512838_sc-1036825.jpg,5,1,1,1,8,,train
0512839_sc-130060.jpg,1,0,1,1,3,,train
0512840_sc-130060.jpg,1,0,1,1,3,,train
0512841_sc-130060.jpg,2,0,1,1,4,,train
0512842_as-2704655.jpg,1,0,0,0,1,,train
0512843_sc-110824.jpg,2,1,1,1,5,,train
0512844_sc-110824.jpg,2,2,0,1,5,,train
0512845_sc-110824.jpg,4,2,1,1,8,,val
0512846_sc-110824.jpg,2,2,0,1,5,,val
0512847_sc-110824.jpg,0,1,1,0,2,,test
0512848_as-3083464.jpg,3,0,2,0,5,,train
0512849_as-2959427.jpg,2,2,1,0,5,,train
0512850_sc-191837.jpg,2,0,0,0,2,,train
0512851_sc-191837.jpg,1,1,0,0,2,,train
0512852_sc-191837.jpg,1,0,0,0,1,,train
0512853_sc-191837.jpg,3,0,0,0,3,,train
0512854_as-3233818.jpg,1,0,1,0,2,,train
0512855_sc-141043.jpg,1,0,0,0,1,,val
0512856_as-3057207.jpg,1,0,0,0,1,,val
0512857_sc-158150.jpg,2,0,1,0,3,,test
0512858_sc-158150.jpg,2,0,0,0,2,,train
0512859_sc-158150.jpg,1,0,0,0,1,,train
0512860_sc-170437.jpg,1,0,0,0,1,,train
0512861_sc-170437.jpg,1,0,0,0,1,,train
0512863_as-2736376.jpg,1,0,0,0,1,,train
0512864_as-0099225.jpg,2,0,1,0,3,,train
0512865_sc-219100.jpg,2,1,0,0,3,,train
0512866_sc-219100.jpg,1,1,1,0,3,,val
0512867_as-2676502.jpg,1,0,0,1,2,,val
0512868_sc-162143.jpg,1,0,0,0,1,,test
0512869_sc-162143.jpg,2,0,0,0,2,,train
0512870_as-2902481.jpg,1,0,1,1,3,,train
0512871_as-2902481.jpg,3,0,0,0,3,,train
0512873_as-0076757.jpg,1,0,1,0,2,,train
0512875_as-0076757.jpg,1,1,2,0,4,,train
0512876_as-0076757.jpg,0,1,1,0,2,,train
0512877_as-0076757.jpg,1,1,2,0,4,,train
0512878_sc-1013001.jpg,5,0,2,0,7,,val
0512879_sc-1013001.jpg,2,0,0,0,2,,val
0512880_sc-1013001.jpg,1,0,0,0,1,,test
0512881_as-7826338.jpg,5,1,2,1,9,,train
0512883_as-0070082.jpg,11,2,0,0,13,,train
0512885_as-0070082.jpg,11,1,0,0,12,,train
0512887_as-0081259.jpg,2,0,0,0,2,,train
0512888_as-0081259.jpg,1,0,0,0,1,,train
0512889_as-0081259.jpg,1,0,0,0,1,,train
0512890_sc-228865.jpg,3,0,0,2,5,,train
0512891_sc-228865.jpg,1,1,0,0,2,,val
0512892_sc-228865.jpg,2,0,1,0,3,,val
0512893_as-3498534.jpg,1,0,2,1,4,,test
0512895_as-0052912.jpg,3,0,2,0,5,,train
0512896_as-9050747.jpg,0,0,2,0,2,,train
0512898_sc-113978.jpg,2,2,1,0,5,,train
0512899_as-0034509.jpg,4,0,0,0,4,,train
0512900_as-0034509.jpg,7,0,0,1,8,,train
0512902_sc-1008223.jpg,1,0,0,1,2,,train
0512903_sc-1008223.jpg,2,0,0,0,2,,train
0512904_sc-213378.jpg,1,0,0,1,2,,val
0512905_sc-213378.jpg,1,0,0,0,1,,val
0512906_sc-213378.jpg,1,0,0,0,1,,test
0512907_sc-213378.jpg,1,0,0,0,1,,train
0512908_as-2525117.jpg,1,0,1,0,2,,train
0512909_as-0098606.jpg,1,0,0,0,1,,train
0512910_as-3038135.jpg,2,0,0,0,2,,train
0512911_as-3038135.jpg,1,0,0,0,1,,train
0512912_as-7108664.jpg,5,0,0,0,5,,train
0512913_sc-222116.jpg,0,1,0,0,1,,train
0512914_as-3291608.jpg,3,0,0,0,3,,val
0512921_as-0055608.jpg,1,1,2,0,4,,val
0512924_as-0072539.jpg,2,1,0,0,3,,test
0512925_as-0072539.jpg,2,1,0,0,3,,train
0512926_as-0072539.jpg,1,0,0,0,1,,train
0512927_as-0072539.jpg,1,1,0,0,2,,train
0512928_as-0072539.jpg,1,1,0,0,2,,train
0512929_as-0072539.jpg,1,1,0,0,2,,train
0512930_as-0072539.jpg,1,0,0,0,1,,train
0512932_as-0087964.jpg,2,1,0,0,3,,train
0512933_as-0087964.jpg,1,0,0,1,2,,val
0512934_as-3313999.jpg,3,3,1,1,8,,val
0512935_sc-224618.jpg,0,0,1,0,1,,test
0512938_sc-1007262.jpg,4,0,0,0,4,,train
0512940_as-0001861.jpg,1,0,0,0,1,,train
0512941_as-2994124.jpg,1,0,0,0,1,,train
0512942_sc-1015997.jpg,1,0,0,0,1,,train
0512943_sc-1015997.jpg,1,0,0,0,1,,train
0512945_sc-1015997.jpg,2,1,0,0,3,,train
0512946_sc-1015997.jpg,2,0,1,0,3,,train
0512947_sc-1015997.jpg,2,0,1,0,3,,val
0512948_sc-1040180.jpg,3,1,0,0,4,,val
0512950_sc-140342.jpg,6,0,0,0,6,,test
0512951_sc-161661.jpg,3,1,0,0,4,,train
0512953_sc-213281.jpg,2,1,1,0,4,,train
0512954_sc-213281.jpg,0,1,1,0,2,,train
0512955_sc-213281.jpg,2,1,1,0,4,,train
0512956_sc-213281.jpg,3,0,0,0,3,,train
0512957_sc-213281.jpg,1,0,0,0,1,,train
0512958_sc-213281.jpg,3,1,1,0,5,,train
0512959_sc-213281.jpg,2,1,1,0,4,,val
0512960_as-0049518.jpg,2,0,0,0,2,,val
0512961_as-0049518.jpg,1,0,0,1,2,,test
0512962_as-7580816.jpg,1,0,0,0,1,,train
0512965_as-0043386.jpg,0,1,1,0,2,,train
0512966_as-0043386.jpg,0,0,1,0,1,,train
0512967_as-7429563.jpg,1,0,0,0,1,,train
0512968_sc-127281.jpg,2,0,0,0,2,,train
0512969_sc-127281.jpg,3,0,0,0,3,,train
0512970_sc-127281.jpg,1,0,0,0,1,,train
0512971_sc-156294.jpg,2,0,1,3,6,,val
0512973_sc-191583.jpg,2,3,0,0,5,,val
0512975_sc-191583.jpg,1,1,0,0,2,,test
0512977_sc-191583.jpg,2,0,0,0,2,,train
0512978_sc-220500.jpg,0,0,1,1,2,,train
0512979_sc-220500.jpg,0,0,1,1,2,,train
0512980_sc-220500.jpg,3,0,0,0,3,,train
0512983_as-0050019.jpg,0,2,1,0,3,,train
0512984_as-0050019.jpg,0,1,2,0,3,,train
0512985_sc-115861.jpg,1,0,0,0,1,,train
0512986_as-0062308.jpg,1,0,0,0,1,,val
0512988_sc-1019561.jpg,1,0,2,2,5,,val
0512989_sc-1019561.jpg,1,0,1,2,4,,test
0512990_sc-1019561.jpg,1,0,1,2,4,,train
0512994_as-0057166.jpg,2,0,0,1,3,,train
0512995_as-0057166.jpg,2,0,0,1,3,,train
0512996_as-0057166.jpg,2,0,0,0,2,,train
0512997_as-2638162.jpg,1,0,0,0,1,,train
0512998_sc-1035324.jpg,1,0,0,1,2,,train
0512999_sc-1035324.jpg,4,0,1,2,7,,train
0513000_sc-1035324.jpg,6,0,0,1,7,,val
0513001_sc-1035324.jpg,2,0,0,0,2,,val
0513002_sc-173330.jpg,1,0,0,0,1,,test
0513004_sc-139483.jpg,2,0,1,0,3,,train
0513005_sc-139483.jpg,0,0,1,0,1,,train
0513006_sc-139483.jpg,5,1,1,0,7,,train
0513007_sc-139483.jpg,4,1,1,2,8,,train
0513009_sc-175709.jpg,1,1,0,0,2,,train
0513010_as-0060791.jpg,1,1,0,0,2,,train
0513011_as-0060791.jpg,1,0,0,0,1,,train
0513012_as-0060791.jpg,1,0,0,0,1,,val
0513013_as-0022770.jpg,2,0,0,1,3,,val
0513014_as-0022770.jpg,2,1,2,1,6,,test
0513015_as-0022770.jpg,1,2,0,1,4,,train
0513016_as-0022770.jpg,1,1,1,0,3,,train
0513017_sc-194712.jpg,0,1,0,0,1,,train
0513018_as-0090328.jpg,1,0,1,0,2,,train
0513019_as-0090328.jpg,1,0,1,0,2,,train
0513020_as-0090328.jpg,0,0,1,0,1,,train
0513022_as-0064013.jpg,6,0,1,0,7,,train
0513023_as-0064013.jpg,5,0,1,0,6,,val
0513024_as-0064013.jpg,5,0,1,0,6,,val
0513025_as-0064013.jpg,9,0,1,0,10,,test
0513026_as-0064441.jpg,0,0,1,0,1,,train
0513027_as-0064441.jpg,3,3,2,0,8,,train
0513028_as-0064441.jpg,1,0,0,0,1,,train
0513030_sc-1037043.jpg,1,0,0,0,1,,train
0513031_sc-1037043.jpg,2,1,1,0,4,,train
0513032_sc-1037043.jpg,0,0,2,0,2,,train
0513033_sc-1037043.jpg,1,0,0,0,1,,train
0513036_as-0016352.jpg,4,0,1,1,6,,val
0513037_as-0016352.jpg,3,0,1,1,5,,val
0513038_as-0016352.jpg,2,0,1,0,3,,test
0513039_as-0016352.jpg,1,0,1,1,3,,train
0513040_as-3077380.jpg,4,2,0,0,6,,train
0513041_as-0079889.jpg,1,0,0,0,1,,train
0513043_as-0024731.jpg,1,0,0,1,2,,train
0513044_as-0024731.jpg,1,0,1,0,2,,train
0513046_as-2838921.jpg,3,0,1,2,6,,train
0513047_as-2812706.jpg,1,0,0,0,1,,train
0513048_sc-164000.jpg,1,2,1,0,4,,val
0513049_sc-164000.jpg,1,1,1,1,4,,val
0513050_sc-164000.jpg,1,0,1,2,4,,test
0513051_sc-164000.jpg,0,0,1,0,1,,train
0513052_as-0074032.jpg,2,0,1,0,3,,train
0513053_as-0074032.jpg,2,0,0,0,2,,train
0513054_as-0074032.jpg,1,0,0,0,1,,train
0513055_as-0074032.jpg,2,0,0,0,2,,train
0513056_as-7756632.jpg,3,0,1,0,4,,train
0513057_sc-167974.jpg,2,0,0,1,3,,train
0513058_sc-167974.jpg,2,0,1,0,3,,val
0513060_as-9020931.jpg,2,0,0,0,2,,val
0513061_sc-107442.jpg,1,2,0,0,3,,test
0513062_as-2844237.jpg,2,1,1,1,5,,train
0513063_sc-173487.jpg,1,2,2,0,5,,train
0513064_sc-173487.jpg,1,1,1,0,3,,train
0513065_sc-1003612.jpg,0,1,0,0,1,,train
0513068_sc-170363.jpg,2,0,1,0,3,,train
0513069_sc-170363.jpg,2,0,0,0,2,,train
0513070_as-9010751.jpg,8,2,3,1,14,,train
0513071_as-7985957.jpg,1,0,0,0,1,,val
0513072_sc-155468.jpg,1,1,2,0,4,,val
0513073_sc-155468.jpg,0,1,1,0,2,,test
0513074_sc-155468.jpg,2,1,2,0,5,,train
0513075_sc-155468.jpg,1,2,1,0,4,,train
0513077_sc-112218.jpg,1,0,0,0,1,,train
0513079_as-0047610.jpg,1,0,0,0,1,,train
0513080_as-0047610.jpg,1,0,0,0,1,,train
0513081_as-0047610.jpg,1,0,0,0,1,,train
0513082_as-0047610.jpg,1,0,0,0,1,,train
0513084_sc-126634.jpg,1,0,0,0,1,,val
0513085_sc-126634.jpg,1,0,0,0,1,,val
0513086_as-3312808.jpg,1,0,0,0,1,,test
0513087_sc-201523.jpg,2,0,0,1,3,,train
0513088_sc-154518.jpg,2,0,0,0,2,,train
0513089_sc-153872.jpg,2,0,1,0,3,,train
0513090_sc-153872.jpg,1,0,1,0,2,,train
0513092_sc-153872.jpg,2,0,1,0,3,,train
0513093_sc-153872.jpg,1,0,0,0,1,,train
0513094_sc-153872.jpg,12,1,1,0,14,,train
0513096_as-0023312.jpg,0,0,1,0,1,,val
0513097_as-0024259.jpg,2,0,1,1,4,,val
0513098_as-3437840.jpg,1,1,0,0,2,,test
0513099_as-3437840.jpg,8,0,0,1,9,,train
0513100_sc-200940.jpg,2,0,0,0,2,,train
0513101_sc-200940.jpg,3,0,1,0,4,,train
0513102_sc-200940.jpg,1,0,1,0,2,,train
0513103_as-0084325.jpg,3,1,0,0,4,,train
0513104_as-0084325.jpg,1,1,0,0,2,,train
0513105_as-3433612.jpg,1,0,1,0,2,,train
0513106_as-3104171.jpg,4,1,3,0,8,,val
0513107_as-0019815.jpg,2,0,0,0,2,,val
0513108_as-0035835.jpg,1,1,0,0,2,,test
0513109_as-0035835.jpg,0,1,0,0,1,,train
0513110_sc-1025462.jpg,1,0,0,0,1,,train
0513111_sc-1025462.jpg,1,0,0,0,1,,train
0513112_sc-1025462.jpg,1,0,0,0,1,,train
0513113_sc-1025462.jpg,1,0,0,0,1,,train
0513114_sc-1025462.jpg,1,0,0,0,1,,train
0513115_sc-1025462.jpg,1,0,0,0,1,,train
0513116_as-0000761.jpg,2,1,0,0,3,,val
0513117_as-0000761.jpg,2,0,0,0,2,,val
0513119_as-0000761.jpg,1,0,0,0,1,,test
0513120_as-2814483.jpg,1,0,0,0,1,,train
0513121_as-0034901.jpg,2,1,0,0,3,,train
0513122_as-0034901.jpg,1,1,0,0,2,,train
0513123_as-0034901.jpg,1,0,0,0,1,,train
0513124_as-0034901.jpg,2,0,0,0,2,,train
0513126_as-0034901.jpg,1,0,0,0,1,,train
0513127_as-0034901.jpg,1,0,0,0,1,,train
0513128_as-0034901.jpg,2,0,0,0,2,,val
0513129_as-0034901.jpg,1,0,0,0,1,,val
0513130_as-0029568.jpg,1,0,0,0,1,,test
0513131_as-3357510.jpg,2,0,0,0,2,,train
0513133_sc-1000450.jpg,5,0,1,0,6,,train
0513134_sc-1000450.jpg,2,0,2,0,4,,train
0513135_sc-1000450.jpg,4,0,1,2,7,,train
0513136_sc-1000450.jpg,1,1,0,0,2,,train
0513137_sc-1000450.jpg,3,0,0,0,3,,train
0513139_sc-1000450.jpg,1,0,0,0,1,,train
0513140_as-0074609.jpg,0,0,1,3,4,,val
0513141_as-0074609.jpg,0,0,0,1,1,,val
0513142_as-7914341.jpg,0,1,0,0,1,,test
0513143_as-0014704.jpg,1,0,0,0,1,,train
0513144_as-0014704.jpg,1,0,0,0,1,,train
0513145_as-0014704.jpg,1,0,0,0,1,,train
0513146_as-0014704.jpg,1,0,0,0,1,,train
0513147_sc-200096.jpg,1,0,1,0,2,,train
0513148_sc-200096.jpg,2,0,1,0,3,,train
0513149_sc-200096.jpg,1,0,1,0,2,,train
0513150_sc-200096.jpg,3,0,0,0,3,,val
0513151_as-2656681.jpg,1,0,1,0,2,,val
0513153_as-3036171.jpg,3,0,0,0,3,,test
0513154_sc-1018422.jpg,1,0,1,0,2,,train
0513155_sc-1018422.jpg,3,0,0,1,4,,train
0513156_sc-1018422.jpg,2,0,0,0,2,,train
0513157_sc-1018422.jpg,5,0,1,1,7,,train
0513159_sc-1018422.jpg,1,0,0,0,1,,train
0513161_sc-1018422.jpg,1,0,0,1,2,,train
0513163_sc-1018422.jpg,1,0,0,1,2,,train
0513164_sc-1018422.jpg,4,0,2,0,6,,val
0513165_sc-1018422.jpg,4,0,1,2,7,,val
0513166_sc-1018422.jpg,2,0,0,0,2,,test
0513167_sc-1018422.jpg,1,0,1,1,3,,train
0513168_sc-1032619.jpg,1,0,0,1,2,,train
0513169_sc-1032619.jpg,1,1,1,0,3,,train
0513170_sc-1032619.jpg,0,0,1,0,1,,train
0513171_as-7438928.jpg,0,0,1,0,1,,train
0513172_sc-179568.jpg,2,0,0,0,2,,train
0513173_sc-179568.jpg,1,0,0,0,1,,train
0513175_sc-217170.jpg,2,1,0,0,3,,val
0513176_sc-217170.jpg,2,0,1,0,3,,val
0513178_sc-118998.jpg,7,0,1,2,10,,test
0513179_sc-118998.jpg,2,0,1,1,4,,train
0513180_sc-118998.jpg,0,0,1,2,3,,train
0513181_sc-118998.jpg,3,1,1,0,5,,train
0513183_as-7953186.jpg,0,1,0,0,1,,train
0513184_as-3081953.jpg,1,0,1,0,2,,train
0513185_as-0016679.jpg,3,1,0,0,4,,train
0513186_as-0016679.jpg,1,0,0,0,1,,train
0513187_as-0016679.jpg,1,0,1,0,2,,val
0513188_as-0016679.jpg,2,0,0,0,2,,val
0513189_as-0016679.jpg,2,0,0,0,2,,test
0513190_sc-1015865.jpg,2,0,1,0,3,,train
0513191_sc-1015865.jpg,1,0,0,0,1,,train
0513192_sc-214614.jpg,6,0,1,1,8,,train
0513193_sc-214614.jpg,5,0,1,1,7,,train
0513194_sc-214614.jpg,2,0,0,0,2,,train
0513195_sc-214614.jpg,6,0,0,0,6,,train
0513196_sc-214614.jpg,4,0,1,0,5,,train
0513197_as-3264296.jpg,0,0,1,0,1,,val
0513198_as-0075403.jpg,1,1,4,1,7,,val
0513199_sc-159358.jpg,1,0,0,1,2,,test
0513200_sc-159358.jpg,1,0,0,1,2,,train
0513201_sc-159358.jpg,3,0,0,2,5,,train
0513202_sc-218109.jpg,2,0,0,0,2,,train
0513203_sc-218109.jpg,1,0,0,0,1,,train
0513207_sc-160860.jpg,2,0,0,0,2,,train
0513208_sc-160860.jpg,5,0,0,0,5,,train
0513209_sc-160860.jpg,3,0,0,0,3,,train
0513210_sc-160860.jpg,5,0,0,0,5,,val
0513211_as-0085636.jpg,2,0,0,0,2,,val
0513212_as-0085636.jpg,1,0,0,0,1,,test
0513213_as-0085636.jpg,2,0,0,0,2,,train
0513214_as-0085636.jpg,3,0,0,0,3,,train
0513215_as-9089484.jpg,4,0,2,0,6,,train
0513217_sc-141348.jpg,5,0,1,1,7,,train
0513218_sc-141348.jpg,3,0,1,1,5,,train
0513220_as-2788618.jpg,2,0,0,0,2,,train
0513221_as-3080123.jpg,2,0,1,1,4,,train
0513222_sc-201181.jpg,3,0,1,0,4,,val
0513223_sc-201181.jpg,2,0,1,0,3,,val
0513224_sc-201181.jpg,2,0,1,0,3,,test
0513225_as-0004412.jpg,4,1,0,0,5,,train
0513226_as-0004412.jpg,1,1,0,0,2,,train
0513227_as-0004412.jpg,2,1,0,0,3,,train
0513229_sc-151047.jpg,2,0,1,0,3,,train
0513232_sc-151047.jpg,1,0,1,0,2,,train
0513233_sc-151047.jpg,1,1,0,0,2,,train
0513234_sc-217115.jpg,3,0,0,0,3,,train
0513235_sc-217115.jpg,1,0,0,0,1,,val
0513236_sc-217115.jpg,3,0,0,0,3,,val
0513237_sc-217115.jpg,2,0,1,0,3,,test
0513238_as-7664535.jpg,2,0,2,2,6,,train
0513240_sc-114155.jpg,2,0,1,0,3,,train
0513241_sc-114155.jpg,2,0,1,0,3,,train
0513242_sc-205114.jpg,1,0,0,0,1,,train
0513243_sc-205114.jpg,1,0,0,0,1,,train
0513244_sc-205114.jpg,2,0,0,0,2,,train
0513245_sc-1034498.jpg,2,0,0,0,2,,train
0513246_sc-1034498.jpg,1,0,0,1,2,,val
0513247_sc-1034498.jpg,1,0,0,0,1,,val
0513248_sc-1034498.jpg,1,0,0,0,1,,test
0513249_as-0047956.jpg,3,0,0,0,3,,train
0513250_as-0047956.jpg,3,0,1,0,4,,train
0513251_as-0047956.jpg,1,0,0,0,1,,train
0513252_as-0047956.jpg,3,0,0,0,3,,train
0513253_as-0047956.jpg,2,0,0,0,2,,train
0513254_sc-208801.jpg,3,2,2,0,7,,train
0513255_sc-208801.jpg,1,0,0,0,1,,train
0513256_sc-208801.jpg,6,1,2,1,10,,val
0513257_sc-208801.jpg,1,0,2,0,3,,val
0513258_sc-208801.jpg,3,0,2,0,5,,test
0513259_sc-208801.jpg,7,1,1,0,9,,train
0513263_sc-178847.jpg,3,0,0,0,3,,train
0513264_sc-178847.jpg,3,0,0,0,3,,train
0513265_sc-178847.jpg,2,0,0,0,2,,train
0513266_sc-178847.jpg,1,0,0,0,1,,train
0513267_sc-178847.jpg,1,1,0,1,3,,train
0513268_sc-178847.jpg,1,1,0,1,3,,train
0513269_sc-178847.jpg,1,1,0,0,2,,val
0513272_as-0007745.jpg,3,1,0,0,4,,val
0513273_as-0007745.jpg,2,1,0,0,3,,test
0513274_as-0007745.jpg,2,0,0,0,2,,train
0513275_as-0007745.jpg,2,0,0,0,2,,train
0513276_as-0007745.jpg,3,0,0,0,3,,train
0513277_as-0007745.jpg,1,1,0,0,2,,train
0513278_as-0007745.jpg,4,1,0,0,5,,train
0513281_as-0049144.jpg,1,0,0,0,1,,train
0513282_as-0049144.jpg,1,1,0,0,2,,train
0513283_as-0049144.jpg,2,0,0,0,2,,val
0513284_as-0049144.jpg,1,0,0,0,1,,val
0513285_as-0049144.jpg,1,1,0,0,2,,test
0513286_as-0049144.jpg,1,0,0,0,1,,train
0513287_as-0049144.jpg,2,0,0,0,2,,train
0513289_sc-191317.jpg,4,0,1,0,5,,train
0513290_sc-191317.jpg,5,0,3,0,8,,train
0513291_sc-191317.jpg,1,0,1,0,2,,train
0513292_sc-1026345.jpg,1,0,0,1,2,,train
0513293_sc-1026345.jpg,3,0,0,2,5,,train
0513294_sc-1026345.jpg,2,0,0,0,2,,val
0513295_sc-1026345.jpg,6,0,0,4,10,,val
0513296_sc-1026345.jpg,2,0,0,1,3,,test
0513297_as-3136403.jpg,1,1,0,0,2,,train
0513298_as-2866726.jpg,3,0,0,1,4,,train
0513299_sc-187647.jpg,5,0,0,0,5,,train
0513300_sc-187647.jpg,2,1,0,0,3,,train
0513301_sc-187647.jpg,2,0,0,0,2,,train
0513305_as-0016780.jpg,3,0,0,0,3,,train
0513308_as-7676259.jpg,2,1,0,0,3,,train
0513312_as-0091801.jpg,2,0,2,0,4,,val
0513313_as-0091801.jpg,4,0,2,0,6,,val
0513316_as-7990091.jpg,3,0,1,1,5,,test
0513317_as-0062173.jpg,2,0,1,1,4,,train
0513320_as-0062173.jpg,3,0,0,0,3,,train
0513321_as-0062173.jpg,1,1,0,0,2,,train
0513324_as-0094715.jpg,1,0,0,1,2,,train
0513325_as-0094715.jpg,1,0,0,1,2,,train
0513326_as-3496167.jpg,2,0,0,0,2,,train
0513327_sc-203037.jpg,0,1,0,0,1,,train
0513328_as-0063630.jpg,1,0,1,0,2,,val
0513330_as-0009828.jpg,2,0,1,2,5,,val
0513331_as-0009828.jpg,2,0,1,2,5,,test
0513332_as-0009828.jpg,2,0,1,1,4,,train
0513333_as-0009828.jpg,2,0,1,1,4,,train
0513334_as-0009828.jpg,2,0,1,1,4,,train
0513335_sc-163604.jpg,4,0,0,0,4,,train
0513336_as-0095583.jpg,1,0,0,0,1,,train
0513338_sc-175078.jpg,5,0,0,1,6,,train
0513339_sc-175078.jpg,6,0,0,1,7,,train
0513340_sc-175078.jpg,5,0,0,1,6,,val
0513341_sc-175078.jpg,5,0,0,1,6,,val
0513342_sc-175078.jpg,4,0,0,1,5,,test
0513343_sc-146384.jpg,0,1,0,0,1,,train
0513344_sc-191975.jpg,0,0,0,1,1,,train
0513345_sc-191975.jpg,3,0,0,1,4,,train
0513346_sc-191975.jpg,0,0,1,1,2,,train
0513347_as-5509428.jpg,1,1,1,1,4,,train
0513348_sc-224391.jpg,6,0,0,0,6,,train
0513349_sc-224391.jpg,3,1,0,0,4,,train
0513350_sc-209917.jpg,3,0,3,1,7,,val
0513351_sc-209917.jpg,1,0,1,1,3,,val
0513352_sc-209917.jpg,1,0,1,1,3,,test
0513353_sc-209917.jpg,2,0,1,0,3,,train
0513354_sc-209917.jpg,1,0,1,0,2,,train
0513356_as-2995432.jpg,3,0,0,0,3,,train
0513360_as-0064951.jpg,1,2,1,0,4,,train
0513362_as-0064951.jpg,0,0,1,0,1,,train
0513364_as-0064951.jpg,4,1,2,2,9,,train
0513366_as-0064951.jpg,1,0,0,0,1,,train
0513369_as-0064951.jpg,2,0,2,2,6,,val
0513370_as-2561718.jpg,1,1,1,0,3,,val
0513374_as-0050789.jpg,1,0,1,1,3,,test
0513375_as-0050789.jpg,1,0,1,1,3,,train
0513377_sc-122139.jpg,1,1,1,1,4,,train
0513380_sc-122139.jpg,4,1,0,0,5,,train
0513381_sc-122139.jpg,1,2,1,0,4,,train
0513382_sc-122139.jpg,1,2,0,0,3,,train
0513383_sc-122139.jpg,1,1,1,0,3,,train
0513384_sc-122139.jpg,1,0,1,0,2,,train
0513385_as-7091361.jpg,2,2,1,1,6,,val
0513387_sc-190502.jpg,5,0,1,0,6,,val
0513388_sc-190502.jpg,12,0,3,0,15,,test
0513389_sc-190502.jpg,5,0,1,0,6,,train
0513391_as-3230432.jpg,0,1,0,0,1,,train
0513392_sc-201983.jpg,3,0,0,0,3,,train
0513393_sc-201983.jpg,2,0,0,0,2,,train
0513394_sc-201983.jpg,5,0,0,0,5,,train
0513395_sc-201983.jpg,1,0,0,0,1,,train
0513396_sc-201983.jpg,1,0,0,0,1,,train
0513397_as-0090923.jpg,2,0,0,0,2,,val
0513398_as-0090923.jpg,2,0,0,0,2,,val
0513401_as-2892089.jpg,1,0,1,1,3,,test
0513402_sc-186761.jpg,1,0,0,0,1,,train
0513403_sc-186761.jpg,1,0,1,2,4,,train
0513404_sc-186761.jpg,1,0,0,1,2,,train
0513405_sc-186761.jpg,2,0,1,0,3,,train
0513406_sc-186761.jpg,1,0,0,1,2,,train
0513407_sc-186761.jpg,1,0,0,1,2,,train
0513408_sc-186761.jpg,1,0,0,1,2,,train
0513409_sc-110854.jpg,2,0,0,0,2,,val
0513410_sc-219313.jpg,2,1,0,0,3,,val
0513411_sc-175593.jpg,3,2,0,0,5,,test
0513413_as-0030996.jpg,5,0,1,0,6,,train
0513419_as-0088884.jpg,2,0,2,1,5,,train
0513421_as-0088884.jpg,2,0,2,1,5,,train
0513423_sc-108456.jpg,2,0,0,0,2,,train
0513424_sc-108456.jpg,2,0,0,0,2,,train
0513427_sc-108456.jpg,1,0,0,0,1,,train
0513429_sc-138482.jpg,3,0,0,0,3,,train
0513430_sc-138482.jpg,1,0,0,0,1,,val
0513431_sc-204818.jpg,3,0,0,0,3,,val
0513432_sc-204818.jpg,6,0,0,2,8,,test
0513433_sc-204818.jpg,2,0,0,0,2,,train
0513434_as-0044606.jpg,4,0,0,0,4,,train
0513435_as-0044606.jpg,4,0,0,0,4,,train
0513438_as-0066696.jpg,1,0,1,0,2,,train
0513439_as-0066696.jpg,1,0,1,0,2,,train
0513440_as-0066696.jpg,1,0,1,0,2,,train
0513442_as-0011159.jpg,0,0,1,0,1,,train
0513445_as-0071212.jpg,2,1,2,1,6,,val
0513446_as-0071212.jpg,2,1,2,1,6,,val
0513447_as-0071212.jpg,2,0,1,0,3,,test
0513448_as-0071212.jpg,0,0,0,1,1,,train
0513449_as-0071212.jpg,1,0,1,1,3,,train
0513450_as-0071212.jpg,1,0,1,1,3,,train
0513451_as-0071212.jpg,0,0,2,0,2,,train
0513452_as-0071212.jpg,0,0,1,0,1,,train
0513453_as-2870223.jpg,1,0,0,0,1,,train
0513455_sc-133149.jpg,3,0,0,0,3,,train
0513456_sc-133149.jpg,4,0,0,0,4,,val
0513459_sc-1025378.jpg,1,0,0,0,1,,val
0513460_as-3023030.jpg,1,0,0,1,2,,test
0513462_as-2925925.jpg,2,0,0,0,2,,train
0513465_sc-143841.jpg,1,0,0,0,1,,train
0513466_sc-168304.jpg,0,0,1,0,1,,train
0513468_sc-111597.jpg,2,0,0,0,2,,train
0513469_sc-117413.jpg,1,0,1,1,3,,train
0513470_sc-117413.jpg,1,1,1,0,3,,train
0513471_sc-117413.jpg,1,2,1,1,5,,train
0513473_as-2689918.jpg,1,0,0,0,1,,val
0513475_sc-169940.jpg,1,0,0,1,2,,val
0513477_sc-1034450.jpg,1,1,0,0,2,,test
0513479_sc-226700.jpg,2,0,0,0,2,,train
0513480_sc-226700.jpg,3,0,0,0,3,,train
0513482_sc-210621.jpg,4,0,0,1,5,,train
0513483_sc-210621.jpg,5,0,0,1,6,,train
0513484_sc-210621.jpg,1,0,0,1,2,,train
0513485_sc-210621.jpg,1,0,0,0,1,,train
0513486_sc-210621.jpg,3,0,0,0,3,,train
0513487_sc-210621.jpg,1,0,0,0,1,,val
0513488_sc-210621.jpg,1,0,1,0,2,,val
0513489_sc-1040522.jpg,7,0,0,0,7,,test
0513490_sc-1040522.jpg,6,0,0,0,6,,train
0513491_sc-1040522.jpg,7,0,0,0,7,,train
0513492_sc-1040522.jpg,12,1,0,0,13,,train
0513493_sc-1040522.jpg,22,0,0,0,22,,train
0513494_sc-1040522.jpg,11,0,0,0,11,,train
0513495_as-7313721.jpg,0,1,0,0,1,,train
0513496_as-0096440.jpg,2,0,0,1,3,,train
0513497_as-0096440.jpg,2,0,1,0,3,,val
0513499_as-0096440.jpg,2,0,0,0,2,,val
0513500_as-0096440.jpg,3,0,0,1,4,,test
0513501_as-0096440.jpg,4,0,0,0,4,,train
0513502_as-0096440.jpg,4,0,0,0,4,,train
0513503_as-0096440.jpg,3,0,0,0,3,,train
0513504_as-3494007.jpg,2,1,0,0,3,,train
0513505_as-0017199.jpg,10,0,1,2,13,,train
0513506_as-0017199.jpg,2,0,1,0,3,,train
0513509_sc-1033076.jpg,2,0,0,1,3,,train
0513510_sc-1033076.jpg,3,0,2,1,6,,val
0513512_sc-195527.jpg,3,0,0,0,3,,val
0513513_sc-195527.jpg,5,0,0,0,5,,test
0513514_sc-195527.jpg,2,0,0,0,2,,train
0513515_sc-195527.jpg,3,0,0,0,3,,train
0513516_sc-195527.jpg,1,0,0,0,1,,train
0513517_sc-195527.jpg,1,0,0,0,1,,train
0513518_sc-195527.jpg,1,0,0,0,1,,train
0513519_as-0008073.jpg,2,0,0,1,3,,train
0513520_as-0008073.jpg,1,0,0,1,2,,train
0513521_as-0008073.jpg,3,0,0,1,4,,val
0513522_as-0008073.jpg,2,0,0,1,3,,val
0513523_as-0008073.jpg,2,0,0,1,3,,test
0513524_as-0008073.jpg,3,0,0,0,3,,train
0513525_as-0008073.jpg,2,0,0,0,2,,train
0513526_as-3129342.jpg,3,0,0,0,3,,train
0513527_sc-1004717.jpg,1,0,0,0,1,,train
0513528_sc-1004717.jpg,1,0,0,0,1,,train
0513529_as-9014089.jpg,2,0,0,0,2,,train
0513532_as-2562476.jpg,1,0,1,1,3,,train
0513534_as-0079671.jpg,4,1,1,0,6,,val
0513535_as-0079671.jpg,0,0,1,0,1,,val
0513536_as-0079671.jpg,2,1,1,0,4,,test
0513537_as-0039625.jpg,1,0,0,0,1,,train
0513538_as-0039625.jpg,0,1,0,0,1,,train
0513539_as-0039625.jpg,0,1,0,0,1,,train
0513540_sc-1025228.jpg,8,0,0,0,8,,train
0513541_as-7735590.jpg,2,1,1,0,4,,train
0513542_as-2603121.jpg,1,0,1,1,3,,train
0513544_as-3223280.jpg,1,1,0,0,2,,train
0513545_as-2671874.jpg,0,1,0,0,1,,val
0513547_as-0030215.jpg,1,0,0,0,1,,val
0513548_as-0030215.jpg,2,0,0,0,2,,test
0513551_as-0092874.jpg,1,1,0,0,2,,train
0513552_as-0092874.jpg,1,1,0,0,2,,train
0513553_as-0092874.jpg,1,1,0,0,2,,train
0513554_as-0092874.jpg,2,0,0,0,2,,train
0513555_as-0098746.jpg,10,0,0,1,11,,train
0513556_as-3133375.jpg,1,0,0,1,2,,train
0513557_sc-1029862.jpg,2,1,0,0,3,,train
0513559_sc-1029862.jpg,2,1,0,0,3,,val
0513562_as-0032742.jpg,6,1,1,0,8,,val
0513563_as-0032742.jpg,0,0,1,0,1,,test
0513564_as-0032742.jpg,5,1,1,0,7,,train
0513565_sc-199564.jpg,1,0,1,1,3,,train
0513566_sc-199564.jpg,2,0,1,1,4,,train
0513568_as-3260076.jpg,1,0,0,0,1,,train
0513571_sc-1018295.jpg,1,1,1,0,3,,train
0513572_sc-1018295.jpg,1,1,0,2,4,,train
0513573_sc-1018295.jpg,3,0,0,0,3,,train
0513574_sc-1018295.jpg,3,0,0,0,3,,val
0513575_sc-1018295.jpg,1,0,0,0,1,,val
0513576_as-0087370.jpg,1,2,2,1,6,,test
0513577_sc-204370.jpg,2,0,0,2,4,,train
0513578_as-5141517.jpg,1,0,1,0,2,,train
0513579_as-3056470.jpg,3,0,0,1,4,,train
0513580_sc-106356.jpg,1,0,0,1,2,,train
0513581_sc-106356.jpg,1,0,0,1,2,,train
0513582_sc-106356.jpg,1,0,0,0,1,,train
0513585_as-0087799.jpg,1,1,2,0,4,,train
0513586_as-0087799.jpg,2,0,0,0,2,,val
0513589_as-3296067.jpg,2,0,0,0,2,,val
0513590_as-0030391.jpg,1,0,0,0,1,,test
0513591_as-0030391.jpg,1,1,1,1,4,,train
0513592_as-0030391.jpg,0,0,1,0,1,,train
0513593_as-3197023.jpg,0,0,1,0,1,,train
0513597_as-0012550.jpg,8,1,1,0,10,,train
0513598_as-0012550.jpg,5,0,0,0,5,,train
0513599_as-0012550.jpg,5,0,1,0,6,,train
0513600_as-0012550.jpg,1,0,0,0,1,,train
0513601_sc-138743.jpg,1,1,0,0,2,,val
0513602_sc-138743.jpg,3,0,0,3,6,,val
0513604_sc-138743.jpg,2,0,1,1,4,,test
0513605_sc-138743.jpg,3,0,1,2,6,,train
0513606_sc-138743.jpg,3,0,0,0,3,,train
0513607_sc-138743.jpg,2,0,0,0,2,,train
0513608_sc-116851.jpg,5,0,0,0,5,,train
0513609_sc-116851.jpg,6,0,0,0,6,,train
0513610_as-3428762.jpg,1,0,0,0,1,,train
0513611_sc-139618.jpg,1,1,0,1,3,,train
0513613_sc-139618.jpg,4,5,0,0,9,,val
0513614_sc-1029945.jpg,5,0,0,0,5,,val
0513615_sc-1029945.jpg,7,0,1,0,8,,test
0513616_sc-151107.jpg,1,1,0,0,2,,train
0513617_sc-151107.jpg,4,1,0,0,5,,train
0513618_sc-152324.jpg,3,1,0,0,4,,train
0513619_sc-183295.jpg,14,0,0,0,14,,train
0513620_sc-183295.jpg,15,1,0,0,16,,train
0513621_sc-183295.jpg,6,0,0,0,6,,train
0513624_sc-183295.jpg,7,0,1,1,9,,train
0513625_sc-183295.jpg,2,0,1,0,3,,val
0513627_sc-183295.jpg,1,0,1,0,2,,val
0513628_sc-183295.jpg,1,0,0,0,1,,test
0513629_sc-183295.jpg,1,0,0,0,1,,train
0513630_sc-183295.jpg,7,0,0,0,7,,train
0513632_sc-183295.jpg,8,0,1,0,9,,train
0513633_sc-183295.jpg,7,0,1,0,8,,train
0513634_as-0023070.jpg,1,0,0,0,1,,train
0513635_as-9058066.jpg,3,0,0,0,3,,train
0513636_as-9058066.jpg,2,1,0,0,3,,train
0513637_as-2639695.jpg,2,0,0,0,2,,val
0513639_as-0053110.jpg,0,0,1,0,1,,val
0513640_as-0053110.jpg,0,0,1,0,1,,test
0513641_as-0053110.jpg,0,0,1,0,1,,train
0513642_as-0053110.jpg,1,0,1,0,2,,train
0513643_as-0053110.jpg,1,0,2,0,3,,train
0513644_as-0053110.jpg,0,0,1,0,1,,train
0513645_as-0053110.jpg,1,0,2,0,3,,train
0513646_as-0053110.jpg,0,0,1,0,1,,train
0513647_as-0053110.jpg,1,0,0,0,1,,train
0513649_sc-213282.jpg,3,0,2,1,6,,val
0513650_sc-213282.jpg,2,0,0,0,2,,val
0513651_sc-213282.jpg,4,0,0,0,4,,test
0513652_sc-213282.jpg,0,0,1,0,1,,train
0513653_sc-196863.jpg,1,0,0,0,1,,train
0513654_sc-196863.jpg,0,1,0,0,1,,train
0513655_sc-230009.jpg,4,0,0,1,5,,train
0513656_sc-230009.jpg,4,0,0,1,5,,train
0513657_sc-230009.jpg,1,0,0,0,1,,train
0513658_sc-230009.jpg,9,0,0,0,9,,train
0513659_sc-230009.jpg,4,0,0,1,5,,val
0513660_sc-230009.jpg,5,0,0,0,5,,val
0513661_sc-230009.jpg,3,0,0,0,3,,test
0513662_sc-152592.jpg,3,0,0,0,3,,train
0513663_sc-152592.jpg,3,0,0,1,4,,train
0513665_sc-152592.jpg,3,0,0,1,4,,train
0513666_sc-152592.jpg,3,0,0,1,4,,train
0513667_sc-121156.jpg,1,2,1,2,6,,train
0513668_sc-121156.jpg,3,1,1,1,6,,train
0513670_sc-220359.jpg,3,0,1,1,5,,train
0513671_sc-220359.jpg,3,0,1,0,4,,val
0513672_sc-220359.jpg,1,0,0,1,2,,val
0513673_sc-220359.jpg,2,0,0,1,3,,test
0513674_sc-220359.jpg,1,0,0,1,2,,train
0513675_sc-220359.jpg,2,0,0,0,2,,train
0513676_sc-220359.jpg,0,0,1,1,2,,train
0513677_sc-220359.jpg,4,0,1,1,6,,train
0513678_sc-220359.jpg,4,0,2,1,7,,train
0513679_sc-220359.jpg,3,0,2,1,6,,train
0513680_sc-220359.jpg,2,0,2,1,5,,train
0513681_sc-220359.jpg,4,0,0,1,5,,val
0513682_sc-220359.jpg,2,0,0,0,2,,val
0513683_sc-220359.jpg,1,0,0,0,1,,test
0513684_sc-117335.jpg,1,2,1,0,4,,train
0513685_sc-1001448.jpg,4,0,0,1,5,,train
0513686_sc-1001448.jpg,2,0,0,0,2,,train
0513687_sc-1001448.jpg,2,0,1,1,4,,train
0513688_sc-1001448.jpg,1,0,1,1,3,,train
0513689_sc-1001448.jpg,2,1,1,1,5,,train
0513690_sc-1001448.jpg,1,0,0,1,2,,train
0513691_sc-1001448.jpg,2,1,1,1,5,,val
0513692_as-9096145.jpg,2,0,0,1,3,,val
0513693_sc-159762.jpg,3,0,1,1,5,,test
0513694_sc-159762.jpg,3,0,1,1,5,,train
0513695_sc-159762.jpg,2,0,1,1,4,,train
0513696_sc-159762.jpg,1,0,0,0,1,,train
0513697_sc-159762.jpg,2,0,0,0,2,,train
0513698_sc-159762.jpg,0,0,0,1,1,,train
0513699_sc-114872.jpg,2,1,1,1,5,,train
0513700_sc-114872.jpg,2,2,0,1,5,,train
0513701_sc-114872.jpg,0,1,1,0,2,,val
0513703_as-0065484.jpg,7,3,0,0,10,,val
0513704_as-0065484.jpg,1,1,1,0,3,,test
0513705_as-0065484.jpg,5,1,1,0,7,,train
0513706_as-0065484.jpg,2,2,1,0,5,,train
0513707_as-0065484.jpg,0,0,1,0,1,,train
0513708_as-0065484.jpg,0,0,1,0,1,,train
0513709_as-0065484.jpg,0,0,1,0,1,,train
0513710_as-0065484.jpg,0,0,1,0,1,,train
0513711_as-0065484.jpg,0,0,1,0,1,,train
0513712_as-0065484.jpg,1,0,0,0,1,,val
0513713_as-0065484.jpg,0,0,1,0,1,,val
0513715_as-0065484.jpg,4,1,0,0,5,,test
0513716_as-0065484.jpg,5,3,1,0,9,,train
0513717_as-0065484.jpg,4,2,1,1,8,,train
0513718_as-0065484.jpg,5,2,1,0,8,,train
0513719_as-0065484.jpg,5,3,2,1,11,,train
0513721_as-0065484.jpg,1,0,1,0,2,,train
0513722_as-0065484.jpg,0,0,1,0,1,,train
0513723_as-0065484.jpg,0,0,2,0,2,,train
0513724_as-0065484.jpg,1,0,1,0,2,,val
0513725_as-0065484.jpg,1,0,2,0,3,,val
0513726_as-0065484.jpg,2,0,0,0,2,,test
0513727_as-0065484.jpg,1,0,0,0,1,,train
0513728_as-5060953.jpg,7,1,1,3,12,,train
0513729_as-3272920.jpg,6,0,0,0,6,,train
0513730_sc-121793.jpg,1,0,0,0,1,,train
0513731_sc-121793.jpg,2,0,0,0,2,,train
0513732_as-2661571.jpg,0,0,1,0,1,,train
0513733_as-2969107.jpg,0,1,1,1,3,,train
0513734_as-2818293.jpg,2,0,0,1,3,,val
0513735_sc-1010783.jpg,1,0,0,0,1,,val
0513736_sc-1010783.jpg,1,0,0,0,1,,test
0513738_as-3412749.jpg,3,0,0,1,4,,train
0513739_as-3404646.jpg,4,0,0,0,4,,train
0513740_as-0034091.jpg,1,0,1,0,2,,train
0513741_as-0034091.jpg,1,0,1,1,3,,train
0513742_as-0034091.jpg,1,1,0,1,3,,train
0513744_as-0034091.jpg,1,0,1,1,3,,train
0513749_sc-1037585.jpg,7,2,1,1,11,,train
0513750_sc-1037585.jpg,3,0,0,0,3,,val
0513751_sc-1037585.jpg,2,2,0,0,4,,val
0513752_sc-1037585.jpg,4,0,0,0,4,,test
0513753_sc-1037585.jpg,0,1,2,0,3,,train
0513754_sc-1037585.jpg,8,0,1,0,9,,train
0513756_sc-187983.jpg,3,2,1,0,6,,train
0513757_as-3468061.jpg,2,0,0,0,2,,train
0513758_sc-197648.jpg,3,0,1,1,5,,train
0513759_sc-197648.jpg,3,0,1,1,5,,train
0513760_sc-197648.jpg,3,0,1,1,5,,train
0513762_as-0069574.jpg,2,0,1,0,3,,val
0513764_as-0028014.jpg,5,0,0,1,6,,val
0513766_as-0008237.jpg,4,0,1,0,5,,test
0513767_as-0008237.jpg,0,1,0,0,1,,train
0513768_as-0008237.jpg,2,1,1,0,4,,train
0513769_as-0008237.jpg,1,1,1,0,3,,train
0513770_as-0008237.jpg,0,0,1,0,1,,train
0513771_as-0008237.jpg,0,1,0,0,1,,train
0513772_as-0008237.jpg,0,1,1,0,2,,train
0513773_as-0008237.jpg,1,0,0,0,1,,train
0513774_as-0008237.jpg,1,0,0,0,1,,val
0513775_sc-153935.jpg,3,0,0,0,3,,val
0513776_sc-153935.jpg,2,0,0,0,2,,test
0513777_sc-153935.jpg,2,0,0,0,2,,train
0513778_sc-153935.jpg,1,0,1,0,2,,train
0513779_sc-153935.jpg,2,0,0,0,2,,train
0513780_sc-153935.jpg,2,0,0,0,2,,train
0513781_as-7894713.jpg,1,0,2,0,3,,train
0513782_as-2663477.jpg,1,0,0,0,1,,train
0513786_as-0023665.jpg,7,1,1,0,9,,train
0513787_sc-226848.jpg,3,0,1,0,4,,val
0513788_sc-226848.jpg,3,0,1,0,4,,val
0513789_sc-226848.jpg,5,0,0,0,5,,test
0513790_sc-226848.jpg,4,0,0,0,4,,train
0513791_sc-226848.jpg,6,1,0,0,7,,train
0513792_sc-226848.jpg,5,1,1,0,7,,train
0513793_sc-226848.jpg,4,1,1,0,6,,train
0513796_as-0053005.jpg,3,0,0,0,3,,train
0513797_as-0053005.jpg,5,0,0,0,5,,train
0513798_as-2733119.jpg,1,0,1,0,2,,train
0513799_as-3250286.jpg,3,0,0,0,3,,val
0513800_as-2780825.jpg,1,0,0,0,1,,val
0513801_as-0008379.jpg,2,0,0,0,2,,test
0513802_as-0008379.jpg,2,0,0,0,2,,train
0513803_as-0008379.jpg,2,1,1,1,5,,train
0513804_as-0008379.jpg,0,2,0,0,2,,train
0513805_as-0008379.jpg,1,2,1,1,5,,train
0513806_as-0008379.jpg,1,0,0,0,1,,train
0513807_as-7354170.jpg,2,0,0,0,2,,train
0513809_sc-195389.jpg,0,1,0,0,1,,train
0513810_sc-195389.jpg,1,0,1,0,2,,val
0513811_sc-195389.jpg,2,0,0,0,2,,val
0513812_sc-195389.jpg,1,0,1,0,2,,test
0513813_sc-195389.jpg,1,0,0,0,1,,train
0513814_sc-167698.jpg,1,0,0,0,1,,train
0513816_sc-167698.jpg,1,0,0,0,1,,train
0513817_sc-167698.jpg,4,0,0,0,4,,train
0513821_as-0009353.jpg,5,0,1,0,6,,train
0513822_as-0009353.jpg,4,0,1,0,5,,train
0513823_as-0009353.jpg,2,0,1,1,4,,train
0513824_as-0009353.jpg,1,1,2,1,5,,val
0513825_as-0009353.jpg,3,0,2,0,5,,val
0513826_as-0009353.jpg,1,0,1,0,2,,test
0513827_as-0009353.jpg,1,0,1,0,2,,train
0513828_as-0009353.jpg,1,0,1,1,3,,train
0513829_as-0009353.jpg,2,0,1,1,4,,train
0513830_as-0009353.jpg,2,0,1,1,4,,train
0513831_as-2678283.jpg,0,0,1,0,1,,train
0513832_as-3236326.jpg,1,0,0,0,1,,train
0513833_sc-208855.jpg,3,0,0,1,4,,train
0513834_sc-208855.jpg,2,0,0,1,3,,val
0513835_as-0032971.jpg,2,0,0,0,2,,val
0513836_as-0032971.jpg,1,0,0,0,1,,test
0513838_sc-159344.jpg,4,0,0,1,5,,train
0513840_sc-159344.jpg,4,0,0,1,5,,train
0513841_sc-159344.jpg,3,0,0,1,4,,train
0513843_as-0017643.jpg,2,0,0,0,2,,train
0513844_sc-1038533.jpg,1,0,0,1,2,,train
0513845_sc-1038533.jpg,1,0,0,2,3,,train
0513846_sc-1038533.jpg,2,0,0,2,4,,train
0513847_sc-1038533.jpg,1,0,0,2,3,,val
0513848_as-3176124.jpg,2,0,0,0,2,,val
0513849_sc-1036370.jpg,1,0,0,0,1,,test
0513850_sc-1036370.jpg,2,0,0,0,2,,train
0513851_as-3129991.jpg,3,0,0,0,3,,train
0513852_as-2605254.jpg,1,0,0,0,1,,train
0513854_sc-175919.jpg,1,0,0,0,1,,train
0513855_as-3213905.jpg,3,0,1,1,5,,train
0513857_as-0067464.jpg,1,1,0,0,2,,train
0513859_as-0067464.jpg,1,0,0,0,1,,train
0513861_as-0067464.jpg,1,0,0,0,1,,val
0513862_as-0062627.jpg,1,0,1,0,2,,val
0513864_as-0062627.jpg,1,0,1,0,2,,test
0513873_as-3299066.jpg,1,0,0,1,2,,train
0513875_as-0080225.jpg,5,0,0,0,5,,train
0513876_as-0080225.jpg,5,0,0,0,5,,train
0513877_as-0052129.jpg,3,0,0,0,3,,train
0513878_as-0052129.jpg,1,0,0,0,1,,train
0513879_as-0052129.jpg,1,0,0,0,1,,train
0513880_as-0052129.jpg,3,0,1,0,4,,train
0513881_as-0052129.jpg,1,0,0,0,1,,val
0513883_sc-1024731.jpg,1,0,0,0,1,,val
0513884_sc-1024731.jpg,3,0,0,0,3,,test
0513885_sc-176754.jpg,3,1,0,0,4,,train
0513886_as-0061685.jpg,2,0,0,0,2,,train
0513887_as-0061685.jpg,2,0,0,0,2,,train
0513889_sc-1009782.jpg,1,0,0,0,1,,train
0513890_sc-1009782.jpg,2,0,0,0,2,,train
0513892_as-0022003.jpg,4,1,0,0,5,,train
0513895_as-0022003.jpg,2,0,0,1,3,,train
0513896_as-0022003.jpg,3,0,0,1,4,,val
0513897_as-0022003.jpg,1,0,0,1,2,,val
0513898_as-0022003.jpg,3,0,1,1,5,,test
0513900_sc-112712.jpg,1,0,0,0,1,,train
0513901_sc-112712.jpg,1,0,0,0,1,,train
0513904_as-3196466.jpg,0,1,0,0,1,,train
0513905_sc-151454.jpg,1,0,1,0,2,,train
0513906_sc-151454.jpg,1,0,1,0,2,,train
0513907_sc-151454.jpg,1,0,1,0,2,,train
0513908_as-2796215.jpg,0,0,1,0,1,,train
0513909_as-0036877.jpg,0,1,0,0,1,,val
0513910_as-0036877.jpg,1,0,0,0,1,,val
0513911_as-0036877.jpg,1,0,0,0,1,,test
0513912_as-0036877.jpg,1,0,0,0,1,,train
0513914_as-0036877.jpg,1,0,0,0,1,,train
0513915_as-0036877.jpg,2,0,0,0,2,,train
0513916_as-0036877.jpg,1,0,0,0,1,,train
0513917_as-0036877.jpg,2,0,0,0,2,,train
0513918_as-3206544.jpg,0,0,1,0,1,,train
0513920_sc-189666.jpg,1,1,3,0,5,,train
0513921_sc-189666.jpg,1,1,2,0,4,,val
0513922_sc-204346.jpg,0,0,1,0,1,,val
0513923_sc-204346.jpg,8,1,0,0,9,,test
0513924_sc-204346.jpg,11,1,0,0,12,,train
0513925_sc-204346.jpg,7,1,1,0,9,,train
0513926_sc-204346.jpg,3,1,0,0,4,,train
0513927_sc-204346.jpg,8,0,0,0,8,,train
0513928_sc-204346.jpg,11,0,0,0,11,,train
0513929_sc-204346.jpg,1,0,1,0,2,,train
0513930_sc-204346.jpg,1,0,1,0,2,,train
0513934_as-0076385.jpg,1,0,1,1,3,,val
0513935_as-0076385.jpg,1,0,0,0,1,,val
0513936_as-0076385.jpg,1,0,1,1,3,,test
0513937_as-0076385.jpg,1,0,1,1,3,,train
0513938_sc-1038371.jpg,2,0,1,1,4,,train
0513939_sc-1038371.jpg,3,0,1,1,5,,train
0513940_sc-1038371.jpg,2,0,1,1,4,,train
0513941_as-2644199.jpg,1,5,2,0,8,,train
0513942_sc-1038438.jpg,1,0,1,1,3,,train
0513943_sc-1038438.jpg,3,0,1,1,5,,train
0513946_sc-199593.jpg,5,0,0,0,5,,val
0513947_sc-199593.jpg,1,0,0,0,1,,val
0513948_as-3416759.jpg,3,1,1,0,5,,test
0513949_as-7704505.jpg,1,1,1,0,3,,train
0513950_as-3361866.jpg,1,0,0,0,1,,train
0513951_sc-123660.jpg,1,0,1,0,2,,train
0513952_sc-123660.jpg,2,0,1,1,4,,train
0513953_sc-123660.jpg,1,0,1,0,2,,train
0513954_sc-123660.jpg,1,0,1,0,2,,train
0513956_as-0044154.jpg,3,1,1,0,5,,train
0513957_sc-187306.jpg,6,2,1,0,9,,val
0513958_sc-175667.jpg,2,0,1,2,5,,val
0513959_sc-175667.jpg,4,1,1,1,7,,test
0513960_sc-175667.jpg,5,1,1,2,9,,train
0513961_sc-178049.jpg,0,0,1,0,1,,train
0513963_sc-178049.jpg,1,0,1,0,2,,train
0513964_sc-178049.jpg,1,0,0,1,2,,train
0513965_sc-178049.jpg,1,0,1,0,2,,train
0513966_sc-178049.jpg,1,0,0,1,2,,train
0513967_sc-178049.jpg,1,0,0,0,1,,train
0513968_sc-178049.jpg,1,0,0,1,2,,val
0513975_as-0077712.jpg,2,1,2,2,7,,val
0513976_as-0077712.jpg,0,1,0,1,2,,test
0513977_sc-195373.jpg,3,0,3,0,6,,train
0513979_sc-195373.jpg,2,0,0,0,2,,train
0513980_sc-195373.jpg,2,0,1,0,3,,train
0513981_sc-195373.jpg,3,0,1,0,4,,train
0513982_sc-195373.jpg,4,0,1,1,6,,train
0513983_sc-195373.jpg,3,0,1,0,4,,train
0513984_sc-195373.jpg,4,0,1,0,5,,train
0513985_sc-195373.jpg,6,0,1,0,7,,val
0513986_sc-195373.jpg,2,0,1,0,3,,val
0513987_sc-195373.jpg,3,0,1,0,4,,test
0513988_sc-195373.jpg,1,0,0,1,2,,train
0513989_sc-195373.jpg,1,0,0,1,2,,train
0513990_sc-195373.jpg,1,0,0,1,2,,train
0513991_as-2933844.jpg,2,0,1,2,5,,train
0513992_as-0052475.jpg,2,0,0,0,2,,train
0513993_as-0052475.jpg,2,0,0,0,2,,train
0513996_as-0052475.jpg,2,0,0,0,2,,train
0513997_as-0052475.jpg,1,0,0,0,1,,val
0513998_as-0052475.jpg,2,0,0,0,2,,val
0513999_as-0052475.jpg,2,0,0,0,2,,test
0514000_as-7181431.jpg,1,2,1,1,5,,train
0514001_sc-200590.jpg,1,0,0,0,1,,train
0514002_sc-200590.jpg,3,2,2,0,7,,train
0514003_sc-200590.jpg,3,2,3,0,8,,train
0514004_sc-200590.jpg,5,2,3,0,10,,train
0514005_as-3169074.jpg,1,0,0,1,2,,train
0514007_as-0039521.jpg,1,0,0,0,1,,train
0514008_as-0039521.jpg,1,0,0,0,1,,val
0514009_as-7113605.jpg,2,0,1,0,3,,val
0514011_as-2765903.jpg,1,0,1,1,3,,test
0514013_as-0002969.jpg,1,3,3,1,8,,train
0514014_as-0002969.jpg,1,5,1,1,8,,train
0514015_as-0002969.jpg,1,1,3,1,6,,train
0514016_sc-154345.jpg,3,0,0,1,4,,train
0514017_sc-154345.jpg,12,1,2,0,15,,train
0514018_sc-154345.jpg,4,1,2,0,7,,train
0514019_sc-154345.jpg,10,0,2,0,12,,train
0514020_sc-154345.jpg,2,0,0,0,2,,val
0514021_sc-154345.jpg,2,0,0,0,2,,val
0514022_sc-154345.jpg,2,0,0,0,2,,test
0514023_sc-154345.jpg,2,0,0,2,4,,train
0514024_sc-154345.jpg,2,0,0,1,3,,train
0514025_sc-154345.jpg,1,0,0,0,1,,train
0514028_as-0012818.jpg,2,0,0,0,2,,train
0514029_as-0012818.jpg,1,0,0,0,1,,train
0514030_as-3039554.jpg,3,0,0,0,3,,train
0514031_as-2833781.jpg,1,0,1,1,3,,train
0514032_as-2978655.jpg,2,1,1,1,5,,val
0514033_as-2859512.jpg,3,2,1,1,7,,val
0514034_sc-1028657.jpg,5,0,2,1,8,,test
0514035_sc-1028657.jpg,2,0,0,0,2,,train
0514036_sc-1028657.jpg,4,0,3,1,8,,train
0514038_as-2884458.jpg,0,0,1,0,1,,train
0514039_as-0054760.jpg,1,0,0,0,1,,train
0514040_as-0054760.jpg,1,0,0,0,1,,train
0514041_as-0054760.jpg,1,0,0,0,1,,train
0514042_sc-1022891.jpg,2,0,0,0,2,,train
0514043_sc-1022891.jpg,3,0,0,0,3,,val
0514044_sc-1022891.jpg,2,1,3,0,6,,val
0514045_as-0024634.jpg,1,0,1,1,3,,test
0514046_as-0024634.jpg,1,0,1,2,4,,train
0514048_sc-152204.jpg,2,0,0,0,2,,train
0514049_sc-152204.jpg,2,0,1,0,3,,train
0514050_sc-152204.jpg,4,0,0,1,5,,train
0514051_sc-1037341.jpg,3,0,0,0,3,,train
0514052_sc-1037341.jpg,2,0,0,1,3,,train
0514053_sc-1037341.jpg,2,0,1,0,3,,train
0514054_sc-1037341.jpg,2,0,1,2,5,,val
0514055_as-9060210.jpg,1,2,1,1,5,,val
0514056_as-9060210.jpg,1,0,2,1,4,,test
0514059_as-0075058.jpg,1,0,1,0,2,,train
0514060_as-0075058.jpg,2,0,0,0,2,,train
0514061_as-0075058.jpg,2,0,0,0,2,,train
0514062_as-0075058.jpg,1,0,0,0,1,,train
0514063_as-0075058.jpg,1,0,0,0,1,,train
0514065_as-0075058.jpg,0,0,1,0,1,,train
0514066_sc-160409.jpg,3,0,0,1,4,,train
0514067_sc-160409.jpg,2,0,1,1,4,,val
0514068_sc-160409.jpg,1,0,0,1,2,,val
0514069_sc-160409.jpg,1,0,0,1,2,,test
0514070_sc-160409.jpg,1,0,0,1,2,,train
0514071_as-7582571.jpg,1,0,0,0,1,,train
0514072_sc-197137.jpg,2,0,0,0,2,,train
0514073_as-2796566.jpg,3,0,0,0,3,,train
0514074_sc-1038221.jpg,3,0,1,0,4,,train
0514075_sc-1038221.jpg,4,0,1,0,5,,train
0514076_as-2685498.jpg,9,1,1,3,14,,train
0514077_as-2685498.jpg,0,0,1,0,1,,val
0514078_as-3067456.jpg,1,0,1,1,3,,val
0514079_sc-176783.jpg,1,0,0,0,1,,test
0514081_as-3416774.jpg,2,0,1,0,3,,train
0514083_as-0081123.jpg,1,2,1,2,6,,train
0514084_as-0081123.jpg,1,2,4,1,8,,train
0514085_as-0081123.jpg,1,2,4,1,8,,train
0514086_as-0081123.jpg,0,3,3,0,6,,train
0514087_as-0081123.jpg,2,2,4,1,9,,train
0514088_as-0081123.jpg,0,2,3,0,5,,train
0514090_as-0076799.jpg,1,0,1,0,2,,val
0514091_as-0076799.jpg,1,0,1,0,2,,val
0514093_as-0076799.jpg,0,1,1,0,2,,test
0514094_sc-182465.jpg,1,0,1,1,3,,train
0514095_sc-182465.jpg,1,0,1,0,2,,train
0514096_sc-182465.jpg,1,0,1,0,2,,train
0514097_sc-182465.jpg,1,0,0,0,1,,train
0514098_sc-182465.jpg,1,0,1,1,3,,train
0514099_sc-182465.jpg,1,0,0,1,2,,train
0514100_sc-182465.jpg,1,0,0,1,2,,train
0514101_sc-182465.jpg,1,0,1,0,2,,val
0514102_sc-182465.jpg,1,0,0,0,1,,val
0514103_sc-103017.jpg,2,0,0,0,2,,test
0514104_as-3405977.jpg,0,0,1,0,1,,train
0514106_as-0091766.jpg,1,0,0,0,1,,train
0514107_as-0091766.jpg,1,0,1,1,3,,train
0514108_as-0091766.jpg,1,0,1,0,2,,train
0514109_as-0091766.jpg,1,0,0,0,1,,train
0514110_as-7799193.jpg,5,1,0,0,6,,train
0514112_sc-223473.jpg,2,0,0,0,2,,train
0514113_sc-223473.jpg,1,0,0,0,1,,val
0514115_as-0084403.jpg,0,0,1,0,1,,val
0514116_as-0084403.jpg,0,0,2,0,2,,test
0514117_as-0084403.jpg,0,0,1,0,1,,train
0514118_as-0084403.jpg,0,1,1,0,2,,train
0514119_as-0012762.jpg,1,2,0,0,3,,train
0514120_as-0012762.jpg,1,1,0,0,2,,train
0514122_sc-124088.jpg,3,0,0,1,4,,train
0514123_sc-124088.jpg,7,0,0,2,9,,train
0514124_sc-124088.jpg,3,0,0,0,3,,train
0514127_sc-159077.jpg,3,0,0,0,3,,val
0514128_as-2916761.jpg,1,0,0,0,1,,val
0514129_as-2926859.jpg,0,1,0,0,1,,test
0514130_as-7956705.jpg,1,0,1,1,3,,train
0514131_as-0007371.jpg,2,1,0,0,3,,train
0514132_as-0007371.jpg,1,0,0,0,1,,train
0514133_sc-1026359.jpg,1,0,0,0,1,,train
0514134_sc-1026359.jpg,1,0,0,0,1,,train
0514135_sc-1026359.jpg,2,0,0,0,2,,train
0514136_sc-1026359.jpg,2,0,0,0,2,,train
0514137_sc-1026359.jpg,1,0,0,0,1,,val
0514138_as-0025711.jpg,5,0,4,1,10,,val
0514139_as-0025711.jpg,2,1,3,1,7,,test
0514141_as-0071035.jpg,3,0,0,1,4,,train
0514142_as-0071035.jpg,3,0,0,1,4,,train
0514143_as-0071035.jpg,2,0,0,1,3,,train
0514144_sc-1019393.jpg,1,1,1,1,4,,train
0514145_sc-147554.jpg,1,0,0,0,1,,train
0514146_sc-147554.jpg,3,0,0,0,3,,train
0514148_sc-147554.jpg,2,0,1,1,4,,train
0514149_sc-147554.jpg,2,0,1,1,4,,val
0514151_sc-147554.jpg,3,0,0,0,3,,val
0514152_sc-147554.jpg,2,0,0,0,2,,test
0514153_sc-147554.jpg,2,0,0,0,2,,train
0514154_sc-147554.jpg,3,0,0,0,3,,train
0514155_sc-147554.jpg,1,0,0,0,1,,train
0514156_sc-199402.jpg,0,0,1,0,1,,train
0514157_sc-199402.jpg,0,0,1,0,1,,train
0514158_sc-199402.jpg,0,0,1,0,1,,train
0514159_sc-199402.jpg,0,0,1,0,1,,train
0514160_as-3342493.jpg,4,0,0,0,4,,val
0514162_sc-105806.jpg,1,1,0,0,2,,val
0514163_sc-181537.jpg,1,0,2,1,4,,test
0514164_sc-181537.jpg,1,0,1,1,3,,train
0514165_sc-181537.jpg,2,0,1,1,4,,train
0514167_as-0030427.jpg,1,0,0,0,1,,train
0514168_as-7009027.jpg,2,0,0,0,2,,train
0514169_sc-213355.jpg,4,0,1,0,5,,train
0514170_sc-213355.jpg,0,1,0,0,1,,train
0514171_sc-213355.jpg,0,1,1,0,2,,train
0514172_sc-213355.jpg,0,1,0,0,1,,val
0514173_sc-213355.jpg,2,0,1,0,3,,val
0514174_as-3005784.jpg,0,0,1,0,1,,test
0514175_as-2894681.jpg,1,0,0,0,1,,train
0514176_sc-1027551.jpg,1,0,0,0,1,,train
0514177_sc-1027551.jpg,2,1,0,1,4,,train
0514179_sc-1027551.jpg,1,0,0,0,1,,train
0514181_as-0019237.jpg,1,0,1,0,2,,train
0514182_as-0019237.jpg,1,0,1,0,2,,train
0514183_as-0019237.jpg,1,0,1,0,2,,train
0514184_as-0019237.jpg,1,0,0,0,1,,val
0514186_sc-209638.jpg,4,0,0,0,4,,val
0514187_sc-210133.jpg,2,1,0,0,3,,test
0514188_sc-210133.jpg,1,1,0,0,2,,train
0514189_sc-210133.jpg,1,0,0,0,1,,train
0514190_sc-210133.jpg,3,0,0,0,3,,train
0514191_sc-210133.jpg,1,0,0,0,1,,train
0514192_sc-210133.jpg,1,1,0,0,2,,train
0514193_sc-210133.jpg,1,1,0,0,2,,train
0514194_sc-210133.jpg,2,1,0,0,3,,train
0514195_sc-210133.jpg,1,1,0,0,2,,val
0514196_sc-210133.jpg,1,0,0,0,1,,val
0514197_as-2965187.jpg,1,1,0,0,2,,test
0514198_as-3294690.jpg,1,0,0,0,1,,train
0514199_sc-157197.jpg,1,0,0,0,1,,train
0514203_sc-132865.jpg,8,0,0,0,8,,train
0514204_sc-225274.jpg,8,0,1,0,9,,train
0514205_sc-225274.jpg,9,0,1,0,10,,train
0514206_sc-225274.jpg,5,1,1,0,7,,train
0514208_as-0002221.jpg,0,0,2,0,2,,train
0514209_as-0002221.jpg,0,1,1,0,2,,val
0514210_as-0002221.jpg,2,0,1,0,3,,val
0514213_as-0067492.jpg,0,0,2,0,2,,test
0514214_as-0067492.jpg,2,0,0,1,3,,train
0514215_as-0067492.jpg,1,0,1,0,2,,train
0514216_sc-1008637.jpg,1,0,0,0,1,,train
0514217_sc-1008637.jpg,1,0,0,0,1,,train
0514220_sc-207326.jpg,4,0,0,0,4,,train
0514221_sc-207326.jpg,1,0,0,1,2,,train
0514222_sc-207326.jpg,1,0,0,0,1,,train
0514223_sc-207326.jpg,1,0,0,0,1,,val
0514224_sc-207326.jpg,1,0,0,0,1,,val
0514225_sc-207326.jpg,4,0,0,0,4,,test
0514226_sc-207326.jpg,1,0,1,0,2,,train
0514227_sc-207326.jpg,7,0,0,0,7,,train
0514228_sc-207326.jpg,4,0,0,0,4,,train
0514229_sc-1006446.jpg,2,0,0,0,2,,train
0514230_sc-1006446.jpg,2,0,1,0,3,,train
0514231_sc-1006446.jpg,1,0,0,0,1,,train
0514232_sc-1006446.jpg,1,1,1,0,3,,train
0514233_sc-1006446.jpg,4,0,1,0,5,,val
0514234_as-7051704.jpg,1,0,1,0,2,,val
0514235_as-0034165.jpg,0,4,2,0,6,,test
0514237_sc-222491.jpg,1,0,1,0,2,,train
0514238_sc-222491.jpg,2,0,1,0,3,,train
0514239_sc-222491.jpg,2,0,1,0,3,,train
0514240_sc-222491.jpg,2,1,1,0,4,,train
0514241_sc-222491.jpg,0,1,1,0,2,,train
0514242_sc-222491.jpg,1,0,1,0,2,,train
0514243_sc-222491.jpg,1,0,1,0,2,,train
0514244_sc-222491.jpg,3,1,1,0,5,,val
0514245_as-2579376.jpg,1,0,0,0,1,,val
0514246_sc-1005850.jpg,1,0,1,0,2,,test
0514247_sc-1005850.jpg,6,0,1,1,8,,train
0514248_sc-1005850.jpg,6,0,1,0,7,,train
0514249_as-0041300.jpg,3,0,0,0,3,,train
0514251_as-0041300.jpg,2,0,0,0,2,,train
0514252_sc-207926.jpg,0,0,1,0,1,,train
0514253_sc-207926.jpg,2,0,1,0,3,,train
0514254_sc-207926.jpg,1,0,1,0,2,,train
0514255_sc-207926.jpg,2,0,1,0,3,,val
0514257_as-3197683.jpg,1,0,0,0,1,,val
0514258_as-2787579.jpg,2,1,1,1,5,,test
0514260_sc-130041.jpg,0,0,0,1,1,,train
0514261_sc-130041.jpg,1,0,0,2,3,,train
0514262_sc-130041.jpg,1,0,0,1,2,,train
0514263_sc-130041.jpg,4,0,1,1,6,,train
0514264_sc-130041.jpg,0,0,0,1,1,,train
0514265_sc-130041.jpg,0,0,0,1,1,,train
0514266_sc-130041.jpg,0,1,0,1,2,,train
0514267_as-0049003.jpg,1,0,0,1,2,,val
0514268_as-0049003.jpg,2,0,0,1,3,,val
0514269_as-0049003.jpg,2,0,0,0,2,,test
0514270_as-7568409.jpg,1,1,0,0,2,,train
0514272_as-0031436.jpg,1,0,0,0,1,,train
0514273_as-0031436.jpg,2,0,0,0,2,,train
0514274_as-0031436.jpg,0,0,0,1,1,,train
0514275_as-0031436.jpg,0,0,1,0,1,,train
0514276_as-0031436.jpg,0,0,0,1,1,,train
0514278_sc-213456.jpg,2,0,0,1,3,,train
0514279_sc-213456.jpg,2,0,0,0,2,,val
0514280_sc-213456.jpg,1,0,0,0,1,,val
0514281_as-3404816.jpg,0,0,1,0,1,,test
0514283_sc-202479.jpg,2,0,0,0,2,,train
0514284_sc-202479.jpg,1,1,2,0,4,,train
0514285_sc-202479.jpg,1,0,0,0,1,,train
0514286_as-0082852.jpg,1,3,2,1,7,,train
0514287_as-0082852.jpg,1,1,1,0,3,,train
0514288_as-0082852.jpg,0,0,1,1,2,,train
0514289_as-0082852.jpg,1,0,1,0,2,,train
0514290_as-0082852.jpg,0,0,1,1,2,,val
0514291_as-0082852.jpg,0,0,1,0,1,,val
0514292_as-0082852.jpg,0,0,2,1,3,,test
0514293_as-0082852.jpg,0,2,0,0,2,,train
0514294_as-0082852.jpg,2,0,0,0,2,,train
0514295_as-0082852.jpg,0,0,2,0,2,,train
0514297_as-9020493.jpg,4,3,0,0,7,,train
0514298_sc-208034.jpg,3,0,0,0,3,,train
0514299_sc-208034.jpg,3,0,0,0,3,,train
0514300_sc-208034.jpg,1,0,0,0,1,,train
0514301_sc-208034.jpg,6,0,0,0,6,,val
0514304_as-7295276.jpg,1,0,0,0,1,,val
0514306_sc-153578.jpg,2,3,0,0,5,,test
0514308_as-0032227.jpg,2,3,0,0,5,,train
0514309_sc-138099.jpg,3,0,0,0,3,,train
0514310_sc-1028091.jpg,1,0,0,0,1,,train
0514311_sc-1028091.jpg,4,0,0,0,4,,train
0514312_sc-1028091.jpg,4,0,0,0,4,,train
0514313_sc-1028091.jpg,13,0,0,0,13,,train
0514314_sc-1028091.jpg,4,0,0,0,4,,train
0514316_sc-1028091.jpg,9,0,0,0,9,,val
0514317_sc-1028091.jpg,3,0,0,0,3,,val
0514318_sc-1028091.jpg,4,0,0,0,4,,test
0514319_sc-1028091.jpg,1,0,0,0,1,,train
0514320_sc-1019242.jpg,1,0,0,0,1,,train
0514321_sc-1019242.jpg,1,0,0,0,1,,train
0514322_sc-1019242.jpg,1,0,0,1,2,,train
0514323_sc-1019242.jpg,1,0,0,1,2,,train
0514324_as-7930856.jpg,1,0,0,0,1,,train
0514326_as-2532013.jpg,1,0,0,0,1,,train
0514331_as-0049952.jpg,1,0,1,0,2,,val
0514337_as-0050330.jpg,2,0,1,2,5,,val
0514338_as-0050330.jpg,3,0,1,2,6,,test
0514339_as-0050330.jpg,4,0,1,1,6,,train
0514340_as-0050330.jpg,2,0,1,2,5,,train
0514341_as-0050330.jpg,1,0,1,1,3,,train
0514342_as-0050330.jpg,3,0,0,3,6,,train
0514343_as-0050330.jpg,1,0,0,1,2,,train
0514344_as-0050330.jpg,2,1,0,2,5,,train
0514345_as-2995449.jpg,2,0,0,0,2,,train
0514346_sc-1017210.jpg,3,0,0,0,3,,val
0514347_sc-1017210.jpg,1,1,0,0,2,,val
0514348_sc-1017210.jpg,2,0,0,0,2,,test
0514349_sc-1017210.jpg,0,2,1,0,3,,train
0514350_sc-1017210.jpg,2,0,0,0,2,,train
0514351_sc-1017210.jpg,5,0,1,0,6,,train
0514352_sc-1017210.jpg,1,1,1,0,3,,train
0514353_as-2783162.jpg,1,0,1,0,2,,train
0514356_sc-138952.jpg,1,0,0,1,2,,train
0514357_as-0073924.jpg,1,0,0,0,1,,train
0514358_as-0073924.jpg,1,0,0,1,2,,val
0514362_as-3497940.jpg,1,0,0,0,1,,val
0514363_as-0090302.jpg,1,0,0,0,1,,test
0514369_as-0084369.jpg,4,0,2,1,7,,train
0514371_as-0084369.jpg,4,0,2,2,8,,train
0514372_as-0084369.jpg,3,0,1,2,6,,train
0514373_as-0084369.jpg,3,0,2,3,8,,train
0514374_as-0080195.jpg,1,0,0,0,1,,train
0514375_as-2985500.jpg,0,0,1,0,1,,train
0514377_as-0006199.jpg,1,0,0,0,1,,train
0514379_sc-183077.jpg,4,0,0,0,4,,val
0514380_sc-206261.jpg,5,2,2,1,10,,val
0514381_sc-206261.jpg,3,2,3,1,9,,test
0514382_sc-206261.jpg,2,2,1,1,6,,train
0514383_sc-206261.jpg,1,0,0,0,1,,train
0514384_sc-206261.jpg,2,0,0,0,2,,train
0514385_sc-206261.jpg,1,0,0,0,1,,train
0514386_sc-206261.jpg,4,1,0,2,7,,train
0514387_sc-113446.jpg,2,2,0,0,4,,train
0514388_sc-113446.jpg,2,1,0,1,4,,train
0514389_sc-139177.jpg,3,0,2,0,5,,val
0514390_sc-139177.jpg,2,1,0,0,3,,val
0514391_sc-139177.jpg,3,1,1,0,5,,test
0514392_sc-1031808.jpg,4,1,1,0,6,,train
0514393_sc-1031808.jpg,2,0,0,0,2,,train
0514394_sc-1031808.jpg,1,0,1,0,2,,train
0514395_sc-1031808.jpg,1,1,1,0,3,,train
0514396_sc-1031808.jpg,2,1,1,0,4,,train
0514398_sc-1031808.jpg,4,0,0,0,4,,train
0514399_as-3306908.jpg,2,0,0,0,2,,train
0514400_as-3389606.jpg,2,0,1,1,4,,val
0514401_as-3363230.jpg,1,2,3,3,9,,val
0514402_as-0035936.jpg,0,0,1,0,1,,test
0514403_sc-1021755.jpg,1,0,0,0,1,,train
0514404_sc-1021755.jpg,1,0,0,0,1,,train
0514406_as-2700310.jpg,7,0,0,0,7,,train
0514407_sc-125786.jpg,1,0,0,0,1,,train
0514408_sc-125786.jpg,1,0,0,0,1,,train
0514409_sc-1026894.jpg,7,0,0,0,7,,train
0514410_sc-1026894.jpg,3,0,1,1,5,,train
0514411_sc-1026894.jpg,6,0,0,1,7,,val
0514412_sc-1026894.jpg,6,0,1,0,7,,val
0514415_sc-1026894.jpg,4,0,0,0,4,,test
0514416_sc-1026894.jpg,2,0,0,0,2,,train
0514417_sc-1026894.jpg,7,0,0,0,7,,train
0514418_sc-1026894.jpg,3,0,0,1,4,,train
0514420_sc-1026894.jpg,9,0,0,0,9,,train
0514421_as-2655795.jpg,1,0,0,1,2,,train
0514422_as-7225502.jpg,1,0,1,1,3,,train
0514424_sc-214382.jpg,1,1,0,0,2,,train
0514425_sc-214382.jpg,2,0,0,0,2,,val
0514426_as-2995336.jpg,2,3,1,3,9,,val
0514427_as-3463554.jpg,3,3,1,1,8,,test
0514428_as-7591892.jpg,0,0,2,0,2,,train
0514429_sc-1014769.jpg,1,3,0,0,4,,train
0514430_sc-1014769.jpg,1,3,0,0,4,,train
0514431_sc-1014769.jpg,4,1,0,0,5,,train
0514433_sc-1014769.jpg,9,4,0,0,13,,train
0514435_as-2746950.jpg,2,1,0,0,3,,train
0514436_as-3450778.jpg,1,1,2,0,4,,train
0514437_as-7875024.jpg,1,1,3,0,5,,val
0514438_as-3458834.jpg,1,0,1,0,2,,val
0514439_sc-223944.jpg,2,2,1,1,6,,test
0514440_sc-223944.jpg,0,0,1,0,1,,train
0514441_as-3386759.jpg,1,0,1,1,3,,train
0514442_sc-196002.jpg,0,0,1,0,1,,train
0514444_sc-123599.jpg,2,1,3,0,6,,train
0514445_sc-123599.jpg,4,0,1,0,5,,train
0514446_sc-104623.jpg,1,1,0,0,2,,train
0514447_sc-104623.jpg,1,2,1,0,4,,train
0514448_sc-104623.jpg,2,1,1,0,4,,val
0514449_sc-104623.jpg,1,2,1,0,4,,val
0514450_sc-104623.jpg,2,1,0,0,3,,test
0514451_as-7080597.jpg,1,0,1,0,2,,train
0514452_sc-168461.jpg,1,1,0,0,2,,train
0514453_sc-168461.jpg,0,1,0,0,1,,train
0514454_as-0031854.jpg,4,0,0,0,4,,train
0514455_as-7282074.jpg,2,0,0,1,3,,train
0514458_as-0022360.jpg,2,1,2,0,5,,train
0514459_as-0022360.jpg,3,2,1,0,6,,train
0514460_as-0022360.jpg,0,2,1,0,3,,val
0514461_as-0022360.jpg,1,1,2,0,4,,val
0514462_as-0022360.jpg,0,0,1,0,1,,test
0514463_as-0022360.jpg,0,0,1,0,1,,train
0514464_as-0022360.jpg,0,0,1,0,1,,train
0514465_as-0022360.jpg,2,0,0,0,2,,train
0514467_sc-174496.jpg,2,0,0,0,2,,train
0514468_sc-174496.jpg,2,0,0,0,2,,train
0514469_sc-174496.jpg,3,0,0,0,3,,train
0514470_as-3244072.jpg,6,1,0,0,7,,train
0514472_as-0094871.jpg,1,0,0,1,2,,val
0514473_sc-117368.jpg,5,0,0,0,5,,val
0514474_sc-117368.jpg,3,0,0,0,3,,test
0514475_as-7431776.jpg,2,1,0,0,3,,train
0514476_as-0088009.jpg,1,0,0,0,1,,train
0514477_as-0088009.jpg,1,0,0,0,1,,train
0514478_as-0088009.jpg,2,0,0,0,2,,train
0514479_as-0088009.jpg,1,0,0,0,1,,train
0514481_sc-172417.jpg,3,2,2,1,8,,train
0514482_sc-172417.jpg,5,1,1,1,8,,train
0514484_sc-215590.jpg,1,0,2,0,3,,val
0514485_sc-215590.jpg,0,1,2,0,3,,val
0514486_sc-215590.jpg,0,1,2,0,3,,test
0514487_sc-215590.jpg,0,0,1,0,1,,train
0514488_as-3064024.jpg,1,0,0,0,1,,train
0514489_sc-202133.jpg,3,0,0,2,5,,train
0514490_sc-202133.jpg,3,0,0,0,3,,train
0514491_sc-202133.jpg,2,0,0,0,2,,train
0514492_sc-202133.jpg,1,0,0,0,1,,train
0514493_sc-202133.jpg,1,0,0,0,1,,train
0514494_sc-202133.jpg,1,0,0,0,1,,val
0514495_sc-202133.jpg,4,0,0,0,4,,val
0514496_sc-202133.jpg,2,0,0,0,2,,test
0514497_sc-202133.jpg,2,0,0,0,2,,train
0514498_sc-202133.jpg,1,0,0,0,1,,train
0514499_sc-202133.jpg,2,0,0,0,2,,train
0514500_sc-202133.jpg,2,0,0,0,2,,train
0514501_sc-202133.jpg,3,0,0,0,3,,train
0514502_sc-202133.jpg,2,0,0,0,2,,train
0514503_sc-202133.jpg,1,0,0,0,1,,train
0514504_sc-202133.jpg,1,0,0,0,1,,val
0514505_sc-202133.jpg,4,0,0,0,4,,val
0514506_sc-202133.jpg,1,0,0,0,1,,test
0514507_sc-202133.jpg,1,0,0,0,1,,train
0514508_sc-202133.jpg,4,0,0,0,4,,train
0514509_sc-161504.jpg,2,0,0,1,3,,train
0514510_sc-161504.jpg,2,0,0,1,3,,train
0514511_as-0012721.jpg,1,1,1,0,3,,train
0514512_as-0012721.jpg,2,1,0,0,3,,train
0514513_as-0012721.jpg,1,0,1,0,2,,train
0514514_as-0012721.jpg,0,0,1,0,1,,val
0514515_as-0012721.jpg,1,0,1,0,2,,val
0514516_as-0012721.jpg,1,1,0,0,2,,test
0514519_sc-109268.jpg,3,0,0,1,4,,train
0514520_sc-109268.jpg,3,0,1,1,5,,train
0514522_as-0057390.jpg,1,0,0,1,2,,train
0514523_as-0057390.jpg,1,0,0,1,2,,train
0514525_as-0044625.jpg,1,0,0,0,1,,train
0514526_as-0044625.jpg,1,0,0,0,1,,train
0514527_as-2930668.jpg,0,1,0,0,1,,train
0514528_sc-111325.jpg,1,0,0,0,1,,val
0514529_sc-103241.jpg,1,0,0,0,1,,val
0514530_sc-103241.jpg,1,0,0,0,1,,test
0514531_as-3268794.jpg,2,1,0,0,3,,train
0514532_as-3109952.jpg,1,0,0,1,2,,train
0514533_as-3428404.jpg,3,1,0,1,5,,train
0514534_sc-209996.jpg,3,2,0,1,6,,train
0514535_sc-209996.jpg,3,1,0,0,4,,train
0514536_sc-209996.jpg,6,1,0,0,7,,train
0514537_as-7293328.jpg,1,0,0,0,1,,train
0514538_as-0035085.jpg,2,0,0,0,2,,val
0514539_as-0035085.jpg,1,0,0,0,1,,val
0514540_as-0035085.jpg,2,0,0,0,2,,test
0514541_as-0035085.jpg,4,0,0,0,4,,train
0514542_as-0035085.jpg,5,1,1,0,7,,train
0514543_as-0035085.jpg,2,1,1,0,4,,train
0514544_as-0035085.jpg,4,1,1,0,6,,train
0514545_as-0035085.jpg,3,1,1,0,5,,train
0514546_as-0035085.jpg,6,1,1,0,8,,train
0514548_sc-111940.jpg,3,0,0,0,3,,train
0514549_sc-111940.jpg,1,0,0,0,1,,val
0514551_sc-111940.jpg,2,0,0,0,2,,val
0514552_sc-111940.jpg,3,0,0,0,3,,test
0514553_sc-111940.jpg,3,0,0,0,3,,train
0514554_sc-111940.jpg,2,0,0,0,2,,train
0514555_sc-111940.jpg,1,0,0,0,1,,train
0514560_sc-146532.jpg,2,0,0,0,2,,train
0514561_sc-146532.jpg,2,0,0,0,2,,train
0514562_as-2790293.jpg,1,0,1,0,2,,train
0514563_sc-134775.jpg,1,0,0,1,2,,train
0514565_sc-134775.jpg,2,0,0,0,2,,val
0514566_as-0058838.jpg,1,0,0,0,1,,val
0514567_as-0058838.jpg,1,0,0,0,1,,test
0514568_as-0058838.jpg,1,0,0,0,1,,train
0514570_as-0061163.jpg,1,0,0,0,1,,train
0514571_as-0061163.jpg,1,0,0,0,1,,train
0514572_sc-1004494.jpg,3,0,0,0,3,,train
0514574_as-0004874.jpg,3,0,0,0,3,,train
0514575_as-0004874.jpg,6,0,0,0,6,,train
0514576_as-0004874.jpg,4,0,0,0,4,,train
0514578_sc-191262.jpg,3,1,1,0,5,,val
0514580_sc-191262.jpg,0,0,2,1,3,,val
0514581_sc-191262.jpg,6,1,1,0,8,,test
0514582_sc-191262.jpg,3,2,0,0,5,,train
0514583_as-0093708.jpg,2,0,0,0,2,,train
0514584_as-0078450.jpg,1,0,1,0,2,,train
0514586_as-0078450.jpg,1,0,2,0,3,,train
0514587_as-0078450.jpg,1,3,0,0,4,,train
0514588_sc-204802.jpg,3,0,1,1,5,,train
0514589_sc-204802.jpg,2,0,1,0,3,,train
0514590_sc-204802.jpg,2,0,0,0,2,,val
0514591_sc-204802.jpg,1,0,0,0,1,,val
0514592_sc-204802.jpg,2,0,0,0,2,,test
0514593_sc-204802.jpg,1,0,0,0,1,,train
0514594_sc-204802.jpg,2,0,0,0,2,,train
0514595_sc-204802.jpg,3,0,0,0,3,,train
0514596_sc-165593.jpg,7,0,0,0,7,,train
0514597_sc-165593.jpg,4,0,0,0,4,,train
0514598_sc-165593.jpg,5,0,0,0,5,,train
0514599_sc-165593.jpg,3,0,0,0,3,,train
0514600_sc-165593.jpg,1,0,0,0,1,,val
0514602_sc-165593.jpg,7,0,0,0,7,,val
0514603_sc-105225.jpg,2,2,0,0,4,,test
0514605_as-0004162.jpg,1,0,2,2,5,,train
0514606_as-0085814.jpg,3,0,1,0,4,,train
0514607_sc-119987.jpg,2,0,1,0,3,,train
0514608_sc-119987.jpg,1,0,1,0,2,,train
0514609_sc-119987.jpg,1,0,1,0,2,,train
0514610_sc-223764.jpg,13,3,1,0,17,,train
0514611_sc-223764.jpg,3,0,2,2,7,,train
0514612_sc-223764.jpg,8,0,2,2,12,,val
0514613_sc-223764.jpg,4,1,3,0,8,,val
0514614_sc-223764.jpg,7,1,2,0,10,,test
0514615_sc-223764.jpg,3,0,0,0,3,,train
0514616_sc-223764.jpg,1,0,0,0,1,,train
0514617_sc-223764.jpg,1,0,0,0,1,,train
0514621_as-0004086.jpg,0,0,1,0,1,,train
0514623_sc-187513.jpg,1,0,0,0,1,,train
0514624_sc-120607.jpg,2,0,0,0,2,,train
0514625_sc-120607.jpg,5,0,1,3,9,,train
0514626_as-0032236.jpg,1,0,0,0,1,,val
0514628_sc-132758.jpg,4,0,2,1,7,,val
0514630_sc-132758.jpg,5,0,1,1,7,,test
0514631_sc-132758.jpg,2,0,1,0,3,,train
0514632_sc-132758.jpg,1,0,1,0,2,,train
0514633_sc-132758.jpg,2,0,1,0,3,,train
0514634_sc-132758.jpg,1,0,1,3,5,,train
0514636_as-0067559.jpg,2,1,0,1,4,,train
0514637_as-0067559.jpg,3,1,0,1,5,,train
0514638_sc-1003040.jpg,1,1,0,0,2,,train
0514639_sc-1003040.jpg,3,0,0,0,3,,val
0514640_sc-1003040.jpg,6,2,0,1,9,,val
0514643_sc-1002090.jpg,1,1,0,1,3,,test
0514644_sc-1002090.jpg,3,0,0,1,4,,train
0514645_sc-1002090.jpg,1,1,0,1,3,,train
0514646_as-0009453.jpg,4,0,0,0,4,,train
0514647_as-2909798.jpg,1,2,0,0,3,,train
0514648_sc-155306.jpg,2,0,2,0,4,,train
0514649_sc-155306.jpg,1,0,2,0,3,,train
0514650_sc-155306.jpg,2,0,2,0,4,,train
0514651_sc-104548.jpg,3,0,0,0,3,,val
0514652_sc-104548.jpg,2,0,0,0,2,,val
0514653_as-3453791.jpg,0,2,0,0,2,,test
0514654_sc-222035.jpg,1,0,0,0,1,,train
0514655_sc-222035.jpg,2,0,0,0,2,,train
0514656_sc-222035.jpg,1,1,1,0,3,,train
0514657_sc-222035.jpg,2,0,0,0,2,,train
0514658_sc-222035.jpg,1,0,0,0,1,,train
0514659_sc-222035.jpg,2,0,0,0,2,,train
0514660_sc-222035.jpg,1,0,0,0,1,,train
0514661_sc-222035.jpg,1,0,0,0,1,,val
0514662_sc-222035.jpg,2,0,0,0,2,,val
0514663_sc-222035.jpg,1,0,0,0,1,,test
0514664_sc-222035.jpg,1,0,0,0,1,,train
0514665_sc-222035.jpg,2,0,0,0,2,,train
0514666_sc-222035.jpg,1,0,0,0,1,,train
0514667_sc-222035.jpg,2,0,0,0,2,,train
0514668_sc-222035.jpg,1,0,0,0,1,,train
0514669_sc-222035.jpg,3,0,1,0,4,,train
0514670_sc-222035.jpg,1,1,1,0,3,,train
0514671_sc-222035.jpg,2,0,0,0,2,,val
0514672_sc-222035.jpg,2,0,0,0,2,,val
0514673_sc-222035.jpg,2,0,0,0,2,,test
0514674_sc-222035.jpg,1,0,0,0,1,,train
0514675_sc-222035.jpg,1,0,0,0,1,,train
0514676_as-2970790.jpg,1,0,0,0,1,,train
0514677_as-2856939.jpg,2,0,0,1,3,,train
0514679_as-7198503.jpg,1,0,1,1,3,,train
0514682_as-0048475.jpg,2,0,0,0,2,,train
0514683_as-0048475.jpg,3,0,0,0,3,,train
0514684_as-0048475.jpg,2,0,0,0,2,,val
0514685_as-0048475.jpg,3,0,0,0,3,,val
0514686_as-0048475.jpg,2,0,0,0,2,,test
0514687_as-0048475.jpg,2,1,0,0,3,,train
0514688_as-0048475.jpg,3,1,0,0,4,,train
0514689_as-2563925.jpg,1,0,0,1,2,,train
0514690_as-2555632.jpg,3,1,2,1,7,,train
0514691_as-2537167.jpg,1,0,0,0,1,,train
0514696_as-0043829.jpg,1,1,1,1,4,,train
0514697_as-2543301.jpg,2,0,0,0,2,,train
0514699_sc-208738.jpg,1,0,0,0,1,,val
0514700_sc-208738.jpg,2,1,0,0,3,,val
0514701_sc-208738.jpg,4,0,0,0,4,,test
0514702_sc-208738.jpg,1,0,0,1,2,,train
0514703_as-0036848.jpg,0,1,3,0,4,,train
0514704_as-0036848.jpg,7,0,0,0,7,,train
0514706_as-0036848.jpg,4,0,0,0,4,,train
0514707_as-0036848.jpg,3,0,0,1,4,,train
0514708_as-0036848.jpg,8,0,0,1,9,,train
0514709_as-0036848.jpg,2,0,0,1,3,,train
0514710_as-0036848.jpg,2,0,0,0,2,,val
0514711_as-0036848.jpg,2,0,0,0,2,,val
0514712_as-0036848.jpg,4,0,1,2,7,,test
0514713_as-0036848.jpg,4,0,1,1,6,,train
0514714_as-0036848.jpg,11,0,0,0,11,,train
0514716_as-0036848.jpg,4,0,2,1,7,,train
0514717_as-0036848.jpg,7,3,4,2,16,,train
0514718_as-0036848.jpg,11,2,5,1,19,,train
0514719_as-0036848.jpg,7,2,3,3,15,,train
0514720_as-0060862.jpg,1,0,0,0,1,,train
0514721_as-0060862.jpg,1,0,0,0,1,,val
0514722_as-0011506.jpg,2,0,0,0,2,,val
0514723_as-0011506.jpg,1,0,0,0,1,,test
0514724_as-0011506.jpg,1,0,0,0,1,,train
0514725_as-0011506.jpg,1,0,0,1,2,,train
0514726_as-0011506.jpg,2,0,0,0,2,,train
0514727_as-0011506.jpg,1,1,0,0,2,,train
0514728_as-0011506.jpg,1,0,0,0,1,,train
0514729_as-0011506.jpg,0,1,0,0,1,,train
0514730_sc-133638.jpg,2,0,1,0,3,,train
0514731_sc-133638.jpg,3,0,1,0,4,,val
0514733_as-0039360.jpg,5,0,2,0,7,,val
0514734_as-0039360.jpg,5,0,2,1,8,,test
0514735_as-0039360.jpg,2,1,1,0,4,,train
0514736_as-0039360.jpg,2,0,1,0,3,,train
0514737_as-0039360.jpg,2,0,0,0,2,,train
0514738_as-0039360.jpg,4,0,0,0,4,,train
0514739_as-0039360.jpg,2,0,0,0,2,,train
0514740_as-0039360.jpg,2,0,1,2,5,,train
0514741_as-0039360.jpg,1,0,0,0,1,,train
0514742_sc-122310.jpg,1,0,0,0,1,,val
0514743_sc-122310.jpg,2,1,0,0,3,,val
0514744_sc-122310.jpg,1,0,0,0,1,,test
0514745_sc-122310.jpg,2,0,0,0,2,,train
0514746_sc-122310.jpg,1,0,0,0,1,,train
0514748_sc-122310.jpg,1,0,0,0,1,,train
0514750_as-7857450.jpg,2,1,2,1,6,,train
0514752_as-0045690.jpg,1,0,0,0,1,,train
0514753_as-0045690.jpg,1,0,0,1,2,,train
0514754_as-0045690.jpg,1,0,0,0,1,,train
0514755_as-0045690.jpg,1,0,0,0,1,,val
0514756_as-0045690.jpg,1,0,0,0,1,,val
0514757_as-0045690.jpg,0,1,0,0,1,,test
0514758_as-0045690.jpg,1,0,0,0,1,,train
0514760_sc-1014250.jpg,5,0,0,0,5,,train
0514762_as-0010631.jpg,1,0,1,1,3,,train
0514763_as-0010631.jpg,1,0,1,1,3,,train
0514764_as-0010631.jpg,1,0,1,1,3,,train
0514765_as-0010631.jpg,1,0,1,1,3,,train
0514766_as-0010631.jpg,1,0,1,1,3,,train
0514767_sc-1025070.jpg,1,1,0,0,2,,val
0514768_sc-1025070.jpg,1,2,0,0,3,,val
0514769_as-7312089.jpg,1,0,0,0,1,,test
0514770_sc-211750.jpg,1,0,0,0,1,,train
0514771_sc-211750.jpg,2,0,0,0,2,,train
0514772_sc-211750.jpg,3,0,0,0,3,,train
0514773_sc-211750.jpg,2,0,0,0,2,,train
0514774_sc-211750.jpg,6,0,0,0,6,,train
0514775_sc-211750.jpg,4,0,0,0,4,,train
0514776_sc-211750.jpg,2,0,0,0,2,,train
0514777_sc-211750.jpg,3,0,0,0,3,,val
0514778_sc-211750.jpg,1,0,0,1,2,,val
0514779_sc-211750.jpg,1,0,0,1,2,,test
0514780_sc-211750.jpg,4,0,0,0,4,,train
0514781_sc-211750.jpg,3,0,0,0,3,,train
0514782_sc-211750.jpg,2,0,0,0,2,,train
0514783_sc-211750.jpg,1,0,0,0,1,,train
0514785_as-0074064.jpg,3,0,1,1,5,,train
0514786_as-0074064.jpg,1,0,1,1,3,,train
0514787_as-0074064.jpg,2,0,1,2,5,,train
0514788_as-0074064.jpg,2,0,0,0,2,,val
0514791_sc-197658.jpg,1,0,1,0,2,,val
0514792_sc-197658.jpg,4,0,0,0,4,,test
0514793_sc-197658.jpg,2,0,0,1,3,,train
0514794_sc-197658.jpg,2,0,0,0,2,,train
0514795_sc-197658.jpg,2,0,0,0,2,,train
0514796_sc-197658.jpg,6,0,0,0,6,,train
0514797_sc-197658.jpg,0,2,1,0,3,,train
0514798_as-2609653.jpg,1,0,0,0,1,,train
0514800_as-0096909.jpg,1,0,0,1,2,,train
0514801_as-0096909.jpg,1,0,0,1,2,,val
0514805_sc-192034.jpg,2,0,1,0,3,,val
0514807_sc-192034.jpg,7,0,2,0,9,,test
0514808_sc-192034.jpg,2,0,1,0,3,,train
0514809_sc-192034.jpg,4,0,1,0,5,,train
0514810_sc-192034.jpg,0,1,0,0,1,,train
0514811_sc-192034.jpg,5,0,1,0,6,,train
0514812_sc-1014588.jpg,2,0,0,0,2,,train
0514813_sc-1014588.jpg,4,0,0,1,5,,train
0514814_as-3040365.jpg,1,0,1,0,2,,train
0514815_as-9032522.jpg,1,1,0,0,2,,val
0514816_sc-189916.jpg,2,0,1,0,3,,val
0514817_sc-189916.jpg,2,1,0,0,3,,test
0514818_as-3267862.jpg,1,0,0,0,1,,train
0514819_sc-125697.jpg,1,0,0,0,1,,train
0514820_sc-125697.jpg,1,0,0,0,1,,train
0514821_as-3266654.jpg,2,0,0,1,3,,train
0514824_as-0084518.jpg,1,0,1,0,2,,train
0514825_as-0084518.jpg,1,0,1,0,2,,train
0514827_as-0084518.jpg,1,1,0,0,2,,train
0514828_as-0084518.jpg,0,0,1,0,1,,val
0514829_as-0084518.jpg,0,0,1,0,1,,val
0514830_as-0084518.jpg,0,0,1,0,1,,test
0514831_as-0084518.jpg,1,0,0,0,1,,train
0514832_sc-160673.jpg,3,0,0,0,3,,train
0514833_sc-160673.jpg,1,0,0,0,1,,train
0514834_sc-160673.jpg,2,0,0,0,2,,train
0514835_sc-160673.jpg,2,0,0,0,2,,train
0514836_as-3238237.jpg,2,0,0,0,2,,train
0514837_sc-115964.jpg,3,0,0,0,3,,train
0514838_sc-115964.jpg,1,1,1,0,3,,val
0514839_sc-115964.jpg,1,1,1,0,3,,val
0514841_sc-1000355.jpg,1,0,0,0,1,,test
0514842_sc-1000355.jpg,2,0,0,0,2,,train
0514843_sc-1000355.jpg,2,0,0,0,2,,train
0514844_sc-1000355.jpg,1,0,0,0,1,,train
0514845_sc-1000355.jpg,2,0,0,0,2,,train
0514846_as-2750371.jpg,3,0,1,1,5,,train
0514847_sc-1026215.jpg,5,0,0,0,5,,train
0514849_sc-121789.jpg,3,1,0,1,5,,train
0514850_sc-121789.jpg,3,1,0,1,5,,val
0514851_sc-121789.jpg,3,1,1,1,6,,val
0514852_sc-206627.jpg,1,0,0,0,1,,test
0514853_sc-206627.jpg,1,0,0,0,1,,train
0514854_sc-206627.jpg,2,0,1,1,4,,train
0514856_sc-206627.jpg,2,0,0,0,2,,train
0514857_sc-206627.jpg,1,0,0,0,1,,train
0514859_sc-206627.jpg,1,0,0,1,2,,train
0514863_sc-206627.jpg,1,0,1,0,2,,train
0514864_as-9012177.jpg,0,0,0,1,1,,train
0514865_as-2514627.jpg,3,1,1,0,5,,val
0514867_as-0091575.jpg,0,1,1,1,3,,val
0514868_as-0091575.jpg,0,1,1,1,3,,test
0514869_as-0091575.jpg,0,1,1,1,3,,train
0514870_as-0091575.jpg,0,1,1,1,3,,train
0514871_sc-176341.jpg,3,0,0,0,3,,train
0514872_sc-136053.jpg,0,0,1,0,1,,train
0514873_sc-1029188.jpg,4,0,0,1,5,,train
0514874_sc-1029188.jpg,4,0,0,0,4,,train
0514875_sc-1029188.jpg,9,0,0,1,10,,train
0514876_sc-1029188.jpg,7,0,1,0,8,,val
0514879_sc-142881.jpg,3,0,0,1,4,,val
0514880_sc-142881.jpg,3,0,0,0,3,,test
0514881_sc-142881.jpg,3,0,0,1,4,,train
0514883_as-0087151.jpg,2,0,0,0,2,,train
0514884_as-0087151.jpg,2,0,0,0,2,,train
0514885_as-0087151.jpg,2,0,0,0,2,,train
0514888_sc-156610.jpg,2,0,0,0,2,,train
0514889_sc-156610.jpg,3,0,1,0,4,,train
0514891_as-0018980.jpg,7,3,0,0,10,,train
0514892_as-0018980.jpg,1,1,1,0,3,,val
0514893_as-0018980.jpg,5,3,0,0,8,,val
0514894_as-0018980.jpg,4,3,0,0,7,,test
0514895_as-0018980.jpg,7,0,2,0,9,,train
0514897_as-0018980.jpg,6,0,1,1,8,,train
0514898_as-0018980.jpg,6,0,0,0,6,,train
0514899_as-0018980.jpg,4,0,0,0,4,,train
0514901_sc-168571.jpg,2,0,0,2,4,,train
0514902_sc-168571.jpg,1,0,0,1,2,,train
0514903_as-3478980.jpg,3,0,0,0,3,,train
0514905_as-0087365.jpg,0,2,3,0,5,,val
0514906_sc-1014217.jpg,1,1,2,0,4,,val
0514907_sc-1014217.jpg,2,2,2,0,6,,test
0514908_sc-209707.jpg,3,0,0,0,3,,train
0514909_sc-209707.jpg,1,0,0,0,1,,train
0514910_sc-209707.jpg,1,0,0,0,1,,train
0514911_as-7677663.jpg,2,0,0,0,2,,train
0514912_as-7585280.jpg,1,0,0,0,1,,train
0514914_sc-117596.jpg,2,0,0,0,2,,train
0514915_sc-117596.jpg,2,0,0,0,2,,train
0514916_sc-113701.jpg,1,1,1,0,3,,val
0514917_sc-113701.jpg,2,1,1,1,5,,val
0514919_sc-113701.jpg,10,2,1,1,14,,test
0514920_sc-113701.jpg,3,1,0,0,4,,train
0514921_sc-113701.jpg,1,0,0,0,1,,train
0514922_sc-113701.jpg,1,0,0,0,1,,train
0514923_sc-113701.jpg,3,0,0,0,3,,train
0514924_sc-113701.jpg,4,0,0,1,5,,train
0514925_as-3045336.jpg,0,1,0,0,1,,train
0514926_as-3092954.jpg,3,0,0,2,5,,train
0514927_sc-1020072.jpg,0,0,0,1,1,,val
0514928_sc-157954.jpg,5,1,1,0,7,,val
0514929_sc-157954.jpg,0,2,0,1,3,,test
0514930_sc-129697.jpg,3,0,0,1,4,,train
0514931_sc-129697.jpg,5,0,0,1,6,,train
0514932_as-7014945.jpg,4,0,1,1,6,,train
0514933_as-0083708.jpg,0,2,0,0,2,,train
0514934_as-0083708.jpg,1,0,0,0,1,,train
0514935_as-0083708.jpg,2,0,1,1,4,,train
0514937_sc-119072.jpg,1,0,1,1,3,,train
0514939_sc-119072.jpg,1,0,1,0,2,,val
0514940_sc-119072.jpg,1,0,1,0,2,,val
0514941_sc-119072.jpg,1,0,1,1,3,,test
0514942_sc-209776.jpg,2,0,0,0,2,,train
0514943_sc-209776.jpg,1,0,0,1,2,,train
0514944_sc-121120.jpg,5,0,4,0,9,,train
0514945_sc-121120.jpg,3,0,4,1,8,,train
0514946_sc-121120.jpg,1,0,3,0,4,,train
0514947_as-3487710.jpg,3,0,0,0,3,,train
0514948_as-0020764.jpg,1,0,0,0,1,,train
0514949_as-0020764.jpg,1,0,0,0,1,,val
0514950_sc-164788.jpg,4,0,1,0,5,,val
0514951_sc-164788.jpg,2,0,2,0,4,,test
0514952_sc-164788.jpg,2,0,2,0,4,,train
0514953_sc-164788.jpg,5,0,2,0,7,,train
0514954_sc-164788.jpg,6,0,3,0,9,,train
0514955_sc-164788.jpg,6,0,2,0,8,,train
0514956_sc-164788.jpg,3,0,1,0,4,,train
0514957_sc-164788.jpg,1,1,1,0,3,,train
0514958_sc-164788.jpg,2,1,1,0,4,,train
0514959_sc-164788.jpg,3,1,1,0,5,,val
0514961_sc-1036551.jpg,2,0,1,0,3,,val
0514962_sc-1036551.jpg,0,1,0,0,1,,test
0514963_as-2517210.jpg,2,0,1,0,3,,train
0514965_as-0031175.jpg,1,1,0,0,2,,train
0514966_as-0031175.jpg,4,0,0,0,4,,train
0514968_as-0053271.jpg,4,2,0,0,6,,train
0514969_as-0053271.jpg,2,1,0,0,3,,train
0514970_as-0053271.jpg,3,0,0,0,3,,train
0514971_as-0053271.jpg,1,1,0,0,2,,train
0514972_as-2779679.jpg,0,0,1,0,1,,val
0514974_as-4657687.jpg,1,0,1,1,3,,val
0514975_as-0047243.jpg,1,0,0,0,1,,test
0514976_as-0047243.jpg,1,0,0,0,1,,train
0514977_as-0047243.jpg,1,0,0,0,1,,train
0514978_as-0047243.jpg,1,0,0,0,1,,train
0514979_as-0047243.jpg,2,0,0,0,2,,train
0514981_as-2947452.jpg,0,0,1,0,1,,train
0514982_sc-118332.jpg,6,0,0,0,6,,train
0514983_sc-118332.jpg,1,0,0,0,1,,train
0514985_sc-118332.jpg,2,0,0,0,2,,val
0514986_sc-118332.jpg,4,0,0,0,4,,val
0514987_sc-118332.jpg,5,0,0,0,5,,test
0514988_as-2533465.jpg,2,2,2,1,7,,train
0514989_sc-121325.jpg,1,0,0,0,1,,train
0514990_sc-121325.jpg,1,0,0,0,1,,train
0514991_sc-121325.jpg,1,0,0,0,1,,train
0514996_as-0060383.jpg,1,0,1,0,2,,train
0515000_as-9096944.jpg,2,0,0,0,2,,train
0515001_as-0034629.jpg,2,2,1,2,7,,train
0515003_as-0034629.jpg,2,0,0,1,3,,val
0515004_as-0015880.jpg,1,0,0,1,2,,val
0515005_as-0015880.jpg,2,0,0,2,4,,test
0515006_as-0015880.jpg,1,0,0,2,3,,train
0515007_as-0015880.jpg,2,0,0,2,4,,train
0515008_as-0015880.jpg,1,0,0,0,1,,train
0515009_as-0015880.jpg,2,0,0,1,3,,train
0515010_as-0015880.jpg,1,0,0,0,1,,train
0515011_as-0015880.jpg,0,1,0,0,1,,train
0515012_as-0095760.jpg,4,0,0,0,4,,train
0515013_as-0095760.jpg,3,0,1,1,5,,val
0515018_sc-152916.jpg,9,0,2,0,11,,val
0515019_sc-152916.jpg,8,2,2,0,12,,test
0515020_sc-152916.jpg,13,2,0,0,15,,train
0515021_sc-152916.jpg,0,0,1,0,1,,train
0515022_sc-212852.jpg,1,0,0,0,1,,train
0515023_sc-212852.jpg,2,0,1,0,3,,train
0515024_sc-212852.jpg,1,0,0,1,2,,train
0515026_sc-122001.jpg,1,0,0,0,1,,train
0515028_sc-146696.jpg,2,0,1,2,5,,train
0515029_sc-146696.jpg,1,0,2,2,5,,val
0515030_sc-146696.jpg,2,0,1,2,5,,val
0515032_as-0000510.jpg,1,0,0,1,2,,test
0515033_as-0000510.jpg,3,0,0,0,3,,train
0515034_as-0000510.jpg,2,0,0,0,2,,train
0515038_as-0085886.jpg,3,0,0,1,4,,train
0515039_sc-138473.jpg,3,0,1,0,4,,train
0515040_sc-138473.jpg,3,0,0,0,3,,train
0515041_sc-138473.jpg,2,0,1,0,3,,train
0515042_as-2901699.jpg,4,0,0,1,5,,train
0515043_as-2720898.jpg,4,0,0,1,5,,val
0515044_as-3332744.jpg,2,0,1,0,3,,val
0515045_as-2798836.jpg,8,0,2,1,11,,test
0515046_as-2800826.jpg,1,0,0,0,1,,train
0515047_sc-148611.jpg,3,0,0,0,3,,train
0515048_as-9038421.jpg,1,0,0,0,1,,train
0515049_sc-222380.jpg,4,0,1,0,5,,train
0515050_sc-222380.jpg,3,0,1,0,4,,train
0515051_sc-222380.jpg,1,0,0,0,1,,train
0515052_as-2857523.jpg,1,0,0,1,2,,train
0515054_as-0035053.jpg,5,0,0,0,5,,val
0515055_as-0035053.jpg,3,0,0,0,3,,val
0515056_as-0035053.jpg,1,0,0,1,2,,test
0515057_as-0035053.jpg,4,0,0,0,4,,train
0515059_as-0089077.jpg,1,1,0,0,2,,train
0515060_sc-207366.jpg,0,1,0,0,1,,train
0515061_sc-207366.jpg,0,1,0,0,1,,train
0515062_sc-207366.jpg,1,2,0,0,3,,train
0515063_sc-1023992.jpg,1,1,0,0,2,,train
0515065_sc-1023992.jpg,2,0,0,0,2,,train
0515067_sc-1023992.jpg,2,0,0,0,2,,val
0515069_sc-1018673.jpg,0,1,0,0,1,,val
0515070_as-2514805.jpg,1,0,0,0,1,,test
0515071_as-3399303.jpg,1,0,0,0,1,,train
0515073_sc-106510.jpg,3,4,2,0,9,,train
0515074_sc-106510.jpg,1,3,2,0,6,,train
0515076_sc-192225.jpg,1,0,0,0,1,,train
0515077_sc-129402.jpg,3,0,1,0,4,,train
0515080_sc-129402.jpg,1,0,1,1,3,,train
0515082_sc-129402.jpg,6,2,1,1,10,,train
0515083_as-0096995.jpg,1,0,0,0,1,,val
0515085_as-0022462.jpg,2,0,0,1,3,,val
0515086_as-0022462.jpg,1,0,0,0,1,,test
0515087_as-0022462.jpg,1,0,0,0,1,,train
0515088_as-2555129.jpg,2,0,1,0,3,,train
0515090_as-7132333.jpg,4,1,0,1,6,,train
0515091_as-7764018.jpg,2,0,1,1,4,,train
0515092_as-2570284.jpg,2,0,0,0,2,,train
0515093_as-3375320.jpg,3,0,1,0,4,,train
0515099_sc-108588.jpg,4,0,0,0,4,,train
0515103_as-0021187.jpg,4,0,3,1,8,,val
0515106_as-0087217.jpg,3,0,0,0,3,,val
0515107_as-0087217.jpg,5,0,0,0,5,,test
0515109_sc-122735.jpg,4,0,1,1,6,,train
0515110_sc-122735.jpg,2,0,1,1,4,,train
0515111_sc-122735.jpg,2,0,1,1,4,,train
0515112_sc-122735.jpg,2,0,1,1,4,,train
0515113_sc-122142.jpg,2,0,0,0,2,,train
0515114_sc-122142.jpg,2,0,0,0,2,,train
0515120_as-0027985.jpg,0,0,1,0,1,,train
0515121_as-3064094.jpg,2,0,1,2,5,,val
0515124_as-0041877.jpg,1,0,0,0,1,,val
0515126_as-0076962.jpg,1,1,1,1,4,,test
0515127_as-0076962.jpg,1,1,2,0,4,,train
0515128_as-0076962.jpg,1,1,1,0,3,,train
0515129_as-0076962.jpg,1,1,2,1,5,,train
0515130_as-0076962.jpg,1,1,0,0,2,,train
0515131_as-0076962.jpg,1,1,0,1,3,,train
0515132_as-0076962.jpg,1,0,1,0,2,,train
0515133_as-0076962.jpg,1,0,1,0,2,,train
0515135_as-9061513.jpg,3,0,1,2,6,,val
0515136_as-9061513.jpg,2,0,0,0,2,,val
0515137_sc-157195.jpg,1,1,1,1,4,,test
0515138_sc-157195.jpg,1,1,1,0,3,,train
0515139_sc-157195.jpg,3,1,0,0,4,,train
0515140_sc-157195.jpg,1,2,1,0,4,,train
0515141_as-7251982.jpg,1,1,0,0,2,,train
0515143_sc-1006929.jpg,2,0,0,0,2,,train
0515144_sc-1006929.jpg,1,0,1,0,2,,train
0515145_sc-1006929.jpg,3,1,0,0,4,,train
0515150_as-0079706.jpg,2,0,0,0,2,,val
0515152_as-0079706.jpg,3,1,4,2,10,,val
0515153_as-0079706.jpg,5,0,3,2,10,,test
0515154_sc-103087.jpg,2,0,0,0,2,,train
0515155_sc-103087.jpg,2,0,0,0,2,,train
0515156_sc-110724.jpg,3,0,0,0,3,,train
0515157_sc-110724.jpg,1,0,0,0,1,,train
0515158_sc-110724.jpg,1,0,0,0,1,,train
0515160_sc-113045.jpg,7,0,2,2,11,,train
0515161_sc-113045.jpg,6,0,2,1,9,,train
0515162_as-0099040.jpg,2,0,0,0,2,,val
0515164_as-7133967.jpg,1,1,3,0,5,,val
0515165_as-2508298.jpg,1,0,0,1,2,,test
0515166_as-2508298.jpg,1,0,0,0,1,,train
0515167_sc-1035454.jpg,1,0,0,0,1,,train
0515168_sc-1035454.jpg,1,0,0,2,3,,train
0515169_sc-1035454.jpg,2,0,0,0,2,,train
0515170_sc-1035454.jpg,0,1,0,0,1,,train
0515171_sc-1035454.jpg,1,0,0,0,1,,train
0515174_sc-119294.jpg,3,0,0,1,4,,train
0515175_sc-119294.jpg,3,1,1,0,5,,val
0515176_sc-119294.jpg,2,0,0,0,2,,val
0515177_sc-119294.jpg,2,0,0,1,3,,test
0515178_sc-119294.jpg,2,0,1,0,3,,train
0515179_sc-119294.jpg,2,1,3,0,6,,train
0515180_sc-119294.jpg,5,3,2,1,11,,train
0515181_sc-119294.jpg,5,1,1,1,8,,train
0515182_sc-119294.jpg,1,0,1,0,2,,train
0515185_as-0069443.jpg,3,0,1,1,5,,train
0515186_as-0069443.jpg,3,0,1,1,5,,train
0515187_as-3028427.jpg,0,0,1,0,1,,val
0515188_as-0084501.jpg,0,0,1,0,1,,val
0515189_as-0084501.jpg,1,0,1,0,2,,test
0515191_as-0084501.jpg,0,1,0,0,1,,train
0515192_sc-1007561.jpg,2,0,0,0,2,,train
0515193_sc-1007561.jpg,0,2,1,0,3,,train
0515194_sc-1007561.jpg,3,0,0,0,3,,train
0515197_sc-1007561.jpg,0,1,2,0,3,,train
0515198_as-2941685.jpg,3,0,1,2,6,,train
0515199_sc-228982.jpg,2,0,0,1,3,,train
0515200_sc-228982.jpg,1,0,1,0,2,,val
0515201_sc-228982.jpg,1,0,1,0,2,,val
0515202_sc-223945.jpg,3,0,0,1,4,,test
0515204_sc-1033268.jpg,2,0,0,0,2,,train
0515205_sc-1033268.jpg,2,0,1,0,3,,train
0515206_sc-1031591.jpg,5,0,2,1,8,,train
0515207_sc-1031591.jpg,8,3,0,2,13,,train
0515208_sc-1031591.jpg,1,0,0,0,1,,train
0515209_sc-1031591.jpg,2,1,0,0,3,,train
0515210_sc-1031591.jpg,8,2,0,0,10,,train
0515211_sc-1031591.jpg,3,1,1,0,5,,val
0515213_sc-1031591.jpg,3,0,0,0,3,,val
0515214_sc-230252.jpg,2,0,1,0,3,,test
0515215_sc-230252.jpg,3,1,2,0,6,,train
0515217_sc-217711.jpg,0,1,0,0,1,,train
0515218_sc-217711.jpg,1,0,0,0,1,,train
0515219_sc-1038924.jpg,4,0,0,0,4,,train
0515220_sc-1038924.jpg,6,2,3,1,12,,train
0515221_sc-1038924.jpg,3,0,2,3,8,,train
0515222_sc-1038924.jpg,2,4,3,1,10,,train
0515223_sc-1038924.jpg,2,2,3,1,8,,val
0515224_as-0006040.jpg,1,0,0,0,1,,val
0515225_as-0058400.jpg,1,0,0,0,1,,test
0515227_as-0084187.jpg,2,0,1,0,3,,train
0515228_as-0084187.jpg,1,0,1,0,2,,train
0515229_as-0084187.jpg,2,0,0,0,2,,train
0515230_as-2767633.jpg,1,0,0,0,1,,train
0515232_sc-1012746.jpg,2,0,0,0,2,,train
0515236_sc-226037.jpg,3,0,2,0,5,,train
0515237_sc-226037.jpg,4,0,2,0,6,,train
0515238_sc-226037.jpg,2,0,2,0,4,,val
0515239_sc-226037.jpg,5,1,1,0,7,,val
0515240_sc-226037.jpg,3,1,1,0,5,,test
0515241_as-7602675.jpg,6,0,1,1,8,,train
0515242_sc-143965.jpg,0,0,0,1,1,,train
0515243_as-0001040.jpg,0,0,2,0,2,,train
0515244_as-0001040.jpg,4,0,2,1,7,,train
0515245_as-0001040.jpg,0,0,1,0,1,,train
0515246_as-0098566.jpg,3,0,1,0,4,,train
0515247_as-0098566.jpg,5,0,1,0,6,,train
0515248_as-3269854.jpg,1,0,0,0,1,,val
0515250_sc-143242.jpg,5,1,0,0,6,,val
0515251_sc-143242.jpg,7,2,0,0,9,,test
0515252_sc-143242.jpg,1,3,0,0,4,,train
0515253_as-3339544.jpg,4,0,1,2,7,,train
0515256_as-0077950.jpg,3,1,0,1,5,,train
0515257_as-0077950.jpg,2,2,1,0,5,,train
0515258_as-0077950.jpg,6,1,1,0,8,,train
0515260_sc-160332.jpg,2,0,0,1,3,,train
0515261_sc-160332.jpg,1,0,0,1,2,,train
0515262_sc-160332.jpg,4,0,0,2,6,,val
0515263_sc-160332.jpg,2,0,0,1,3,,val
0515264_sc-160332.jpg,3,0,0,1,4,,test
0515265_sc-160332.jpg,2,0,0,1,3,,train
0515266_sc-160332.jpg,0,0,0,2,2,,train
0515270_as-2756986.jpg,3,0,0,0,3,,train
0515271_sc-147118.jpg,1,2,1,0,4,,train
0515272_sc-147118.jpg,1,2,2,0,5,,train
0515273_sc-147118.jpg,4,1,0,0,5,,train
0515277_sc-1037667.jpg,1,0,0,0,1,,train
0515279_sc-1009811.jpg,1,0,0,0,1,,val
0515280_sc-1009811.jpg,1,0,0,0,1,,val
0515282_as-0076321.jpg,1,0,0,0,1,,test
0515283_as-0076321.jpg,1,0,0,0,1,,train
0515284_as-0076321.jpg,1,0,0,0,1,,train
0515285_as-0076321.jpg,1,0,0,0,1,,train
0515286_as-0076321.jpg,1,0,0,0,1,,train
0515288_as-0076321.jpg,1,0,0,0,1,,train
0515291_as-0073539.jpg,0,1,0,0,1,,train
0515292_as-0073539.jpg,1,0,2,0,3,,train
0515293_as-0073539.jpg,1,0,2,1,4,,val
0515294_sc-142904.jpg,1,0,0,0,1,,val
0515295_sc-142904.jpg,2,0,0,0,2,,test
0515296_sc-142904.jpg,1,0,0,0,1,,train
0515297_sc-1026355.jpg,0,0,2,1,3,,train
0515298_sc-1026355.jpg,1,0,2,1,4,,train
0515299_sc-1026355.jpg,4,0,1,1,6,,train
0515301_sc-173065.jpg,2,0,0,0,2,,train
0515302_sc-173065.jpg,2,0,1,0,3,,train
0515303_sc-211012.jpg,2,0,0,0,2,,train
0515304_sc-211012.jpg,1,0,0,0,1,,val
0515305_sc-211012.jpg,1,0,0,1,2,,val
0515306_sc-211012.jpg,2,0,0,1,3,,test
0515307_sc-211012.jpg,1,1,0,0,2,,train
0515308_sc-211012.jpg,1,1,0,0,2,,train
0515309_as-2922034.jpg,1,0,1,1,3,,train
0515310_sc-168219.jpg,2,0,0,1,3,,train
0515311_sc-168219.jpg,2,0,0,1,3,,train
0515312_sc-168219.jpg,3,0,0,0,3,,train
0515314_as-0076559.jpg,6,1,1,0,8,,train
0515315_as-2959151.jpg,1,0,1,1,3,,val
0515316_as-0051857.jpg,2,0,0,1,3,,val
0515317_as-0051857.jpg,1,0,0,1,2,,test
0515319_sc-132264.jpg,1,0,0,2,3,,train
0515320_sc-132264.jpg,1,0,0,1,2,,train
0515321_sc-1025157.jpg,2,0,1,1,4,,train
0515322_sc-1025157.jpg,2,0,0,0,2,,train
0515323_sc-1025157.jpg,3,0,1,0,4,,train
0515324_sc-1035864.jpg,1,0,1,0,2,,train
0515325_sc-1034593.jpg,1,0,0,0,1,,train
0515326_sc-1034593.jpg,2,0,0,0,2,,val
0515327_sc-1034593.jpg,3,0,0,0,3,,val
0515328_sc-1034593.jpg,1,0,0,0,1,,test
0515330_sc-1027864.jpg,4,0,0,1,5,,train
0515331_sc-1027864.jpg,5,0,0,0,5,,train
0515332_sc-1027864.jpg,5,0,0,1,6,,train
0515334_as-2625600.jpg,1,0,0,1,2,,train
0515336_sc-194142.jpg,5,0,0,0,5,,train
0515337_sc-194142.jpg,5,0,0,0,5,,train
0515338_sc-194142.jpg,2,0,0,0,2,,train
0515339_as-0084955.jpg,3,0,0,0,3,,val
0515341_as-0084955.jpg,2,0,0,0,2,,val
0515342_as-0084955.jpg,1,0,0,0,1,,test
0515343_as-0084955.jpg,3,0,0,0,3,,train
0515346_as-0075788.jpg,1,0,0,0,1,,train
0515347_sc-132991.jpg,0,1,0,0,1,,train
0515348_as-2921529.jpg,1,0,1,0,2,,train
0515349_sc-145836.jpg,1,0,1,1,3,,train
0515350_sc-145836.jpg,1,0,1,1,3,,train
0515353_sc-1021206.jpg,5,0,1,0,6,,train
0515354_sc-1021206.jpg,2,0,1,0,3,,val
0515356_as-0006101.jpg,0,0,1,0,1,,val
0515357_as-0006101.jpg,2,0,2,0,4,,test
0515358_sc-1012447.jpg,1,0,1,0,2,,train
0515360_as-2749697.jpg,2,0,1,0,3,,train
0515361_sc-156948.jpg,4,0,0,2,6,,train
0515362_sc-156948.jpg,6,0,1,1,8,,train
0515364_sc-156948.jpg,3,0,0,2,5,,train
0515366_sc-156948.jpg,4,0,0,1,5,,train
0515367_sc-1035699.jpg,1,3,1,1,6,,train
0515369_sc-1035699.jpg,2,1,0,1,4,,val
0515370_sc-1029380.jpg,0,0,1,0,1,,val
0515371_sc-1029380.jpg,1,0,0,0,1,,test
0515372_sc-1029380.jpg,1,0,1,0,2,,train
0515373_sc-1029380.jpg,0,0,1,0,1,,train
0515374_as-2764727.jpg,2,0,0,0,2,,train
0515376_sc-133735.jpg,0,0,0,1,1,,train
0515377_sc-1038455.jpg,0,0,1,0,1,,train
0515378_sc-1038455.jpg,0,0,1,0,1,,train
0515379_sc-1038455.jpg,0,0,1,0,1,,train
0515380_sc-1024885.jpg,2,1,0,0,3,,val
0515381_sc-1024885.jpg,1,0,0,0,1,,val
0515382_sc-1024885.jpg,2,1,1,0,4,,test
0515383_as-7647624.jpg,3,0,1,0,4,,train
0515385_sc-129916.jpg,6,0,1,1,8,,train
0515386_sc-161061.jpg,4,0,0,0,4,,train
0515389_sc-161061.jpg,2,0,0,0,2,,train
0515390_sc-161061.jpg,2,0,0,0,2,,train
0515391_sc-161061.jpg,2,0,0,0,2,,train
0515392_sc-161061.jpg,1,0,0,0,1,,train
0515393_as-3061770.jpg,1,0,0,0,1,,val
0515394_sc-133894.jpg,2,1,1,1,5,,val
0515395_sc-171175.jpg,2,0,0,0,2,,test
0515396_sc-171175.jpg,2,0,0,0,2,,train
0515397_sc-186613.jpg,3,3,3,2,11,,train
0515398_sc-133777.jpg,3,0,0,0,3,,train
0515399_sc-133777.jpg,2,0,0,0,2,,train
0515401_as-3189643.jpg,5,0,2,1,8,,train
0515403_sc-226326.jpg,1,5,0,1,7,,train
0515404_sc-192078.jpg,3,0,1,0,4,,train
0515405_sc-192078.jpg,1,0,1,0,2,,val
0515411_as-0078609.jpg,1,0,2,1,4,,val
0515412_as-0078609.jpg,1,1,0,0,2,,test
0515413_as-0078609.jpg,2,1,7,2,12,,train
0515415_as-0078609.jpg,4,3,5,4,16,,train
0515417_as-0078609.jpg,1,0,1,2,4,,train
0515418_as-0078609.jpg,0,1,0,0,1,,train
0515419_as-0078609.jpg,3,0,0,0,3,,train
0515420_as-7991113.jpg,2,0,0,0,2,,train
0515421_as-9047270.jpg,2,0,0,0,2,,train
0515422_sc-228987.jpg,1,0,0,0,1,,val
0515423_sc-228987.jpg,4,0,2,5,11,,val
0515424_as-0012504.jpg,1,0,0,0,1,,test
0515425_as-0012504.jpg,1,0,0,0,1,,train
0515426_as-7792028.jpg,0,1,0,0,1,,train
0515427_as-3205368.jpg,3,0,2,0,5,,train
0515429_as-3127449.jpg,2,0,0,0,2,,train
0515430_sc-174254.jpg,1,0,1,0,2,,train
0515431_sc-174254.jpg,5,0,0,0,5,,train
0515432_sc-174254.jpg,1,1,0,1,3,,train
0515433_as-3373844.jpg,1,0,0,0,1,,val
0515434_as-7013121.jpg,1,0,0,1,2,,val
0515435_as-7620944.jpg,6,0,1,0,7,,test
0515436_as-7722399.jpg,1,0,1,0,2,,train
0515438_sc-176350.jpg,3,0,0,0,3,,train
0515439_as-2654745.jpg,5,1,5,0,11,,train
0515440_sc-213968.jpg,2,0,0,1,3,,train
0515441_sc-213968.jpg,3,0,0,1,4,,train
0515442_sc-213968.jpg,3,0,1,1,5,,train
0515443_sc-213968.jpg,1,0,0,0,1,,train
0515444_sc-213968.jpg,1,0,0,0,1,,val
0515445_sc-213968.jpg,1,0,0,0,1,,val
0515446_sc-113671.jpg,2,1,0,0,3,,test
0515447_sc-113671.jpg,1,0,1,0,2,,train
0515451_sc-1027904.jpg,1,0,0,4,5,,train
0515452_as-2699089.jpg,0,0,1,0,1,,train
0515453_sc-1040215.jpg,1,0,1,0,2,,train
0515455_sc-1040215.jpg,2,0,1,0,3,,train
0515456_sc-1016690.jpg,1,1,0,0,2,,train
0515457_sc-1016690.jpg,1,0,1,0,2,,train
0515458_sc-1016690.jpg,1,0,1,0,2,,val
0515459_sc-193869.jpg,2,1,1,0,4,,val
0515460_sc-193869.jpg,4,0,0,0,4,,test
0515461_sc-193869.jpg,3,0,0,0,3,,train
0515462_sc-193869.jpg,1,0,0,0,1,,train
0515463_sc-193869.jpg,3,0,0,0,3,,train
0515464_sc-193869.jpg,4,0,0,0,4,,train
0515465_sc-193869.jpg,2,0,0,0,2,,train
0515466_as-7080633.jpg,1,0,1,1,3,,train
0515468_as-0083351.jpg,1,1,2,1,5,,train
0515470_as-0083351.jpg,0,0,1,0,1,,val
0515471_as-3497494.jpg,1,1,1,1,4,,val
0515473_as-0079822.jpg,2,0,0,0,2,,test
0515476_as-0079822.jpg,3,0,0,1,4,,train
0515477_as-0079822.jpg,1,0,0,1,2,,train
0515478_as-0079822.jpg,1,0,0,1,2,,train
0515479_as-0079822.jpg,1,0,0,1,2,,train
0515480_as-0079822.jpg,2,0,0,0,2,,train
0515481_sc-207587.jpg,7,0,0,0,7,,train
0515482_sc-207587.jpg,3,0,0,0,3,,train
0515483_sc-207587.jpg,2,0,1,1,4,,val
0515484_sc-207587.jpg,2,0,1,1,4,,val
0515486_sc-1037371.jpg,1,0,0,0,1,,test
0515487_sc-1036141.jpg,2,0,0,0,2,,train
0515488_sc-1036141.jpg,1,0,0,0,1,,train
0515489_sc-1036141.jpg,2,0,0,0,2,,train
0515490_sc-1036141.jpg,2,0,0,1,3,,train
0515491_sc-1036141.jpg,3,0,0,1,4,,train
0515492_sc-1036141.jpg,5,0,0,0,5,,train
0515493_sc-1036141.jpg,1,0,0,1,2,,train
0515494_sc-1036141.jpg,1,0,0,1,2,,val
0515495_sc-1036141.jpg,3,0,0,2,5,,val
0515496_as-0063512.jpg,2,0,0,0,2,,test
0515498_as-0063512.jpg,1,0,0,0,1,,train
0515499_as-0063512.jpg,1,0,0,0,1,,train
0515500_as-3295371.jpg,2,0,1,0,3,,train
0515501_as-0075621.jpg,2,1,1,2,6,,train
0515502_as-0075621.jpg,1,0,0,0,1,,train
0515503_sc-127601.jpg,2,0,0,0,2,,train
0515504_sc-1015117.jpg,1,0,0,0,1,,train
0515506_as-3241081.jpg,0,1,0,0,1,,val
0515507_sc-185071.jpg,1,0,1,1,3,,val
0515508_as-3177751.jpg,2,1,0,1,4,,test
0515509_as-0056919.jpg,1,0,0,1,2,,train
0515511_as-0041991.jpg,1,0,0,0,1,,train
0515512_as-0041991.jpg,1,0,0,0,1,,train
0515515_as-0041991.jpg,1,0,0,0,1,,train
0515516_as-0041991.jpg,1,0,0,0,1,,train
0515517_as-0041991.jpg,1,0,1,0,2,,train
0515518_as-0041991.jpg,1,0,0,0,1,,train
0515519_as-2731641.jpg,3,0,1,0,4,,val
0515520_as-0032934.jpg,0,0,2,1,3,,val
0515522_as-0032934.jpg,3,0,0,0,3,,test
0515523_as-0032934.jpg,1,0,0,0,1,,train
0515524_as-0032934.jpg,5,0,0,0,5,,train
0515527_as-0032934.jpg,0,1,0,0,1,,train
0515528_sc-1023511.jpg,1,0,0,0,1,,train
0515529_sc-1023511.jpg,1,0,0,0,1,,train
0515530_as-0047669.jpg,3,0,2,2,7,,train
0515531_as-0047669.jpg,2,0,2,2,6,,train
0515532_as-0047669.jpg,4,0,1,1,6,,val
0515533_as-0047669.jpg,3,0,1,1,5,,val
0515534_as-0047669.jpg,4,0,1,1,6,,test
0515535_as-0047669.jpg,4,0,0,2,6,,train
0515536_sc-129022.jpg,1,0,0,0,1,,train
0515537_sc-129022.jpg,2,0,0,0,2,,train
0515538_as-0073900.jpg,4,1,0,0,5,,train
0515539_as-0073900.jpg,2,2,0,0,4,,train
0515540_as-0073900.jpg,1,1,1,0,3,,train
0515541_as-0073900.jpg,0,1,0,0,1,,train
0515542_as-0073900.jpg,2,0,0,1,3,,val
0515544_as-7215124.jpg,1,0,1,1,3,,val
0515546_sc-114192.jpg,1,0,0,0,1,,test
0515547_sc-114192.jpg,1,0,1,0,2,,train
0515548_sc-114192.jpg,1,0,0,0,1,,train
0515549_sc-114192.jpg,1,0,1,0,2,,train
0515550_sc-114192.jpg,1,0,1,0,2,,train
0515551_sc-114192.jpg,1,0,1,0,2,,train
0515552_sc-114192.jpg,1,0,1,0,2,,train
0515553_sc-114192.jpg,1,0,1,0,2,,train
0515554_as-0100028.jpg,1,0,0,0,1,,val
0515555_as-0100028.jpg,1,0,0,0,1,,val
0515556_sc-1007823.jpg,2,0,0,1,3,,test
0515557_sc-1007823.jpg,1,0,0,1,2,,train
0515558_sc-1007823.jpg,1,0,0,0,1,,train
0515559_sc-1007823.jpg,3,0,0,0,3,,train
0515562_as-0004276.jpg,1,0,1,0,2,,train
0515563_as-0004276.jpg,1,0,0,0,1,,train
0515565_as-0056567.jpg,2,0,0,0,2,,train
0515566_as-0056567.jpg,2,0,1,0,3,,train
0515567_as-3079232.jpg,1,0,0,0,1,,val
0515568_sc-195156.jpg,1,0,0,0,1,,val
0515569_sc-195156.jpg,1,0,0,0,1,,test
0515570_sc-195156.jpg,2,0,0,0,2,,train
0515571_sc-1007722.jpg,1,0,1,0,2,,train
0515572_sc-1007722.jpg,3,0,0,0,3,,train
0515573_sc-1007722.jpg,1,1,0,0,2,,train
0515574_sc-1007722.jpg,2,1,0,0,3,,train
0515575_as-0075886.jpg,1,0,0,1,2,,train
0515576_sc-1040876.jpg,1,0,0,0,1,,train
0515577_sc-1040876.jpg,2,0,0,0,2,,val
0515579_sc-1040876.jpg,2,0,0,0,2,,val
0515580_sc-1040876.jpg,2,0,0,0,2,,test
0515582_sc-1021512.jpg,2,0,0,0,2,,train
0515583_sc-1021512.jpg,1,0,0,0,1,,train
0515584_sc-1021512.jpg,2,0,0,0,2,,train
0515585_sc-1021512.jpg,1,0,0,0,1,,train
0515586_sc-1021512.jpg,2,0,0,0,2,,train
0515587_sc-1021512.jpg,2,0,0,0,2,,train
0515589_as-2616849.jpg,0,0,1,0,1,,train
0515590_sc-1033374.jpg,2,0,0,0,2,,val
0515591_sc-171990.jpg,1,0,0,1,2,,val
0515592_sc-171990.jpg,3,0,0,0,3,,test
0515593_sc-171990.jpg,3,0,0,0,3,,train
0515594_sc-171990.jpg,1,0,0,1,2,,train
0515595_sc-171990.jpg,2,0,0,0,2,,train
0515596_sc-171990.jpg,2,0,0,0,2,,train
0515597_sc-171990.jpg,4,0,0,1,5,,train
0515598_sc-171990.jpg,1,0,0,1,2,,train
0515599_as-0039480.jpg,0,0,2,1,3,,train
0515601_sc-215226.jpg,1,0,0,0,1,,val
0515602_sc-159064.jpg,1,0,0,0,1,,val
0515603_sc-159064.jpg,1,0,0,0,1,,test
0515604_sc-159064.jpg,2,0,0,0,2,,train
0515605_sc-159064.jpg,2,0,1,0,3,,train
0515610_sc-216405.jpg,4,2,0,0,6,,train
0515611_sc-216405.jpg,4,2,0,0,6,,train
0515612_as-0036187.jpg,1,0,0,0,1,,train
0515613_as-0036187.jpg,3,0,0,0,3,,train
0515614_as-0036187.jpg,2,0,0,0,2,,train
0515615_as-0036187.jpg,1,0,0,0,1,,val
0515616_as-0036187.jpg,0,3,0,0,3,,val
0515617_as-0036187.jpg,1,0,0,0,1,,test
0515618_as-0036187.jpg,1,0,0,0,1,,train
0515619_as-0036187.jpg,1,0,0,0,1,,train
0515620_as-0036187.jpg,6,0,0,0,6,,train
0515621_as-0036187.jpg,1,0,0,0,1,,train
0515623_sc-109875.jpg,2,0,0,1,3,,train
0515624_as-0060047.jpg,2,0,0,0,2,,train
0515625_as-0060047.jpg,2,0,0,0,2,,train
0515626_as-0060047.jpg,1,0,0,0,1,,val
0515628_as-0002745.jpg,9,1,0,0,10,,val
0515629_as-0002745.jpg,12,1,1,0,14,,test
0515631_sc-227935.jpg,1,0,1,0,2,,train
0515632_sc-227935.jpg,1,0,1,0,2,,train
0515633_sc-227935.jpg,0,0,1,0,1,,train
0515634_sc-227935.jpg,1,0,1,0,2,,train
0515635_as-3113457.jpg,1,0,0,0,1,,train
0515636_sc-200390.jpg,1,0,1,0,2,,train
0515637_sc-200390.jpg,2,0,0,0,2,,train
0515639_sc-1029126.jpg,1,1,0,0,2,,val
0515640_sc-1029126.jpg,1,1,0,0,2,,val
0515641_sc-1029126.jpg,3,1,0,0,4,,test
0515642_sc-1029126.jpg,2,1,0,0,3,,train
0515643_sc-1029126.jpg,2,0,1,0,3,,train
0515644_as-3170476.jpg,1,1,0,1,3,,train
0515645_sc-1002469.jpg,8,0,0,0,8,,train
0515646_sc-1002469.jpg,8,0,0,0,8,,train
0515647_sc-1002469.jpg,8,0,0,0,8,,train
0515648_as-7023353.jpg,1,4,3,2,10,,train
0515650_sc-154726.jpg,3,0,0,0,3,,val
0515651_sc-154726.jpg,1,0,0,1,2,,val
0515652_sc-154726.jpg,5,0,1,1,7,,test
0515653_sc-154726.jpg,2,0,0,1,3,,train
0515654_sc-154726.jpg,2,0,0,1,3,,train
0515655_sc-154726.jpg,4,0,0,0,4,,train
0515656_sc-154726.jpg,3,0,0,0,3,,train
0515657_sc-154726.jpg,2,0,0,0,2,,train
0515658_sc-154726.jpg,2,1,2,0,5,,train
0515659_sc-154726.jpg,2,0,0,0,2,,train
0515660_sc-154726.jpg,2,1,2,1,6,,val
0515661_sc-154726.jpg,1,0,2,0,3,,val
0515663_sc-162086.jpg,5,0,1,0,6,,test
0515664_sc-162086.jpg,2,0,0,1,3,,train
0515665_sc-162086.jpg,4,0,0,1,5,,train
0515666_sc-162086.jpg,2,0,1,1,4,,train
0515667_sc-162086.jpg,3,0,0,1,4,,train
0515669_sc-162086.jpg,3,0,0,0,3,,train
0515670_sc-162086.jpg,3,0,0,0,3,,train
0515671_sc-162086.jpg,1,0,0,1,2,,train
0515672_sc-162086.jpg,3,0,0,0,3,,val
0515673_sc-162086.jpg,4,0,1,1,6,,val
0515675_sc-203272.jpg,3,0,0,1,4,,test
0515677_sc-203272.jpg,0,0,2,1,3,,train
0515679_as-0003535.jpg,3,1,1,0,5,,train
0515680_as-0003535.jpg,3,0,0,1,4,,train
0515681_as-0003535.jpg,4,2,2,2,10,,train
0515682_as-0003535.jpg,0,1,3,1,5,,train
0515684_sc-1025440.jpg,3,0,0,0,3,,train
0515685_sc-1025440.jpg,6,0,0,0,6,,train
0515687_sc-1025440.jpg,5,0,1,0,6,,val
0515688_sc-1025440.jpg,7,0,0,0,7,,val
0515689_sc-1039578.jpg,2,0,0,0,2,,test
0515690_sc-1039578.jpg,1,0,0,0,1,,train
0515691_sc-1002040.jpg,7,0,0,0,7,,train
0515692_sc-1002040.jpg,7,0,1,0,8,,train
0515693_sc-1002040.jpg,8,0,0,0,8,,train
0515694_sc-1040551.jpg,1,0,1,0,2,,train
0515695_sc-1040551.jpg,4,0,1,0,5,,train
0515696_sc-1040551.jpg,2,0,1,0,3,,train
0515697_sc-1005403.jpg,3,0,2,2,7,,val
0515698_sc-1005403.jpg,1,0,1,2,4,,val
0515699_sc-1022418.jpg,0,0,0,1,1,,test
0515700_sc-1022418.jpg,5,6,0,4,15,,train
0515702_sc-1022418.jpg,1,0,0,1,2,,train
0515703_sc-177807.jpg,6,0,0,0,6,,train
0515704_as-9062967.jpg,3,1,1,1,6,,train
0515706_sc-198008.jpg,1,1,0,0,2,,train
0515707_as-0038702.jpg,2,0,0,0,2,,train
0515708_as-0038702.jpg,2,0,0,0,2,,train
0515709_sc-1017860.jpg,1,0,1,0,2,,val
0515710_sc-1017860.jpg,1,0,1,0,2,,val
0515711_sc-1017860.jpg,1,0,1,1,3,,test
0515713_sc-1017860.jpg,1,0,0,1,2,,train
0515714_sc-1017860.jpg,2,0,1,0,3,,train
0515715_sc-1017860.jpg,2,0,1,0,3,,train
0515716_as-0044263.jpg,1,0,0,0,1,,train
0515718_sc-176129.jpg,0,0,1,0,1,,train
0515720_sc-1029774.jpg,3,0,0,0,3,,train
0515721_sc-1029774.jpg,3,2,0,1,6,,train
0515722_sc-1029774.jpg,3,0,0,1,4,,val
0515723_sc-198126.jpg,2,1,0,0,3,,val
0515725_as-3318915.jpg,4,0,1,1,6,,test
0515726_sc-191676.jpg,1,0,0,0,1,,train
0515727_sc-191676.jpg,1,0,0,0,1,,train
0515728_sc-191676.jpg,1,0,0,0,1,,train
0515729_sc-191676.jpg,2,0,0,0,2,,train
0515730_sc-174483.jpg,0,1,0,0,1,,train
0515732_sc-174483.jpg,1,0,0,1,2,,train
0515733_sc-174483.jpg,0,0,1,1,2,,train
0515735_sc-174483.jpg,0,0,2,0,2,,val
0515736_sc-174483.jpg,1,0,1,1,3,,val
0515738_sc-174483.jpg,0,1,0,0,1,,test
0515739_as-7250805.jpg,1,0,0,0,1,,train
0515740_as-2640382.jpg,2,0,0,1,3,,train
0515742_sc-179634.jpg,1,1,1,0,3,,train
0515744_sc-105169.jpg,1,0,0,0,1,,train
0515746_sc-213973.jpg,3,0,0,0,3,,train
0515747_sc-213973.jpg,2,1,0,0,3,,train
0515748_sc-213973.jpg,1,1,0,0,2,,train
0515749_sc-213973.jpg,3,1,0,0,4,,val
0515750_sc-213973.jpg,3,0,0,0,3,,val
0515751_sc-213973.jpg,4,0,0,0,4,,test
0515752_sc-213973.jpg,1,0,0,0,1,,train
0515754_as-0038659.jpg,2,1,1,0,4,,train
0515756_as-0038659.jpg,1,1,1,0,3,,train
0515757_as-0038659.jpg,1,1,0,0,2,,train
0515758_as-0038659.jpg,1,0,0,0,1,,train
0515759_as-0038659.jpg,1,0,0,0,1,,train
0515761_as-0004147.jpg,1,0,0,1,2,,train
0515763_sc-1031446.jpg,1,1,0,1,3,,val
0515764_sc-1031446.jpg,1,0,0,0,1,,val
0515765_sc-1031446.jpg,1,0,0,0,1,,test
0515767_sc-1031446.jpg,1,0,0,0,1,,train
0515768_sc-1031446.jpg,1,0,0,0,1,,train
0515769_as-0021840.jpg,5,0,3,0,8,,train
0515770_as-0021840.jpg,1,0,2,0,3,,train
0515771_as-0030032.jpg,2,0,0,0,2,,train
0515772_as-0030032.jpg,1,0,0,0,1,,train
0515774_as-3347083.jpg,3,1,1,1,6,,train
0515775_as-0001446.jpg,1,0,0,0,1,,val
0515776_sc-1035837.jpg,3,0,0,0,3,,val
0515777_sc-1035837.jpg,2,0,0,0,2,,test
0515778_as-0063173.jpg,1,0,0,0,1,,train
0515781_sc-177880.jpg,1,0,0,0,1,,train
0515783_as-0041935.jpg,1,0,0,0,1,,train
0515784_as-0041935.jpg,3,2,1,1,7,,train
0515785_as-0041935.jpg,2,1,0,0,3,,train
0515786_as-0098544.jpg,1,0,0,0,1,,train
0515787_as-0098544.jpg,1,0,0,0,1,,train
0515788_as-0098544.jpg,1,0,0,0,1,,val
0515789_as-3421341.jpg,1,0,0,1,2,,val
0515790_sc-158797.jpg,1,0,1,0,2,,test
0515791_sc-158797.jpg,2,0,1,0,3,,train
0515792_sc-158797.jpg,3,0,1,0,4,,train
0515793_sc-162876.jpg,2,0,0,1,3,,train
0515794_sc-162876.jpg,2,0,0,1,3,,train
0515795_sc-162876.jpg,2,0,0,1,3,,train
0515799_sc-1023583.jpg,0,0,2,1,3,,train
0515800_sc-1023583.jpg,3,0,1,1,5,,train
0515801_sc-1023583.jpg,3,0,1,0,4,,val
0515802_sc-155412.jpg,3,0,0,0,3,,val
0515803_sc-155412.jpg,1,0,0,0,1,,test
0515805_sc-182778.jpg,4,0,1,0,5,,train
0515806_sc-182778.jpg,3,0,1,1,5,,train
0515807_sc-182778.jpg,3,0,1,1,5,,train
0515808_as-0070806.jpg,4,0,0,0,4,,train
0515809_as-0070806.jpg,4,0,0,0,4,,train
0515810_as-0070806.jpg,4,0,0,0,4,,train
0515811_as-0070806.jpg,6,0,0,0,6,,train
0515812_as-0070806.jpg,2,0,0,0,2,,val
0515813_as-0070806.jpg,1,1,2,0,4,,val
0515814_as-0070806.jpg,3,0,0,0,3,,test
0515819_as-0049603.jpg,6,0,0,2,8,,train
0515820_as-0049603.jpg,6,0,0,1,7,,train
0515821_as-0049603.jpg,2,0,0,0,2,,train
0515822_as-0049603.jpg,4,0,0,0,4,,train
0515823_as-0049603.jpg,7,0,0,1,8,,train
0515824_as-0049603.jpg,8,0,0,0,8,,train
0515825_as-0049603.jpg,5,0,0,0,5,,train
0515826_as-0049603.jpg,8,1,0,0,9,,val
0515827_as-0049603.jpg,7,1,0,0,8,,val
0515828_as-0049603.jpg,4,1,0,0,5,,test
0515829_as-0049603.jpg,12,1,0,0,13,,train
0515830_as-3047230.jpg,1,0,0,0,1,,train
0515831_as-0030977.jpg,1,0,0,0,1,,train
0515832_sc-202684.jpg,1,0,0,0,1,,train
0515833_sc-202684.jpg,2,0,0,0,2,,train
0515834_sc-202684.jpg,2,0,0,0,2,,train
0515835_sc-202684.jpg,2,0,0,0,2,,train
0515837_as-0096127.jpg,1,0,0,1,2,,val
0515838_as-0096127.jpg,1,0,0,1,2,,val
0515839_as-0096127.jpg,1,0,0,1,2,,test
0515840_as-0096127.jpg,1,0,0,1,2,,train
0515841_as-3303166.jpg,1,0,0,0,1,,train
0515842_sc-137760.jpg,1,1,0,0,2,,train
0515843_as-0032999.jpg,4,0,0,0,4,,train
0515844_as-0032999.jpg,1,0,0,0,1,,train
0515845_as-0032999.jpg,1,0,0,0,1,,train
0515846_as-0032999.jpg,1,0,0,0,1,,train
0515847_as-3217057.jpg,0,2,0,0,2,,val
0515848_sc-127658.jpg,2,0,0,0,2,,val
0515849_sc-127658.jpg,4,0,0,0,4,,test
0515850_sc-203428.jpg,2,0,0,3,5,,train
0515851_sc-203428.jpg,1,0,0,3,4,,train
0515852_sc-203428.jpg,1,0,0,2,3,,train
0515853_as-7033153.jpg,4,0,0,2,6,,train
0515854_as-3158264.jpg,1,0,2,0,3,,train
0515855_sc-1036083.jpg,3,1,0,0,4,,train
0515856_sc-1036083.jpg,4,1,0,0,5,,train
0515858_as-3175408.jpg,1,0,0,0,1,,val
0515859_as-3396996.jpg,1,0,0,0,1,,val
0515863_as-3169094.jpg,0,1,1,0,2,,test
0515865_as-2966340.jpg,0,1,0,0,1,,train
0515868_as-0042300.jpg,0,1,0,0,1,,train
0515869_as-0042300.jpg,1,0,0,0,1,,train
0515870_sc-161244.jpg,4,0,0,0,4,,train
0515871_as-3261266.jpg,2,1,0,0,3,,train
0515872_as-7320342.jpg,3,0,0,2,5,,train
0515876_as-0089210.jpg,0,0,1,0,1,,train
0515877_as-0089210.jpg,0,0,1,0,1,,val
0515878_as-0089210.jpg,0,0,1,0,1,,val
0515879_as-0089210.jpg,0,0,1,0,1,,test
0515880_as-0089210.jpg,0,0,1,0,1,,train
0515881_sc-214914.jpg,0,1,0,0,1,,train
0515882_as-0077582.jpg,2,0,0,0,2,,train
0515883_sc-204779.jpg,2,0,0,1,3,,train
0515884_sc-204779.jpg,2,0,0,1,3,,train
0515885_sc-210316.jpg,1,1,0,0,2,,train
0515886_sc-210316.jpg,1,2,0,0,3,,train
0515887_as-2574141.jpg,1,0,0,0,1,,val
0515889_as-0046866.jpg,2,0,0,0,2,,val
0515890_as-0046866.jpg,1,0,1,0,2,,test
0515891_as-0046866.jpg,0,0,1,0,1,,train
0515892_as-0046866.jpg,2,0,0,0,2,,train
0515893_as-3111112.jpg,1,0,0,2,3,,train
0515895_as-0059765.jpg,1,1,1,0,3,,train
0515896_as-0059765.jpg,4,0,1,0,5,,train
0515897_as-0059765.jpg,2,0,1,0,3,,train
0515898_as-9088738.jpg,3,0,0,0,3,,train
0515899_sc-230054.jpg,4,0,1,0,5,,val
0515900_sc-230054.jpg,4,0,1,0,5,,val
0515901_sc-230054.jpg,4,4,2,0,10,,test
0515902_sc-230054.jpg,3,3,2,0,8,,train
0515903_sc-150706.jpg,2,0,2,2,6,,train
0515905_sc-150706.jpg,2,0,1,2,5,,train
0515906_sc-150706.jpg,1,0,1,1,3,,train
0515909_as-0073314.jpg,1,0,0,0,1,,train
0515910_as-0073314.jpg,1,0,2,1,4,,train
0515911_as-0073314.jpg,1,0,2,1,4,,train
0515912_as-0073314.jpg,1,0,1,1,3,,val
0515913_as-0073314.jpg,1,0,0,0,1,,val
0515914_as-0073314.jpg,1,0,0,0,1,,test
0515915_as-0073314.jpg,3,0,0,0,3,,train
0515916_as-0073314.jpg,3,0,0,0,3,,train
0515917_as-9074074.jpg,2,0,0,1,3,,train
0515918_as-0037314.jpg,0,0,1,0,1,,train
0515919_as-0037314.jpg,0,0,1,0,1,,train
0515920_as-0037314.jpg,0,0,2,0,2,,train
0515921_as-0037314.jpg,0,2,0,1,3,,train
0515922_as-0037314.jpg,0,2,0,1,3,,val
0515923_as-0037314.jpg,1,2,0,1,4,,val
0515924_as-0037314.jpg,0,2,0,0,2,,test
0515925_as-0037314.jpg,0,1,0,0,1,,train
0515926_sc-155742.jpg,2,1,1,0,4,,train
0515927_sc-155742.jpg,0,0,1,0,1,,train
0515928_sc-155742.jpg,1,0,0,0,1,,train
0515929_as-2540156.jpg,2,0,1,0,3,,train
0515930_sc-163097.jpg,2,0,0,0,2,,train
0515931_sc-115352.jpg,1,0,0,0,1,,train
0515932_sc-115352.jpg,1,0,0,0,1,,val
0515934_sc-115352.jpg,1,0,0,0,1,,val
0515935_as-2597833.jpg,2,0,0,0,2,,test
0515936_as-0074926.jpg,0,0,1,0,1,,train
0515938_as-0074926.jpg,3,1,0,0,4,,train
0515941_sc-198284.jpg,1,0,0,1,2,,train
0515942_sc-198284.jpg,2,0,0,1,3,,train
0515943_sc-198284.jpg,1,1,0,1,3,,train
0515944_sc-198284.jpg,3,0,0,0,3,,train
0515946_sc-169394.jpg,1,0,0,0,1,,train
0515948_as-0084400.jpg,0,1,1,0,2,,val
0515949_as-0084400.jpg,2,2,0,0,4,,val
0515950_as-0084400.jpg,1,0,0,0,1,,test
0515951_as-0084400.jpg,0,0,1,0,1,,train
0515953_sc-1023209.jpg,2,0,0,0,2,,train
0515954_sc-1023209.jpg,1,0,0,0,1,,train
0515955_sc-1023209.jpg,1,0,0,0,1,,train
0515956_sc-1023209.jpg,1,0,0,0,1,,train
0515957_sc-138000.jpg,1,0,0,0,1,,train
0515959_sc-138000.jpg,0,0,1,0,1,,train
0515960_as-0014994.jpg,2,0,0,0,2,,val
0515961_as-0014994.jpg,2,0,0,0,2,,val
0515962_sc-230562.jpg,2,0,0,0,2,,test
0515963_as-0055523.jpg,5,0,0,0,5,,train
0515964_sc-119880.jpg,2,0,1,0,3,,train
0515965_sc-139760.jpg,0,1,0,0,1,,train
0515967_sc-225139.jpg,1,1,2,0,4,,train
0515968_sc-225139.jpg,3,1,2,1,7,,train
0515969_sc-225139.jpg,1,0,1,0,2,,train
0515970_as-0063925.jpg,2,2,0,1,5,,train
0515971_as-0063925.jpg,1,2,1,0,4,,val
0515972_as-0063925.jpg,2,4,1,1,8,,val
0515975_sc-1005647.jpg,0,0,1,0,1,,test
0515976_sc-1005647.jpg,2,1,0,0,3,,train
0515977_sc-1005647.jpg,1,1,1,0,3,,train
0515979_as-0051517.jpg,1,0,0,0,1,,train
0515980_as-0051517.jpg,1,0,0,0,1,,train
0515981_sc-225903.jpg,0,0,0,1,1,,train
0515982_sc-158839.jpg,2,0,0,1,3,,train
0515984_as-0058817.jpg,2,0,0,0,2,,train
0515985_as-0058817.jpg,1,0,1,0,2,,val
0515989_as-7577013.jpg,0,1,3,3,7,,val
0515990_sc-156227.jpg,1,0,0,0,1,,test
0515991_sc-156227.jpg,2,0,0,0,2,,train
0515992_sc-156227.jpg,1,0,0,0,1,,train
0515995_as-0020722.jpg,3,1,3,0,7,,train
0515996_as-0020722.jpg,3,0,1,0,4,,train
0515997_as-0020722.jpg,1,0,1,0,2,,train
0515998_as-0020722.jpg,0,0,1,0,1,,train
0515999_as-0020722.jpg,0,0,1,0,1,,train
0516002_as-0032015.jpg,1,0,0,0,1,,val
0516003_as-0032015.jpg,1,0,0,0,1,,val
0516004_as-0032015.jpg,1,0,0,0,1,,test
0516005_as-0032015.jpg,1,0,0,1,2,,train
0516006_as-0032015.jpg,1,0,0,1,2,,train
0516007_as-0032015.jpg,1,0,0,1,2,,train
0516011_as-0072616.jpg,0,0,2,0,2,,train
0516012_as-0072616.jpg,0,2,3,0,5,,train
0516013_as-0072616.jpg,0,0,1,0,1,,train
0516014_as-0072616.jpg,0,1,1,0,2,,train
0516015_as-0072616.jpg,0,0,2,0,2,,val
0516016_as-3132467.jpg,2,0,0,0,2,,val
0516017_as-0036583.jpg,1,0,0,1,2,,test
0516018_as-0036583.jpg,7,0,0,0,7,,train
0516019_as-0036583.jpg,2,0,0,0,2,,train
0516020_sc-212417.jpg,1,0,0,0,1,,train
0516021_as-0076554.jpg,4,0,0,0,4,,train
0516023_as-0076554.jpg,6,0,0,2,8,,train
0516024_sc-1034228.jpg,0,0,0,1,1,,train
0516025_as-0080199.jpg,5,0,0,1,6,,train
0516026_as-0080199.jpg,2,0,0,0,2,,val
0516027_as-0080199.jpg,1,0,0,0,1,,val
0516028_as-0080199.jpg,4,0,0,0,4,,test
0516029_as-0089436.jpg,1,0,0,1,2,,train
0516030_as-0089436.jpg,4,0,0,1,5,,train
0516031_as-0009591.jpg,2,2,3,0,7,,train
0516032_as-0009591.jpg,2,2,4,0,8,,train
0516033_as-0009591.jpg,2,2,3,0,7,,train
0516034_as-0009591.jpg,3,1,3,0,7,,train
0516035_as-0009591.jpg,2,2,3,0,7,,train
0516038_sc-1001438.jpg,1,0,0,1,2,,val
0516039_sc-1001438.jpg,2,0,0,0,2,,val
0516040_sc-1037772.jpg,1,0,1,0,2,,test
0516041_sc-1037772.jpg,4,0,1,0,5,,train
0516042_as-7497665.jpg,1,0,0,0,1,,train
0516044_as-3373686.jpg,1,2,1,0,4,,train
0516047_sc-172219.jpg,2,0,0,0,2,,train
0516048_sc-172219.jpg,3,0,1,1,5,,train
0516049_sc-172219.jpg,7,0,0,1,8,,train
0516050_sc-1027917.jpg,1,0,0,0,1,,train
0516051_sc-1027917.jpg,1,0,0,0,1,,val
0516052_sc-1005086.jpg,2,1,1,0,4,,val
0516053_as-3343392.jpg,1,0,0,0,1,,test
0516054_as-0061539.jpg,3,0,0,1,4,,train
0516056_as-0015788.jpg,1,0,0,0,1,,train
0516058_as-0015788.jpg,1,0,0,0,1,,train
0516062_as-0056757.jpg,3,0,0,1,4,,train
0516063_as-0056757.jpg,4,0,0,1,5,,train
0516066_sc-106180.jpg,2,0,0,0,2,,train
0516067_sc-106180.jpg,2,0,0,0,2,,train
0516068_sc-106180.jpg,2,0,0,0,2,,val
0516071_as-0015260.jpg,4,2,2,1,9,,val
0516072_as-0015260.jpg,1,0,1,1,3,,test
0516073_as-0015260.jpg,1,0,2,0,3,,train
0516076_as-0015260.jpg,2,0,2,1,5,,train
0516077_sc-1002718.jpg,1,1,0,0,2,,train
0516079_sc-130848.jpg,2,2,0,0,4,,train
0516080_sc-130848.jpg,2,2,0,0,4,,train
0516081_sc-130848.jpg,2,0,1,0,3,,train
0516082_sc-130848.jpg,1,1,0,0,2,,train
0516083_sc-130848.jpg,1,1,1,0,3,,val
0516086_sc-161879.jpg,1,0,0,0,1,,val
0516087_sc-161879.jpg,1,0,0,0,1,,test
0516089_sc-161879.jpg,2,1,0,0,3,,train
0516091_sc-161879.jpg,1,1,1,0,3,,train
0516092_sc-148566.jpg,1,0,1,0,2,,train
0516097_as-0028343.jpg,1,0,0,0,1,,train
0516098_as-0028343.jpg,1,0,0,0,1,,train
0516100_as-0077705.jpg,1,1,2,0,4,,train
0516102_as-0043658.jpg,4,2,1,0,7,,train
0516103_as-0001249.jpg,10,0,0,1,11,,val
0516105_as-0066594.jpg,1,0,1,1,3,,val
0516106_as-0066594.jpg,1,1,1,1,4,,test
0516107_as-0066594.jpg,2,0,1,1,4,,train
0516108_as-0066594.jpg,2,0,1,1,4,,train
0516109_as-0066594.jpg,1,0,0,0,1,,train
0516110_as-0066594.jpg,2,0,0,0,2,,train
0516111_as-0066594.jpg,4,0,0,1,5,,train
0516112_as-0027175.jpg,2,0,2,0,4,,train
0516113_as-0027175.jpg,3,1,3,0,7,,train
0516114_as-0017721.jpg,3,0,0,1,4,,val
0516115_as-0017721.jpg,4,0,0,1,5,,val
0516116_as-2736185.jpg,7,0,0,0,7,,test
0516118_sc-114545.jpg,7,0,1,0,8,,train
0516120_as-2917873.jpg,3,0,0,0,3,,train
0516122_sc-186405.jpg,2,0,0,1,3,,train
0516123_sc-186405.jpg,2,0,0,1,3,,train
0516125_sc-151780.jpg,1,1,2,0,4,,train
0516127_sc-113453.jpg,1,1,0,0,2,,train
0516128_sc-113453.jpg,1,1,0,0,2,,train
0516130_as-2943451.jpg,2,1,1,0,4,,val
0516131_as-3289440.jpg,7,0,3,0,10,,val
0516132_sc-202421.jpg,6,1,1,1,9,,test
0516133_sc-202421.jpg,10,1,2,2,15,,train
0516135_sc-202421.jpg,7,1,1,1,10,,train
0516136_sc-202421.jpg,4,1,3,1,9,,train
0516137_sc-202421.jpg,1,0,0,0,1,,train
0516138_sc-202421.jpg,11,1,2,1,15,,train
0516139_sc-202421.jpg,3,0,1,2,6,,train
0516141_as-2832873.jpg,1,1,0,1,3,,train
0516142_sc-215980.jpg,1,0,0,1,2,,val
0516143_sc-215980.jpg,1,1,0,1,3,,val
0516144_as-7206128.jpg,0,0,1,0,1,,test
0516145_as-0085332.jpg,2,0,0,0,2,,train
0516146_as-0085332.jpg,2,0,0,0,2,,train
0516147_as-0085332.jpg,2,0,0,0,2,,train
0516149_as-7071075.jpg,0,0,1,0,1,,train
0516152_sc-109157.jpg,1,0,0,0,1,,train
0516154_sc-168473.jpg,2,1,0,0,3,,train
0516156_sc-1022321.jpg,3,4,3,0,10,,train
0516157_sc-1022321.jpg,3,1,3,0,7,,val
0516158_sc-1022321.jpg,5,1,2,0,8,,val
0516160_as-0095542.jpg,1,0,1,1,3,,test
0516161_sc-1041345.jpg,2,0,2,0,4,,train
0516162_sc-1041345.jpg,1,0,1,0,2,,train
0516163_sc-1041345.jpg,3,1,1,0,5,,train
0516164_sc-222516.jpg,2,0,0,0,2,,train
0516165_sc-222516.jpg,2,0,0,0,2,,train
0516166_sc-222516.jpg,2,0,0,0,2,,train
0516167_sc-222516.jpg,1,0,0,0,1,,train
0516168_sc-222516.jpg,2,0,0,0,2,,val
0516170_as-2571959.jpg,1,0,0,1,2,,val
0516171_sc-175914.jpg,2,0,0,0,2,,test
0516172_sc-175914.jpg,3,0,0,0,3,,train
0516173_as-0033209.jpg,1,0,0,0,1,,train
0516174_as-0033209.jpg,1,0,0,0,1,,train
0516175_as-0033209.jpg,2,0,0,0,2,,train
0516176_as-0033209.jpg,2,0,0,0,2,,train
0516177_as-0033209.jpg,2,0,0,0,2,,train
0516178_as-2570314.jpg,1,0,0,0,1,,train
0516183_as-0021107.jpg,2,0,1,0,3,,val
0516184_as-0021107.jpg,1,0,1,0,2,,val
0516185_as-0021107.jpg,2,0,1,0,3,,test
0516187_as-0021107.jpg,1,0,0,0,1,,train
0516188_as-0021107.jpg,1,1,0,0,2,,train
0516189_as-0047227.jpg,1,1,0,0,2,,train
0516190_as-0047227.jpg,1,0,0,0,1,,train
0516192_sc-109143.jpg,2,0,0,0,2,,train
0516193_sc-109143.jpg,1,0,1,0,2,,train
0516194_sc-109143.jpg,1,0,1,0,2,,train
0516195_sc-109143.jpg,2,0,1,0,3,,val
0516196_sc-109143.jpg,2,1,0,0,3,,val
0516197_sc-109143.jpg,1,2,0,0,3,,test
0516199_as-3440889.jpg,4,2,1,1,8,,train
0516200_sc-205495.jpg,4,0,2,1,7,,train
0516201_sc-205495.jpg,4,0,2,1,7,,train
0516202_sc-205495.jpg,4,0,1,1,6,,train
0516203_sc-205495.jpg,2,0,2,1,5,,train
0516204_sc-205495.jpg,2,0,2,1,5,,train
0516205_as-0054695.jpg,1,0,0,0,1,,train
0516206_as-0054695.jpg,1,0,0,0,1,,val
0516207_as-0054695.jpg,2,0,0,0,2,,val
0516208_as-0054695.jpg,2,0,0,0,2,,test
0516209_as-3139106.jpg,1,0,2,0,3,,train
0516211_sc-217116.jpg,1,0,0,0,1,,train
0516212_sc-217116.jpg,1,0,0,0,1,,train
0516213_sc-217116.jpg,3,0,0,0,3,,train
0516214_sc-217116.jpg,1,0,0,0,1,,train
0516215_as-2540740.jpg,2,0,1,0,3,,train
0516216_sc-1011718.jpg,1,0,0,0,1,,train
0516217_sc-1011718.jpg,3,0,0,1,4,,val
0516218_sc-171533.jpg,1,0,1,0,2,,val
0516219_sc-171533.jpg,1,0,1,0,2,,test
0516220_sc-171533.jpg,1,0,2,0,3,,train
0516221_sc-171533.jpg,1,0,1,0,2,,train
0516222_sc-171533.jpg,1,0,2,0,3,,train
0516224_as-2683503.jpg,1,0,0,0,1,,train
0516225_sc-1016161.jpg,1,0,0,0,1,,train
0516226_as-3289217.jpg,3,1,1,0,5,,train
0516228_sc-1015560.jpg,5,0,0,2,7,,train
0516229_sc-1015560.jpg,0,1,0,0,1,,val
0516230_sc-1015560.jpg,1,0,0,0,1,,val
0516231_sc-140509.jpg,3,0,0,0,3,,test
0516232_sc-137507.jpg,2,0,0,0,2,,train
0516234_sc-137507.jpg,1,0,0,0,1,,train
0516235_sc-203490.jpg,1,0,1,1,3,,train
0516236_as-0056235.jpg,1,0,0,0,1,,train
0516237_as-9050788.jpg,1,0,0,0,1,,train
0516238_sc-1026878.jpg,1,0,1,1,3,,train
0516239_sc-1026878.jpg,1,0,1,0,2,,train
0516240_sc-1026878.jpg,2,0,0,1,3,,val
0516241_sc-1019367.jpg,2,1,0,0,3,,val
0516242_sc-1019367.jpg,4,0,0,0,4,,test
0516243_sc-1019367.jpg,4,0,0,0,4,,train
0516244_sc-1026653.jpg,1,0,1,1,3,,train
0516245_sc-1026653.jpg,1,0,0,1,2,,train
0516246_sc-1026653.jpg,1,0,1,0,2,,train
0516247_sc-1026653.jpg,1,0,0,1,2,,train
0516248_as-2668910.jpg,3,1,0,1,5,,train
0516250_as-0082963.jpg,1,1,0,0,2,,train
0516251_as-0082963.jpg,1,1,1,0,3,,val
0516252_as-0082963.jpg,0,1,1,0,2,,val
0516254_as-0082963.jpg,1,0,0,0,1,,test
0516255_as-0082963.jpg,1,0,0,0,1,,train
0516256_as-0082963.jpg,1,0,0,0,1,,train
0516257_as-0082963.jpg,1,0,0,1,2,,train
0516258_as-0082963.jpg,1,0,0,1,2,,train
0516259_as-0082963.jpg,1,0,0,1,2,,train
0516260_as-0082963.jpg,1,0,0,0,1,,train
0516262_as-0082963.jpg,1,1,0,0,2,,train
0516263_as-0082963.jpg,1,0,0,0,1,,val
0516265_as-0083613.jpg,1,0,1,1,3,,val
0516266_as-0083613.jpg,1,0,0,1,2,,test
0516267_as-5000167.jpg,1,0,1,1,3,,train
0516268_as-2559305.jpg,1,0,0,0,1,,train
0516269_sc-161336.jpg,4,0,0,1,5,,train
0516270_sc-161336.jpg,4,0,0,1,5,,train
0516271_sc-196940.jpg,1,0,0,1,2,,train
0516272_sc-218605.jpg,1,0,0,0,1,,train
0516273_sc-218605.jpg,1,0,0,0,1,,train
0516274_sc-218605.jpg,3,0,0,1,4,,val
0516275_sc-218605.jpg,2,1,2,0,5,,val
0516276_sc-218605.jpg,1,1,2,0,4,,test
0516277_sc-218605.jpg,2,0,3,1,6,,train
0516278_as-2970646.jpg,2,0,0,0,2,,train
0516279_sc-126389.jpg,1,0,0,0,1,,train
0516280_sc-126389.jpg,1,0,0,1,2,,train
0516281_sc-126389.jpg,1,0,0,0,1,,train
0516282_sc-126389.jpg,2,0,0,0,2,,train
0516283_as-2842537.jpg,4,0,0,0,4,,train
0516284_sc-1011640.jpg,1,0,0,0,1,,val
0516285_sc-1011640.jpg,2,0,1,0,3,,val
0516286_sc-1011640.jpg,4,0,1,0,5,,test
0516287_sc-1011640.jpg,3,0,0,0,3,,train
0516288_sc-144691.jpg,2,0,0,0,2,,train
0516289_sc-144691.jpg,3,0,1,0,4,,train
0516290_sc-144691.jpg,1,0,0,1,2,,train
0516291_sc-144691.jpg,5,0,1,1,7,,train
0516292_sc-144691.jpg,2,0,0,0,2,,train
0516293_sc-144691.jpg,2,0,0,0,2,,train
0516294_sc-144691.jpg,0,0,0,1,1,,val
0516295_sc-144691.jpg,1,0,0,2,3,,val
0516296_sc-144691.jpg,2,0,0,1,3,,test
0516299_as-0050871.jpg,1,0,0,0,1,,train
0516300_as-0050871.jpg,1,0,1,0,2,,train
0516301_as-0034248.jpg,1,0,0,0,1,,train
0516302_as-0034248.jpg,3,0,1,0,4,,train
0516303_as-0034248.jpg,3,0,2,0,5,,train
0516306_as-0034248.jpg,1,0,1,0,2,,train
0516307_as-0034248.jpg,2,1,2,2,7,,train
0516308_as-0034248.jpg,1,1,2,1,5,,val
0516309_as-0034248.jpg,1,1,2,1,5,,val
0516310_sc-157078.jpg,1,0,0,0,1,,test
0516312_as-2855844.jpg,2,1,1,1,5,,train
0516314_as-0023162.jpg,1,0,1,0,2,,train
0516315_as-0023162.jpg,1,1,0,0,2,,train
0516316_as-0023162.jpg,1,0,1,0,2,,train
0516317_as-0023162.jpg,1,1,1,0,3,,train
0516318_as-0090873.jpg,1,0,0,0,1,,train
0516319_as-0090873.jpg,1,0,0,0,1,,train
0516320_as-0090873.jpg,1,1,1,0,3,,val
0516321_as-0002024.jpg,6,1,2,1,10,,val
0516322_as-0002024.jpg,2,1,2,1,6,,test
0516323_as-7150242.jpg,1,0,0,0,1,,train
0516324_sc-166721.jpg,5,0,1,1,7,,train
0516326_sc-115725.jpg,0,0,1,0,1,,train
0516327_sc-110768.jpg,0,0,0,1,1,,train
0516328_sc-110768.jpg,2,0,0,0,2,,train
0516329_sc-110768.jpg,2,0,0,0,2,,train
0516330_sc-110768.jpg,0,0,0,1,1,,train
0516331_sc-110768.jpg,0,0,0,1,1,,val
0516332_sc-110768.jpg,0,0,0,3,3,,val
0516333_sc-110768.jpg,1,0,0,1,2,,test
0516334_sc-102980.jpg,3,0,0,0,3,,train
0516335_sc-102980.jpg,2,0,0,0,2,,train
0516336_sc-102980.jpg,3,0,0,0,3,,train
0516339_as-9041753.jpg,1,0,0,1,2,,train
0516340_as-7525121.jpg,1,2,2,1,6,,train
0516342_sc-1026928.jpg,3,2,2,1,8,,train
0516343_sc-1026928.jpg,5,0,1,0,6,,train
0516344_sc-1026928.jpg,6,0,2,2,10,,val
0516345_sc-1026928.jpg,5,0,0,1,6,,val
0516346_sc-1026928.jpg,4,0,1,1,6,,test
0516347_sc-1026928.jpg,6,0,2,0,8,,train
0516348_sc-1026928.jpg,8,1,2,0,11,,train
0516349_sc-105833.jpg,1,2,0,1,4,,train
0516350_sc-105833.jpg,1,2,0,1,4,,train
0516351_sc-105833.jpg,3,1,0,1,5,,train
0516352_as-2719967.jpg,1,0,1,1,3,,train
0516355_sc-115439.jpg,2,0,0,1,3,,train
0516356_sc-115439.jpg,1,1,1,0,3,,val
0516357_sc-115439.jpg,1,1,1,0,3,,val
0516358_sc-210875.jpg,0,0,0,2,2,,test
0516359_sc-210875.jpg,0,0,1,0,1,,train
0516361_sc-210875.jpg,2,0,0,0,2,,train
0516364_as-7579562.jpg,0,1,0,0,1,,train
0516365_sc-130217.jpg,1,1,0,0,2,,train
0516367_sc-165367.jpg,3,0,0,0,3,,train
0516369_sc-165367.jpg,1,1,2,0,4,,train
0516370_sc-165367.jpg,1,0,1,0,2,,train
0516371_sc-165367.jpg,2,0,1,1,4,,val
0516372_sc-165367.jpg,2,0,0,1,3,,val
0516373_sc-165367.jpg,1,0,0,1,2,,test
0516374_sc-165367.jpg,1,0,0,1,2,,train
0516375_sc-165367.jpg,1,0,0,1,2,,train
0516376_sc-165367.jpg,2,0,1,1,4,,train
0516378_as-0027253.jpg,4,3,0,0,7,,train
0516379_as-0027253.jpg,0,2,0,0,2,,train
0516383_as-0044670.jpg,1,0,0,0,1,,train
0516384_as-0044670.jpg,1,0,1,1,3,,train
0516385_as-0044670.jpg,0,0,3,0,3,,val
0516386_as-0044670.jpg,0,0,1,0,1,,val
0516387_as-2982856.jpg,2,0,1,0,3,,test
0516388_sc-106119.jpg,1,0,0,1,2,,train
0516389_sc-106119.jpg,1,0,0,0,1,,train
0516391_sc-106119.jpg,1,0,0,1,2,,train
0516392_sc-106119.jpg,1,0,0,0,1,,train
0516393_sc-106119.jpg,1,0,0,0,1,,train
0516394_sc-106119.jpg,1,0,0,0,1,,train
0516396_sc-106119.jpg,1,0,0,0,1,,train
0516397_sc-106119.jpg,1,0,0,0,1,,val
0516398_as-9023588.jpg,4,0,0,0,4,,val
0516399_sc-186927.jpg,1,0,0,0,1,,test
0516400_sc-186927.jpg,2,0,0,0,2,,train
0516401_sc-186927.jpg,1,0,0,1,2,,train
0516402_sc-186927.jpg,1,0,0,0,1,,train
0516403_sc-186927.jpg,1,0,0,0,1,,train
0516404_sc-186927.jpg,1,0,0,0,1,,train
0516405_sc-186927.jpg,1,0,0,0,1,,train
0516406_sc-1040832.jpg,1,0,0,1,2,,train
0516408_as-2512885.jpg,2,2,1,1,6,,val
0516412_as-0059108.jpg,1,1,0,0,2,,val
0516413_as-0059108.jpg,1,1,0,0,2,,test
0516414_as-0059108.jpg,1,1,0,0,2,,train
0516415_as-0059108.jpg,1,1,0,0,2,,train
0516417_as-2610697.jpg,2,0,1,0,3,,train
0516418_as-2610697.jpg,1,2,3,0,6,,train
0516419_sc-1024004.jpg,2,0,0,0,2,,train
0516420_sc-1024004.jpg,3,0,0,0,3,,train
0516421_sc-1024004.jpg,3,0,0,0,3,,train
0516422_sc-1024004.jpg,3,0,0,0,3,,val
0516423_sc-1024004.jpg,3,0,0,0,3,,val
0516424_sc-1024004.jpg,2,0,0,0,2,,test
0516425_sc-1024004.jpg,2,0,0,0,2,,train
0516428_as-0079498.jpg,2,0,1,0,3,,train
0516429_as-0079498.jpg,4,0,1,0,5,,train
0516430_sc-1041140.jpg,3,0,0,0,3,,train
0516431_sc-1041140.jpg,1,0,0,0,1,,train
0516432_sc-1041140.jpg,2,0,0,0,2,,train
0516433_as-2991252.jpg,1,0,0,0,1,,train
0516434_sc-1035271.jpg,0,5,0,0,5,,val
0516435_sc-196082.jpg,1,0,0,0,1,,val
0516436_sc-196082.jpg,3,0,0,0,3,,test
0516437_sc-196082.jpg,3,0,0,0,3,,train
0516438_sc-196082.jpg,2,0,0,0,2,,train
0516439_sc-196082.jpg,1,0,0,0,1,,train
0516440_sc-196082.jpg,2,0,0,0,2,,train
0516441_sc-196082.jpg,4,0,0,0,4,,train
0516442_as-3305879.jpg,0,0,1,0,1,,train
0516443_as-7123164.jpg,1,1,0,0,2,,train
0516444_as-2694536.jpg,0,1,0,0,1,,val
0516445_as-7595262.jpg,2,2,3,0,7,,val
0516446_as-0068818.jpg,1,0,0,0,1,,test
0516447_as-0068818.jpg,1,0,1,1,3,,train
0516448_as-0068818.jpg,1,0,0,1,2,,train
0516449_as-0068818.jpg,1,0,0,1,2,,train
0516450_as-0068818.jpg,0,0,1,0,1,,train
0516451_as-0068818.jpg,0,0,1,0,1,,train
0516452_as-0068818.jpg,1,0,0,1,2,,train
0516453_as-0068818.jpg,1,0,0,1,2,,train
0516454_as-0068818.jpg,1,0,0,1,2,,val
0516455_as-0068818.jpg,1,0,0,0,1,,val
0516456_as-0068818.jpg,1,0,0,0,1,,test
0516457_as-0068818.jpg,1,0,0,1,2,,train
0516458_as-0068818.jpg,1,0,0,1,2,,train
0516459_sc-164851.jpg,1,0,1,0,2,,train
0516460_as-2847942.jpg,1,0,0,0,1,,train
0516463_as-2856162.jpg,4,0,0,0,4,,train
0516464_sc-1029445.jpg,3,0,0,0,3,,train
0516466_as-3228247.jpg,2,0,0,1,3,,train
0516467_as-3247812.jpg,6,1,1,0,8,,val
0516468_as-2687763.jpg,2,0,1,0,3,,val
0516469_sc-147504.jpg,0,2,0,0,2,,test
0516470_sc-228938.jpg,2,1,1,0,4,,train
0516471_sc-1006709.jpg,1,0,0,1,2,,train
0516472_sc-1006709.jpg,1,0,0,1,2,,train
0516477_sc-1035910.jpg,13,0,0,0,13,,train
0516478_sc-219097.jpg,1,0,0,0,1,,train
0516479_sc-219097.jpg,2,0,0,0,2,,train
0516480_sc-219097.jpg,5,0,3,1,9,,train
0516481_as-2539695.jpg,0,0,1,0,1,,val
0516482_sc-1028426.jpg,1,0,1,0,2,,val
0516483_sc-1028426.jpg,1,0,1,0,2,,test
0516484_sc-122188.jpg,1,0,0,2,3,,train
0516485_sc-122188.jpg,8,0,0,3,11,,train
0516486_sc-122188.jpg,1,0,0,0,1,,train
0516488_as-0082974.jpg,2,0,0,0,2,,train
0516489_as-0082974.jpg,3,0,0,0,3,,train
0516490_as-0082974.jpg,2,0,0,0,2,,train
0516491_as-0082974.jpg,2,0,0,0,2,,train
0516492_as-2820031.jpg,3,0,0,0,3,,val
0516495_as-0026596.jpg,0,1,0,0,1,,val
0516496_as-0026596.jpg,1,2,0,1,4,,test
0516497_as-0026596.jpg,3,2,0,1,6,,train
0516498_as-0026596.jpg,0,0,1,1,2,,train
0516499_as-0026596.jpg,3,0,1,0,4,,train
0516500_as-0026596.jpg,1,0,0,1,2,,train
0516501_as-0026596.jpg,1,0,0,1,2,,train
0516504_as-0026596.jpg,2,2,0,1,5,,train
0516505_as-0026596.jpg,1,1,0,2,4,,train
0516506_as-0026596.jpg,1,1,1,1,4,,val
0516507_as-3012145.jpg,3,0,0,0,3,,val
0516508_as-2986725.jpg,3,0,0,0,3,,test
0516509_sc-1032486.jpg,4,0,1,2,7,,train
0516510_sc-1032486.jpg,17,0,1,2,20,,train
0516511_sc-222470.jpg,3,0,0,0,3,,train
0516512_as-3195292.jpg,2,0,0,1,3,,train
0516513_as-3195292.jpg,1,0,0,0,1,,train
0516516_as-2697574.jpg,4,1,0,0,5,,train
0516518_as-0082377.jpg,1,0,0,0,1,,train
0516519_as-0082377.jpg,1,0,0,0,1,,val
0516520_as-0082377.jpg,1,0,0,0,1,,val
0516521_sc-155454.jpg,4,0,0,0,4,,test
0516522_sc-155454.jpg,4,0,0,0,4,,train
0516523_sc-155454.jpg,4,0,0,0,4,,train
0516525_sc-155454.jpg,1,0,0,0,1,,train
0516526_sc-155454.jpg,1,0,0,0,1,,train
0516527_sc-183870.jpg,3,0,0,0,3,,train
0516528_sc-183870.jpg,2,0,0,0,2,,train
0516530_sc-221433.jpg,1,0,0,0,1,,train
0516531_sc-221018.jpg,3,2,1,0,6,,val
0516534_as-0080563.jpg,2,0,1,0,3,,val
0516535_as-2513723.jpg,1,0,0,0,1,,test
0516538_as-0028346.jpg,1,0,0,0,1,,train
0516539_as-0028346.jpg,3,0,0,0,3,,train
0516540_as-0028346.jpg,1,0,1,0,2,,train
0516541_as-0028346.jpg,0,1,0,0,1,,train
0516542_as-2859572.jpg,2,0,1,1,4,,train
0516543_as-2859572.jpg,3,0,3,0,6,,train
0516544_sc-206217.jpg,11,2,2,1,16,,train
0516545_sc-206217.jpg,8,0,0,1,9,,val
0516546_sc-206217.jpg,4,0,0,1,5,,val
0516550_sc-199902.jpg,3,1,1,0,5,,test
0516551_sc-199902.jpg,5,0,1,0,6,,train
0516552_sc-199902.jpg,5,0,0,0,5,,train
0516553_sc-1028614.jpg,4,1,1,0,6,,train
0516554_sc-1028614.jpg,3,1,1,0,5,,train
0516557_as-0044362.jpg,1,1,2,0,4,,train
0516558_as-0044362.jpg,2,0,1,0,3,,train
0516560_as-2764348.jpg,1,1,0,0,2,,train
0516561_sc-212921.jpg,1,0,0,0,1,,val
0516562_as-7862900.jpg,2,0,0,0,2,,val
0516563_sc-1022274.jpg,0,0,3,0,3,,test
0516566_as-0017524.jpg,1,0,0,0,1,,train
0516567_as-0017524.jpg,1,0,1,1,3,,train
0516568_as-0017524.jpg,1,0,0,0,1,,train
0516569_as-0017524.jpg,1,0,1,1,3,,train
0516571_as-3471092.jpg,1,0,0,0,1,,train
0516572_sc-204759.jpg,3,0,1,0,4,,train
0516573_sc-204759.jpg,4,0,1,0,5,,train
0516574_sc-1027262.jpg,2,0,1,0,3,,val
0516575_sc-1027262.jpg,1,0,1,0,2,,val
0516576_sc-223494.jpg,1,0,0,2,3,,test
0516577_sc-223494.jpg,1,0,0,0,1,,train
0516578_sc-223494.jpg,2,0,0,0,2,,train
0516579_sc-1000105.jpg,3,0,0,0,3,,train
0516580_sc-1000105.jpg,5,0,0,0,5,,train
0516581_sc-1000105.jpg,3,0,0,0,3,,train
0516583_sc-211348.jpg,1,0,0,1,2,,train
0516584_sc-211348.jpg,3,0,0,1,4,,train
0516585_sc-211348.jpg,2,0,0,1,3,,val
0516588_sc-154524.jpg,4,1,1,1,7,,val
0516589_sc-154524.jpg,4,1,0,1,6,,test
0516590_sc-154524.jpg,5,1,0,0,6,,train
0516592_as-3037236.jpg,0,0,1,0,1,,train
0516593_sc-197442.jpg,1,0,0,0,1,,train
0516594_sc-197442.jpg,4,0,0,0,4,,train
0516595_sc-197442.jpg,1,0,0,0,1,,train
0516596_sc-197442.jpg,1,0,0,0,1,,train
0516597_sc-223239.jpg,2,1,2,1,6,,train
0516598_sc-223239.jpg,2,1,2,0,5,,val
0516599_sc-223239.jpg,1,1,2,0,4,,val
0516600_sc-223239.jpg,2,0,1,1,4,,test
0516601_sc-223239.jpg,3,1,0,0,4,,train
0516602_sc-223239.jpg,2,0,0,0,2,,train
0516603_as-0011284.jpg,3,0,2,1,6,,train
0516604_as-0011284.jpg,0,0,2,0,2,,train
0516605_as-0011284.jpg,1,0,1,1,3,,train
0516606_as-0011284.jpg,4,0,1,1,6,,train
0516607_as-3303382.jpg,0,0,0,2,2,,train
0516609_sc-193128.jpg,2,0,0,0,2,,val
0516610_sc-193128.jpg,3,0,0,0,3,,val
0516611_sc-193128.jpg,2,0,0,0,2,,test
0516612_sc-193128.jpg,3,0,0,0,3,,train
0516613_sc-193128.jpg,3,0,0,0,3,,train
0516614_sc-193128.jpg,2,0,0,0,2,,train
0516615_sc-193128.jpg,0,0,1,0,1,,train
0516616_sc-193128.jpg,0,0,1,0,1,,train
0516617_sc-168286.jpg,1,0,0,0,1,,train
0516618_sc-1005946.jpg,8,1,0,0,9,,train
0516619_sc-1005946.jpg,3,0,1,0,4,,val
0516620_sc-207594.jpg,4,0,0,0,4,,val
0516621_sc-207594.jpg,6,0,0,0,6,,test
0516622_sc-207594.jpg,3,0,0,0,3,,train
0516623_sc-1018350.jpg,4,0,0,1,5,,train
0516625_sc-1018350.jpg,5,0,0,0,5,,train
0516626_sc-1018350.jpg,4,0,0,1,5,,train
0516628_as-3459413.jpg,7,0,1,1,9,,train
0516629_as-3110575.jpg,2,0,0,0,2,,train
0516632_as-0079244.jpg,1,0,0,0,1,,train
0516634_as-0088547.jpg,1,0,1,1,3,,val
0516635_as-0088547.jpg,1,0,1,1,3,,val
0516636_as-0088547.jpg,1,0,0,0,1,,test
0516637_as-2898157.jpg,1,0,0,0,1,,train
0516639_sc-192997.jpg,0,2,0,0,2,,train
0516640_as-3463092.jpg,0,0,1,0,1,,train
0516641_as-3463092.jpg,1,0,0,0,1,,train
0516642_sc-111307.jpg,2,0,2,0,4,,train
0516643_sc-111307.jpg,0,1,1,0,2,,train
0516644_sc-1034803.jpg,1,0,0,0,1,,train
0516645_sc-1034803.jpg,1,0,0,0,1,,val
0516646_as-2735151.jpg,1,0,0,0,1,,val
0516647_as-0083968.jpg,1,0,0,0,1,,test
0516648_as-0083968.jpg,2,0,0,0,2,,train
0516649_as-0083968.jpg,2,0,0,0,2,,train
0516650_as-0083968.jpg,1,0,0,0,1,,train
0516652_sc-150781.jpg,0,0,0,1,1,,train
0516653_sc-150781.jpg,1,0,0,1,2,,train
0516654_sc-191683.jpg,1,0,0,0,1,,train
0516655_sc-191683.jpg,2,1,0,0,3,,train
0516656_sc-191683.jpg,2,0,0,1,3,,val
0516657_sc-191683.jpg,2,1,0,1,4,,val
0516658_sc-1037764.jpg,0,1,0,0,1,,test
0516659_sc-1037764.jpg,2,0,0,0,2,,train
0516660_sc-1037764.jpg,1,0,0,1,2,,train
0516662_sc-1037764.jpg,0,2,0,0,2,,train
0516663_sc-1037764.jpg,1,1,0,1,3,,train
0516664_sc-1037764.jpg,2,0,0,1,3,,train
0516667_as-0085180.jpg,1,0,0,0,1,,train
0516668_as-0085180.jpg,2,0,0,0,2,,train
0516669_as-0085180.jpg,1,0,0,0,1,,val
0516670_as-0085180.jpg,1,0,0,0,1,,val
0516671_as-9046567.jpg,3,1,0,0,4,,test
0516672_sc-1039610.jpg,2,0,0,0,2,,train
0516673_as-2611472.jpg,0,2,0,0,2,,train
0516674_as-0045072.jpg,2,1,1,0,4,,train
0516675_as-0029226.jpg,0,0,1,0,1,,train
0516676_as-0029226.jpg,1,2,0,0,3,,train
0516677_as-0029226.jpg,1,2,0,0,3,,train
0516678_as-0029226.jpg,1,0,1,0,2,,train
0516680_as-0029226.jpg,1,0,0,0,1,,val
0516681_as-0029226.jpg,0,0,1,0,1,,val
0516682_as-0029226.jpg,2,2,2,1,7,,test
0516683_as-5071237.jpg,2,0,0,0,2,,train
0516684_as-2830630.jpg,0,0,2,0,2,,train
0516685_as-7735079.jpg,1,0,0,0,1,,train
0516686_as-3281292.jpg,1,0,0,0,1,,train
0516687_sc-144527.jpg,2,0,1,0,3,,train
0516688_as-3141014.jpg,1,0,1,0,2,,train
0516689_sc-123951.jpg,4,0,0,2,6,,train
0516690_sc-123951.jpg,4,0,0,1,5,,val
0516691_sc-123951.jpg,2,0,0,1,3,,val
0516693_sc-123951.jpg,5,0,0,1,6,,test
0516694_sc-123951.jpg,1,0,0,1,2,,train
0516695_sc-123951.jpg,3,0,0,1,4,,train
0516697_as-0020160.jpg,1,0,1,1,3,,train
0516698_sc-136462.jpg,2,1,1,0,4,,train
0516699_sc-136462.jpg,4,0,2,0,6,,train
0516700_sc-136462.jpg,2,0,1,0,3,,train
0516701_sc-136462.jpg,2,3,3,3,11,,train
0516702_sc-136462.jpg,2,1,2,2,7,,val
0516705_sc-1020225.jpg,4,0,1,0,5,,val
0516706_sc-1020225.jpg,5,0,1,0,6,,test
0516707_sc-195687.jpg,0,1,1,0,2,,train
0516708_sc-195687.jpg,0,0,1,0,1,,train
0516709_sc-209436.jpg,1,0,0,0,1,,train
0516710_sc-209436.jpg,1,0,0,1,2,,train
0516711_sc-209436.jpg,2,0,0,0,2,,train
0516712_sc-209436.jpg,2,0,0,0,2,,train
0516713_sc-209436.jpg,1,0,1,1,3,,train
0516714_as-2619969.jpg,0,1,1,0,2,,val
0516715_sc-153871.jpg,4,1,0,0,5,,val
0516716_sc-153871.jpg,4,1,0,0,5,,test
0516717_sc-153871.jpg,1,2,0,0,3,,train
0516719_as-9053033.jpg,3,0,0,0,3,,train
0516720_as-2558989.jpg,0,1,0,1,2,,train
0516722_sc-1028923.jpg,0,1,0,0,1,,train
0516724_as-0033490.jpg,1,0,0,0,1,,train
0516725_sc-228177.jpg,4,1,0,0,5,,train
0516726_as-3492596.jpg,2,0,0,0,2,,train
0516727_as-3288754.jpg,2,0,0,0,2,,val
0516728_as-9041577.jpg,2,1,2,1,6,,val
0516729_as-3053872.jpg,1,0,0,1,2,,test
0516730_as-2682165.jpg,2,0,0,0,2,,train
0516731_as-2958133.jpg,1,0,1,2,4,,train
0516732_sc-165142.jpg,2,0,0,1,3,,train
0516733_sc-165142.jpg,1,0,1,1,3,,train
0516734_sc-165142.jpg,2,0,0,2,4,,train
0516735_sc-165142.jpg,2,0,0,1,3,,train
0516736_sc-206259.jpg,3,0,0,0,3,,train
0516737_sc-214278.jpg,1,0,0,1,2,,val
0516738_sc-214278.jpg,2,0,0,1,3,,val
0516739_sc-214278.jpg,1,0,0,0,1,,test
0516740_sc-214278.jpg,1,0,0,0,1,,train
0516741_sc-214278.jpg,1,0,0,1,2,,train
0516742_sc-214278.jpg,1,0,0,0,1,,train
0516743_sc-214278.jpg,1,0,0,1,2,,train
0516744_sc-184582.jpg,1,0,0,1,2,,train
0516745_sc-184582.jpg,2,0,0,1,3,,train
0516746_sc-178427.jpg,1,1,1,0,3,,train
0516747_sc-178427.jpg,1,1,1,0,3,,val
0516748_sc-178427.jpg,3,1,1,0,5,,val
0516750_sc-133230.jpg,1,1,0,1,3,,test
0516752_sc-133230.jpg,2,3,1,1,7,,train
0516753_sc-133230.jpg,1,0,0,1,2,,train
0516754_sc-149621.jpg,1,0,0,0,1,,train
0516755_sc-149621.jpg,1,0,0,0,1,,train
0516756_sc-149621.jpg,2,0,0,0,2,,train
0516757_as-2611720.jpg,2,0,0,0,2,,train
0516758_sc-219392.jpg,5,0,5,2,12,,train
0516759_sc-219392.jpg,0,3,2,1,6,,val
0516760_sc-219392.jpg,1,0,5,1,7,,val
0516761_sc-219392.jpg,1,1,3,2,7,,test
0516762_sc-219392.jpg,0,1,2,2,5,,train
0516763_sc-219392.jpg,1,0,2,1,4,,train
0516764_sc-219392.jpg,0,0,3,2,5,,train
0516765_sc-222812.jpg,0,1,0,0,1,,train
0516766_as-3235965.jpg,1,0,1,0,2,,train
0516767_sc-168540.jpg,3,1,0,0,4,,train
0516768_sc-168540.jpg,4,0,0,0,4,,train
0516769_sc-168540.jpg,3,0,1,0,4,,val
0516770_sc-168540.jpg,2,0,0,0,2,,val
0516771_sc-168540.jpg,3,0,1,0,4,,test
0516772_sc-168540.jpg,4,0,2,0,6,,train
0516774_sc-1030708.jpg,1,0,0,0,1,,train
0516775_sc-1030708.jpg,1,0,0,0,1,,train
0516776_sc-1030708.jpg,2,0,0,0,2,,train
0516777_sc-1030708.jpg,1,0,0,0,1,,train
0516778_sc-1030708.jpg,1,0,0,0,1,,train
0516779_sc-1030708.jpg,1,0,0,0,1,,train
0516782_as-0005049.jpg,4,2,1,2,9,,val
0516785_as-0005049.jpg,0,0,1,0,1,,val
0516786_as-0005049.jpg,0,2,1,0,3,,test
0516787_as-7957273.jpg,1,0,1,0,2,,train
0516793_as-0017871.jpg,1,0,0,0,1,,train
0516794_as-0017871.jpg,1,0,0,0,1,,train
0516795_as-0017871.jpg,1,0,0,0,1,,train
0516797_as-0030070.jpg,3,0,0,0,3,,train
0516798_as-0030070.jpg,1,0,0,0,1,,train
0516799_as-0030070.jpg,4,0,0,0,4,,train
0516800_as-0030070.jpg,5,0,0,0,5,,val
0516802_as-3474707.jpg,0,0,1,0,1,,val
0516803_as-2759759.jpg,1,0,1,1,3,,test
0516804_sc-128217.jpg,2,1,0,0,3,,train
0516805_sc-128217.jpg,1,0,0,0,1,,train
0516806_sc-1017744.jpg,3,1,0,1,5,,train
0516807_sc-1017744.jpg,4,1,1,1,7,,train
0516808_sc-1017744.jpg,2,0,0,0,2,,train
0516809_sc-1017744.jpg,4,0,0,0,4,,train
0516810_sc-1017744.jpg,3,1,1,1,6,,train
0516812_sc-1017744.jpg,0,0,2,0,2,,val
0516813_sc-1017744.jpg,6,0,0,0,6,,val
0516814_as-2906527.jpg,2,0,0,0,2,,test
0516816_as-0037933.jpg,0,0,0,1,1,,train
0516817_as-0037933.jpg,1,0,2,0,3,,train
0516819_as-3150371.jpg,4,3,1,0,8,,train
0516820_sc-1039001.jpg,3,0,2,1,6,,train
0516821_sc-1039001.jpg,3,0,2,1,6,,train
0516822_as-2711391.jpg,4,0,0,1,5,,train
0516823_as-3137556.jpg,2,0,0,0,2,,train
0516824_as-7281117.jpg,1,0,0,0,1,,val
0516825_sc-225985.jpg,2,1,0,0,3,,val
0516826_sc-225985.jpg,2,1,1,0,4,,test
0516828_as-3455267.jpg,5,0,1,0,6,,train
0516829_sc-1020628.jpg,3,1,1,1,6,,train
0516830_sc-1020628.jpg,3,1,1,1,6,,train
0516831_sc-1020628.jpg,4,1,1,1,7,,train
0516832_sc-1001233.jpg,1,0,2,2,5,,train
0516833_sc-1001233.jpg,2,0,1,0,3,,train
0516834_as-0022755.jpg,2,0,0,0,2,,train
0516835_as-7073360.jpg,3,0,2,1,6,,val
0516836_as-2574160.jpg,0,2,0,0,2,,val
0516837_sc-119761.jpg,1,0,0,1,2,,test
0516838_sc-119761.jpg,1,0,0,1,2,,train
0516840_sc-197888.jpg,3,2,2,0,7,,train
0516841_sc-197888.jpg,1,1,0,1,3,,train
0516842_sc-197888.jpg,1,0,0,0,1,,train
0516843_sc-197888.jpg,2,0,4,1,7,,train
0516844_sc-197888.jpg,0,0,1,0,1,,train
0516845_sc-197888.jpg,0,0,1,0,1,,train
0516846_sc-197888.jpg,0,0,2,0,2,,val
0516847_sc-197888.jpg,1,0,2,1,4,,val
0516848_sc-197888.jpg,1,1,1,0,3,,test
0516849_sc-197888.jpg,3,0,1,1,5,,train
0516850_sc-197888.jpg,1,0,1,0,2,,train
0516851_sc-197888.jpg,2,0,1,0,3,,train
0516852_sc-1018135.jpg,1,0,0,0,1,,train
0516853_as-0094312.jpg,1,0,0,0,1,,train
0516854_as-0094312.jpg,1,0,0,0,1,,train
0516855_as-0094312.jpg,1,0,0,0,1,,train
0516856_as-2960570.jpg,1,0,0,0,1,,val
0516857_as-3460317.jpg,2,0,0,1,3,,val
0516859_sc-178064.jpg,1,0,0,0,1,,test
0516860_sc-178064.jpg,0,0,0,2,2,,train
0516863_sc-178064.jpg,6,1,1,0,8,,train
0516864_sc-178064.jpg,2,1,1,0,4,,train
0516865_sc-178064.jpg,3,1,1,0,5,,train
0516867_sc-1025688.jpg,6,1,0,0,7,,train
0516869_as-7137449.jpg,5,0,0,0,5,,train
0516872_sc-138358.jpg,3,0,0,0,3,,train
0516873_sc-138358.jpg,2,0,1,1,4,,val
0516874_sc-138358.jpg,5,1,1,0,7,,val
0516875_sc-138358.jpg,6,1,0,1,8,,test
0516876_as-0029094.jpg,1,0,1,1,3,,train
0516878_as-2760145.jpg,1,0,0,0,1,,train
0516879_as-0068866.jpg,3,0,0,0,3,,train
0516880_as-0068866.jpg,4,0,0,1,5,,train
0516881_as-0068866.jpg,1,0,1,2,4,,train
0516882_as-0068866.jpg,1,0,1,1,3,,train
0516883_as-0068866.jpg,1,0,1,1,3,,train
0516884_as-3187832.jpg,7,2,1,4,14,,val
0516885_sc-211808.jpg,4,0,0,0,4,,val
0516886_as-0075425.jpg,2,0,0,0,2,,test
0516887_as-0075425.jpg,4,0,0,0,4,,train
0516888_as-0075425.jpg,3,0,0,1,4,,train
0516889_as-0075425.jpg,1,0,0,0,1,,train
0516890_as-0075425.jpg,1,0,0,1,2,,train
0516892_as-0075425.jpg,4,0,0,0,4,,train
0516893_as-0075425.jpg,3,0,0,1,4,,train
0516894_as-0075425.jpg,1,0,0,1,2,,train
0516895_as-0075425.jpg,3,0,0,1,4,,val
0516896_as-0075425.jpg,1,0,0,0,1,,val
0516897_as-0075425.jpg,2,0,0,0,2,,test
0516898_as-0075425.jpg,3,0,0,0,3,,train
0516899_sc-209688.jpg,3,0,0,0,3,,train
0516900_sc-209688.jpg,3,0,0,0,3,,train
0516901_sc-201522.jpg,0,0,1,0,1,,train
0516902_sc-201522.jpg,0,0,1,0,1,,train
0516903_sc-201522.jpg,0,3,1,2,6,,train
0516904_sc-201522.jpg,0,2,0,2,4,,train
0516905_sc-201522.jpg,0,2,2,3,7,,val
0516906_sc-201522.jpg,0,1,1,2,4,,val
0516907_sc-201522.jpg,0,2,0,1,3,,test
0516908_sc-201522.jpg,0,1,2,1,4,,train
0516909_sc-201522.jpg,1,0,2,0,3,,train
0516910_sc-201522.jpg,1,2,1,1,5,,train
0516911_sc-201522.jpg,0,1,1,0,2,,train
0516912_sc-201522.jpg,0,0,2,1,3,,train
0516913_sc-201522.jpg,2,0,1,0,3,,train
0516914_sc-201522.jpg,1,0,1,0,2,,train
0516915_sc-201522.jpg,1,0,1,0,2,,val
0516916_sc-201522.jpg,0,0,1,0,1,,val
0516917_sc-201522.jpg,0,0,2,0,2,,test
0516918_sc-201522.jpg,0,0,1,0,1,,train
0516919_sc-201522.jpg,2,0,0,0,2,,train
0516920_sc-201522.jpg,2,0,0,0,2,,train
0516921_sc-201522.jpg,0,0,1,1,2,,train
0516922_sc-201522.jpg,0,0,1,0,1,,train
0516924_sc-159366.jpg,0,0,1,1,2,,train
0516926_sc-159366.jpg,9,0,1,1,11,,train
0516927_sc-226367.jpg,3,0,0,2,5,,val
0516928_as-9036487.jpg,1,0,0,1,2,,val
0516929_sc-206784.jpg,2,1,0,0,3,,test
0516930_sc-206784.jpg,1,0,1,0,2,,train
0516931_sc-206784.jpg,1,0,1,0,2,,train
0516932_sc-206784.jpg,5,1,1,0,7,,train
0516933_sc-206784.jpg,4,1,0,0,5,,train
0516934_sc-206784.jpg,1,0,1,0,2,,train
0516935_sc-206784.jpg,1,0,1,0,2,,train
0516936_sc-206784.jpg,2,0,1,0,3,,train
0516937_sc-206784.jpg,1,0,0,0,1,,val
0516938_sc-206784.jpg,3,0,1,0,4,,val
0516939_as-9055096.jpg,3,0,0,1,4,,test
0516941_sc-1040691.jpg,1,0,0,0,1,,train
0516942_as-3447103.jpg,1,1,0,0,2,,train
0516944_as-0039639.jpg,4,0,0,1,5,,train
0516946_as-0045273.jpg,1,0,0,0,1,,train
0516947_as-0045273.jpg,0,0,1,0,1,,train
0516948_as-0045273.jpg,2,0,0,0,2,,train
0516949_as-0045273.jpg,1,0,0,0,1,,train
0516950_as-0045273.jpg,1,0,0,0,1,,val
0516951_as-0045273.jpg,1,0,0,0,1,,val
0516952_sc-190452.jpg,3,0,0,0,3,,test
0516953_as-2593860.jpg,0,0,1,0,1,,train
0516954_as-7413559.jpg,0,1,0,0,1,,train
0516955_sc-218147.jpg,2,0,0,0,2,,train
0516956_sc-218147.jpg,2,0,1,0,3,,train
0516957_sc-1027222.jpg,12,0,0,0,12,,train
0516958_sc-1027222.jpg,17,0,0,0,17,,train
0516959_as-7322192.jpg,1,0,1,1,3,,train
0516961_sc-174634.jpg,2,0,0,0,2,,val
0516962_sc-112104.jpg,2,0,0,0,2,,val
0516963_sc-112104.jpg,3,0,0,0,3,,test
0516964_sc-112104.jpg,2,0,0,0,2,,train
0516965_sc-112104.jpg,0,0,1,0,1,,train
0516966_sc-112104.jpg,0,0,1,0,1,,train
0516967_sc-112104.jpg,0,0,1,0,1,,train
0516968_sc-112104.jpg,2,0,1,0,3,,train
0516969_sc-112104.jpg,1,0,0,0,1,,train
0516970_sc-197341.jpg,1,0,1,1,3,,train
0516971_sc-147754.jpg,4,0,0,0,4,,val
0516972_sc-147754.jpg,1,0,0,0,1,,val
0516973_sc-147754.jpg,7,0,0,0,7,,test
0516974_as-3442764.jpg,11,1,0,1,13,,train
0516978_as-0079016.jpg,0,0,1,1,2,,train
0516980_as-0079016.jpg,9,2,1,0,12,,train
0516981_as-0079016.jpg,13,2,0,1,16,,train
0516982_as-2946562.jpg,2,0,0,0,2,,train
0516986_sc-1017952.jpg,2,0,1,0,3,,train
0516987_sc-1017952.jpg,0,0,1,0,1,,train
0516988_sc-1017952.jpg,0,0,1,0,1,,val
0516989_sc-135827.jpg,2,1,1,0,4,,val
0516992_sc-107869.jpg,1,0,0,1,2,,test
0516993_sc-107869.jpg,2,0,0,1,3,,train
0516994_sc-107869.jpg,2,0,0,1,3,,train
0516995_sc-107869.jpg,3,0,0,0,3,,train
0516996_sc-145325.jpg,1,1,0,0,2,,train
0516997_sc-145325.jpg,0,1,0,1,2,,train
0516999_sc-145325.jpg,1,0,1,0,2,,train
0517000_sc-145325.jpg,0,0,1,0,1,,train
0517001_sc-162276.jpg,2,0,0,0,2,,val
0517002_sc-130040.jpg,4,0,1,1,6,,val
0517003_sc-130040.jpg,3,0,1,1,5,,test
0517004_sc-130040.jpg,2,0,1,1,4,,train
0517005_sc-213946.jpg,1,0,0,0,1,,train
0517006_sc-180205.jpg,0,1,0,0,1,,train
0517007_sc-1035471.jpg,3,0,0,0,3,,train
0517008_sc-1035471.jpg,2,0,0,0,2,,train
0517009_sc-1035471.jpg,1,0,0,0,1,,train
0517010_sc-1035471.jpg,1,0,0,0,1,,train
0517011_sc-1035471.jpg,1,0,0,1,2,,val
0517012_sc-1035471.jpg,4,0,0,0,4,,val
0517013_sc-1035471.jpg,2,0,1,0,3,,test
0517014_as-0056445.jpg,1,0,0,0,1,,train
0517015_sc-1025055.jpg,4,0,0,0,4,,train
0517016_sc-1025055.jpg,1,0,0,0,1,,train
0517017_sc-1025055.jpg,5,0,0,0,5,,train
0517019_as-0004556.jpg,8,5,3,0,16,,train
0517020_as-0004556.jpg,4,2,3,1,10,,train
0517021_as-0004556.jpg,4,3,1,0,8,,train
0517022_as-0004556.jpg,1,3,3,1,8,,val
0517023_as-0004556.jpg,3,0,1,0,4,,val
0517024_as-0004556.jpg,1,0,1,0,2,,test
0517025_sc-1027845.jpg,1,0,0,0,1,,train
0517026_sc-1027845.jpg,1,0,1,0,2,,train
0517029_as-0072178.jpg,1,0,0,0,1,,train
0517030_sc-192643.jpg,3,0,0,0,3,,train
0517031_sc-192643.jpg,2,0,0,0,2,,train
0517032_sc-192643.jpg,3,0,0,0,3,,train
0517033_sc-192643.jpg,3,0,0,0,3,,train
0517034_sc-192643.jpg,1,0,0,0,1,,val
0517037_as-0020417.jpg,1,0,0,0,1,,val
0517038_as-0020417.jpg,1,0,0,0,1,,test
0517039_as-3296242.jpg,1,0,1,0,2,,train
0517041_as-7512744.jpg,0,0,2,0,2,,train
0517043_sc-157502.jpg,0,0,0,1,1,,train
0517044_sc-157502.jpg,1,0,0,1,2,,train
0517045_sc-157502.jpg,0,0,0,1,1,,train
0517046_sc-228143.jpg,1,0,0,0,1,,train
0517047_sc-228143.jpg,1,0,1,0,2,,train
0517048_sc-228143.jpg,1,0,1,1,3,,val
0517049_sc-228143.jpg,1,0,0,1,2,,val
0517050_sc-1039098.jpg,0,0,1,1,2,,test
0517051_sc-1039098.jpg,1,1,1,1,4,,train
0517052_sc-127057.jpg,2,0,0,1,3,,train
0517053_sc-127057.jpg,1,0,0,0,1,,train
0517054_sc-127057.jpg,1,0,0,0,1,,train
0517056_sc-138199.jpg,2,0,0,0,2,,train
0517057_sc-138199.jpg,2,0,0,0,2,,train
0517061_as-0083072.jpg,2,0,0,0,2,,train
0517062_as-0083072.jpg,2,0,0,0,2,,val
0517063_as-0083072.jpg,0,0,1,0,1,,val
0517064_as-0083072.jpg,1,0,0,0,1,,test
0517065_as-0083072.jpg,1,0,0,0,1,,train
0517066_as-0083072.jpg,1,0,0,0,1,,train
0517067_as-0083072.jpg,1,0,0,0,1,,train
0517072_as-0060292.jpg,5,0,1,0,6,,train
0517073_as-0060292.jpg,6,0,2,0,8,,train
0517074_as-0060292.jpg,7,0,2,0,9,,train
0517075_as-0060292.jpg,3,0,1,0,4,,train
0517077_as-0060292.jpg,5,0,1,0,6,,val
0517078_as-3444562.jpg,1,0,0,0,1,,val
0517080_sc-177392.jpg,2,0,0,0,2,,test
0517086_as-0015041.jpg,7,1,1,1,10,,train
0517088_as-0015041.jpg,3,0,0,0,3,,train
0517089_as-0015041.jpg,8,0,0,0,8,,train
0517090_as-0015041.jpg,4,0,0,0,4,,train
0517091_as-2894105.jpg,1,0,0,0,1,,train
0517092_sc-203821.jpg,3,0,1,0,4,,train
0517093_sc-203821.jpg,1,0,1,0,2,,train
0517096_sc-155349.jpg,2,0,1,2,5,,val
0517097_sc-155349.jpg,3,1,1,2,7,,val
0517098_sc-155349.jpg,4,0,1,2,7,,test
0517099_sc-155349.jpg,3,0,1,2,6,,train
0517100_sc-155349.jpg,3,0,0,2,5,,train
0517101_sc-155349.jpg,1,0,0,0,1,,train
0517102_as-2519284.jpg,3,0,0,0,3,,train
0517103_sc-216270.jpg,1,1,2,1,5,,train
0517104_sc-216270.jpg,2,0,4,1,7,,train
0517105_sc-216270.jpg,3,0,2,1,6,,train
0517106_as-3498057.jpg,0,0,0,1,1,,val
0517108_sc-1034569.jpg,1,0,0,1,2,,val
0517110_sc-1034569.jpg,0,0,1,0,1,,test
0517111_sc-104418.jpg,7,0,1,1,9,,train
0517112_sc-104418.jpg,9,0,1,1,11,,train
0517113_sc-104418.jpg,2,0,1,1,4,,train
0517114_as-0046165.jpg,1,0,0,0,1,,train
0517115_as-0046165.jpg,1,0,0,0,1,,train
0517116_as-0046165.jpg,1,0,0,0,1,,train
0517117_sc-135282.jpg,2,0,1,1,4,,train
0517118_sc-135282.jpg,1,0,1,1,3,,val
0517119_sc-135282.jpg,1,0,1,1,3,,val
0517120_as-3137083.jpg,1,0,0,0,1,,test
0517122_sc-177280.jpg,4,0,0,0,4,,train
0517123_sc-207746.jpg,4,0,1,0,5,,train
0517124_sc-207746.jpg,6,0,1,0,7,,train
0517125_sc-207746.jpg,5,0,1,0,6,,train
0517126_sc-207746.jpg,3,0,0,0,3,,train
0517127_sc-207746.jpg,1,0,0,0,1,,train
0517128_sc-207746.jpg,3,0,0,0,3,,train
0517129_sc-207746.jpg,0,1,0,0,1,,val
0517130_sc-207746.jpg,0,1,0,0,1,,val
0517131_sc-207746.jpg,0,1,0,0,1,,test
0517132_as-0051571.jpg,3,0,0,0,3,,train
0517133_as-0051571.jpg,3,0,0,0,3,,train
0517134_as-0051571.jpg,4,0,0,0,4,,train
0517135_as-0051571.jpg,5,0,0,0,5,,train
0517136_as-0051571.jpg,3,0,0,0,3,,train
0517137_sc-1002492.jpg,0,1,0,0,1,,train
0517139_sc-1002492.jpg,3,0,1,0,4,,train
0517140_sc-225195.jpg,2,1,0,0,3,,val
0517141_sc-225195.jpg,1,1,0,0,2,,val
0517142_sc-225195.jpg,1,1,0,0,2,,test
0517143_sc-225195.jpg,1,1,0,0,2,,train
0517144_sc-225195.jpg,2,0,1,0,3,,train
0517145_sc-137203.jpg,2,1,1,1,5,,train
0517147_sc-137203.jpg,1,0,1,1,3,,train
0517148_sc-1030890.jpg,1,0,0,1,2,,train
0517149_sc-148215.jpg,2,0,0,0,2,,train
0517150_sc-148215.jpg,2,0,0,0,2,,train
0517151_sc-148215.jpg,3,0,0,0,3,,val
0517152_sc-148215.jpg,2,0,0,0,2,,val
0517153_sc-148215.jpg,4,0,0,0,4,,test
0517154_as-3304974.jpg,2,0,0,0,2,,train
0517155_sc-224559.jpg,1,2,3,1,7,,train
0517156_sc-224559.jpg,0,1,2,2,5,,train
0517157_sc-224559.jpg,0,2,3,1,6,,train
0517158_as-7021499.jpg,2,0,0,0,2,,train
0517159_as-0095752.jpg,2,0,0,0,2,,train
0517160_as-0095752.jpg,1,0,0,0,1,,train
0517161_as-0095752.jpg,1,0,0,0,1,,val
0517162_as-0095752.jpg,1,0,0,0,1,,val
0517163_as-0004586.jpg,2,0,0,0,2,,test
0517164_as-0004586.jpg,2,0,0,0,2,,train
0517165_sc-1006381.jpg,1,1,0,2,4,,train
0517166_sc-1006381.jpg,4,0,0,0,4,,train
0517167_as-2538581.jpg,3,1,1,1,6,,train
0517169_sc-209482.jpg,1,2,0,0,3,,train
0517171_as-2558093.jpg,1,1,0,0,2,,train
0517172_sc-110751.jpg,0,1,0,0,1,,train
0517173_as-2586312.jpg,1,0,3,0,4,,val
0517175_sc-148636.jpg,2,0,0,1,3,,val
0517176_sc-148636.jpg,1,0,0,1,2,,test
0517177_sc-148636.jpg,3,0,0,1,4,,train
0517178_sc-148636.jpg,1,0,0,1,2,,train
0517179_sc-194628.jpg,1,1,0,0,2,,train
0517180_sc-194628.jpg,1,0,0,1,2,,train
0517181_sc-194628.jpg,1,0,0,1,2,,train
0517182_sc-219983.jpg,4,0,0,0,4,,train
0517183_sc-219983.jpg,3,0,0,0,3,,train
0517184_sc-219983.jpg,4,0,0,0,4,,val
0517185_sc-219983.jpg,4,0,0,0,4,,val
0517186_sc-167737.jpg,1,0,0,0,1,,test
0517187_sc-167737.jpg,1,0,0,0,1,,train
0517189_as-0067272.jpg,2,1,2,0,5,,train
0517190_sc-1028750.jpg,1,0,0,0,1,,train
0517191_sc-1028750.jpg,2,2,2,2,8,,train
0517192_sc-1028750.jpg,1,0,1,2,4,,train
0517193_sc-1028750.jpg,2,1,1,0,4,,train
0517194_sc-1028750.jpg,4,0,3,0,7,,train
0517195_sc-216188.jpg,6,0,0,0,6,,val
0517196_sc-216188.jpg,5,0,0,0,5,,val
0517197_sc-216188.jpg,4,0,1,0,5,,test
0517198_as-0031416.jpg,1,0,0,0,1,,train
0517199_as-0031416.jpg,2,0,0,0,2,,train
0517200_as-0031416.jpg,2,0,0,0,2,,train
0517201_as-0031416.jpg,1,0,0,0,1,,train
0517202_sc-171711.jpg,3,0,0,0,3,,train
0517203_sc-171711.jpg,3,0,0,0,3,,train
0517204_sc-134853.jpg,1,0,0,0,1,,train
0517205_sc-134853.jpg,1,0,0,0,1,,val
0517206_as-2594245.jpg,0,0,1,0,1,,val
0517207_sc-227440.jpg,1,0,0,1,2,,test
0517208_as-7240688.jpg,1,0,0,0,1,,train
0517209_as-5580520.jpg,5,0,0,0,5,,train
0517210_sc-129143.jpg,1,0,0,0,1,,train
0517211_as-3468857.jpg,3,0,0,1,4,,train
0517212_as-0082639.jpg,1,0,0,0,1,,train
0517213_sc-125748.jpg,2,0,0,0,2,,train
0517214_sc-125748.jpg,2,0,0,0,2,,train
0517215_sc-125748.jpg,3,0,0,0,3,,val
0517217_sc-218487.jpg,1,0,0,0,1,,val
0517218_sc-218487.jpg,2,0,0,0,2,,test
0517219_sc-218487.jpg,1,0,0,0,1,,train
0517220_sc-184607.jpg,1,0,1,1,3,,train
0517221_as-2697600.jpg,0,1,0,0,1,,train
0517222_sc-1026769.jpg,1,0,0,1,2,,train
0517223_sc-1026769.jpg,1,0,0,1,2,,train
0517224_sc-1026769.jpg,1,0,0,1,2,,train
0517225_sc-1026769.jpg,1,1,1,1,4,,train
0517226_sc-218496.jpg,5,0,0,2,7,,val
0517227_sc-218496.jpg,3,0,0,0,3,,val
0517228_sc-218496.jpg,1,0,0,1,2,,test
0517229_as-0004850.jpg,4,0,0,0,4,,train
0517231_sc-1022916.jpg,4,0,0,0,4,,train
0517232_sc-1022916.jpg,3,0,0,0,3,,train
0517233_as-2960098.jpg,2,1,1,0,4,,train
0517235_sc-151882.jpg,4,0,1,0,5,,train
0517236_sc-151882.jpg,2,0,0,0,2,,train
0517237_sc-151882.jpg,1,0,0,0,1,,train
0517238_as-0067128.jpg,1,1,1,1,4,,val
0517240_as-3215895.jpg,2,0,0,0,2,,val
0517241_as-3223676.jpg,2,0,0,0,2,,test
0517243_as-0041233.jpg,1,0,0,0,1,,train
0517244_as-0041233.jpg,1,0,0,0,1,,train
0517246_sc-141220.jpg,7,0,0,0,7,,train
0517247_sc-211245.jpg,3,1,3,0,7,,train
0517248_sc-211245.jpg,9,1,4,0,14,,train
0517249_sc-211245.jpg,13,1,4,1,19,,train
0517250_sc-211245.jpg,2,0,2,0,4,,train
0517251_sc-211245.jpg,2,0,0,0,2,,val
0517252_sc-211245.jpg,1,0,0,1,2,,val
0517253_as-7709296.jpg,5,0,1,0,6,,test
0517254_sc-178997.jpg,1,0,0,0,1,,train
0517255_sc-178997.jpg,1,0,0,0,1,,train
0517256_sc-178997.jpg,1,0,0,0,1,,train
0517257_sc-178997.jpg,2,0,1,0,3,,train
0517258_sc-1018278.jpg,7,0,0,0,7,,train
0517260_as-3091690.jpg,2,0,2,1,5,,train
0517261_sc-205653.jpg,2,0,1,0,3,,train
0517262_sc-205653.jpg,10,0,1,0,11,,val
0517263_sc-205653.jpg,7,0,0,0,7,,val
0517264_sc-205653.jpg,7,0,0,0,7,,test
0517265_sc-205653.jpg,2,0,1,0,3,,train
0517266_sc-218633.jpg,1,0,1,1,3,,train
0517268_as-0081964.jpg,1,0,0,0,1,,train
0517269_as-0081964.jpg,1,0,0,0,1,,train
0517270_as-0008193.jpg,3,0,2,4,9,,train
0517271_as-0008193.jpg,1,0,0,1,2,,train
0517273_as-0008193.jpg,2,1,0,1,4,,train
0517274_as-0008193.jpg,1,1,0,1,3,,val
0517275_as-0008193.jpg,2,1,0,1,4,,val
0517276_sc-156853.jpg,1,2,0,1,4,,test
0517277_sc-156853.jpg,3,0,0,0,3,,train
0517278_sc-156853.jpg,1,0,1,0,2,,train
0517282_sc-156853.jpg,1,2,0,1,4,,train
0517283_sc-156853.jpg,1,1,0,1,3,,train
0517287_sc-156853.jpg,3,2,1,0,6,,train
0517288_sc-156853.jpg,0,0,1,0,1,,train
0517289_sc-156853.jpg,1,0,0,0,1,,train
0517292_as-0018377.jpg,1,1,0,0,2,,val
0517294_as-2523983.jpg,1,0,0,0,1,,val
0517296_sc-120400.jpg,11,0,0,0,11,,test
0517297_sc-120400.jpg,9,0,0,0,9,,train
0517298_sc-120400.jpg,3,0,0,0,3,,train
0517299_as-0020499.jpg,1,0,0,0,1,,train
0517300_as-0020499.jpg,5,0,0,0,5,,train
0517301_as-0020499.jpg,4,0,0,0,4,,train
0517303_as-0089603.jpg,1,0,0,0,1,,train
0517304_as-0089603.jpg,0,1,0,0,1,,train
0517305_as-0089603.jpg,0,1,0,0,1,,val
0517306_sc-1012374.jpg,1,0,0,0,1,,val
0517308_sc-142258.jpg,1,0,0,0,1,,test
0517309_sc-142258.jpg,1,0,0,0,1,,train
0517310_sc-145168.jpg,1,0,0,1,2,,train
0517313_sc-145168.jpg,1,0,0,1,2,,train
0517314_as-0032656.jpg,3,0,0,0,3,,train
0517315_as-0032656.jpg,1,0,0,0,1,,train
0517316_sc-226922.jpg,1,0,0,0,1,,train
0517317_sc-1010758.jpg,1,1,0,0,2,,train
0517319_as-0010026.jpg,2,0,1,1,4,,val
0517320_as-0010026.jpg,2,1,1,1,5,,val
0517321_as-0010026.jpg,1,2,1,1,5,,test
0517322_as-0010026.jpg,1,0,1,1,3,,train
0517323_as-0010026.jpg,1,0,1,1,3,,train
0517324_as-0010026.jpg,1,0,1,1,3,,train
0517325_as-9018256.jpg,8,0,0,0,8,,train
0517326_as-3181348.jpg,1,0,0,0,1,,train
0517328_sc-207039.jpg,4,0,0,0,4,,train
0517329_sc-207039.jpg,3,0,0,0,3,,train
0517331_sc-1021090.jpg,5,1,1,0,7,,val
0517332_sc-1021090.jpg,2,0,0,0,2,,val
0517333_sc-1021090.jpg,4,0,1,0,5,,test
0517335_as-3226404.jpg,3,2,0,0,5,,train
0517339_as-0058128.jpg,2,0,1,1,4,,train
0517340_as-0058128.jpg,2,0,1,1,4,,train
0517341_as-0058128.jpg,2,0,1,1,4,,train
0517343_sc-1037918.jpg,2,0,0,2,4,,train
0517344_sc-1037918.jpg,3,0,0,2,5,,train
0517345_sc-1037918.jpg,3,0,0,4,7,,train
0517347_as-2779295.jpg,2,0,0,0,2,,val
0517349_sc-103368.jpg,0,0,1,0,1,,val
0517350_sc-103368.jpg,2,0,1,1,4,,test
0517352_sc-103368.jpg,1,0,1,1,3,,train
0517353_sc-103368.jpg,1,0,1,1,3,,train
0517354_sc-103368.jpg,0,0,1,1,2,,train
0517356_as-0000392.jpg,1,0,0,0,1,,train
0517357_as-0000392.jpg,3,0,1,1,5,,train
0517358_as-0000392.jpg,1,0,0,1,2,,train
0517359_as-0000392.jpg,3,0,1,1,5,,train
0517361_as-0060384.jpg,1,0,0,0,1,,val
0517362_as-0060384.jpg,1,1,0,0,2,,val
0517363_as-7086700.jpg,1,0,1,1,3,,test
0517364_sc-202773.jpg,1,0,1,1,3,,train
0517365_sc-202773.jpg,2,0,1,0,3,,train
0517366_sc-156018.jpg,2,1,0,1,4,,train
0517367_sc-156018.jpg,4,1,2,1,8,,train
0517369_as-0055354.jpg,8,0,0,0,8,,train
0517370_as-0055354.jpg,1,0,0,0,1,,train
0517371_as-0055354.jpg,1,0,1,0,2,,train
0517374_as-0068191.jpg,1,0,0,0,1,,val
0517376_as-2888965.jpg,6,1,0,0,7,,val
0517377_sc-211668.jpg,1,0,0,0,1,,test
0517378_sc-211668.jpg,1,0,0,0,1,,train
0517380_as-0015623.jpg,1,0,0,0,1,,train
0517381_as-0015623.jpg,1,0,0,0,1,,train
0517382_as-0015623.jpg,2,0,0,0,2,,train
0517383_as-0015623.jpg,1,0,0,0,1,,train
0517384_as-9064455.jpg,1,0,0,0,1,,train
0517385_as-3291238.jpg,2,0,0,0,2,,train
0517386_as-0046370.jpg,1,0,0,1,2,,val
0517387_as-0046370.jpg,1,0,0,1,2,,val
0517388_as-0046370.jpg,1,0,0,1,2,,test
0517389_as-0046370.jpg,1,0,0,1,2,,train
0517390_as-0008313.jpg,3,0,1,1,5,,train
0517392_as-0008313.jpg,5,0,1,1,7,,train
0517393_as-0008313.jpg,1,0,1,1,3,,train
0517394_as-0008313.jpg,4,0,0,0,4,,train
0517395_as-0008313.jpg,2,0,0,1,3,,train
0517397_sc-153407.jpg,0,1,1,0,2,,train
0517398_as-7359612.jpg,5,0,0,0,5,,val
0517399_sc-1018669.jpg,1,0,0,0,1,,val
0517400_sc-1018669.jpg,1,0,0,0,1,,test
0517401_sc-1018669.jpg,2,0,1,0,3,,train
0517402_as-3175023.jpg,0,0,1,0,1,,train
0517403_as-3242377.jpg,2,0,0,0,2,,train
0517404_as-3350576.jpg,2,0,0,0,2,,train
0517405_as-0036970.jpg,0,1,0,0,1,,train
0517406_as-0036970.jpg,0,0,1,0,1,,train
0517407_as-0036970.jpg,0,0,2,0,2,,train
0517408_as-0036970.jpg,0,0,1,0,1,,val
0517409_as-0036970.jpg,2,0,0,0,2,,val
0517410_as-3239551.jpg,1,0,1,0,2,,test
0517412_as-3014046.jpg,1,0,0,0,1,,train
0517413_as-3208888.jpg,1,0,0,0,1,,train
0517414_as-2698608.jpg,1,0,2,0,3,,train
0517415_as-2615511.jpg,3,0,2,0,5,,train
0517416_as-2581381.jpg,3,0,0,0,3,,train
0517417_as-0022800.jpg,0,0,1,1,2,,train
0517418_as-0022800.jpg,2,0,2,1,5,,train
0517420_sc-201819.jpg,1,0,0,0,1,,val
0517421_sc-201819.jpg,1,0,0,0,1,,val
0517422_sc-201819.jpg,1,0,0,2,3,,test
0517423_sc-201819.jpg,1,0,0,0,1,,train
0517424_sc-201819.jpg,3,0,0,0,3,,train
0517425_sc-201819.jpg,2,0,0,0,2,,train
0517426_sc-201819.jpg,1,1,1,0,3,,train
0517427_sc-201819.jpg,3,0,0,0,3,,train
0517428_sc-201819.jpg,3,0,0,0,3,,train
0517429_sc-201819.jpg,1,0,0,0,1,,train
0517430_sc-201819.jpg,1,0,0,0,1,,val
0517431_sc-201819.jpg,1,0,0,0,1,,val
0517432_sc-201819.jpg,1,0,0,0,1,,test
0517433_sc-201819.jpg,1,0,0,0,1,,train
0517434_sc-201819.jpg,2,0,0,0,2,,train
0517435_sc-201819.jpg,2,0,0,0,2,,train
0517436_sc-201819.jpg,4,1,0,1,6,,train
0517437_sc-201819.jpg,1,0,0,1,2,,train
0517438_sc-209824.jpg,0,0,1,0,1,,train
0517439_sc-209824.jpg,1,0,0,0,1,,train
0517440_sc-198902.jpg,1,0,0,0,1,,val
0517441_sc-198902.jpg,2,0,0,0,2,,val
0517442_as-2851147.jpg,2,0,0,0,2,,test
0517445_as-0027326.jpg,3,0,0,0,3,,train
0517448_sc-112079.jpg,1,0,0,0,1,,train
0517450_sc-159969.jpg,2,0,0,0,2,,train
0517451_sc-142003.jpg,1,0,0,0,1,,train
0517452_sc-142003.jpg,2,0,0,1,3,,train
0517453_sc-142003.jpg,2,0,0,1,3,,train
0517454_as-0093909.jpg,4,2,1,1,8,,train
0517455_as-0093909.jpg,1,3,1,1,6,,val
0517456_as-0093909.jpg,0,3,0,1,4,,val
0517457_as-3424478.jpg,1,0,0,1,2,,test
0517458_as-2810056.jpg,1,1,1,0,3,,train
0517459_as-2852621.jpg,1,0,0,0,1,,train
0517461_sc-220438.jpg,0,1,0,0,1,,train
0517462_sc-220438.jpg,0,1,0,0,1,,train
0517465_as-0025032.jpg,2,0,0,0,2,,train
0517466_as-0025032.jpg,1,0,0,0,1,,train
0517468_as-3311445.jpg,2,0,1,0,3,,train
0517469_as-0030561.jpg,5,1,0,0,6,,val
0517470_as-0030561.jpg,3,1,1,1,6,,val
0517471_as-0030561.jpg,2,2,0,0,4,,test
0517474_as-0092205.jpg,1,0,0,0,1,,train
0517475_as-0092205.jpg,1,0,0,0,1,,train
0517476_as-0092205.jpg,1,0,0,0,1,,train
0517478_as-0033752.jpg,1,0,0,1,2,,train
0517479_as-0033752.jpg,1,0,1,0,2,,train
0517480_as-0033752.jpg,1,0,1,0,2,,train
0517481_as-0033752.jpg,1,0,1,1,3,,train
0517482_as-0033752.jpg,1,0,1,0,2,,val
0517483_as-0033752.jpg,1,0,0,1,2,,val
0517484_as-0033752.jpg,2,0,1,1,4,,test
0517485_as-0033752.jpg,2,0,1,1,4,,train
0517486_as-0033752.jpg,1,0,1,0,2,,train
0517487_sc-1000331.jpg,1,0,0,0,1,,train
0517488_sc-1000331.jpg,2,1,0,0,3,,train
0517489_sc-122561.jpg,0,0,1,1,2,,train
0517490_sc-122561.jpg,0,0,1,1,2,,train
0517491_sc-122561.jpg,0,0,1,2,3,,train
0517492_as-0094249.jpg,1,0,0,0,1,,val
0517494_sc-198942.jpg,2,0,0,0,2,,val
0517495_sc-198942.jpg,2,0,0,0,2,,test
0517496_sc-145164.jpg,1,0,1,1,3,,train
0517497_as-9054065.jpg,1,0,0,0,1,,train
0517500_as-0079634.jpg,5,0,0,0,5,,train
0517501_as-2534835.jpg,3,2,2,0,7,,train
0517503_sc-113087.jpg,1,0,2,0,3,,train
0517504_sc-113087.jpg,1,0,1,0,2,,train
0517505_sc-113087.jpg,1,2,1,0,4,,train
0517506_sc-138369.jpg,0,1,0,0,1,,val
0517507_sc-138369.jpg,1,1,0,0,2,,val
0517508_as-0054391.jpg,2,1,0,0,3,,test
0517509_as-0054391.jpg,3,0,0,0,3,,train
0517510_sc-165893.jpg,1,0,0,0,1,,train
0517511_as-3427627.jpg,1,0,0,0,1,,train
0517512_as-7784988.jpg,2,0,0,0,2,,train
0517514_sc-215613.jpg,1,0,0,0,1,,train
0517515_sc-215613.jpg,1,0,0,0,1,,train
0517516_as-2605252.jpg,3,1,1,0,5,,train
0517518_sc-152976.jpg,1,0,0,0,1,,val
0517519_sc-152976.jpg,2,0,0,0,2,,val
0517521_sc-172742.jpg,6,1,1,0,8,,test
0517522_sc-172742.jpg,6,0,1,0,7,,train
0517523_sc-172742.jpg,5,0,1,0,6,,train
0517524_sc-172742.jpg,3,0,0,0,3,,train
0517525_sc-107609.jpg,1,0,0,1,2,,train
0517526_sc-107609.jpg,1,0,0,1,2,,train
0517527_sc-107609.jpg,1,0,0,1,2,,train
0517528_sc-229195.jpg,4,1,1,0,6,,train
0517529_sc-229195.jpg,1,0,0,1,2,,val
0517530_sc-1008267.jpg,2,1,0,0,3,,val
0517531_as-0046506.jpg,0,0,0,1,1,,test
0517532_as-0046506.jpg,2,0,0,1,3,,train
0517533_as-0046506.jpg,2,1,0,0,3,,train
0517535_as-0046506.jpg,2,0,0,0,2,,train
0517536_as-0046506.jpg,1,0,0,0,1,,train
0517537_as-2724945.jpg,1,0,1,0,2,,train
0517538_sc-171016.jpg,8,3,3,0,14,,train
0517539_sc-171016.jpg,2,1,2,0,5,,train
0517541_as-0001068.jpg,5,0,0,0,5,,val
0517542_sc-1019384.jpg,2,0,0,0,2,,val
0517543_as-3259291.jpg,1,0,0,0,1,,test
0517544_as-0055445.jpg,1,0,0,0,1,,train
0517545_as-0055445.jpg,1,2,0,0,3,,train
0517546_as-0055445.jpg,1,0,0,0,1,,train
0517547_as-0055445.jpg,0,1,0,0,1,,train
0517548_as-0055445.jpg,1,1,0,0,2,,train
0517549_as-0055445.jpg,1,1,0,0,2,,train
0517550_as-0055445.jpg,1,1,0,0,2,,train
0517551_as-0055445.jpg,0,1,0,0,1,,val
0517552_as-0055445.jpg,0,1,0,0,1,,val
0517553_as-3291946.jpg,2,1,1,2,6,,test
0517554_as-3134759.jpg,1,0,0,0,1,,train
0517555_as-0016967.jpg,0,0,1,0,1,,train
0517556_as-0016967.jpg,0,1,0,0,1,,train
0517557_as-0016967.jpg,0,1,0,1,2,,train
0517558_as-0016967.jpg,0,1,0,0,1,,train
0517559_sc-118307.jpg,3,0,0,0,3,,train
0517561_sc-118307.jpg,1,0,2,1,4,,train
0517565_as-9073304.jpg,1,0,0,1,2,,val
0517566_as-0066876.jpg,1,0,0,1,2,,val
0517568_as-7077065.jpg,1,0,2,1,4,,test
0517570_sc-1018872.jpg,1,0,1,1,3,,train
0517572_as-0064458.jpg,3,0,0,0,3,,train
0517573_as-0065302.jpg,2,1,0,0,3,,train
0517574_as-0065302.jpg,2,0,0,0,2,,train
0517575_as-0065302.jpg,5,1,1,1,8,,train
0517576_as-0065302.jpg,1,0,0,0,1,,train
0517577_as-3366498.jpg,1,0,1,1,3,,train
0517578_sc-201048.jpg,5,0,0,0,5,,val
0517579_as-3145881.jpg,1,0,0,0,1,,val
0517584_as-0008812.jpg,1,1,0,0,2,,test
0517586_sc-111943.jpg,1,0,0,0,1,,train
0517587_as-2762587.jpg,1,0,1,0,2,,train
0517588_as-0088869.jpg,0,0,1,0,1,,train
0517590_as-0088869.jpg,1,0,0,0,1,,train
0517591_as-0088869.jpg,1,0,1,0,2,,train
0517592_as-0088869.jpg,1,0,1,0,2,,train
0517593_as-0088869.jpg,1,0,1,0,2,,train
0517594_as-0088869.jpg,1,0,1,0,2,,val
0517595_as-0088869.jpg,1,0,1,0,2,,val
0517596_as-3097657.jpg,1,1,1,1,4,,test
0517597_as-0039601.jpg,0,0,2,1,3,,train
0517598_as-7578880.jpg,1,1,1,0,3,,train
0517600_as-0030170.jpg,2,1,1,1,5,,train
0517601_as-0030170.jpg,2,2,0,0,4,,train
0517603_as-0002947.jpg,1,0,0,0,1,,train
0517604_as-0002947.jpg,2,0,0,0,2,,train
0517605_as-0002947.jpg,2,0,0,0,2,,train
0517606_as-0002947.jpg,4,0,0,0,4,,val
0517607_as-0002947.jpg,1,0,0,1,2,,val
0517608_as-2928428.jpg,0,0,1,0,1,,test
0517609_as-2846159.jpg,3,0,2,0,5,,train
0517611_sc-116903.jpg,2,1,0,0,3,,train
0517612_sc-116903.jpg,1,0,0,0,1,,train
0517613_sc-116903.jpg,1,1,0,0,2,,train
0517614_as-2811965.jpg,2,0,0,0,2,,train
0517616_as-2983927.jpg,2,0,2,1,5,,train
0517617_as-0077740.jpg,0,1,0,0,1,,train
0517618_as-0077740.jpg,0,1,0,0,1,,val
0517621_as-0064146.jpg,2,0,1,0,3,,val
0517623_as-0064146.jpg,2,1,3,0,6,,test
0517624_as-0064146.jpg,1,1,3,0,5,,train
0517625_sc-229393.jpg,0,1,0,0,1,,train
0517626_sc-229393.jpg,1,1,0,0,2,,train
0517627_as-0021651.jpg,4,0,0,0,4,,train
0517628_sc-129357.jpg,1,0,0,1,2,,train
0517629_sc-129357.jpg,2,0,0,1,3,,train
0517630_sc-129357.jpg,1,0,1,1,3,,train
0517631_sc-129357.jpg,3,0,0,1,4,,val
0517632_sc-129357.jpg,1,0,0,0,1,,val
0517633_sc-129357.jpg,3,0,0,0,3,,test
0517634_as-0051697.jpg,3,1,1,1,6,,train
0517635_sc-201552.jpg,3,0,0,0,3,,train
0517636_sc-201552.jpg,2,0,0,0,2,,train
0517637_sc-201552.jpg,1,0,0,0,1,,train
0517638_sc-116932.jpg,0,0,1,0,1,,train
0517639_sc-116932.jpg,0,0,1,0,1,,train
0517640_as-0064543.jpg,1,0,0,0,1,,train
0517641_as-0064543.jpg,0,0,1,0,1,,val
0517642_as-0064543.jpg,0,3,4,1,8,,val
0517643_as-0064543.jpg,0,1,2,1,4,,test
0517644_as-0064543.jpg,1,1,1,1,4,,train
0517648_as-0012847.jpg,2,0,1,1,4,,train
0517649_as-0012847.jpg,2,0,1,1,4,,train
0517650_as-0012847.jpg,1,0,1,1,3,,train
0517651_as-0012847.jpg,1,0,1,1,3,,train
0517652_as-0012847.jpg,1,0,1,0,2,,train
0517653_as-0012847.jpg,1,0,1,0,2,,train
0517655_as-0012847.jpg,5,3,0,0,8,,val
0517656_as-0012847.jpg,3,2,2,0,7,,val
0517657_as-0012847.jpg,1,0,1,0,2,,test
0517658_as-0012847.jpg,1,0,2,0,3,,train
0517659_as-0012847.jpg,0,0,1,0,1,,train
0517660_as-0012847.jpg,0,0,1,0,1,,train
0517662_as-0012847.jpg,1,0,1,0,2,,train
0517663_as-0012847.jpg,0,1,1,0,2,,train
0517664_as-0012847.jpg,0,1,1,0,2,,train
0517665_as-0012847.jpg,1,0,0,0,1,,train
0517666_as-3108395.jpg,0,1,2,0,3,,val
0517671_as-0041335.jpg,3,1,1,0,5,,val
0517672_as-0041335.jpg,1,0,0,1,2,,test
0517673_as-2769443.jpg,2,0,1,1,4,,train
0517674_sc-107676.jpg,1,1,0,0,2,,train
0517676_as-3387359.jpg,0,0,2,0,2,,train
0517677_sc-138478.jpg,2,0,0,0,2,,train
0517678_sc-138478.jpg,4,0,0,1,5,,train
0517679_as-2626507.jpg,2,0,0,1,3,,train
0517680_as-2810330.jpg,1,0,1,1,3,,train
0517681_as-2540642.jpg,1,0,0,0,1,,val
0517682_as-0070168.jpg,2,0,1,0,3,,val
0517683_as-0070168.jpg,1,0,2,0,3,,test
0517684_as-0070168.jpg,1,0,2,0,3,,train
0517685_as-0070168.jpg,1,0,1,0,2,,train
0517686_as-0070168.jpg,1,0,1,1,3,,train
0517687_as-0075659.jpg,0,1,0,0,1,,train
0517691_as-0085314.jpg,3,1,2,1,7,,train
0517694_sc-158753.jpg,3,0,0,0,3,,train
0517695_sc-158753.jpg,1,0,0,0,1,,train
0517696_sc-158753.jpg,1,0,1,0,2,,val
0517697_sc-158753.jpg,6,0,1,0,7,,val
0517698_sc-158753.jpg,4,0,1,0,5,,test
0517699_sc-158753.jpg,2,0,1,0,3,,train
0517700_as-0060679.jpg,1,0,0,0,1,,train
0517701_as-0060679.jpg,2,0,0,0,2,,train
0517703_sc-1041327.jpg,2,0,0,0,2,,train
0517705_sc-1041327.jpg,1,0,0,0,1,,train
0517706_as-0054801.jpg,5,0,0,0,5,,train
0517707_as-0054801.jpg,5,0,0,0,5,,train
0517708_as-0054801.jpg,5,0,0,0,5,,val
0517710_as-0068195.jpg,1,0,0,0,1,,val
0517711_as-0068195.jpg,3,1,0,1,5,,test
0517712_as-0068195.jpg,2,1,2,0,5,,train
0517713_as-0068195.jpg,1,0,2,0,3,,train
0517714_as-9038480.jpg,2,0,0,0,2,,train
0517715_as-0045821.jpg,1,1,0,0,2,,train
0517716_as-0045821.jpg,1,0,0,2,3,,train
0517717_as-7006904.jpg,5,0,0,0,5,,train
0517718_as-0067953.jpg,1,0,1,0,2,,train
0517719_as-0067953.jpg,1,1,0,0,2,,val
0517720_as-2949031.jpg,1,0,1,0,2,,val
0517721_as-2949031.jpg,2,0,0,0,2,,test
0517722_as-3317110.jpg,2,0,0,0,2,,train
0517724_as-0085809.jpg,3,0,1,1,5,,train
0517726_as-0085809.jpg,2,0,1,1,4,,train
0517728_as-2762009.jpg,1,0,0,1,2,,train
0517729_sc-176128.jpg,5,0,0,0,5,,train
0517730_sc-176128.jpg,9,0,1,0,10,,train
0517731_sc-176128.jpg,3,0,1,1,5,,train
0517732_sc-176128.jpg,0,0,1,0,1,,val
0517733_sc-176128.jpg,2,0,1,0,3,,val
0517734_sc-176128.jpg,4,0,0,0,4,,test
0517735_sc-176128.jpg,2,0,0,0,2,,train
0517736_sc-176128.jpg,3,0,2,0,5,,train
0517737_sc-176128.jpg,2,0,0,0,2,,train
0517738_sc-211509.jpg,2,1,0,0,3,,train
0517739_sc-208243.jpg,1,1,0,0,2,,train
0517740_as-3110115.jpg,1,0,0,1,2,,train
0517741_as-3196030.jpg,1,0,1,1,3,,train
0517742_as-2989105.jpg,0,1,1,2,4,,val
0517743_as-2650470.jpg,2,0,0,0,2,,val
0517744_as-3494913.jpg,1,0,1,0,2,,test
0517745_sc-196671.jpg,1,0,0,0,1,,train
0517746_sc-196671.jpg,1,0,0,0,1,,train
0517747_sc-196671.jpg,4,0,0,0,4,,train
0517748_sc-196671.jpg,4,0,0,0,4,,train
0517752_sc-196671.jpg,2,0,0,0,2,,train
0517753_sc-151007.jpg,1,1,0,0,2,,train
0517757_as-2881246.jpg,1,0,0,0,1,,train
0517758_as-2884242.jpg,2,0,0,0,2,,val
0517759_as-3046036.jpg,1,0,0,0,1,,val
0517760_as-2637819.jpg,3,0,2,3,8,,test
0517761_sc-1008206.jpg,2,1,0,0,3,,train
0517762_sc-1008206.jpg,0,0,1,0,1,,train
0517763_sc-1008206.jpg,2,1,1,0,4,,train
0517764_sc-1008206.jpg,2,2,2,0,6,,train
0517765_sc-1008206.jpg,7,2,2,0,11,,train
0517766_sc-159252.jpg,3,0,0,0,3,,train
0517767_sc-159252.jpg,2,0,0,0,2,,train
0517768_sc-159252.jpg,2,1,0,0,3,,val
0517769_sc-159252.jpg,3,0,0,0,3,,val
0517770_sc-159252.jpg,1,0,0,0,1,,test
0517771_sc-226082.jpg,2,0,0,0,2,,train
0517772_sc-226082.jpg,1,0,0,0,1,,train
0517773_sc-226082.jpg,1,0,0,0,1,,train
0517774_sc-226082.jpg,1,0,0,0,1,,train
0517775_sc-226082.jpg,3,0,0,0,3,,train
0517776_sc-226082.jpg,1,0,0,0,1,,train
0517777_sc-226082.jpg,1,0,0,0,1,,train
0517778_sc-226082.jpg,1,0,0,0,1,,val
0517779_sc-226082.jpg,2,0,0,0,2,,val
0517780_sc-226082.jpg,4,0,0,0,4,,test
0517781_as-3435878.jpg,0,0,1,0,1,,train
0517782_sc-103975.jpg,2,0,0,0,2,,train
0517783_sc-103975.jpg,3,0,0,0,3,,train
0517784_sc-103975.jpg,9,0,0,1,10,,train
0517785_as-0008448.jpg,1,1,0,1,3,,train
0517786_as-0008448.jpg,1,1,0,1,3,,train
0517788_as-0046040.jpg,3,1,0,1,5,,train
0517789_as-0046040.jpg,2,0,0,1,3,,val
0517790_as-0046040.jpg,0,1,0,0,1,,val
0517791_as-0046040.jpg,2,0,0,0,2,,test
0517792_as-0046040.jpg,3,1,0,1,5,,train
0517793_as-3446170.jpg,3,0,2,0,5,,train
0517794_as-5133849.jpg,2,0,1,0,3,,train
0517795_sc-175072.jpg,2,0,0,0,2,,train
0517796_sc-1023133.jpg,1,0,0,0,1,,train
0517797_sc-1023133.jpg,0,0,0,1,1,,train
0517798_sc-1023133.jpg,1,0,0,0,1,,train
0517799_sc-1023133.jpg,2,0,0,0,2,,val
0517800_sc-1023133.jpg,1,0,0,0,1,,val
0517801_sc-1023133.jpg,3,0,0,0,3,,test
0517802_sc-1023133.jpg,3,0,0,0,3,,train
0517803_sc-1023133.jpg,2,0,0,0,2,,train
0517804_sc-1023133.jpg,0,0,0,1,1,,train
0517805_sc-1023133.jpg,0,0,0,2,2,,train
0517806_sc-1023133.jpg,1,0,1,0,2,,train
0517807_sc-1023133.jpg,1,0,1,0,2,,train
0517808_sc-1023133.jpg,1,0,1,0,2,,train
0517810_sc-1017950.jpg,1,0,0,0,1,,val
0517812_sc-1017950.jpg,0,1,0,0,1,,val
0517813_sc-1017950.jpg,1,0,0,0,1,,test
0517816_as-0089480.jpg,3,0,0,1,4,,train
0517817_as-3266119.jpg,1,1,0,0,2,,train
0517819_as-3194296.jpg,2,0,0,0,2,,train
0517820_sc-121525.jpg,2,1,3,0,6,,train
0517823_as-0055382.jpg,3,0,0,1,4,,train
0517824_as-0055382.jpg,1,0,0,1,2,,train
0517825_as-2825212.jpg,3,0,1,2,6,,train
0517827_as-0069212.jpg,2,0,0,1,3,,val
0517828_as-0069212.jpg,2,0,0,1,3,,val
0517829_as-2633142.jpg,3,1,0,0,4,,test
0517830_as-2798879.jpg,5,0,2,1,8,,train
0517831_as-2637070.jpg,1,0,0,1,2,,train
0517832_as-0093075.jpg,2,0,0,0,2,,train
0517833_as-0093075.jpg,2,0,0,0,2,,train
0517834_as-0093075.jpg,1,0,1,0,2,,train
0517835_as-0042090.jpg,1,0,0,0,1,,train
0517837_as-0042090.jpg,1,1,1,1,4,,train
0517840_as-0042090.jpg,0,0,1,0,1,,val
0517841_as-0042090.jpg,1,0,1,0,2,,val
0517842_as-0042090.jpg,2,0,0,0,2,,test
0517843_as-0042090.jpg,4,0,0,0,4,,train
0517845_as-0042090.jpg,2,0,1,0,3,,train
0517847_as-0042090.jpg,1,1,2,0,4,,train
0517848_as-0042090.jpg,1,1,0,0,2,,train
0517849_as-0042090.jpg,2,0,0,0,2,,train
0517850_as-3418018.jpg,2,1,1,0,4,,train
0517851_sc-201765.jpg,1,2,0,0,3,,train
0517852_sc-201765.jpg,1,2,0,0,3,,val
0517853_sc-136128.jpg,1,0,1,0,2,,val
0517854_sc-136128.jpg,1,0,1,0,2,,test
0517855_sc-136128.jpg,1,0,1,0,2,,train
0517856_as-3261176.jpg,1,1,0,0,2,,train
0517857_sc-224142.jpg,1,0,0,0,1,,train
0517858_sc-224142.jpg,2,0,0,0,2,,train
0517859_sc-224142.jpg,1,0,1,0,2,,train
0517860_sc-202939.jpg,1,0,0,0,1,,train
0517861_sc-202939.jpg,1,0,0,0,1,,train
0517862_sc-229147.jpg,3,0,0,0,3,,val
0517863_sc-229147.jpg,3,0,0,0,3,,val
0517866_as-3216432.jpg,2,2,0,0,4,,test
0517867_as-3216432.jpg,3,1,2,1,7,,train
0517868_sc-227226.jpg,3,0,0,0,3,,train
0517869_sc-227226.jpg,4,0,0,0,4,,train
0517870_sc-228282.jpg,6,0,0,1,7,,train
0517871_sc-228282.jpg,5,0,0,1,6,,train
0517872_as-0038616.jpg,1,0,1,1,3,,train
0517873_as-0038616.jpg,1,0,1,1,3,,train
0517875_sc-183053.jpg,4,2,0,0,6,,val
0517876_sc-226672.jpg,0,0,1,0,1,,val
0517877_sc-226672.jpg,0,1,0,0,1,,test
0517878_sc-226672.jpg,0,0,1,0,1,,train
0517879_sc-226672.jpg,1,0,0,0,1,,train
0517880_sc-226672.jpg,1,0,0,0,1,,train
0517881_sc-198413.jpg,0,2,0,0,2,,train
0517882_sc-198413.jpg,1,0,0,0,1,,train
0517884_sc-198413.jpg,0,2,0,0,2,,train
0517885_sc-198413.jpg,1,0,0,0,1,,train
0517887_sc-170729.jpg,0,0,1,0,1,,val
0517888_sc-170729.jpg,1,0,0,0,1,,val
0517889_as-0022408.jpg,1,0,0,0,1,,test
0517890_as-0022408.jpg,1,0,0,0,1,,train
0517891_as-0022408.jpg,4,0,0,0,4,,train
0517893_as-0022408.jpg,0,0,1,1,2,,train
0517894_as-0022408.jpg,0,0,1,0,1,,train
0517895_as-0022408.jpg,2,1,1,0,4,,train
0517896_as-0024402.jpg,3,0,0,2,5,,train
0517897_as-0024402.jpg,1,0,0,2,3,,train
0517898_as-0024402.jpg,2,0,0,2,4,,val
0517899_as-0024402.jpg,1,0,0,1,2,,val
0517900_as-3199728.jpg,1,0,1,0,2,,test
0517901_sc-215187.jpg,2,0,0,1,3,,train
0517902_sc-215187.jpg,4,0,0,0,4,,train
0517903_sc-215187.jpg,4,0,1,0,5,,train
0517904_sc-215187.jpg,6,0,2,0,8,,train
0517905_sc-221855.jpg,0,1,1,1,3,,train
0517907_sc-132047.jpg,2,0,1,0,3,,train
0517908_sc-132047.jpg,3,0,1,0,4,,train
0517909_sc-132047.jpg,2,0,1,0,3,,val
0517910_sc-132047.jpg,1,0,0,1,2,,val
0517914_sc-132047.jpg,2,0,0,0,2,,test
0517915_sc-132047.jpg,1,0,1,0,2,,train
0517916_sc-132047.jpg,2,0,1,0,3,,train
0517918_sc-132047.jpg,1,0,1,1,3,,train
0517919_sc-132047.jpg,1,0,1,1,3,,train
0517920_as-2508275.jpg,2,0,0,0,2,,train
0517921_sc-117225.jpg,4,0,0,0,4,,train
0517922_sc-117225.jpg,1,0,0,1,2,,train
0517923_sc-117225.jpg,2,0,0,0,2,,val
0517924_sc-117225.jpg,1,0,0,0,1,,val
0517925_sc-117225.jpg,1,0,0,0,1,,test
0517926_sc-117225.jpg,1,0,0,0,1,,train
0517927_as-0008947.jpg,1,0,0,0,1,,train
0517929_sc-182920.jpg,2,0,0,0,2,,train
0517930_sc-182920.jpg,1,0,0,0,1,,train
0517931_sc-182920.jpg,1,1,0,0,2,,train
0517932_sc-136022.jpg,3,0,1,0,4,,train
0517933_sc-136022.jpg,7,0,0,0,7,,train
0517934_sc-136022.jpg,0,0,1,0,1,,val
0517935_sc-136022.jpg,3,1,0,0,4,,val
0517936_sc-136022.jpg,1,0,0,0,1,,test
0517937_sc-116511.jpg,1,0,0,1,2,,train
0517938_sc-116511.jpg,4,0,0,3,7,,train
0517939_sc-116511.jpg,3,0,0,0,3,,train
0517940_sc-116511.jpg,4,0,0,0,4,,train
0517941_sc-116511.jpg,6,0,0,0,6,,train
0517942_sc-116511.jpg,2,0,0,0,2,,train
0517943_sc-116511.jpg,0,0,0,1,1,,train
0517945_sc-116511.jpg,0,0,0,1,1,,val
0517946_sc-116511.jpg,2,0,0,0,2,,val
0517947_sc-116511.jpg,2,0,0,0,2,,test
0517948_sc-116511.jpg,0,0,2,1,3,,train
0517949_sc-116511.jpg,3,0,0,0,3,,train
0517950_sc-116511.jpg,2,0,0,0,2,,train
0517951_as-0001801.jpg,3,0,1,0,4,,train
0517952_as-0001801.jpg,11,2,1,0,14,,train
0517953_as-3223361.jpg,0,1,1,0,2,,train
0517954_as-3223361.jpg,1,0,0,0,1,,train
0517955_as-2760008.jpg,4,0,0,0,4,,val
0517956_sc-145948.jpg,1,1,0,0,2,,val
0517957_sc-145948.jpg,4,0,0,0,4,,test
0517959_sc-186309.jpg,3,0,0,2,5,,train
0517960_sc-186309.jpg,4,0,0,2,6,,train
0517961_as-2954213.jpg,0,0,0,1,1,,train
0517965_as-0100061.jpg,2,1,1,1,5,,train
0517967_as-0100061.jpg,1,1,1,1,4,,train
0517969_sc-1018731.jpg,1,0,0,0,1,,train
0517970_sc-1018731.jpg,1,0,0,0,1,,train
0517971_sc-1018731.jpg,1,0,1,0,2,,val
0517972_as-2814679.jpg,0,0,0,1,1,,val
0517973_as-0085927.jpg,1,0,2,0,3,,test
0517975_as-0072150.jpg,2,0,0,0,2,,train
0517977_as-0047347.jpg,1,0,2,1,4,,train
0517978_as-0047347.jpg,2,0,2,0,4,,train
0517981_sc-157770.jpg,4,0,0,0,4,,train
0517982_sc-157770.jpg,2,1,0,0,3,,train
0517983_sc-157770.jpg,2,1,0,0,3,,train
0517984_sc-157770.jpg,1,1,0,0,2,,train
0517985_sc-157770.jpg,1,1,1,1,4,,val
0517986_sc-157770.jpg,1,1,1,1,4,,val
0517987_sc-157770.jpg,1,1,1,1,4,,test
0517990_sc-213038.jpg,5,1,1,0,7,,train
0517991_sc-213038.jpg,2,0,1,0,3,,train
0517992_sc-213038.jpg,3,0,0,0,3,,train
0517993_sc-116059.jpg,2,0,0,2,4,,train
0517994_sc-152778.jpg,1,0,0,0,1,,train
0517995_sc-152778.jpg,1,0,0,0,1,,train
0517997_sc-152778.jpg,1,0,0,0,1,,train
0517998_sc-152778.jpg,1,0,0,0,1,,val
0517999_sc-152778.jpg,2,0,0,0,2,,val
0518000_sc-172155.jpg,5,0,0,1,6,,test
0518001_sc-172155.jpg,5,0,0,2,7,,train
0518003_as-3422336.jpg,1,0,0,0,1,,train
0518004_as-3165646.jpg,4,0,2,0,6,,train
0518006_as-0063374.jpg,0,0,1,0,1,,train
0518007_as-0079692.jpg,2,0,1,0,3,,train
0518008_sc-208358.jpg,5,0,1,0,6,,train
0518009_sc-208358.jpg,4,2,0,0,6,,train
0518010_sc-208358.jpg,1,0,0,0,1,,val
0518011_sc-1035162.jpg,2,1,0,0,3,,val
0518012_sc-1035162.jpg,3,0,1,0,4,,test
0518013_sc-1035162.jpg,8,0,1,2,11,,train
0518014_sc-1035162.jpg,4,0,1,2,7,,train
0518015_sc-1035162.jpg,3,0,1,0,4,,train
0518019_sc-116283.jpg,0,1,0,0,1,,train
0518020_sc-186131.jpg,3,0,0,0,3,,train
0518021_sc-186131.jpg,2,0,1,0,3,,train
0518022_sc-201162.jpg,1,0,1,0,2,,train
0518024_sc-201162.jpg,8,0,0,0,8,,val
0518026_sc-201162.jpg,1,0,0,0,1,,val
0518027_sc-201162.jpg,0,0,1,0,1,,test
0518028_sc-201162.jpg,0,0,1,0,1,,train
0518029_sc-201162.jpg,1,0,1,0,2,,train
0518030_sc-201162.jpg,1,0,1,0,2,,train
0518031_sc-154713.jpg,4,0,0,0,4,,train
0518033_sc-154713.jpg,1,0,0,0,1,,train
0518034_sc-154713.jpg,1,0,0,0,1,,train
0518035_sc-154713.jpg,1,0,0,0,1,,train
0518036_sc-154713.jpg,1,0,0,0,1,,val
0518038_as-2721253.jpg,1,0,0,0,1,,val
0518039_as-2528157.jpg,4,0,0,0,4,,test
0518040_as-3316637.jpg,2,0,0,0,2,,train
0518041_as-0031092.jpg,3,0,0,1,4,,train
0518044_as-0088247.jpg,2,0,0,2,4,,train
0518045_as-0088247.jpg,2,0,0,0,2,,train
0518046_as-0088247.jpg,2,0,0,0,2,,train
0518047_as-0088247.jpg,2,0,0,0,2,,train
0518048_sc-1013484.jpg,1,0,0,1,2,,train
0518049_sc-1013484.jpg,1,0,0,2,3,,val
0518051_sc-1029556.jpg,9,0,2,1,12,,val
0518053_as-3305458.jpg,0,1,1,0,2,,test
0518057_as-2975416.jpg,0,0,4,0,4,,train
0518060_sc-154671.jpg,1,0,1,0,2,,train
0518061_sc-154671.jpg,2,0,0,1,3,,train
0518062_sc-154671.jpg,3,0,1,0,4,,train
0518064_sc-118540.jpg,2,0,0,0,2,,train
0518065_sc-118540.jpg,2,0,0,0,2,,train
0518066_as-2893067.jpg,1,1,1,0,3,,train
0518068_sc-105434.jpg,3,1,0,0,4,,val
0518069_sc-104308.jpg,1,0,0,0,1,,val
0518070_sc-206327.jpg,2,0,0,0,2,,test
0518071_sc-206327.jpg,2,0,0,0,2,,train
0518075_sc-206327.jpg,3,0,0,0,3,,train
0518076_sc-206327.jpg,2,0,0,0,2,,train
0518077_sc-206327.jpg,1,0,0,0,1,,train
0518079_sc-122197.jpg,0,0,1,0,1,,train
0518080_sc-122197.jpg,0,0,1,0,1,,train
0518081_sc-1000711.jpg,3,0,0,1,4,,train
0518082_sc-1000711.jpg,1,0,0,1,2,,val
0518084_as-0080602.jpg,3,0,0,0,3,,val
0518085_as-0080602.jpg,1,0,0,0,1,,test
0518087_as-0080602.jpg,4,0,0,0,4,,train
0518088_sc-1040069.jpg,3,0,0,0,3,,train
0518092_sc-133686.jpg,1,0,0,1,2,,train
0518093_sc-133686.jpg,1,0,0,1,2,,train
0518094_sc-133686.jpg,2,0,0,0,2,,train
0518095_sc-133686.jpg,2,0,0,0,2,,train
0518096_sc-133686.jpg,2,0,0,0,2,,train
0518097_sc-133686.jpg,1,0,1,0,2,,val
0518098_sc-133686.jpg,2,0,0,1,3,,val
0518099_sc-133686.jpg,2,0,0,0,2,,test
0518100_sc-1008951.jpg,1,0,1,1,3,,train
0518101_sc-1008951.jpg,2,0,2,2,6,,train
0518102_sc-1008951.jpg,2,1,1,1,5,,train
0518103_sc-1008951.jpg,2,0,1,1,4,,train
0518106_as-0045932.jpg,6,0,0,0,6,,train
0518107_as-0045932.jpg,1,0,0,0,1,,train
0518108_as-0045932.jpg,1,0,0,0,1,,train
0518109_as-0045932.jpg,1,0,0,0,1,,val
0518117_as-3268774.jpg,2,0,0,0,2,,val
0518118_sc-1026167.jpg,6,2,1,1,10,,test
0518121_sc-1009804.jpg,5,0,0,1,6,,train
0518122_sc-1006342.jpg,1,0,1,1,3,,train
0518123_sc-1006342.jpg,3,0,1,1,5,,train
0518124_sc-1006342.jpg,2,0,1,0,3,,train
0518125_as-3299712.jpg,1,0,1,0,2,,train
0518126_as-3299712.jpg,1,0,0,0,1,,train
0518129_as-0064664.jpg,1,0,0,0,1,,train
0518131_sc-142529.jpg,4,0,0,0,4,,val
0518132_sc-142529.jpg,4,0,0,0,4,,val
0518134_as-0027859.jpg,1,0,0,1,2,,test
0518135_as-0027859.jpg,1,0,0,1,2,,train
0518136_as-0027859.jpg,1,0,0,1,2,,train
0518137_as-0027859.jpg,1,0,0,1,2,,train
0518138_as-0027859.jpg,1,0,1,0,2,,train
0518140_as-0027859.jpg,1,0,0,1,2,,train
0518141_as-0027859.jpg,1,0,0,1,2,,train
0518142_as-0027859.jpg,1,0,0,1,2,,train
0518143_sc-194237.jpg,5,0,0,0,5,,val
0518145_sc-194237.jpg,2,0,0,0,2,,val
0518147_sc-194237.jpg,1,0,1,0,2,,test
0518148_sc-194237.jpg,0,0,1,0,1,,train
0518149_sc-194237.jpg,1,0,0,0,1,,train
0518150_sc-194237.jpg,2,0,0,0,2,,train
0518151_as-7594224.jpg,1,1,0,0,2,,train
0518152_as-9029237.jpg,2,1,0,0,3,,train
0518153_sc-211355.jpg,2,0,0,0,2,,train
0518154_sc-211355.jpg,1,0,0,0,1,,train
0518156_sc-211355.jpg,2,0,0,0,2,,val
0518157_sc-211355.jpg,1,0,0,0,1,,val
0518158_sc-211355.jpg,1,0,0,0,1,,test
0518159_sc-211355.jpg,3,0,1,0,4,,train
0518161_sc-211355.jpg,1,0,1,0,2,,train
0518162_sc-211355.jpg,3,0,1,0,4,,train
0518163_sc-211355.jpg,2,0,0,0,2,,train
0518164_sc-211355.jpg,3,0,0,0,3,,train
0518165_sc-211355.jpg,3,0,0,0,3,,train
0518167_as-0068255.jpg,0,1,0,0,1,,train
0518168_as-0068255.jpg,1,1,0,0,2,,val
0518169_as-0045587.jpg,1,1,0,0,2,,val
0518170_as-0045587.jpg,1,1,0,0,2,,test
0518171_as-0045587.jpg,1,0,0,0,1,,train
0518172_as-0045587.jpg,1,1,0,0,2,,train
0518173_as-0045587.jpg,1,0,0,0,1,,train
0518174_as-0045587.jpg,1,0,0,0,1,,train
0518175_as-2526922.jpg,1,0,1,1,3,,train
0518176_sc-106977.jpg,2,1,1,1,5,,train
0518178_sc-106977.jpg,0,1,0,0,1,,train
0518179_sc-106977.jpg,1,2,0,1,4,,val
0518180_sc-106977.jpg,0,1,0,1,2,,val
0518181_sc-106977.jpg,0,2,0,0,2,,test
0518182_sc-106977.jpg,2,1,0,0,3,,train
0518183_sc-106977.jpg,1,0,1,1,3,,train
0518184_as-3059212.jpg,1,0,0,1,2,,train
0518188_sc-1007421.jpg,0,2,3,0,5,,train
0518189_sc-1007421.jpg,2,4,0,0,6,,train
0518190_sc-1007421.jpg,1,1,0,0,2,,train
0518191_as-7208826.jpg,0,1,0,0,1,,train
0518192_as-0030764.jpg,1,0,0,0,1,,val
0518193_as-0030764.jpg,1,0,0,0,1,,val
0518194_as-0030764.jpg,1,0,0,0,1,,test
0518195_as-0073573.jpg,1,0,0,0,1,,train
0518197_as-0024492.jpg,1,0,2,1,4,,train
0518198_as-0024492.jpg,1,0,2,1,4,,train
0518199_as-0024492.jpg,1,0,2,1,4,,train
0518200_as-0024492.jpg,3,0,1,1,5,,train
0518201_as-0024492.jpg,2,0,0,0,2,,train
0518202_as-3087098.jpg,0,0,2,1,3,,train
0518203_sc-1033422.jpg,2,0,1,0,3,,val
0518204_sc-1033422.jpg,2,0,1,0,3,,val
0518205_sc-1033422.jpg,1,0,1,0,2,,test
0518206_sc-219001.jpg,3,0,0,0,3,,train
0518207_sc-219001.jpg,3,0,0,1,4,,train
0518208_sc-219001.jpg,3,0,0,1,4,,train
0518209_as-0080591.jpg,7,0,0,0,7,,train
0518210_sc-213607.jpg,1,0,1,1,3,,train
0518211_sc-213607.jpg,1,0,2,1,4,,train
0518212_sc-213607.jpg,2,0,1,1,4,,train
0518213_sc-213607.jpg,1,0,1,0,2,,val
0518214_sc-213607.jpg,3,0,1,0,4,,val
0518215_sc-137494.jpg,4,0,1,1,6,,test
0518216_sc-137494.jpg,7,0,1,1,9,,train
0518217_sc-137494.jpg,5,0,1,1,7,,train
0518219_sc-1033577.jpg,1,0,0,0,1,,train
0518220_sc-1033577.jpg,1,0,0,0,1,,train
0518221_as-0038724.jpg,2,0,0,0,2,,train
0518222_as-0038724.jpg,1,0,0,0,1,,train
0518223_as-0038724.jpg,1,0,0,0,1,,train
0518224_as-0073526.jpg,3,0,0,0,3,,val
0518225_as-0073526.jpg,3,0,1,3,7,,val
0518226_as-0073526.jpg,2,0,1,1,4,,test
0518228_as-2716120.jpg,1,0,0,0,1,,train
0518229_as-2801355.jpg,1,0,0,0,1,,train
0518230_as-2711013.jpg,1,0,0,0,1,,train
0518231_sc-1001838.jpg,1,0,0,1,2,,train
0518232_sc-1001838.jpg,3,0,0,2,5,,train
0518234_sc-1001838.jpg,1,0,0,1,2,,train
0518236_as-0041115.jpg,2,0,0,0,2,,train
0518237_as-0041115.jpg,2,0,2,2,6,,val
0518238_as-0041115.jpg,2,0,0,0,2,,val
0518247_as-7768174.jpg,11,0,2,1,14,,test
0518248_as-3414422.jpg,5,0,1,0,6,,train
0518249_sc-157189.jpg,7,0,1,0,8,,train
0518250_sc-157189.jpg,8,0,1,0,9,,train
0518251_sc-157189.jpg,7,0,1,0,8,,train
0518252_sc-157189.jpg,7,0,1,0,8,,train
0518254_sc-117492.jpg,0,3,1,1,5,,train
0518256_as-2797113.jpg,1,0,1,1,3,,train
0518257_sc-175480.jpg,4,0,2,0,6,,val
0518258_sc-175480.jpg,1,0,1,0,2,,val
0518259_sc-175480.jpg,0,0,0,1,1,,test
0518260_sc-175480.jpg,2,0,0,1,3,,train
0518261_sc-175480.jpg,3,0,1,0,4,,train
0518262_sc-175480.jpg,3,0,1,0,4,,train
0518263_as-7463452.jpg,1,0,0,0,1,,train
0518264_sc-215657.jpg,2,0,0,0,2,,train
0518266_as-0015797.jpg,0,0,0,1,1,,train
0518270_as-0015263.jpg,2,0,0,0,2,,train
0518271_as-0015263.jpg,1,0,0,0,1,,val
0518272_as-0015263.jpg,2,0,0,0,2,,val
0518273_as-0038708.jpg,1,0,0,1,2,,test
0518274_sc-189390.jpg,2,0,0,0,2,,train
0518275_sc-189390.jpg,2,0,1,0,3,,train
0518276_sc-189390.jpg,3,0,0,0,3,,train
0518277_as-7645195.jpg,1,0,0,0,1,,train
0518279_sc-211746.jpg,2,0,0,1,3,,train
0518280_sc-211746.jpg,2,0,0,0,2,,train
0518281_sc-211746.jpg,4,0,1,0,5,,train
0518282_sc-211746.jpg,2,0,0,1,3,,val
0518283_as-2843212.jpg,4,0,1,0,5,,val
0518287_sc-164587.jpg,0,0,0,1,1,,test
0518288_sc-164587.jpg,2,0,0,0,2,,train
0518289_sc-164587.jpg,2,0,0,1,3,,train
0518290_sc-164587.jpg,8,0,0,0,8,,train
0518291_sc-164587.jpg,2,0,0,1,3,,train
0518292_sc-164587.jpg,3,0,0,0,3,,train
0518293_as-0029838.jpg,0,0,1,0,1,,train
0518294_as-0029838.jpg,2,0,0,0,2,,train
0518295_as-3450153.jpg,0,1,0,0,1,,val
0518297_as-0014477.jpg,1,0,0,0,1,,val
0518298_as-0014477.jpg,4,3,1,1,9,,test
0518299_as-0014477.jpg,1,0,1,1,3,,train
0518300_sc-180201.jpg,1,1,1,0,3,,train
0518301_as-7035707.jpg,2,0,1,0,3,,train
0518303_sc-1039918.jpg,4,0,0,0,4,,train
0518304_sc-134600.jpg,1,3,0,1,5,,train
0518306_sc-134600.jpg,1,1,0,0,2,,train
0518307_sc-134600.jpg,1,2,0,2,5,,train
0518308_sc-134600.jpg,1,3,0,1,5,,val
0518309_sc-134600.jpg,1,2,0,0,3,,val
0518310_sc-211992.jpg,0,1,0,0,1,,test
0518315_as-0017740.jpg,4,0,0,1,5,,train
0518317_as-0017740.jpg,1,0,0,2,3,,train
0518318_sc-183176.jpg,1,0,0,1,2,,train
0518319_sc-183176.jpg,1,0,1,0,2,,train
0518320_sc-183176.jpg,2,0,0,1,3,,train
0518321_as-3277044.jpg,0,1,0,0,1,,train
0518322_as-3484498.jpg,0,1,1,1,3,,train
0518323_sc-181547.jpg,1,0,0,1,2,,val
0518324_as-2992939.jpg,1,0,0,0,1,,val
0518326_as-0052933.jpg,3,0,0,0,3,,test
0518327_as-0052933.jpg,1,0,0,0,1,,train
0518328_as-0052933.jpg,2,0,0,0,2,,train
0518330_as-0048891.jpg,4,0,0,0,4,,train
0518331_as-0048891.jpg,4,0,0,0,4,,train
0518332_as-0048891.jpg,4,0,0,0,4,,train
0518333_as-0048891.jpg,2,0,0,0,2,,train
0518334_as-0048891.jpg,1,0,0,0,1,,train
0518335_as-7283342.jpg,1,2,2,1,6,,val
0518338_as-0041937.jpg,1,0,0,1,2,,val
0518339_as-0041937.jpg,2,0,0,1,3,,test
0518341_sc-108164.jpg,2,0,0,0,2,,train
0518342_sc-108164.jpg,3,0,0,0,3,,train
0518343_as-3280026.jpg,4,0,0,0,4,,train
0518344_sc-1006990.jpg,4,0,0,0,4,,train
0518345_sc-1006990.jpg,3,0,0,0,3,,train
0518346_sc-104414.jpg,2,0,0,0,2,,train
0518348_as-0061557.jpg,1,0,0,0,1,,train
0518349_as-0061557.jpg,1,0,0,0,1,,val
0518350_as-0061557.jpg,1,0,0,0,1,,val
0518351_as-0061557.jpg,1,0,0,0,1,,test
0518352_as-0061557.jpg,1,0,0,0,1,,train
0518353_sc-1012339.jpg,1,0,0,0,1,,train
0518354_sc-1012339.jpg,1,0,0,0,1,,train
0518355_as-0056485.jpg,1,0,0,0,1,,train
0518357_as-0056485.jpg,1,2,2,3,8,,train
0518358_as-0056485.jpg,1,0,0,0,1,,train
0518359_as-0056485.jpg,1,0,0,0,1,,train
0518360_as-0056485.jpg,1,0,0,0,1,,val
0518361_as-0056485.jpg,1,0,1,1,3,,val
0518362_as-0056485.jpg,1,0,1,1,3,,test
0518363_as-0056485.jpg,1,0,1,1,3,,train
0518364_as-0056485.jpg,1,0,1,0,2,,train
0518365_as-0056485.jpg,1,0,1,1,3,,train
0518366_as-0056485.jpg,2,0,1,2,5,,train
0518367_as-0056485.jpg,1,0,1,1,3,,train
0518368_as-0056485.jpg,1,0,1,1,3,,train
0518369_as-0056485.jpg,1,0,1,1,3,,train
0518370_as-0056485.jpg,0,0,1,2,3,,val
0518371_as-0056485.jpg,0,0,1,1,2,,val
0518372_as-0056485.jpg,1,0,1,1,3,,test
0518373_as-0056485.jpg,0,1,1,2,4,,train
0518374_as-0056485.jpg,1,0,0,0,1,,train
0518375_as-0056485.jpg,1,0,0,0,1,,train
0518376_as-0056485.jpg,1,1,1,0,3,,train
0518377_as-0056485.jpg,1,1,1,1,4,,train
0518378_as-0056485.jpg,2,1,2,0,5,,train
0518379_as-3455864.jpg,1,0,0,0,1,,train
0518380_as-0020783.jpg,0,0,1,0,1,,val
0518381_as-0020783.jpg,1,0,1,0,2,,val
0518382_as-0020783.jpg,2,0,1,0,3,,test
0518383_as-0020783.jpg,3,1,2,0,6,,train
0518385_as-0020783.jpg,0,0,1,0,1,,train
0518386_as-3050784.jpg,0,1,0,0,1,,train
0518387_as-7521658.jpg,1,0,1,0,2,,train
0518388_sc-1021837.jpg,2,0,2,0,4,,train
0518389_sc-1021837.jpg,5,0,1,0,6,,train
0518390_sc-1021837.jpg,4,0,0,0,4,,train
0518391_sc-1021837.jpg,3,0,1,0,4,,val
0518392_sc-1021837.jpg,2,0,1,0,3,,val
0518393_as-2867593.jpg,3,0,0,0,3,,test
0518394_as-2659781.jpg,1,0,0,0,1,,train
0518395_sc-110653.jpg,1,0,0,0,1,,train
0518396_sc-110653.jpg,8,0,0,0,8,,train
0518397_sc-110653.jpg,8,0,0,0,8,,train
0518398_sc-110653.jpg,9,0,0,0,9,,train
0518399_sc-110653.jpg,9,0,0,0,9,,train
0518400_sc-110653.jpg,2,1,0,0,3,,train
0518401_sc-110653.jpg,13,0,0,1,14,,val
0518402_sc-110653.jpg,11,0,1,0,12,,val
0518403_sc-110653.jpg,6,0,1,0,7,,test
0518404_sc-110653.jpg,11,0,0,1,12,,train
0518405_sc-110653.jpg,0,1,0,0,1,,train
0518406_sc-110653.jpg,6,0,0,0,6,,train
0518407_as-0030972.jpg,1,0,0,1,2,,train
0518410_as-0086574.jpg,1,0,2,1,4,,train
0518411_as-0086574.jpg,2,0,2,1,5,,train
0518413_as-0086574.jpg,1,0,0,0,1,,train
0518414_as-0086574.jpg,1,0,0,0,1,,val
0518415_as-2814818.jpg,1,0,0,0,1,,val
0518416_as-0048615.jpg,5,0,0,0,5,,test
0518417_as-0048615.jpg,2,0,0,0,2,,train
0518418_as-0048615.jpg,5,0,0,0,5,,train
0518419_as-2623840.jpg,2,0,0,0,2,,train
0518420_as-2992377.jpg,0,0,1,0,1,,train
0518421_as-0021311.jpg,1,0,1,1,3,,train
0518422_as-7001000.jpg,3,2,0,0,5,,train
0518423_sc-1010756.jpg,1,0,0,0,1,,train
0518425_sc-1010756.jpg,5,1,0,1,7,,val
0518426_as-3362302.jpg,0,0,1,2,3,,val
0518427_as-3266744.jpg,2,0,1,0,3,,test
0518428_sc-1004233.jpg,1,1,0,0,2,,train
0518431_as-0052877.jpg,1,0,0,0,1,,train
0518432_as-0052877.jpg,4,0,0,0,4,,train
0518433_as-0052877.jpg,5,0,0,0,5,,train
0518434_as-0052877.jpg,1,0,0,0,1,,train
0518435_as-0052877.jpg,2,0,0,0,2,,train
0518436_as-0052877.jpg,4,0,1,0,5,,train
0518439_sc-1024568.jpg,4,0,0,1,5,,val
0518440_sc-1017610.jpg,1,0,0,1,2,,val
0518442_sc-103675.jpg,2,1,0,0,3,,test
0518443_sc-103675.jpg,1,1,0,0,2,,train
0518445_sc-1023527.jpg,1,0,2,0,3,,train
0518446_sc-1023527.jpg,1,0,1,0,2,,train
0518447_sc-1023527.jpg,0,0,1,0,1,,train
0518449_sc-1023527.jpg,1,0,1,0,2,,train
0518450_sc-212290.jpg,3,0,0,0,3,,train
0518451_sc-212290.jpg,4,0,0,0,4,,train
0518452_sc-212290.jpg,0,0,1,0,1,,val
0518453_sc-212290.jpg,4,0,0,0,4,,val
0518455_as-0081279.jpg,2,0,1,0,3,,test
0518457_sc-1037141.jpg,1,0,0,0,1,,train
0518458_sc-1037141.jpg,2,0,1,0,3,,train
0518459_sc-1037141.jpg,4,0,0,0,4,,train
0518460_sc-1037141.jpg,1,0,0,0,1,,train
0518461_sc-1037141.jpg,3,0,0,0,3,,train
0518462_sc-1037141.jpg,3,0,0,0,3,,train
0518463_sc-1037141.jpg,3,0,0,0,3,,train
0518464_sc-1037141.jpg,2,0,0,0,2,,val
0518465_sc-1036276.jpg,1,0,0,0,1,,val
0518466_sc-1036276.jpg,1,0,0,0,1,,test
0518467_sc-1036276.jpg,1,0,0,0,1,,train
0518468_sc-1036276.jpg,1,0,0,0,1,,train
0518469_sc-1036276.jpg,1,0,0,0,1,,train
0518470_sc-1036276.jpg,1,0,0,0,1,,train
0518472_sc-1026109.jpg,4,0,1,0,5,,train
0518474_sc-1026109.jpg,2,0,1,0,3,,train
0518480_sc-224893.jpg,2,1,2,0,5,,train
0518481_sc-224893.jpg,1,0,0,1,2,,val
0518482_sc-224893.jpg,1,0,0,1,2,,val
0518483_as-7306501.jpg,1,0,1,1,3,,test
0518484_sc-151260.jpg,2,0,0,0,2,,train
0518486_sc-174580.jpg,3,1,0,0,4,,train
0518488_sc-174580.jpg,4,1,1,0,6,,train
0518490_as-0026827.jpg,0,0,1,0,1,,train
0518491_as-0026827.jpg,0,0,1,0,1,,train
0518492_as-0026827.jpg,0,0,1,0,1,,train
0518493_as-0026827.jpg,0,0,0,1,1,,train
0518494_as-2518396.jpg,2,0,0,0,2,,val
0518495_as-3275765.jpg,1,0,0,0,1,,val
0518498_sc-114069.jpg,0,1,0,0,1,,test
0518499_as-3003720.jpg,1,0,0,1,2,,train
0518502_sc-144304.jpg,8,0,0,0,8,,train
0518503_as-7004005.jpg,0,1,1,1,3,,train
0518505_as-0060078.jpg,3,0,0,0,3,,train
0518506_as-0060078.jpg,3,0,0,0,3,,train
0518507_as-0060078.jpg,6,0,0,0,6,,train
0518508_as-0060078.jpg,3,0,0,0,3,,train
0518509_as-0033928.jpg,1,1,0,0,2,,val
0518510_as-0033928.jpg,3,1,0,0,4,,val
0518511_as-0033928.jpg,3,1,1,0,5,,test
0518512_as-0033928.jpg,2,1,1,0,4,,train
0518514_sc-186572.jpg,3,0,1,0,4,,train
0518515_as-5516182.jpg,1,2,1,1,5,,train
0518516_sc-185343.jpg,1,0,0,0,1,,train
0518517_sc-185343.jpg,13,1,0,0,14,,train
0518518_sc-185343.jpg,3,1,1,0,5,,train
0518519_sc-185343.jpg,8,1,0,0,9,,train
0518520_as-3317015.jpg,6,1,0,0,7,,val
0518521_sc-205931.jpg,4,0,0,0,4,,val
0518522_sc-191520.jpg,2,0,0,0,2,,test
0518523_sc-191520.jpg,2,1,0,0,3,,train
0518524_sc-201117.jpg,1,0,0,0,1,,train
0518525_sc-194975.jpg,1,0,1,0,2,,train
0518527_sc-194975.jpg,1,0,1,0,2,,train
0518528_as-0010317.jpg,1,0,0,1,2,,train
0518529_as-0010317.jpg,1,0,0,1,2,,train
0518530_as-0010317.jpg,1,0,0,0,1,,train
0518531_as-0010317.jpg,1,0,0,1,2,,val
0518532_sc-140754.jpg,0,1,0,0,1,,val
0518533_as-0034195.jpg,1,1,0,0,2,,test
0518534_as-0034195.jpg,1,0,0,0,1,,train
0518535_sc-229391.jpg,1,0,0,0,1,,train
0518536_sc-229391.jpg,3,0,0,0,3,,train
0518537_sc-229391.jpg,4,0,0,0,4,,train
0518538_sc-229391.jpg,2,0,0,0,2,,train
0518539_sc-229391.jpg,2,0,0,0,2,,train
0518540_sc-192160.jpg,2,0,0,0,2,,train
0518541_sc-192160.jpg,2,0,0,0,2,,val
0518542_sc-192160.jpg,1,0,0,0,1,,val
0518543_sc-192160.jpg,1,0,0,0,1,,test
0518544_sc-123722.jpg,2,1,1,0,4,,train
0518545_sc-123722.jpg,0,1,2,0,3,,train
0518547_sc-123722.jpg,1,0,3,0,4,,train
0518548_sc-123722.jpg,0,0,3,0,3,,train
0518550_sc-123722.jpg,0,0,5,0,5,,train
0518551_sc-123722.jpg,0,0,2,0,2,,train
0518552_sc-123722.jpg,0,0,3,0,3,,train
0518554_as-0034819.jpg,0,0,1,0,1,,val
0518556_as-3465972.jpg,5,0,0,1,6,,val
0518557_as-7531584.jpg,2,0,0,0,2,,test
0518560_as-0092079.jpg,1,1,0,0,2,,train
0518561_as-0092079.jpg,1,1,0,0,2,,train
0518562_as-0092079.jpg,1,0,0,0,1,,train
0518563_as-0092079.jpg,1,0,0,0,1,,train
0518565_as-0092079.jpg,1,0,0,0,1,,train
0518566_as-0092079.jpg,2,0,0,1,3,,train
0518567_as-0092079.jpg,2,0,0,1,3,,train
0518570_as-0092079.jpg,2,0,0,0,2,,val
0518571_as-0092079.jpg,2,0,1,0,3,,val
0518572_as-0092079.jpg,1,0,0,0,1,,test
0518573_as-0092079.jpg,1,0,2,1,4,,train
0518576_as-0092079.jpg,1,0,3,1,5,,train
0518577_as-0092079.jpg,0,0,2,1,3,,train
0518578_as-0092079.jpg,0,0,1,1,2,,train
0518580_as-0092079.jpg,0,0,1,0,1,,train
0518581_as-0092079.jpg,1,0,1,0,2,,train
0518582_as-0092079.jpg,0,0,2,0,2,,train
0518583_as-0092079.jpg,0,0,2,1,3,,val
0518584_as-0092079.jpg,0,0,2,1,3,,val
0518585_as-0092079.jpg,0,0,2,1,3,,test
0518586_as-0092079.jpg,0,0,2,1,3,,train
0518587_as-0092079.jpg,0,0,2,1,3,,train
0518589_as-0092079.jpg,1,0,0,0,1,,train
0518590_sc-1023593.jpg,3,0,0,0,3,,train
0518591_sc-1023593.jpg,2,0,1,1,4,,train
0518593_sc-164711.jpg,6,1,0,0,7,,train
0518594_sc-164711.jpg,6,1,0,0,7,,train
0518595_sc-164711.jpg,4,1,0,0,5,,val
0518596_sc-164711.jpg,4,0,0,0,4,,val
0518598_sc-107781.jpg,1,1,0,1,3,,test
0518599_as-2546253.jpg,1,0,0,0,1,,train
0518600_sc-1033016.jpg,3,1,2,0,6,,train
0518601_sc-1033016.jpg,3,0,2,1,6,,train
0518602_sc-1033016.jpg,2,0,1,0,3,,train
0518603_sc-223140.jpg,1,0,0,1,2,,train
0518604_as-7296434.jpg,1,0,0,0,1,,train
0518605_as-7822494.jpg,0,1,0,0,1,,train
0518607_sc-178870.jpg,1,0,0,1,2,,val
0518608_as-0004066.jpg,1,1,1,0,3,,val
0518610_as-0004066.jpg,1,0,1,0,2,,test
0518613_sc-118315.jpg,1,1,0,0,2,,train
0518614_sc-118315.jpg,1,1,0,0,2,,train
0518616_as-3379392.jpg,2,0,0,0,2,,train
0518619_as-0085054.jpg,0,1,2,1,4,,train
0518620_as-0085054.jpg,3,1,2,1,7,,train
0518621_as-0085054.jpg,0,0,1,1,2,,train
0518622_as-0085054.jpg,0,0,1,0,1,,train
0518623_sc-1006902.jpg,1,0,0,0,1,,val
0518625_as-0069747.jpg,3,2,1,1,7,,val
0518626_as-0069747.jpg,1,0,0,0,1,,test
0518629_sc-121411.jpg,1,0,0,0,1,,train
0518630_sc-121411.jpg,1,0,0,0,1,,train
0518632_as-2811387.jpg,1,0,1,1,3,,train
0518634_as-0025297.jpg,2,0,0,1,3,,train
0518635_as-0025297.jpg,2,1,0,0,3,,train
0518636_as-0025297.jpg,1,0,0,0,1,,train
0518637_sc-1022586.jpg,1,0,0,0,1,,train
0518638_sc-1022586.jpg,1,0,0,0,1,,val
0518639_sc-1022586.jpg,2,0,0,0,2,,val
0518641_sc-1022586.jpg,1,1,0,1,3,,test
0518643_as-0080203.jpg,1,0,0,0,1,,train
0518644_sc-196976.jpg,1,1,0,0,2,,train
0518645_sc-196976.jpg,1,0,0,0,1,,train
0518646_sc-196976.jpg,2,0,0,0,2,,train
0518647_as-7028365.jpg,2,0,0,1,3,,train
0518649_as-2835786.jpg,1,0,0,0,1,,train
0518650_as-0074515.jpg,1,0,0,0,1,,train
0518651_as-0074515.jpg,1,0,0,0,1,,val
0518652_as-3365642.jpg,1,0,1,0,2,,val
0518653_sc-194645.jpg,1,0,0,0,1,,test
0518655_as-0080138.jpg,1,0,0,0,1,,train
0518656_as-0074480.jpg,0,0,0,1,1,,train
0518657_as-0074480.jpg,0,0,0,1,1,,train
0518659_as-0074480.jpg,0,0,0,1,1,,train
0518660_sc-123413.jpg,2,0,0,0,2,,train
0518661_sc-123413.jpg,3,0,0,0,3,,train
0518662_sc-123413.jpg,2,0,0,0,2,,train
0518663_sc-123413.jpg,3,0,0,0,3,,val
0518664_sc-210354.jpg,0,0,1,0,1,,val
0518665_as-0081381.jpg,2,0,0,0,2,,test
0518666_as-0081381.jpg,2,0,0,0,2,,train
0518667_sc-220712.jpg,0,0,0,1,1,,train
0518668_sc-220712.jpg,2,0,1,1,4,,train
0518669_sc-220712.jpg,2,0,1,1,4,,train
0518670_sc-220712.jpg,0,0,1,1,2,,train
0518671_sc-220712.jpg,3,0,1,1,5,,train
0518672_sc-220712.jpg,1,0,1,1,3,,train
0518673_sc-220712.jpg,5,0,1,0,6,,val
0518674_sc-220712.jpg,5,0,1,0,6,,val
0518675_sc-220712.jpg,2,0,0,1,3,,test
0518676_sc-220712.jpg,0,0,1,1,2,,train
0518677_sc-220712.jpg,1,0,0,0,1,,train
0518678_as-3380347.jpg,8,1,0,1,10,,train
0518681_sc-166141.jpg,3,0,0,0,3,,train
0518682_sc-166141.jpg,4,0,0,0,4,,train
0518683_sc-166141.jpg,1,0,0,0,1,,train
0518684_sc-166141.jpg,3,0,0,0,3,,train
0518685_sc-166141.jpg,3,0,0,0,3,,val
0518686_as-7813942.jpg,0,0,0,2,2,,val
0518690_as-0023880.jpg,3,0,1,2,6,,test
0518691_as-0023880.jpg,3,0,0,1,4,,train
0518693_as-0053828.jpg,2,0,0,1,3,,train
0518694_as-0053828.jpg,1,0,0,1,2,,train
0518697_sc-145852.jpg,1,0,0,0,1,,train
0518698_sc-145852.jpg,1,0,0,0,1,,train
0518699_sc-145852.jpg,1,0,0,0,1,,train
0518700_sc-145852.jpg,1,0,0,0,1,,train
0518705_as-0071677.jpg,2,0,0,0,2,,val
0518706_as-0071677.jpg,2,1,1,0,4,,val
0518707_sc-214279.jpg,6,2,1,0,9,,test
0518709_sc-128513.jpg,6,0,0,0,6,,train
0518710_sc-128513.jpg,3,0,0,0,3,,train
0518712_sc-128513.jpg,2,0,0,0,2,,train
0518713_sc-128513.jpg,2,0,0,1,3,,train
0518715_as-0065616.jpg,1,0,0,0,1,,train
0518716_as-0065616.jpg,1,0,0,0,1,,train
0518718_sc-208193.jpg,2,0,0,1,3,,train
0518721_as-0082676.jpg,4,0,0,0,4,,val
0518722_as-0082676.jpg,1,0,0,0,1,,val
0518723_as-0082676.jpg,0,1,0,0,1,,test
0518724_as-0082676.jpg,2,0,0,0,2,,train
0518725_as-0082676.jpg,2,0,0,0,2,,train
0518726_as-0082676.jpg,1,0,0,0,1,,train
0518727_sc-224109.jpg,1,0,1,0,2,,train
0518728_sc-224109.jpg,0,0,1,0,1,,train
0518729_sc-117052.jpg,2,0,0,1,3,,train
0518730_sc-117052.jpg,4,0,0,2,6,,train
0518731_as-0036537.jpg,1,0,0,0,1,,val
0518732_as-0036537.jpg,1,0,0,0,1,,val
0518733_as-0036537.jpg,1,0,0,0,1,,test
0518734_as-0036537.jpg,1,0,0,0,1,,train
0518735_as-0036537.jpg,2,0,0,0,2,,train
0518736_as-0036537.jpg,1,0,0,0,1,,train
0518737_as-0036537.jpg,2,0,0,0,2,,train
0518740_sc-191871.jpg,1,0,0,0,1,,train
0518741_as-3189360.jpg,0,0,1,1,2,,train
0518742_sc-139737.jpg,3,0,1,0,4,,train
0518743_sc-1008708.jpg,5,0,0,0,5,,val
0518745_sc-156628.jpg,1,0,0,0,1,,val
0518746_sc-156628.jpg,4,0,1,0,5,,test
0518747_sc-156628.jpg,2,0,1,0,3,,train
0518749_sc-1031933.jpg,4,0,1,0,5,,train
0518750_sc-1031933.jpg,2,0,1,0,3,,train
0518751_sc-1031933.jpg,4,1,1,1,7,,train
0518752_sc-135866.jpg,3,0,0,0,3,,train
0518753_sc-120261.jpg,7,0,0,2,9,,train
0518754_sc-216302.jpg,2,0,0,0,2,,train
0518755_sc-216302.jpg,1,0,0,1,2,,val
0518756_sc-216302.jpg,1,0,0,1,2,,val
0518757_sc-216302.jpg,1,0,0,1,2,,test
0518758_sc-216302.jpg,1,0,0,0,1,,train
0518759_sc-216302.jpg,3,0,0,1,4,,train
0518760_sc-1030266.jpg,4,0,1,0,5,,train
0518761_sc-1030266.jpg,2,0,0,0,2,,train
0518762_sc-1030266.jpg,2,0,0,0,2,,train
0518763_sc-1030266.jpg,1,0,0,0,1,,train
0518764_sc-1030266.jpg,2,0,0,0,2,,train
0518765_as-0034431.jpg,2,0,0,0,2,,val
0518766_as-0034431.jpg,1,0,0,0,1,,val
0518768_as-0034431.jpg,3,0,2,1,6,,test
0518770_as-3491803.jpg,1,0,0,0,1,,train
0518771_sc-214639.jpg,1,0,0,0,1,,train
0518772_sc-214639.jpg,1,0,0,0,1,,train
0518773_sc-214639.jpg,1,0,0,0,1,,train
0518774_sc-214639.jpg,2,0,0,0,2,,train
0518775_sc-214639.jpg,2,0,0,0,2,,train
0518776_sc-214639.jpg,1,0,0,0,1,,train
0518777_as-0086153.jpg,1,0,0,0,1,,val
0518778_as-0086153.jpg,0,0,0,1,1,,val
0518780_as-0086153.jpg,0,0,0,1,1,,test
0518781_sc-147998.jpg,1,1,0,0,2,,train
0518782_sc-147998.jpg,1,1,0,0,2,,train
0518783_sc-138903.jpg,1,0,0,1,2,,train
0518784_sc-138903.jpg,1,0,0,1,2,,train
0518785_sc-138903.jpg,1,0,0,0,1,,train
0518786_sc-138903.jpg,1,0,0,0,1,,train
0518787_sc-138903.jpg,1,0,1,1,3,,train
0518788_sc-138903.jpg,1,0,1,1,3,,val
0518789_as-0050388.jpg,0,1,1,1,3,,val
0518793_as-0086616.jpg,2,0,0,0,2,,test
0518794_as-0086616.jpg,3,0,0,0,3,,train
0518798_sc-178501.jpg,7,0,1,1,9,,train
0518799_sc-107404.jpg,5,0,0,0,5,,train
0518800_as-7907589.jpg,2,0,0,2,4,,train
0518801_as-0090756.jpg,1,0,2,0,3,,train
0518802_as-0090756.jpg,0,0,1,0,1,,train
0518806_as-0090756.jpg,3,0,1,0,4,,train
0518807_as-0090756.jpg,0,0,1,0,1,,val
0518808_as-0090756.jpg,0,0,1,0,1,,val
0518809_sc-1037970.jpg,3,1,2,0,6,,test
0518811_sc-217373.jpg,2,0,0,1,3,,train
0518812_sc-217373.jpg,3,0,0,1,4,,train
0518813_sc-217373.jpg,1,0,0,1,2,,train
0518815_as-2587129.jpg,1,0,0,0,1,,train
0518817_sc-109252.jpg,3,0,0,0,3,,train
0518820_sc-115249.jpg,1,0,0,0,1,,train
0518821_sc-115249.jpg,1,0,0,0,1,,train
0518822_sc-115249.jpg,1,0,0,1,2,,val
0518823_sc-115249.jpg,1,0,0,1,2,,val
0518825_sc-115249.jpg,2,0,0,0,2,,test
0518826_sc-210022.jpg,2,0,0,0,2,,train
0518827_sc-210022.jpg,2,0,0,0,2,,train
0518828_sc-134843.jpg,6,0,0,0,6,,train
0518829_sc-134843.jpg,8,0,0,0,8,,train
0518830_sc-134843.jpg,1,0,0,0,1,,train
0518831_sc-134843.jpg,6,0,0,0,6,,train
0518832_sc-134843.jpg,4,0,0,0,4,,train
0518833_sc-134843.jpg,5,0,0,0,5,,val
0518834_sc-134843.jpg,3,0,0,0,3,,val
0518835_sc-134843.jpg,5,0,0,0,5,,test
0518836_as-0062575.jpg,1,0,0,1,2,,train
0518837_as-0062575.jpg,1,0,0,1,2,,train
0518838_as-7655173.jpg,2,0,0,0,2,,train
0518840_sc-1001181.jpg,1,0,0,0,1,,train
0518841_sc-1001181.jpg,1,0,0,1,2,,train
0518842_sc-1001181.jpg,1,0,0,0,1,,train
0518843_sc-1001181.jpg,1,0,0,1,2,,train
0518844_sc-1001181.jpg,1,0,0,1,2,,val
0518845_sc-1001181.jpg,1,0,0,0,1,,val
0518846_sc-1001181.jpg,1,0,0,0,1,,test
0518847_as-0065468.jpg,3,0,1,2,6,,train
0518848_as-0065468.jpg,2,0,0,0,2,,train
0518849_as-0065468.jpg,1,0,1,1,3,,train
0518851_as-0077952.jpg,4,0,2,0,6,,train
0518852_as-0077952.jpg,2,0,0,0,2,,train
0518854_sc-156475.jpg,1,0,1,1,3,,train
0518855_as-3025631.jpg,1,0,0,0,1,,train
0518856_as-4959589.jpg,2,0,0,0,2,,val
0518857_as-7727285.jpg,1,0,0,0,1,,val
0518858_as-2838018.jpg,2,1,1,1,5,,test
0518859_sc-125057.jpg,1,0,0,1,2,,train
0518860_sc-125057.jpg,1,0,0,1,2,,train
0518861_sc-125057.jpg,2,0,0,3,5,,train
0518863_sc-154854.jpg,4,0,0,1,5,,train
0518864_sc-154854.jpg,2,0,0,0,2,,train
0518865_sc-154854.jpg,4,0,2,1,7,,train
0518866_sc-154854.jpg,6,0,0,1,7,,train
0518870_sc-188202.jpg,1,1,0,0,2,,val
0518871_as-2842213.jpg,3,0,0,0,3,,val
0518874_as-0086868.jpg,6,0,0,4,10,,test
0518875_as-0086868.jpg,7,0,0,1,8,,train
0518876_as-0086868.jpg,4,0,0,1,5,,train
0518877_as-0086868.jpg,4,0,0,3,7,,train
0518879_as-0086868.jpg,1,0,0,0,1,,train
0518880_sc-1038493.jpg,1,0,0,0,1,,train
0518881_sc-1038493.jpg,1,0,0,1,2,,train
0518882_sc-1038493.jpg,1,0,0,1,2,,train
0518883_sc-197070.jpg,2,0,0,0,2,,val
0518884_sc-197070.jpg,2,0,0,0,2,,val
0518885_sc-197070.jpg,3,0,0,0,3,,test
0518886_sc-197070.jpg,1,0,0,0,1,,train
0518887_sc-197070.jpg,2,0,1,2,5,,train
0518888_sc-197070.jpg,1,0,1,3,5,,train
0518889_sc-197070.jpg,2,0,1,1,4,,train
0518891_sc-197070.jpg,1,0,1,1,3,,train
0518892_sc-1030379.jpg,3,0,1,1,5,,train
0518893_sc-1030379.jpg,2,0,0,1,3,,train
0518894_as-0068411.jpg,0,2,0,0,2,,val
0518895_as-0068411.jpg,1,1,1,0,3,,val
0518896_as-0037952.jpg,1,0,0,0,1,,test
0518898_sc-176262.jpg,2,0,0,0,2,,train
0518899_sc-206173.jpg,0,1,0,0,1,,train
0518900_as-9023565.jpg,2,0,1,0,3,,train
0518901_as-2527602.jpg,1,0,0,1,2,,train
0518902_sc-1039456.jpg,3,0,0,0,3,,train
0518904_sc-1039456.jpg,1,1,0,0,2,,train
0518905_as-3020874.jpg,3,0,0,0,3,,train
0518906_sc-112464.jpg,3,1,0,0,4,,val
0518907_sc-112464.jpg,1,1,0,0,2,,val
0518908_sc-125578.jpg,2,0,1,0,3,,test
0518909_as-0023877.jpg,2,0,0,0,2,,train
0518910_as-0023877.jpg,3,0,0,0,3,,train
0518911_sc-211546.jpg,1,0,0,0,1,,train
0518912_sc-211546.jpg,2,0,0,0,2,,train
0518913_sc-211546.jpg,1,0,0,0,1,,train
0518914_sc-211546.jpg,1,0,0,0,1,,train
0518915_sc-211546.jpg,1,0,0,0,1,,train
0518916_sc-211546.jpg,0,2,1,0,3,,val
0518917_sc-211546.jpg,0,2,1,1,4,,val
0518918_sc-211546.jpg,2,0,0,0,2,,test
0518919_sc-211546.jpg,1,0,0,1,2,,train
0518920_sc-211546.jpg,1,0,0,0,1,,train
0518921_sc-211546.jpg,3,0,0,0,3,,train
0518922_sc-211546.jpg,1,0,0,0,1,,train
0518923_sc-211546.jpg,1,0,0,0,1,,train
0518924_sc-211546.jpg,1,0,0,0,1,,train
0518925_sc-211546.jpg,1,1,0,0,2,,train
0518926_as-0055419.jpg,1,0,0,1,2,,val
0518928_as-0055419.jpg,1,0,0,1,2,,val
0518930_as-3197717.jpg,4,0,1,0,5,,test
0518932_as-2862338.jpg,1,0,1,1,3,,train
0518934_sc-1027988.jpg,1,0,0,0,1,,train
0518935_sc-1027988.jpg,0,0,1,0,1,,train
0518937_sc-156751.jpg,2,0,1,0,3,,train
0518939_sc-147884.jpg,1,1,1,0,3,,train
0518941_sc-147884.jpg,2,0,0,0,2,,train
0518942_sc-147884.jpg,2,1,2,0,5,,train
0518944_sc-147884.jpg,1,1,1,0,3,,val
0518945_sc-166501.jpg,1,1,0,0,2,,val
0518948_as-0084375.jpg,0,1,3,2,6,,test
0518949_as-0084375.jpg,2,0,2,1,5,,train
0518950_as-0084375.jpg,2,1,3,1,7,,train
0518951_as-0084375.jpg,3,1,1,1,6,,train
0518953_as-0072814.jpg,3,1,0,0,4,,train
0518954_as-0072814.jpg,10,1,1,0,12,,train
0518955_as-0072814.jpg,12,2,1,0,15,,train
0518956_as-2892420.jpg,2,0,1,0,3,,train
0518957_as-3330909.jpg,1,0,1,0,2,,val
0518958_sc-1021778.jpg,2,0,0,0,2,,val
0518960_sc-1040244.jpg,0,0,1,1,2,,test
0518961_sc-1040244.jpg,0,0,1,0,1,,train
0518963_sc-1028230.jpg,4,0,0,1,5,,train
0518965_sc-1028230.jpg,2,0,0,1,3,,train
0518968_as-3051582.jpg,8,1,0,0,9,,train
0518969_sc-1006767.jpg,3,0,0,0,3,,train
0518971_sc-1010668.jpg,3,0,0,0,3,,train
0518972_sc-1010668.jpg,2,0,0,0,2,,train
0518973_as-2793487.jpg,0,0,3,1,4,,val
0518974_as-3493873.jpg,3,0,1,0,4,,val
0518975_as-3318856.jpg,0,0,0,1,1,,test
0518977_as-0047300.jpg,1,1,0,1,3,,train
0518978_as-0047300.jpg,1,1,0,1,3,,train
0518980_as-3239756.jpg,3,0,0,0,3,,train
0518981_as-3239756.jpg,2,0,0,1,3,,train
0518982_as-2941459.jpg,1,0,0,0,1,,train
0518983_as-7937974.jpg,5,0,1,0,6,,train
0518984_sc-182162.jpg,1,0,0,0,1,,train
0518986_sc-182162.jpg,1,0,0,0,1,,val
0518987_as-3028100.jpg,1,0,0,0,1,,val
0518988_sc-145487.jpg,2,1,0,0,3,,test
0518989_sc-145487.jpg,1,0,0,1,2,,train
0518990_sc-145487.jpg,3,1,0,0,4,,train
0518991_as-3459065.jpg,4,0,0,0,4,,train
0518992_sc-140082.jpg,0,0,1,0,1,,train
0518993_as-0070053.jpg,1,0,0,0,1,,train
0518995_as-0070053.jpg,1,0,0,0,1,,train
0518996_as-0070053.jpg,1,0,0,0,1,,train
0518999_as-0039235.jpg,3,0,0,0,3,,val
0519000_as-0039235.jpg,3,3,3,0,9,,val
0519001_as-3188938.jpg,4,0,0,1,5,,test
0519002_as-2663521.jpg,1,0,0,0,1,,train
0519004_as-2623868.jpg,2,0,0,0,2,,train
0519005_sc-221376.jpg,2,0,0,0,2,,train
0519006_sc-221376.jpg,1,1,0,0,2,,train
0519007_sc-221376.jpg,1,0,0,0,1,,train
0519008_sc-221376.jpg,1,0,0,0,1,,train
0519009_sc-221376.jpg,1,0,0,0,1,,train
0519010_as-2808578.jpg,2,1,1,0,4,,val
0519012_as-0077821.jpg,3,0,1,1,5,,val
0519013_as-0077821.jpg,1,1,1,1,4,,test
0519014_sc-206117.jpg,1,0,0,0,1,,train
0519015_sc-206117.jpg,4,0,0,0,4,,train
0519017_sc-105151.jpg,5,0,1,2,8,,train
0519018_sc-110779.jpg,1,0,0,1,2,,train
0519019_sc-110779.jpg,0,0,1,1,2,,train
0519023_sc-110779.jpg,4,1,0,0,5,,train
0519024_sc-110779.jpg,2,1,1,0,4,,train
0519025_sc-110779.jpg,0,0,1,0,1,,val
0519026_sc-178581.jpg,3,0,0,0,3,,val
0519027_sc-178581.jpg,2,0,0,0,2,,test
0519028_as-7333267.jpg,5,0,0,1,6,,train
0519030_as-0093336.jpg,1,1,1,1,4,,train
0519031_as-0093336.jpg,3,0,0,0,3,,train
0519032_as-0093336.jpg,1,0,0,0,1,,train
0519033_as-0093336.jpg,1,1,0,0,2,,train
0519034_as-0093336.jpg,2,0,0,0,2,,train
0519036_as-3223030.jpg,0,1,0,0,1,,train
0519037_sc-126876.jpg,1,0,0,1,2,,val
0519038_sc-126876.jpg,2,0,0,0,2,,val
0519039_sc-126876.jpg,1,0,0,0,1,,test
0519040_sc-126876.jpg,1,0,0,0,1,,train
0519041_sc-126876.jpg,1,0,0,0,1,,train
0519042_sc-126876.jpg,1,0,0,0,1,,train
0519044_sc-1021381.jpg,2,0,0,0,2,,train
0519045_as-2746701.jpg,1,0,1,1,3,,train
0519046_sc-151645.jpg,3,0,1,0,4,,train
0519048_sc-151645.jpg,3,0,0,0,3,,train
0519050_sc-151645.jpg,1,0,1,0,2,,val
0519051_as-3248808.jpg,1,0,0,0,1,,val
0519053_sc-220458.jpg,3,0,1,1,5,,test
0519054_sc-220458.jpg,3,0,1,1,5,,train
0519055_sc-220458.jpg,4,0,1,1,6,,train
0519056_sc-193048.jpg,3,0,1,3,7,,train
0519057_sc-193048.jpg,3,0,1,2,6,,train
0519058_sc-193048.jpg,7,1,1,1,10,,train
0519059_sc-193048.jpg,9,0,1,2,12,,train
0519060_sc-193048.jpg,5,1,1,1,8,,train
0519061_sc-193048.jpg,3,0,0,0,3,,val
0519062_sc-193048.jpg,8,0,0,1,9,,val
0519063_sc-1033753.jpg,1,0,0,1,2,,test
0519064_sc-1033753.jpg,1,0,0,1,2,,train
0519067_sc-113143.jpg,1,0,0,1,2,,train
0519068_sc-113143.jpg,5,0,0,0,5,,train
0519069_sc-144004.jpg,2,1,2,0,5,,train
0519070_sc-144004.jpg,1,1,1,0,3,,train
0519071_as-3259056.jpg,2,0,0,2,4,,train
0519072_as-2724800.jpg,1,0,0,0,1,,train
0519073_as-2670979.jpg,0,1,2,1,4,,val
0519074_as-0076132.jpg,1,0,0,0,1,,val
0519075_as-0076132.jpg,1,0,0,0,1,,test
0519076_as-0076132.jpg,2,0,0,0,2,,train
0519078_as-2576764.jpg,1,0,1,1,3,,train
0519079_as-3431658.jpg,4,0,0,0,4,,train
0519081_sc-125041.jpg,1,0,0,1,2,,train
0519082_as-7272581.jpg,1,0,0,0,1,,train
0519083_sc-109748.jpg,1,1,0,0,2,,train
0519084_sc-109748.jpg,3,0,0,0,3,,train
0519085_sc-109748.jpg,3,0,0,0,3,,val
0519087_sc-109748.jpg,1,0,0,0,1,,val
0519088_sc-110371.jpg,3,0,0,1,4,,test
0519089_sc-110371.jpg,2,0,0,1,3,,train
0519092_as-0043800.jpg,0,4,0,1,5,,train
0519093_as-2820895.jpg,0,0,1,0,1,,train
0519096_sc-223423.jpg,1,1,2,1,5,,train
0519097_sc-223423.jpg,1,0,3,0,4,,train
0519098_sc-223423.jpg,2,0,1,0,3,,train
0519099_sc-223423.jpg,3,0,4,0,7,,train
0519100_sc-1029575.jpg,1,0,0,0,1,,val
0519101_sc-1029575.jpg,1,0,0,0,1,,val
0519102_sc-1029575.jpg,1,0,0,1,2,,test
0519103_as-0049377.jpg,2,0,0,0,2,,train
0519104_as-0049377.jpg,3,0,1,0,4,,train
0519105_as-0049377.jpg,3,0,0,0,3,,train
0519106_as-0049377.jpg,1,0,0,0,1,,train
0519107_as-0049377.jpg,3,0,0,0,3,,train
0519108_as-0049377.jpg,1,2,1,0,4,,train
0519109_as-0049377.jpg,1,0,2,1,4,,train
0519110_as-0049377.jpg,2,1,4,0,7,,val
0519111_as-0049377.jpg,1,0,1,0,2,,val
0519113_sc-1025893.jpg,3,0,1,1,5,,test
0519115_as-0014429.jpg,3,0,0,0,3,,train
0519116_as-0014429.jpg,4,0,0,0,4,,train
0519117_as-0014429.jpg,2,0,0,0,2,,train
0519118_as-0014429.jpg,3,0,0,0,3,,train
0519119_as-0014429.jpg,4,0,0,0,4,,train
0519121_sc-184559.jpg,4,1,0,0,5,,train
0519122_sc-184559.jpg,4,1,1,0,6,,train
0519124_as-0078088.jpg,1,0,0,0,1,,val
0519126_as-0078088.jpg,5,0,0,0,5,,val
0519127_as-0078088.jpg,4,0,0,1,5,,test
0519128_as-0078088.jpg,4,0,0,0,4,,train
0519129_as-0078088.jpg,1,0,0,0,1,,train
0519131_sc-154066.jpg,1,0,2,4,7,,train
0519132_sc-154066.jpg,1,0,2,4,7,,train
0519133_sc-154066.jpg,1,0,1,4,6,,train
0519134_sc-154066.jpg,4,0,0,0,4,,train
0519135_sc-154066.jpg,4,1,0,0,5,,train
0519136_sc-154066.jpg,2,0,2,4,8,,val
0519138_sc-211210.jpg,4,0,0,0,4,,val
0519139_sc-211210.jpg,1,0,0,0,1,,test
0519140_sc-211210.jpg,3,0,0,0,3,,train
0519141_sc-211210.jpg,1,0,0,0,1,,train
0519142_sc-211210.jpg,1,0,0,0,1,,train
0519143_sc-211210.jpg,2,0,0,0,2,,train
0519144_as-3124333.jpg,2,0,0,0,2,,train
0519145_sc-160621.jpg,2,0,1,0,3,,train
0519146_as-9090516.jpg,1,0,0,0,1,,train
0519147_sc-1038614.jpg,0,1,0,0,1,,val
0519148_sc-133526.jpg,1,0,0,0,1,,val
0519150_sc-133526.jpg,6,0,1,0,7,,test
0519151_sc-133526.jpg,0,0,1,0,1,,train
0519152_sc-150327.jpg,2,0,0,0,2,,train
0519153_sc-150327.jpg,2,1,0,0,3,,train
0519154_sc-121190.jpg,1,1,0,0,2,,train
0519157_sc-124263.jpg,2,0,0,1,3,,train
0519158_sc-124263.jpg,1,0,0,1,2,,train
0519159_sc-124263.jpg,0,0,1,0,1,,train
0519160_sc-206957.jpg,3,0,0,0,3,,val
0519161_sc-206957.jpg,7,0,0,0,7,,val
0519162_sc-206957.jpg,7,0,0,2,9,,test
0519163_sc-206957.jpg,1,0,0,0,1,,train
0519164_sc-206957.jpg,1,0,0,0,1,,train
0519166_as-0055426.jpg,0,0,3,0,3,,train
0519169_as-0055426.jpg,1,1,3,1,6,,train
0519170_sc-216472.jpg,1,0,0,0,1,,train
0519171_sc-216472.jpg,1,0,0,0,1,,train
0519172_sc-216472.jpg,1,0,0,0,1,,train
0519173_sc-216472.jpg,1,0,0,0,1,,val
0519174_sc-216472.jpg,1,0,0,1,2,,val
0519175_sc-216472.jpg,2,0,0,0,2,,test
0519176_sc-216472.jpg,1,0,0,0,1,,train
0519178_as-0058841.jpg,1,0,0,1,2,,train
0519179_as-0058841.jpg,2,0,1,1,4,,train
0519186_as-0059078.jpg,1,1,0,1,3,,train
0519187_as-0059078.jpg,0,1,1,1,3,,train
0519188_as-0059078.jpg,3,3,1,2,9,,train
0519189_sc-149814.jpg,1,0,1,1,3,,train
0519191_sc-149814.jpg,1,0,1,1,3,,val
0519192_sc-149814.jpg,1,0,1,1,3,,val
0519193_sc-149814.jpg,1,0,1,1,3,,test
0519196_sc-162406.jpg,6,1,0,0,7,,train
0519197_sc-162406.jpg,16,1,0,0,17,,train
0519198_sc-162406.jpg,5,1,0,1,7,,train
0519199_sc-162406.jpg,2,0,0,1,3,,train
0519200_sc-162406.jpg,4,0,0,0,4,,train
0519201_sc-162406.jpg,4,0,0,0,4,,train
0519202_sc-162406.jpg,6,0,2,0,8,,train
0519203_sc-162406.jpg,1,0,1,0,2,,val
0519204_sc-211480.jpg,1,0,0,0,1,,val
0519205_sc-212289.jpg,1,0,0,0,1,,test
0519206_sc-212289.jpg,1,0,1,0,2,,train
0519207_sc-212289.jpg,1,0,1,0,2,,train
0519208_sc-212289.jpg,2,0,0,0,2,,train
0519209_sc-212289.jpg,3,0,0,1,4,,train
0519210_sc-212289.jpg,2,0,0,2,4,,train
0519215_sc-1014256.jpg,4,0,0,1,5,,train
0519216_sc-180265.jpg,1,0,0,0,1,,train
0519217_sc-180265.jpg,1,0,0,0,1,,val
0519218_sc-180265.jpg,1,0,0,0,1,,val
0519219_as-0031893.jpg,1,0,1,0,2,,test
0519220_as-0031893.jpg,1,0,1,0,2,,train
0519222_as-2705595.jpg,2,2,2,1,7,,train
0519224_sc-197202.jpg,0,1,0,0,1,,train
0519225_sc-197202.jpg,0,1,0,0,1,,train
0519227_as-0002132.jpg,0,0,0,1,1,,train
0519228_as-0002132.jpg,0,0,0,1,1,,train
0519229_sc-1033408.jpg,3,0,1,0,4,,train
0519230_sc-1033408.jpg,2,0,0,0,2,,val
0519231_sc-1033408.jpg,1,1,0,0,2,,val
0519232_sc-1033408.jpg,1,0,1,1,3,,test
0519233_sc-1033408.jpg,1,0,1,1,3,,train
0519236_sc-1033408.jpg,2,0,1,0,3,,train
0519238_sc-1002990.jpg,5,0,0,0,5,,train
0519239_sc-1002990.jpg,2,0,0,0,2,,train
0519243_as-7986884.jpg,1,0,0,0,1,,train
0519244_as-3077764.jpg,1,0,0,0,1,,train
0519245_sc-200149.jpg,2,1,2,0,5,,train
0519246_as-3047911.jpg,0,0,1,0,1,,val
0519248_sc-181157.jpg,2,0,0,0,2,,val
0519250_sc-1017491.jpg,6,1,1,0,8,,test
0519251_as-2738796.jpg,1,0,0,0,1,,train
0519252_sc-1032747.jpg,3,0,0,0,3,,train
0519253_sc-1032747.jpg,5,0,1,0,6,,train
0519255_sc-116492.jpg,2,0,1,1,4,,train
0519256_sc-116492.jpg,1,0,1,1,3,,train
0519258_sc-135674.jpg,0,1,0,0,1,,train
0519260_as-0080885.jpg,1,0,0,0,1,,train
0519261_as-0080885.jpg,1,0,0,0,1,,val
0519262_as-0080885.jpg,1,0,0,0,1,,val
0519263_as-0080885.jpg,1,0,0,0,1,,test
0519264_as-7033212.jpg,1,0,0,0,1,,train
0519265_as-2795290.jpg,0,1,3,0,4,,train
0519267_as-2563508.jpg,4,4,1,1,10,,train
0519268_as-3068496.jpg,2,1,0,0,3,,train
0519269_sc-223341.jpg,13,1,4,2,20,,train
0519270_sc-223341.jpg,17,1,5,2,25,,train
0519271_sc-223341.jpg,12,1,4,1,18,,train
0519272_sc-223341.jpg,5,1,4,1,11,,val
0519273_sc-223341.jpg,3,0,3,1,7,,val
0519274_sc-223341.jpg,12,1,3,1,17,,test
0519275_sc-223341.jpg,8,1,5,2,16,,train
0519276_sc-223341.jpg,10,2,2,0,14,,train
0519277_sc-223341.jpg,14,2,5,2,23,,train
0519278_sc-223341.jpg,13,2,6,2,23,,train
0519279_sc-223341.jpg,2,0,3,0,5,,train
0519280_as-0056881.jpg,1,0,0,0,1,,train
0519281_as-0056881.jpg,1,0,0,0,1,,train
0519282_sc-1033193.jpg,1,2,0,0,3,,val
0519283_sc-1033193.jpg,1,3,0,0,4,,val
0519285_sc-1024024.jpg,2,1,0,0,3,,test
0519286_sc-201314.jpg,4,0,0,1,5,,train
0519287_as-9048045.jpg,3,0,0,0,3,,train
0519288_sc-197389.jpg,4,0,1,1,6,,train
0519289_sc-197389.jpg,6,0,2,2,10,,train
0519290_as-0070290.jpg,1,0,1,0,2,,train
0519295_as-0070290.jpg,1,0,1,0,2,,train
0519296_as-0070290.jpg,2,0,2,0,4,,train
0519297_as-0070290.jpg,5,0,1,1,7,,val
0519301_as-0076838.jpg,0,0,1,0,1,,val
0519302_as-0076838.jpg,1,0,2,0,3,,test
0519303_as-0076838.jpg,0,0,3,0,3,,train
0519304_sc-115769.jpg,1,0,0,2,3,,train
0519305_sc-115769.jpg,1,0,0,1,2,,train
0519306_sc-212626.jpg,3,0,0,2,5,,train
0519307_sc-212626.jpg,2,0,0,0,2,,train
0519308_as-7804989.jpg,0,0,2,0,2,,train
0519309_as-3372305.jpg,1,1,1,2,5,,train
0519310_sc-1011427.jpg,1,0,0,0,1,,val
0519312_sc-195818.jpg,6,0,0,0,6,,val
0519313_sc-224408.jpg,11,0,0,1,12,,test
0519314_sc-224408.jpg,14,1,0,1,16,,train
0519315_sc-224408.jpg,5,0,0,0,5,,train
0519316_sc-224408.jpg,2,0,0,0,2,,train
0519317_sc-224408.jpg,5,0,0,0,5,,train
0519318_sc-224408.jpg,8,0,0,0,8,,train
0519319_as-0063814.jpg,1,0,0,0,1,,train
0519321_as-0063814.jpg,1,0,0,0,1,,train
0519323_as-0063814.jpg,3,1,3,1,8,,val
0519324_as-7426659.jpg,1,0,0,0,1,,val
0519327_as-0041427.jpg,6,1,0,0,7,,test
0519328_as-3195368.jpg,1,0,0,0,1,,train
0519330_as-0006347.jpg,3,0,1,0,4,,train
0519331_as-0006347.jpg,4,0,1,0,5,,train
0519332_as-0006347.jpg,3,0,0,0,3,,train
0519333_sc-216852.jpg,1,0,1,0,2,,train
0519334_sc-216852.jpg,3,0,1,0,4,,train
0519335_sc-216852.jpg,3,0,1,0,4,,train
0519336_sc-216852.jpg,3,0,1,0,4,,val
0519337_as-2833881.jpg,0,0,0,1,1,,val
0519338_as-2855046.jpg,0,0,1,0,1,,test
0519340_as-0062378.jpg,1,0,0,0,1,,train
0519341_as-0062378.jpg,3,0,0,0,3,,train
0519342_as-0062378.jpg,4,0,0,0,4,,train
0519343_as-0062378.jpg,1,0,0,0,1,,train
0519344_as-0062378.jpg,1,0,0,0,1,,train
0519345_as-0062378.jpg,1,0,0,0,1,,train
0519346_as-0062378.jpg,1,0,0,0,1,,train
0519347_as-9033893.jpg,1,0,3,0,4,,val
0519349_sc-124844.jpg,0,1,0,0,1,,val
0519350_sc-124844.jpg,3,0,0,0,3,,test
0519352_sc-180604.jpg,1,1,0,0,2,,train
0519354_sc-124104.jpg,3,0,0,1,4,,train
0519355_sc-124104.jpg,4,1,1,2,8,,train
0519356_sc-124104.jpg,2,1,1,1,5,,train
0519360_as-7997082.jpg,2,0,0,1,3,,train
0519361_as-2885438.jpg,1,0,0,1,2,,train
0519362_sc-117109.jpg,1,0,0,0,1,,train
0519363_sc-117109.jpg,1,0,0,0,1,,val
0519365_sc-174038.jpg,1,0,0,0,1,,val
0519367_as-0072627.jpg,1,0,0,0,1,,test
0519368_as-0072627.jpg,1,0,0,0,1,,train
0519369_sc-124237.jpg,1,0,1,0,2,,train
0519370_as-3100368.jpg,1,0,0,0,1,,train
0519372_sc-116917.jpg,3,1,0,0,4,,train
0519376_sc-122569.jpg,10,1,0,0,11,,train
0519377_sc-153765.jpg,1,0,0,1,2,,train
0519378_sc-128908.jpg,2,1,0,0,3,,train
0519379_sc-128908.jpg,2,1,0,0,3,,val
0519380_sc-131570.jpg,8,0,0,0,8,,val
0519381_sc-131570.jpg,7,0,0,0,7,,test
0519382_sc-131570.jpg,1,0,0,0,1,,train
0519383_as-2884934.jpg,2,0,1,0,3,,train
0519384_as-3415084.jpg,1,0,1,0,2,,train
0519385_sc-174145.jpg,2,0,0,2,4,,train
0519386_sc-174145.jpg,1,0,0,1,2,,train
0519387_sc-174145.jpg,1,0,0,1,2,,train
0519388_sc-213742.jpg,6,0,0,0,6,,train
0519389_as-3237642.jpg,2,1,0,0,3,,val
0519390_as-0010962.jpg,1,0,0,1,2,,val
0519391_as-0010962.jpg,1,0,0,1,2,,test
0519392_as-0010962.jpg,2,0,0,1,3,,train
0519393_sc-129121.jpg,1,0,1,0,2,,train
0519394_sc-129121.jpg,1,0,1,0,2,,train
0519395_sc-212915.jpg,1,0,1,0,2,,train
0519396_sc-212915.jpg,4,0,0,0,4,,train
0519397_sc-212915.jpg,0,0,1,0,1,,train
0519398_sc-111353.jpg,1,0,0,0,1,,train
0519399_as-3458237.jpg,1,1,1,1,4,,val
0519400_sc-1003628.jpg,0,1,0,0,1,,val
0519401_sc-1003628.jpg,3,0,0,0,3,,test
0519403_sc-1003628.jpg,0,1,0,0,1,,train
0519405_sc-1003628.jpg,1,0,0,0,1,,train
0519406_sc-159684.jpg,3,0,0,0,3,,train
0519407_sc-159684.jpg,1,0,0,1,2,,train
0519408_sc-159684.jpg,1,0,0,1,2,,train
0519410_sc-159684.jpg,2,0,0,0,2,,train
0519411_sc-159684.jpg,2,0,0,0,2,,train
0519413_sc-159684.jpg,1,0,0,0,1,,val
0519415_sc-159684.jpg,5,0,0,0,5,,val
0519416_sc-159684.jpg,5,0,0,0,5,,test
0519417_sc-159684.jpg,1,0,0,0,1,,train
0519418_sc-159684.jpg,1,0,0,1,2,,train
0519419_as-3204588.jpg,5,3,1,3,12,,train
0519421_sc-137604.jpg,1,0,1,1,3,,train
0519422_sc-137604.jpg,1,0,1,1,3,,train
0519424_sc-137604.jpg,1,1,1,0,3,,train
0519425_sc-171481.jpg,4,0,0,0,4,,train
0519426_sc-171481.jpg,2,0,0,0,2,,val
0519427_sc-171481.jpg,3,0,0,0,3,,val
0519428_sc-171481.jpg,4,0,0,0,4,,test
0519429_as-0099131.jpg,1,1,0,1,3,,train
0519430_as-0099131.jpg,0,1,0,1,2,,train
0519431_sc-186252.jpg,4,1,0,0,5,,train
0519432_sc-186252.jpg,1,0,0,1,2,,train
0519433_sc-186252.jpg,4,0,1,0,5,,train
0519434_as-3241329.jpg,2,1,0,0,3,,train
0519435_as-2607837.jpg,3,1,0,0,4,,train
0519436_as-7041092.jpg,1,1,1,0,3,,val
0519437_sc-228766.jpg,5,0,0,1,6,,val
0519438_sc-228766.jpg,1,0,0,0,1,,test
0519439_sc-228766.jpg,4,0,0,0,4,,train
0519441_sc-228766.jpg,3,0,0,0,3,,train
0519442_as-3274071.jpg,1,0,1,1,3,,train
0519444_as-2575487.jpg,1,0,1,0,2,,train
0519445_sc-191117.jpg,0,1,0,0,1,,train
0519446_sc-191117.jpg,0,1,0,0,1,,train
0519447_as-0039776.jpg,2,0,0,0,2,,train
0519450_sc-156249.jpg,1,1,1,1,4,,val
0519451_sc-156249.jpg,2,0,1,1,4,,val
0519452_sc-229316.jpg,2,0,0,0,2,,test
0519453_sc-229316.jpg,2,0,0,0,2,,train
0519454_sc-229316.jpg,1,0,0,0,1,,train
0519455_sc-229316.jpg,1,0,0,0,1,,train
0519456_as-0062037.jpg,1,0,0,0,1,,train
0519457_as-0062037.jpg,1,0,0,0,1,,train
0519458_as-0062037.jpg,1,0,0,0,1,,train
0519459_as-0062037.jpg,1,0,0,0,1,,train
0519460_sc-153984.jpg,2,0,0,1,3,,val
0519461_sc-227101.jpg,1,0,0,0,1,,val
0519463_sc-129264.jpg,3,0,0,1,4,,test
0519464_as-0004049.jpg,3,1,1,0,5,,train
0519465_sc-132798.jpg,0,0,1,0,1,,train
0519466_sc-132798.jpg,9,0,1,0,10,,train
0519467_sc-200265.jpg,1,0,0,0,1,,train
0519468_sc-200265.jpg,2,0,0,0,2,,train
0519469_sc-200265.jpg,1,0,0,0,1,,train
0519470_as-3303001.jpg,3,0,2,0,5,,train
0519472_sc-227171.jpg,3,0,0,0,3,,val
0519473_sc-227171.jpg,2,0,0,0,2,,val
0519474_as-3441855.jpg,1,0,0,0,1,,test
0519476_sc-195588.jpg,1,1,0,0,2,,train
0519479_as-0013190.jpg,1,1,0,0,2,,train
0519483_as-0057991.jpg,3,0,0,0,3,,train
0519484_as-0057991.jpg,2,0,0,0,2,,train
0519485_as-0057991.jpg,3,0,0,0,3,,train
0519486_as-0057991.jpg,3,0,0,0,3,,train
0519487_as-0057991.jpg,2,0,0,0,2,,train
0519488_as-0057991.jpg,5,0,0,0,5,,val
0519489_as-0057991.jpg,3,0,0,0,3,,val
0519490_sc-113820.jpg,1,1,0,0,2,,test
0519491_sc-113820.jpg,1,0,0,0,1,,train
0519492_sc-113820.jpg,3,0,0,0,3,,train
0519495_sc-171821.jpg,0,0,1,0,1,,train
0519496_sc-171821.jpg,1,0,0,0,1,,train
0519497_sc-171821.jpg,1,0,0,0,1,,train
0519498_sc-171821.jpg,1,0,0,0,1,,train
0519500_sc-171821.jpg,1,0,0,0,1,,train
0519502_sc-171821.jpg,1,0,0,0,1,,val
0519503_sc-171821.jpg,1,0,0,0,1,,val
0519504_sc-171821.jpg,2,0,0,0,2,,test
0519505_sc-171821.jpg,1,0,0,0,1,,train
0519506_sc-171821.jpg,1,0,0,0,1,,train
0519507_sc-171821.jpg,1,0,0,0,1,,train
0519508_sc-171821.jpg,1,0,0,0,1,,train
0519509_sc-171821.jpg,1,0,0,0,1,,train
0519510_sc-171821.jpg,1,0,0,0,1,,train
0519511_sc-171821.jpg,1,0,0,0,1,,train
0519512_sc-171821.jpg,1,0,0,0,1,,val
0519513_sc-171821.jpg,1,0,0,0,1,,val
0519514_sc-171821.jpg,1,0,0,0,1,,test
0519515_sc-171821.jpg,1,0,0,0,1,,train
0519516_sc-171821.jpg,1,0,0,0,1,,train
0519517_sc-171821.jpg,1,0,0,0,1,,train
0519520_as-3307439.jpg,1,0,1,2,4,,train
0519521_sc-227823.jpg,1,0,1,1,3,,train
0519522_as-2630467.jpg,2,0,0,1,3,,train
0519523_sc-123037.jpg,1,0,0,0,1,,train
0519524_sc-207902.jpg,2,0,0,0,2,,val
0519525_sc-207902.jpg,1,0,0,0,1,,val
0519526_sc-207902.jpg,1,0,0,0,1,,test
0519527_sc-207902.jpg,2,0,0,0,2,,train
0519528_sc-207902.jpg,1,0,0,0,1,,train
0519530_as-3334313.jpg,2,0,0,0,2,,train
0519531_sc-229181.jpg,3,1,0,1,5,,train
0519536_as-0006676.jpg,1,0,0,1,2,,train
0519537_as-7150291.jpg,1,1,1,0,3,,train
0519538_sc-210824.jpg,1,0,0,0,1,,train
0519539_as-2609932.jpg,1,0,0,0,1,,val
0519541_as-3040805.jpg,1,1,1,0,3,,val
0519542_sc-194160.jpg,0,0,1,0,1,,test
0519543_sc-194160.jpg,1,1,1,2,5,,train
0519545_sc-194160.jpg,3,0,0,0,3,,train
0519548_as-0078997.jpg,2,0,1,1,4,,train
0519549_as-0078997.jpg,2,0,1,0,3,,train
0519553_sc-168831.jpg,7,0,0,1,8,,train
0519554_sc-168831.jpg,5,0,0,0,5,,train
0519555_sc-168831.jpg,4,0,0,0,4,,train
0519558_sc-178231.jpg,1,0,3,2,6,,val
0519559_sc-208910.jpg,3,0,0,0,3,,val
0519560_sc-208910.jpg,4,0,0,0,4,,test
0519561_sc-208910.jpg,4,0,0,0,4,,train
0519562_sc-208910.jpg,1,0,0,0,1,,train
0519563_as-0030944.jpg,3,1,0,0,4,,train
0519564_as-0030944.jpg,2,0,0,0,2,,train
0519565_as-0030944.jpg,0,2,0,0,2,,train
0519566_as-0030944.jpg,2,1,0,1,4,,train
0519567_as-0030944.jpg,1,0,0,0,1,,train
0519568_as-0030944.jpg,1,0,1,0,2,,val
0519569_as-0030944.jpg,4,0,0,0,4,,val
0519570_as-0030944.jpg,3,1,0,1,5,,test
0519573_as-0030944.jpg,4,0,0,0,4,,train
0519574_as-0030944.jpg,4,0,0,0,4,,train
0519576_as-2572521.jpg,2,0,0,1,3,,train
0519577_sc-1030970.jpg,1,0,1,0,2,,train
0519578_sc-1030970.jpg,1,0,0,0,1,,train
0519579_sc-1017593.jpg,2,0,0,0,2,,train
0519580_sc-1017593.jpg,1,1,0,0,2,,train
0519581_sc-106737.jpg,4,0,0,1,5,,val
0519582_sc-106737.jpg,6,0,0,0,6,,val
0519583_as-7652290.jpg,2,0,0,0,2,,test
0519584_sc-228490.jpg,2,1,1,0,4,,train
0519585_sc-228490.jpg,4,0,0,1,5,,train
0519586_sc-228490.jpg,1,0,1,1,3,,train
0519587_sc-228490.jpg,5,0,1,0,6,,train
0519588_sc-228490.jpg,2,0,1,1,4,,train
0519589_as-0004426.jpg,5,0,0,0,5,,train
0519590_as-0004426.jpg,2,0,0,0,2,,train
0519591_as-0004426.jpg,2,0,0,0,2,,val
0519592_sc-225450.jpg,0,1,0,0,1,,val
0519593_sc-225450.jpg,2,1,0,0,3,,test
0519594_sc-225450.jpg,1,1,0,0,2,,train
0519595_sc-225450.jpg,2,1,0,0,3,,train
0519596_sc-123922.jpg,1,0,0,1,2,,train
0519597_sc-123922.jpg,1,0,0,0,1,,train
0519598_as-2523647.jpg,2,0,2,1,5,,train
0519599_as-0021917.jpg,3,0,0,0,3,,train
0519600_as-0021917.jpg,3,0,0,0,3,,train
0519601_as-0021917.jpg,2,0,0,0,2,,val
0519602_as-0021917.jpg,1,0,0,0,1,,val
0519603_as-0021917.jpg,1,0,0,0,1,,test
0519606_sc-142114.jpg,1,0,0,0,1,,train
0519608_as-3256970.jpg,2,0,0,0,2,,train
0519609_sc-226303.jpg,0,1,0,0,1,,train
0519610_as-0051864.jpg,0,2,0,1,3,,train
0519612_as-0034447.jpg,1,0,0,0,1,,train
0519613_as-0034447.jpg,3,0,0,0,3,,train
0519615_sc-125155.jpg,8,0,0,0,8,,train
0519616_as-2509028.jpg,1,0,0,0,1,,val
0519621_as-0089053.jpg,2,1,0,0,3,,val
0519622_as-0089053.jpg,2,1,0,0,3,,test
0519623_as-0089053.jpg,0,1,0,0,1,,train
0519625_as-2974519.jpg,1,0,0,0,1,,train
0519626_sc-206332.jpg,3,0,0,0,3,,train
0519627_sc-206332.jpg,3,0,0,0,3,,train
0519629_as-0022607.jpg,2,1,1,0,4,,train
0519630_sc-117348.jpg,5,0,1,2,8,,train
0519631_sc-117348.jpg,4,0,0,0,4,,train
0519632_sc-122988.jpg,4,0,0,1,5,,val
0519633_as-3143542.jpg,1,0,0,0,1,,val
0519634_sc-1001919.jpg,1,0,1,0,2,,test
0519635_sc-1001919.jpg,1,0,1,0,2,,train
0519636_sc-1001919.jpg,3,0,1,0,4,,train
0519637_sc-204940.jpg,2,0,0,0,2,,train
0519638_sc-217763.jpg,2,0,0,0,2,,train
0519639_sc-217763.jpg,3,3,2,1,9,,train
0519640_sc-217763.jpg,0,1,2,0,3,,train
0519641_sc-217763.jpg,3,1,1,1,6,,train
0519642_sc-217763.jpg,1,2,1,0,4,,val
0519643_as-2695858.jpg,3,0,0,0,3,,val
0519644_as-3172532.jpg,1,0,0,1,2,,test
0519645_as-0022538.jpg,5,0,0,0,5,,train
0519647_as-7182920.jpg,3,0,0,0,3,,train
0519648_sc-1034350.jpg,4,1,2,0,7,,train
0519649_sc-1034350.jpg,4,1,2,0,7,,train
0519650_sc-1034350.jpg,2,0,1,0,3,,train
0519652_sc-1034350.jpg,0,0,1,0,1,,train
0519653_sc-1034350.jpg,0,0,1,0,1,,train
0519654_as-0018204.jpg,1,0,1,1,3,,val
0519655_as-0018204.jpg,0,0,1,0,1,,val
0519656_as-0018204.jpg,1,0,1,1,3,,test
0519657_as-2611517.jpg,1,0,0,0,1,,train
0519659_as-0063472.jpg,4,0,0,0,4,,train
0519660_as-0063472.jpg,2,0,0,1,3,,train
0519661_as-0063472.jpg,3,1,0,0,4,,train
0519662_as-0063472.jpg,0,0,1,0,1,,train
0519663_as-2890153.jpg,0,0,1,0,1,,train
0519664_as-2509108.jpg,1,2,0,0,3,,train
0519665_as-0098224.jpg,2,1,1,1,5,,val
0519666_as-0098224.jpg,0,1,0,0,1,,val
0519667_as-0098224.jpg,1,0,1,0,2,,test
0519668_as-0098224.jpg,1,0,1,1,3,,train
0519669_as-0098224.jpg,1,0,2,1,4,,train
0519670_as-0098224.jpg,1,0,1,1,3,,train
0519672_as-0027292.jpg,2,0,0,1,3,,train
0519673_as-0027292.jpg,3,0,1,1,5,,train
0519674_as-0027292.jpg,6,0,0,0,6,,train
0519675_as-0027292.jpg,3,0,0,0,3,,train
0519676_as-0034734.jpg,1,0,1,0,2,,val
0519677_as-0034734.jpg,1,1,1,0,3,,val
0519678_as-0034734.jpg,2,1,1,0,4,,test
0519679_as-0034734.jpg,0,0,1,0,1,,train
0519680_as-0034734.jpg,1,1,1,0,3,,train
0519681_sc-200423.jpg,1,1,0,1,3,,train
0519682_sc-200423.jpg,1,0,0,0,1,,train
0519683_sc-200423.jpg,1,0,0,0,1,,train
0519684_sc-200423.jpg,1,0,0,0,1,,train
0519685_sc-200423.jpg,1,1,0,0,2,,train
0519686_sc-160393.jpg,5,0,1,0,6,,val
0519687_sc-160393.jpg,1,0,0,0,1,,val
0519688_sc-160393.jpg,3,0,1,0,4,,test
0519689_sc-160393.jpg,6,0,1,0,7,,train
0519692_as-0004265.jpg,8,1,2,2,13,,train
0519693_as-0004265.jpg,4,1,2,2,9,,train
0519697_as-0004265.jpg,3,1,4,1,9,,train
0519698_as-0004265.jpg,3,0,1,1,5,,train
0519699_as-0004265.jpg,0,0,1,0,1,,train
0519700_as-3148767.jpg,1,0,0,0,1,,train
0519701_as-3078911.jpg,2,0,1,1,4,,val
0519704_as-0084138.jpg,0,2,2,0,4,,val
0519705_as-0084138.jpg,0,1,2,0,3,,test
0519706_as-0084138.jpg,0,0,1,0,1,,train
0519707_as-0084138.jpg,1,1,0,0,2,,train
0519708_as-0084138.jpg,1,0,0,0,1,,train
0519709_as-0084138.jpg,1,0,0,0,1,,train
0519710_as-0084138.jpg,1,1,1,1,4,,train
0519711_as-0084138.jpg,2,0,0,0,2,,train
0519712_as-2624739.jpg,3,0,1,1,5,,train
0519713_as-2672678.jpg,3,0,1,0,4,,val
0519714_as-0008089.jpg,2,0,1,0,3,,val
0519715_as-0008089.jpg,1,0,0,1,2,,test
0519716_as-2702349.jpg,0,1,0,0,1,,train
0519717_as-3371777.jpg,1,1,0,1,3,,train
0519718_as-3466512.jpg,1,0,0,0,1,,train
0519719_as-2668515.jpg,2,0,0,1,3,,train
0519721_as-3375695.jpg,1,1,1,0,3,,train
0519723_as-0095716.jpg,2,0,0,0,2,,train
0519724_as-0095716.jpg,1,0,0,0,1,,train
0519725_sc-224488.jpg,7,0,0,1,8,,val
0519726_sc-224488.jpg,3,0,0,0,3,,val
0519727_sc-224488.jpg,8,0,0,0,8,,test
0519728_sc-224488.jpg,10,0,0,0,10,,train
0519729_sc-224488.jpg,3,0,0,0,3,,train
0519730_sc-224488.jpg,7,0,0,0,7,,train
0519731_sc-224488.jpg,2,0,0,0,2,,train
0519732_sc-224488.jpg,10,0,0,0,10,,train
0519733_sc-224488.jpg,6,0,0,0,6,,train
0519734_sc-224488.jpg,5,0,0,0,5,,train
0519735_sc-173030.jpg,5,0,0,0,5,,val
0519736_as-2642240.jpg,1,1,0,0,2,,val
0519737_sc-190924.jpg,3,0,0,0,3,,test
0519738_sc-190924.jpg,1,0,0,0,1,,train
0519739_sc-211647.jpg,1,0,0,0,1,,train
0519740_sc-211647.jpg,2,0,0,0,2,,train
0519741_as-7149534.jpg,2,0,0,1,3,,train
0519742_as-0068991.jpg,1,0,0,0,1,,train
0519743_as-0068991.jpg,1,0,0,0,1,,train
0519744_as-0068991.jpg,0,0,1,0,1,,train
0519745_as-0068991.jpg,0,0,1,0,1,,val
0519748_as-0076228.jpg,2,0,1,0,3,,val
0519749_as-0076228.jpg,1,0,0,0,1,,test
0519750_as-0097545.jpg,1,0,0,0,1,,train
0519751_as-0097545.jpg,1,0,0,0,1,,train
0519752_as-0097545.jpg,3,0,0,0,3,,train
0519753_as-0097545.jpg,3,0,0,0,3,,train
0519754_as-0097545.jpg,1,0,0,0,1,,train
0519755_as-0046154.jpg,3,3,8,0,14,,train
0519756_as-0046154.jpg,3,4,7,0,14,,train
0519757_as-0046154.jpg,2,0,1,0,3,,val
0519758_as-0046154.jpg,2,0,1,0,3,,val
0519759_as-0046154.jpg,3,0,0,0,3,,test
0519760_as-2575529.jpg,6,0,0,1,7,,train
0519762_as-2625449.jpg,2,0,0,0,2,,train
0519763_sc-1005321.jpg,2,0,0,0,2,,train
0519764_sc-1005321.jpg,1,3,1,0,5,,train
0519765_sc-1005321.jpg,2,3,0,0,5,,train
0519767_sc-1031617.jpg,2,1,1,1,5,,train
0519768_as-0049149.jpg,0,0,0,1,1,,train
0519770_as-0049149.jpg,2,0,0,0,2,,val
0519771_as-0049149.jpg,2,0,0,0,2,,val
0519772_as-0049149.jpg,3,0,0,0,3,,test
0519773_as-0049149.jpg,2,0,0,0,2,,train
0519774_as-0049149.jpg,1,0,0,0,1,,train
0519775_as-2688715.jpg,1,0,0,0,1,,train
0519776_as-0071401.jpg,1,0,2,0,3,,train
0519777_as-0071401.jpg,0,0,1,0,1,,train
0519778_as-0071401.jpg,0,0,1,0,1,,train
0519779_as-0071401.jpg,0,0,2,0,2,,train
0519780_as-0071401.jpg,0,0,1,0,1,,val
0519781_as-0061323.jpg,7,0,0,1,8,,val
0519782_as-0061323.jpg,5,2,1,1,9,,test
0519784_as-0001896.jpg,5,0,0,1,6,,train
0519785_as-0001896.jpg,2,0,0,0,2,,train
0519786_as-0001896.jpg,2,0,0,0,2,,train
0519787_as-3269532.jpg,1,0,1,1,3,,train
0519788_sc-111919.jpg,2,0,1,0,3,,train
0519789_sc-111919.jpg,4,0,0,0,4,,train
0519790_sc-111919.jpg,3,0,0,0,3,,train
0519791_as-2702092.jpg,4,0,0,0,4,,val
0519792_as-9098555.jpg,1,0,0,0,1,,val
0519793_as-0006617.jpg,4,2,0,0,6,,test
0519794_as-0006617.jpg,1,1,0,1,3,,train
0519796_as-3316983.jpg,1,1,1,1,4,,train
0519797_as-0086367.jpg,1,0,1,1,3,,train
0519798_as-0086367.jpg,1,0,1,1,3,,train
0519799_as-0086367.jpg,1,0,2,1,4,,train
0519800_as-0086367.jpg,1,0,2,0,3,,train
0519801_sc-119991.jpg,1,0,0,0,1,,train
0519802_sc-119991.jpg,1,0,0,0,1,,val
0519803_sc-119991.jpg,1,0,0,0,1,,val
0519804_sc-119991.jpg,1,0,0,0,1,,test
0519807_as-2786962.jpg,0,0,1,0,1,,train
0519808_sc-202241.jpg,1,0,0,0,1,,train
0519809_sc-202241.jpg,1,0,0,0,1,,train
0519810_as-0032801.jpg,1,1,3,0,5,,train
0519811_sc-229961.jpg,1,0,3,0,4,,train
0519812_sc-229961.jpg,1,0,0,0,1,,train
0519817_as-0009944.jpg,7,1,1,1,10,,train
0519818_as-0009944.jpg,8,0,1,3,12,,val
0519822_as-0077203.jpg,1,1,0,0,2,,val
0519823_as-0077203.jpg,2,1,0,0,3,,test
0519824_sc-107615.jpg,1,0,0,0,1,,train
0519825_sc-107615.jpg,2,0,0,0,2,,train
0519826_sc-107615.jpg,3,0,0,0,3,,train
0519829_sc-107615.jpg,1,0,0,0,1,,train
0519830_sc-107615.jpg,3,0,0,0,3,,train
0519831_sc-107615.jpg,3,0,0,0,3,,train
0519832_sc-107615.jpg,2,0,0,0,2,,train
0519833_sc-107615.jpg,3,0,0,1,4,,val
0519834_sc-1040489.jpg,2,0,0,0,2,,val
0519835_sc-1040489.jpg,0,3,0,0,3,,test
0519836_as-0049066.jpg,0,1,1,2,4,,train
0519837_as-0049066.jpg,0,0,1,1,2,,train
0519838_as-0049066.jpg,1,1,2,1,5,,train
0519839_as-0049066.jpg,0,1,1,1,3,,train
0519840_as-0049066.jpg,2,2,2,1,7,,train
0519841_as-0049066.jpg,2,0,0,0,2,,train
0519842_as-0049066.jpg,1,0,1,1,3,,train
0519843_as-0049066.jpg,1,0,1,0,2,,val
0519844_as-0049066.jpg,0,1,1,0,2,,val
0519846_sc-1033239.jpg,1,0,0,0,1,,test
0519847_sc-1033239.jpg,1,0,0,0,1,,train
0519848_sc-1025772.jpg,1,0,0,0,1,,train
0519849_sc-1025772.jpg,1,0,0,1,2,,train
0519850_as-0042902.jpg,0,0,2,1,3,,train
0519851_as-0001501.jpg,1,0,0,0,1,,train
0519854_as-0001501.jpg,3,0,0,0,3,,train
0519855_as-0072812.jpg,2,0,0,0,2,,train
0519856_sc-204711.jpg,1,0,1,0,2,,val
0519857_as-3421964.jpg,4,0,1,0,5,,val
0519858_sc-145385.jpg,0,0,1,1,2,,test
0519859_sc-145385.jpg,0,0,1,1,2,,train
0519860_sc-145385.jpg,1,0,0,0,1,,train
0519861_sc-145385.jpg,4,0,0,1,5,,train
0519862_sc-1019742.jpg,2,0,2,1,5,,train
0519863_sc-1019742.jpg,1,0,0,0,1,,train
0519865_sc-1019742.jpg,1,0,1,0,2,,train
0519866_sc-1008333.jpg,3,0,0,0,3,,train
0519867_sc-1008333.jpg,6,0,0,0,6,,val
0519868_as-2989332.jpg,2,0,2,0,4,,val
0519872_as-0085368.jpg,1,0,1,0,2,,test
0519873_as-0085368.jpg,1,0,1,1,3,,train
0519877_as-0085368.jpg,3,3,1,1,8,,train
0519878_sc-1015665.jpg,4,0,0,1,5,,train
0519880_sc-1015665.jpg,6,0,0,1,7,,train
0519881_sc-1015665.jpg,8,0,0,1,9,,train
0519882_sc-1015665.jpg,1,1,0,0,2,,train
0519883_sc-1015665.jpg,4,0,0,1,5,,train
0519884_sc-1024705.jpg,3,0,0,0,3,,val
0519885_sc-1024705.jpg,2,0,0,0,2,,val
0519886_sc-1024705.jpg,1,0,0,0,1,,test
0519889_sc-143475.jpg,3,1,0,0,4,,train
0519891_sc-143475.jpg,2,0,0,0,2,,train
0519892_sc-143475.jpg,4,1,1,0,6,,train
0519893_sc-143475.jpg,7,1,1,0,9,,train
0519894_sc-143475.jpg,1,1,0,0,2,,train
0519895_sc-195559.jpg,1,0,1,1,3,,train
0519896_sc-195559.jpg,1,0,1,1,3,,train
0519898_sc-195559.jpg,1,0,1,1,3,,val
0519899_sc-195559.jpg,1,0,0,1,2,,val
0519900_as-2595122.jpg,1,1,0,0,2,,test
0519902_sc-136383.jpg,2,0,1,1,4,,train
0519903_sc-136383.jpg,1,0,1,1,3,,train
0519904_sc-136383.jpg,2,0,1,1,4,,train
0519905_as-0057466.jpg,0,0,0,1,1,,train
0519906_as-0057466.jpg,1,0,0,1,2,,train
0519907_as-0057466.jpg,1,0,0,1,2,,train
0519909_sc-107973.jpg,2,1,2,3,8,,train
0519910_as-0080766.jpg,0,0,1,0,1,,val
0519911_as-0080766.jpg,5,2,3,2,12,,val
0519915_as-0070818.jpg,0,1,1,0,2,,test
0519916_as-0070818.jpg,0,1,1,0,2,,train
0519917_sc-1018166.jpg,2,0,0,0,2,,train
0519918_sc-1018166.jpg,1,0,0,0,1,,train
0519919_sc-1018166.jpg,3,0,0,0,3,,train
0519920_sc-1018166.jpg,1,0,0,0,1,,train
0519921_sc-1018166.jpg,1,0,0,0,1,,train
0519922_sc-1018166.jpg,1,1,0,0,2,,train
0519923_sc-1018166.jpg,2,0,0,0,2,,val
0519924_sc-224157.jpg,1,0,1,0,2,,val
0519925_sc-224157.jpg,1,1,1,0,3,,test
0519926_sc-224157.jpg,1,0,1,0,2,,train
0519927_sc-194681.jpg,1,0,0,0,1,,train
0519928_sc-194681.jpg,1,0,0,0,1,,train
0519929_sc-194681.jpg,2,0,0,0,2,,train
0519930_sc-194681.jpg,2,0,1,0,3,,train
0519931_sc-222575.jpg,4,0,0,1,5,,train
0519932_as-3272214.jpg,1,0,1,1,3,,train
0519933_sc-161667.jpg,2,5,0,2,9,,val
0519936_sc-161565.jpg,3,0,1,1,5,,val
0519937_sc-161565.jpg,1,0,1,1,3,,test
0519939_sc-161565.jpg,1,0,0,0,1,,train
0519940_as-0020816.jpg,2,1,0,0,3,,train
0519941_as-0020816.jpg,3,1,0,0,4,,train
0519942_as-0020816.jpg,3,1,0,0,4,,train
0519943_as-0020816.jpg,0,1,0,0,1,,train
0519944_as-0020816.jpg,1,0,0,0,1,,train
0519946_as-0086013.jpg,1,0,1,0,2,,train
0519948_as-0086013.jpg,1,1,1,1,4,,val
0519949_as-0086013.jpg,0,1,0,0,1,,val
0519952_as-0086013.jpg,1,1,0,0,2,,test
0519956_sc-217605.jpg,0,2,3,2,7,,train
0519957_sc-217605.jpg,0,2,2,2,6,,train
0519958_sc-217605.jpg,0,3,3,1,7,,train
0519959_sc-129501.jpg,1,0,1,0,2,,train
0519960_sc-129501.jpg,2,0,1,1,4,,train
0519961_sc-129501.jpg,0,0,1,0,1,,train
0519962_sc-129501.jpg,7,0,2,2,11,,train
0519963_sc-129501.jpg,7,0,1,1,9,,val
0519965_as-0064930.jpg,1,0,0,0,1,,val
0519966_sc-1021753.jpg,3,1,4,0,8,,test
0519967_sc-1021753.jpg,2,1,4,1,8,,train
0519968_sc-1021753.jpg,3,1,3,0,7,,train
0519969_as-3307161.jpg,1,0,1,0,2,,train
0519970_as-3126646.jpg,1,0,0,0,1,,train
0519972_as-0094689.jpg,2,0,0,0,2,,train
0519973_as-0094689.jpg,3,0,0,0,3,,train
0519974_as-0094689.jpg,3,0,0,0,3,,train
0519975_as-0000083.jpg,3,0,0,0,3,,val
0519978_sc-222266.jpg,2,0,0,1,3,,val
0519979_sc-222266.jpg,2,0,0,1,3,,test
0519980_as-0010155.jpg,2,0,0,0,2,,train
0519981_as-0010155.jpg,2,0,1,0,3,,train
0519982_as-0010155.jpg,2,0,1,0,3,,train
0519983_as-0010155.jpg,2,0,1,0,3,,train
0519984_as-7357529.jpg,1,0,0,0,1,,train
0519986_as-0057965.jpg,1,0,0,0,1,,train
0519987_as-0057965.jpg,2,0,1,2,5,,train
0519988_as-0057965.jpg,2,0,1,1,4,,val
0519989_as-0057965.jpg,2,4,1,1,8,,val
0519990_as-0057965.jpg,2,1,1,1,5,,test
0519991_as-0057965.jpg,2,0,1,1,4,,train
0519992_as-0057965.jpg,0,0,1,2,3,,train
0519993_as-0057965.jpg,1,0,2,1,4,,train
0519994_as-0057965.jpg,1,0,1,2,4,,train
0519995_as-0057965.jpg,1,0,1,1,3,,train
0519996_as-0057965.jpg,1,0,1,2,4,,train
0519997_as-7713014.jpg,1,0,0,0,1,,train
0519998_as-0050069.jpg,1,0,0,0,1,,val
0519999_sc-216280.jpg,2,0,0,0,2,,val
0520000_as-3439064.jpg,4,0,0,0,4,,test
0520001_as-2611672.jpg,3,0,0,2,5,,train
0520002_sc-157025.jpg,1,0,1,1,3,,train
0520004_sc-157025.jpg,1,1,1,0,3,,train
0520005_sc-157025.jpg,1,1,0,0,2,,train
0520006_sc-157025.jpg,1,1,0,0,2,,train
0520008_as-0055395.jpg,1,0,1,0,2,,train
0520009_as-0055395.jpg,2,0,1,0,3,,train
0520010_as-0055395.jpg,1,0,0,1,2,,val
0520011_as-0090698.jpg,1,0,0,0,1,,val
0520012_sc-228191.jpg,3,0,0,0,3,,test
0520014_as-7001166.jpg,2,0,0,0,2,,train
0520015_as-3234503.jpg,1,0,0,0,1,,train
0520016_sc-1004090.jpg,1,0,0,0,1,,train
0520017_sc-1004090.jpg,2,0,0,0,2,,train
0520018_as-3024670.jpg,2,0,2,0,4,,train
0520019_sc-120214.jpg,0,0,0,1,1,,train
0520020_sc-197792.jpg,2,0,0,0,2,,train
0520021_sc-197792.jpg,2,0,0,0,2,,val
0520022_sc-197792.jpg,2,0,0,0,2,,val
0520023_sc-197792.jpg,2,0,0,0,2,,test
0520024_sc-224958.jpg,3,1,0,0,4,,train
0520025_as-0051847.jpg,1,2,1,0,4,,train
0520026_as-0051847.jpg,0,1,1,0,2,,train
0520029_as-0085254.jpg,1,0,0,0,1,,train
0520030_as-0085254.jpg,4,0,0,0,4,,train
0520031_as-0085254.jpg,1,0,0,0,1,,train
0520032_as-0085254.jpg,1,0,0,0,1,,train
0520033_as-0085254.jpg,2,0,0,0,2,,val
0520036_sc-1026019.jpg,2,0,2,0,4,,val
0520037_sc-1026019.jpg,3,0,1,0,4,,test
0520038_as-3443259.jpg,2,0,0,0,2,,train
0520039_sc-138291.jpg,2,0,0,1,3,,train
0520040_sc-138291.jpg,3,0,0,1,4,,train
0520041_sc-138291.jpg,4,0,0,0,4,,train
0520042_sc-138291.jpg,2,0,0,1,3,,train
0520043_sc-138291.jpg,2,0,0,1,3,,train
0520044_sc-138291.jpg,2,0,0,0,2,,train
0520045_sc-138291.jpg,2,0,0,1,3,,val
0520046_sc-138291.jpg,2,0,0,1,3,,val
0520047_as-2513257.jpg,2,0,1,0,3,,test
0520048_sc-1007315.jpg,6,0,0,0,6,,train
0520049_sc-1007315.jpg,4,0,0,0,4,,train
0520050_as-0068440.jpg,1,1,0,0,2,,train
0520051_as-0068440.jpg,1,1,0,0,2,,train
0520052_sc-192047.jpg,1,0,0,0,1,,train
0520053_sc-192047.jpg,1,0,0,0,1,,train
0520054_sc-1025651.jpg,4,0,0,0,4,,train
0520057_as-0020199.jpg,1,0,0,0,1,,val
0520058_as-0020199.jpg,0,0,1,0,1,,val
0520059_as-0020199.jpg,0,0,1,0,1,,test
0520060_as-0020199.jpg,1,0,0,0,1,,train
0520061_as-0020199.jpg,1,0,0,0,1,,train
0520062_as-0083266.jpg,2,1,0,0,3,,train
0520063_as-0083266.jpg,3,0,2,0,5,,train
0520064_as-0083266.jpg,3,0,1,0,4,,train
0520065_as-0083266.jpg,2,1,0,0,3,,train
0520066_as-0029114.jpg,5,0,0,0,5,,train
0520067_as-0029114.jpg,1,0,0,0,1,,val
0520068_sc-225275.jpg,6,0,0,0,6,,val
0520069_sc-225275.jpg,2,0,0,0,2,,test
0520070_sc-225275.jpg,4,0,0,0,4,,train
0520071_sc-225275.jpg,4,0,0,0,4,,train
0520072_as-3057246.jpg,0,0,1,1,2,,train
0520073_sc-158530.jpg,1,0,0,0,1,,train
0520074_sc-158530.jpg,3,0,0,0,3,,train
0520075_sc-158530.jpg,1,0,0,0,1,,train
0520076_sc-158530.jpg,2,0,0,0,2,,train
0520077_sc-158530.jpg,1,0,0,0,1,,val
0520082_as-0051564.jpg,1,0,1,0,2,,val
0520083_as-0051564.jpg,2,0,1,0,3,,test
0520084_as-3454996.jpg,0,0,1,1,2,,train
0520085_as-0018623.jpg,1,0,0,1,2,,train
0520086_as-0018623.jpg,2,0,0,0,2,,train
0520087_as-0018623.jpg,1,0,1,2,4,,train
0520089_as-0018623.jpg,3,0,0,0,3,,train
0520090_as-0018623.jpg,1,0,1,1,3,,train
0520091_as-3314347.jpg,0,0,1,0,1,,train
0520092_sc-226366.jpg,3,0,1,1,5,,val
0520093_sc-226366.jpg,0,3,0,1,4,,val
0520095_as-0007153.jpg,1,0,1,1,3,,test
0520096_as-0007153.jpg,5,0,0,1,6,,train
0520097_as-0007153.jpg,1,0,1,1,3,,train
0520098_as-0007153.jpg,1,0,0,1,2,,train
0520101_as-0029921.jpg,2,0,5,0,7,,train
0520102_as-0029921.jpg,3,0,3,0,6,,train
0520103_as-0029921.jpg,0,0,1,0,1,,train
0520104_as-0029921.jpg,1,0,1,0,2,,train
0520105_as-0050226.jpg,1,0,0,0,1,,val
0520106_as-0050226.jpg,1,0,0,0,1,,val
0520107_as-0050226.jpg,1,0,0,0,1,,test
0520108_as-0050226.jpg,1,0,0,0,1,,train
0520109_as-2776618.jpg,2,1,0,0,3,,train
0520110_as-2675804.jpg,1,1,1,0,3,,train
0520111_sc-1036614.jpg,1,0,1,1,3,,train
0520112_sc-1036614.jpg,1,0,1,0,2,,train
0520113_sc-1036614.jpg,2,0,1,1,4,,train
0520114_sc-1036614.jpg,2,0,1,1,4,,train
0520115_sc-124165.jpg,2,0,0,0,2,,val
0520116_sc-169174.jpg,1,0,0,0,1,,val
0520117_as-3028875.jpg,1,1,0,0,2,,test
0520118_as-3028875.jpg,0,0,1,1,2,,train
0520122_sc-121125.jpg,1,0,1,0,2,,train
0520123_sc-121125.jpg,1,0,0,0,1,,train
0520126_as-0017768.jpg,1,0,0,0,1,,train
0520127_as-0017768.jpg,1,0,0,1,2,,train
0520128_as-0017768.jpg,1,0,0,1,2,,train
0520129_as-0017768.jpg,1,0,0,0,1,,train
0520132_as-0006738.jpg,1,0,0,1,2,,val
0520133_as-0006738.jpg,2,0,0,0,2,,val
0520135_sc-163058.jpg,1,0,0,0,1,,test
0520137_sc-217600.jpg,1,0,1,1,3,,train
0520138_sc-217600.jpg,1,0,1,1,3,,train
0520140_sc-161010.jpg,0,2,1,0,3,,train
0520141_sc-161010.jpg,3,2,1,0,6,,train
0520142_sc-161010.jpg,1,1,1,0,3,,train
0520143_sc-161010.jpg,0,2,1,0,3,,train
0520145_as-9031690.jpg,2,0,1,0,3,,train
0520146_as-3400401.jpg,2,0,0,0,2,,val
0520147_sc-150528.jpg,2,1,0,0,3,,val
0520148_sc-150528.jpg,1,1,0,0,2,,test
0520149_as-3406184.jpg,1,0,1,1,3,,train
0520151_as-0082036.jpg,4,0,0,0,4,,train
0520152_as-0082036.jpg,2,0,0,0,2,,train
0520153_as-0082036.jpg,1,0,0,0,1,,train
0520155_as-0082036.jpg,3,0,0,0,3,,train
0520156_as-0082036.jpg,1,0,0,0,1,,train
0520157_as-2549653.jpg,2,0,0,0,2,,train
0520158_sc-155991.jpg,3,0,0,0,3,,val
0520160_sc-155991.jpg,9,2,0,1,12,,val
0520161_sc-155991.jpg,9,1,0,1,11,,test
0520162_sc-155991.jpg,12,1,0,0,13,,train
0520163_sc-155991.jpg,1,1,0,0,2,,train
0520166_sc-1030110.jpg,3,1,1,0,5,,train
0520168_sc-1030110.jpg,2,0,0,0,2,,train
0520169_sc-1030110.jpg,2,2,0,0,4,,train
0520170_sc-1030110.jpg,2,1,0,0,3,,train
0520173_as-9013099.jpg,3,1,0,0,4,,train
0520175_sc-198850.jpg,0,0,1,1,2,,val
0520179_sc-198850.jpg,0,0,1,1,2,,val
0520181_as-2829524.jpg,1,0,2,0,3,,test
0520186_as-0084489.jpg,3,1,1,0,5,,train
0520187_as-0084489.jpg,1,0,1,0,2,,train
0520188_as-0084489.jpg,2,0,1,0,3,,train
0520189_as-0084489.jpg,3,1,1,0,5,,train
0520190_as-0084489.jpg,1,0,1,0,2,,train
0520191_as-0084489.jpg,5,0,0,0,5,,train
0520192_as-3415928.jpg,3,1,0,0,4,,train
0520193_sc-157077.jpg,5,2,2,2,11,,val
0520195_sc-157077.jpg,2,2,1,2,7,,val
0520196_sc-157077.jpg,1,2,2,2,7,,test
0520197_sc-157077.jpg,1,1,1,2,5,,train
0520198_sc-157077.jpg,2,0,0,0,2,,train
0520199_sc-157077.jpg,2,0,0,1,3,,train
0520200_sc-157077.jpg,0,0,0,3,3,,train
0520203_as-0018854.jpg,1,1,3,1,6,,train
0520204_as-0018854.jpg,1,1,3,0,5,,train
0520205_as-0018854.jpg,2,0,1,0,3,,train
0520206_as-9033159.jpg,2,0,0,0,2,,val
0520207_sc-1015394.jpg,2,0,0,0,2,,val
0520208_sc-1015394.jpg,2,0,0,0,2,,test
0520209_sc-1015394.jpg,2,0,0,0,2,,train
0520212_as-3283516.jpg,1,0,0,0,1,,train
0520213_sc-1029925.jpg,1,0,0,0,1,,train
0520214_sc-1029925.jpg,1,0,0,0,1,,train
0520215_as-0098752.jpg,1,0,2,0,3,,train
0520216_as-0098752.jpg,0,1,0,1,2,,train
0520217_as-0098752.jpg,1,1,0,0,2,,train
0520218_sc-1022711.jpg,1,0,0,0,1,,val
0520219_sc-1022711.jpg,2,0,0,0,2,,val
0520220_sc-148634.jpg,1,0,1,1,3,,test
0520221_sc-148634.jpg,2,0,1,1,4,,train
0520222_sc-148634.jpg,2,0,1,1,4,,train
0520223_sc-148634.jpg,1,0,0,0,1,,train
0520224_as-0048494.jpg,2,0,0,0,2,,train
0520225_as-0048494.jpg,1,0,0,1,2,,train
0520226_as-0048494.jpg,1,0,0,0,1,,train
0520228_sc-204517.jpg,2,0,0,0,2,,train
0520229_sc-204517.jpg,6,0,1,0,7,,val
0520230_sc-204517.jpg,3,0,1,0,4,,val
0520231_sc-204517.jpg,3,0,1,0,4,,test
0520232_sc-204517.jpg,0,1,0,1,2,,train
0520233_sc-204517.jpg,0,0,0,1,1,,train
0520234_sc-204517.jpg,2,0,3,1,6,,train
0520235_sc-204517.jpg,0,0,1,0,1,,train
0520236_sc-204517.jpg,1,0,1,0,2,,train
0520237_sc-217621.jpg,1,0,0,0,1,,train
0520238_sc-217621.jpg,3,0,0,0,3,,train
0520239_sc-217621.jpg,1,0,0,0,1,,val
0520240_sc-217621.jpg,2,0,0,0,2,,val
0520241_as-0053376.jpg,3,0,1,1,5,,test
0520242_as-0053376.jpg,2,0,1,1,4,,train
0520245_as-0053376.jpg,3,0,1,1,5,,train
0520246_as-0053376.jpg,1,0,1,1,3,,train
0520247_as-0053376.jpg,2,0,0,1,3,,train
0520248_as-2961707.jpg,1,0,0,1,2,,train
0520250_as-0050757.jpg,1,1,0,0,2,,train
0520251_as-0082237.jpg,2,0,1,1,4,,train
0520252_as-0082237.jpg,1,1,1,1,4,,val
0520253_as-2551608.jpg,2,0,0,1,3,,val
0520254_as-0042504.jpg,4,0,2,2,8,,test
0520255_sc-106237.jpg,9,0,0,1,10,,train
0520257_sc-106237.jpg,6,0,0,1,7,,train
0520258_sc-106237.jpg,8,0,0,0,8,,train
0520259_sc-106237.jpg,6,0,0,0,6,,train
0520260_as-7177733.jpg,4,0,1,0,5,,train
0520261_sc-1009994.jpg,1,0,0,0,1,,train
0520262_sc-1009994.jpg,0,0,1,0,1,,train
0520264_sc-1009994.jpg,1,1,1,0,3,,val
0520266_as-0060237.jpg,7,0,1,0,8,,val
0520267_as-0060237.jpg,2,0,0,0,2,,test
0520268_as-0046696.jpg,2,0,1,1,4,,train
0520270_as-2935898.jpg,1,0,0,0,1,,train
0520271_sc-1021184.jpg,2,2,2,0,6,,train
0520272_sc-1021184.jpg,2,0,1,0,3,,train
0520273_sc-1021184.jpg,2,1,2,0,5,,train
0520274_sc-1021184.jpg,4,2,4,0,10,,train
0520275_as-0082208.jpg,1,0,0,0,1,,train
0520276_as-0082208.jpg,1,0,0,0,1,,val
0520278_as-0082208.jpg,1,0,1,0,2,,val
0520279_as-0082208.jpg,1,0,1,0,2,,test
0520280_as-0082208.jpg,1,0,0,0,1,,train
0520281_sc-219066.jpg,4,0,0,0,4,,train
0520286_as-0037299.jpg,5,0,0,0,5,,train
0520287_as-0037299.jpg,3,0,1,0,4,,train
0520289_as-0069155.jpg,2,0,1,0,3,,train
0520290_as-9033850.jpg,1,0,0,0,1,,train
0520292_sc-121444.jpg,6,0,0,0,6,,train
0520295_as-0019119.jpg,1,0,0,0,1,,val
0520296_as-0019119.jpg,1,0,0,0,1,,val
0520297_as-0019119.jpg,2,0,0,1,3,,test
0520298_as-0019119.jpg,1,0,0,1,2,,train
0520299_as-0019119.jpg,1,0,0,1,2,,train
0520300_sc-148625.jpg,9,0,2,0,11,,train
0520301_sc-148625.jpg,0,0,0,1,1,,train
0520303_sc-148625.jpg,8,0,0,0,8,,train
0520304_sc-148625.jpg,12,0,1,0,13,,train
0520305_sc-148625.jpg,6,0,2,0,8,,train
0520306_sc-148625.jpg,1,0,1,0,2,,val
0520307_sc-148625.jpg,1,0,0,1,2,,val
0520308_sc-148625.jpg,13,0,0,1,14,,test
0520309_sc-148625.jpg,4,0,0,1,5,,train
0520310_sc-148625.jpg,2,0,0,1,3,,train
0520311_sc-148625.jpg,1,0,1,0,2,,train
0520312_sc-148625.jpg,14,0,2,0,16,,train
0520313_sc-217892.jpg,0,0,3,0,3,,train
0520314_sc-217892.jpg,0,0,2,0,2,,train
0520315_sc-217892.jpg,0,0,1,0,1,,train
0520317_sc-223663.jpg,1,0,1,0,2,,val
0520318_sc-223663.jpg,1,0,1,0,2,,val
0520319_sc-223663.jpg,0,0,1,0,1,,test
0520320_sc-223663.jpg,0,1,1,0,2,,train
0520321_sc-223663.jpg,1,0,0,0,1,,train
0520322_sc-223663.jpg,4,0,0,0,4,,train
0520323_as-7776986.jpg,1,0,0,1,2,,train
0520324_as-0020976.jpg,2,0,0,0,2,,train
0520325_as-0020976.jpg,0,0,1,0,1,,train
0520326_as-0020976.jpg,0,0,1,0,1,,train
0520327_as-0020976.jpg,4,0,0,0,4,,val
0520328_sc-1026876.jpg,5,0,0,0,5,,val
0520329_sc-1026876.jpg,1,1,0,0,2,,test
0520330_sc-1026876.jpg,0,0,1,0,1,,train
0520332_as-0006874.jpg,1,0,0,0,1,,train
0520333_as-0006874.jpg,1,0,0,0,1,,train
0520334_as-0006874.jpg,2,0,0,0,2,,train
0520335_as-0006874.jpg,2,0,0,0,2,,train
0520336_as-0006874.jpg,2,0,0,0,2,,train
0520337_as-0006874.jpg,2,0,0,0,2,,train
0520338_as-0006874.jpg,3,0,0,0,3,,val
0520339_as-2682346.jpg,1,0,2,0,3,,val
0520340_as-7285068.jpg,0,1,1,1,3,,test
0520341_sc-158422.jpg,4,0,0,0,4,,train
0520343_as-7289840.jpg,0,0,1,0,1,,train
0520345_sc-193389.jpg,11,2,1,0,14,,train
0520346_sc-193389.jpg,5,1,0,0,6,,train
0520347_sc-193389.jpg,12,2,0,0,14,,train
0520348_sc-193389.jpg,1,0,0,0,1,,train
0520349_sc-193389.jpg,3,0,0,0,3,,train
0520350_sc-193389.jpg,1,0,0,0,1,,val
0520351_sc-193389.jpg,1,0,1,0,2,,val
0520352_as-9013306.jpg,0,0,0,1,1,,test
0520354_sc-206657.jpg,1,0,0,1,2,,train
0520355_sc-206657.jpg,2,0,0,1,3,,train
0520356_sc-206657.jpg,4,0,0,1,5,,train
0520357_sc-206657.jpg,1,0,1,1,3,,train
0520358_as-3162025.jpg,1,0,0,0,1,,train
0520360_sc-222056.jpg,1,1,2,0,4,,train
0520361_sc-222056.jpg,2,0,1,0,3,,train
0520362_sc-222056.jpg,2,0,1,0,3,,val
0520364_as-3059374.jpg,2,0,2,3,7,,val
0520365_sc-1034458.jpg,1,0,0,2,3,,test
0520366_as-3299654.jpg,4,0,1,1,6,,train
0520367_as-0082778.jpg,1,0,0,0,1,,train
0520368_as-0082778.jpg,4,0,0,0,4,,train
0520371_sc-1039840.jpg,3,0,0,0,3,,train
0520372_sc-1039840.jpg,3,0,0,0,3,,train
0520377_sc-134667.jpg,0,1,0,0,1,,train
0520378_sc-134667.jpg,1,2,1,0,4,,train
0520379_sc-134667.jpg,0,1,1,0,2,,val
0520380_as-0003608.jpg,2,0,0,1,3,,val
0520381_sc-214357.jpg,4,0,0,0,4,,test
0520382_sc-202236.jpg,1,0,1,0,2,,train
0520383_sc-202236.jpg,2,0,1,1,4,,train
0520384_sc-202236.jpg,1,0,0,0,1,,train
0520385_sc-202236.jpg,1,0,0,0,1,,train
0520386_sc-202236.jpg,2,0,1,0,3,,train
0520387_sc-202236.jpg,2,0,1,0,3,,train
0520388_sc-202236.jpg,1,0,0,1,2,,train
0520389_sc-202236.jpg,1,0,1,1,3,,val
0520391_as-3158466.jpg,1,0,0,0,1,,val
0520392_sc-225141.jpg,4,0,0,1,5,,test
0520393_sc-225141.jpg,4,1,0,2,7,,train
0520394_sc-225141.jpg,1,0,0,0,1,,train
0520395_sc-225141.jpg,3,0,0,0,3,,train
0520396_sc-225141.jpg,3,0,0,0,3,,train
0520397_sc-179344.jpg,1,2,1,0,4,,train
0520398_sc-179344.jpg,5,2,1,0,8,,train
0520399_sc-179344.jpg,2,0,0,0,2,,train
0520400_sc-179344.jpg,2,0,1,0,3,,val
0520402_as-0029944.jpg,3,0,0,0,3,,val
0520405_as-0058782.jpg,1,0,0,0,1,,test
0520406_as-0058782.jpg,0,0,1,0,1,,train
0520407_as-0058782.jpg,1,1,0,0,2,,train
0520408_as-0058782.jpg,0,0,1,0,1,,train
0520409_sc-184602.jpg,0,0,1,1,2,,train
0520410_as-0065257.jpg,1,0,0,0,1,,train
0520411_sc-1027783.jpg,3,0,1,0,4,,train
0520412_sc-1027783.jpg,1,0,0,1,2,,train
0520413_sc-1027783.jpg,5,0,1,0,6,,val
0520414_sc-194620.jpg,2,0,0,0,2,,val
0520416_sc-194620.jpg,2,0,0,0,2,,test
0520418_as-0032751.jpg,4,1,2,0,7,,train
0520420_as-0032751.jpg,2,0,0,0,2,,train
0520422_as-0032751.jpg,2,0,2,1,5,,train
0520423_as-0032751.jpg,4,1,1,2,8,,train
0520424_as-0032751.jpg,2,1,1,2,6,,train
0520427_sc-103836.jpg,2,0,1,0,3,,train
0520428_sc-103836.jpg,0,1,1,0,2,,train
0520429_sc-103836.jpg,0,1,1,0,2,,val
0520430_sc-103836.jpg,0,0,1,0,1,,val
0520432_sc-156547.jpg,2,0,0,2,4,,test
0520433_sc-156547.jpg,4,0,0,2,6,,train
0520435_as-0036995.jpg,3,2,0,0,5,,train
0520436_as-7096601.jpg,2,0,0,2,4,,train
0520438_as-0099739.jpg,4,0,2,2,8,,train
0520439_as-0099739.jpg,1,0,3,1,5,,train
0520441_as-0099739.jpg,4,0,0,0,4,,train
0520443_as-0086551.jpg,2,0,2,1,5,,train
0520444_as-0086551.jpg,1,0,1,1,3,,val
0520445_as-0086551.jpg,0,1,0,0,1,,val
0520449_as-0086551.jpg,5,0,0,0,5,,test
0520450_sc-191848.jpg,0,1,1,0,2,,train
0520451_sc-191848.jpg,0,0,0,1,1,,train
0520453_sc-191848.jpg,1,0,0,0,1,,train
0520454_sc-191848.jpg,3,0,0,0,3,,train
0520455_as-9048053.jpg,1,0,0,0,1,,train
0520457_as-0047612.jpg,2,1,0,0,3,,train
0520458_as-0047612.jpg,0,1,0,0,1,,train
0520459_as-0047612.jpg,1,2,1,1,5,,val
0520460_as-0047612.jpg,3,1,0,0,4,,val
0520461_as-0047612.jpg,3,1,0,0,4,,test
0520462_as-2512008.jpg,5,0,0,0,5,,train
0520463_sc-145496.jpg,1,0,0,0,1,,train
0520464_sc-145496.jpg,1,0,1,0,2,,train
0520465_sc-145496.jpg,4,0,0,0,4,,train
0520466_sc-145496.jpg,2,0,0,0,2,,train
0520467_sc-145496.jpg,2,0,0,0,2,,train
0520468_sc-1038954.jpg,1,0,0,1,2,,train
0520470_sc-129662.jpg,2,0,1,0,3,,val
0520471_sc-129662.jpg,2,0,1,0,3,,val
0520472_sc-129662.jpg,3,0,1,0,4,,test
0520477_as-0038867.jpg,0,2,1,0,3,,train
0520478_as-0038867.jpg,0,2,2,0,4,,train
0520479_as-0038867.jpg,1,0,0,1,2,,train
0520480_as-0038867.jpg,1,1,2,1,5,,train
0520481_as-0038867.jpg,1,1,0,0,2,,train
0520482_as-0038867.jpg,1,1,0,0,2,,train
0520483_sc-205816.jpg,1,0,1,0,2,,train
0520484_as-2963405.jpg,0,1,1,0,2,,val
0520485_as-0031570.jpg,0,1,1,0,2,,val
0520486_as-0031570.jpg,1,1,0,1,3,,test
0520487_as-0031570.jpg,2,0,0,0,2,,train
0520489_as-0031570.jpg,1,0,1,0,2,,train
0520490_sc-159320.jpg,1,1,1,0,3,,train
0520491_sc-159320.jpg,8,2,0,0,10,,train
0520492_sc-162068.jpg,1,0,0,0,1,,train
0520493_sc-162068.jpg,1,0,0,0,1,,train
0520499_as-0069589.jpg,1,0,0,0,1,,train
0520500_as-0069589.jpg,2,0,0,0,2,,val
0520501_as-7984421.jpg,1,0,0,1,2,,val
0520504_as-0012158.jpg,1,0,0,0,1,,test
0520505_as-0012158.jpg,2,0,0,0,2,,train
0520506_as-0012158.jpg,2,0,0,0,2,,train
0520507_as-0012158.jpg,1,0,0,0,1,,train
0520508_as-0012158.jpg,1,0,0,0,1,,train
0520509_as-0012158.jpg,1,0,0,0,1,,train
0520510_as-0012158.jpg,1,0,0,1,2,,train
0520513_sc-183763.jpg,10,0,1,0,11,,train
0520514_sc-183763.jpg,8,0,0,0,8,,val
0520515_as-3310489.jpg,2,0,0,0,2,,val
0520516_sc-229751.jpg,1,0,1,0,2,,test
0520517_sc-229751.jpg,1,0,1,0,2,,train
0520518_sc-229751.jpg,1,0,1,0,2,,train
0520519_sc-229751.jpg,2,0,0,0,2,,train
0520520_sc-1003677.jpg,7,0,1,1,9,,train
0520521_sc-1003677.jpg,11,4,2,5,22,,train
0520522_sc-1003677.jpg,10,2,1,2,15,,train
0520523_sc-1003677.jpg,16,3,1,0,20,,train
0520524_sc-1003677.jpg,8,4,1,3,16,,val
0520527_sc-196826.jpg,3,0,1,0,4,,val
0520528_sc-196826.jpg,1,0,0,0,1,,test
0520529_sc-196826.jpg,1,1,0,0,2,,train
0520530_sc-196826.jpg,1,0,1,0,2,,train
0520531_sc-196826.jpg,1,0,1,0,2,,train
0520532_as-3217664.jpg,3,0,0,0,3,,train
0520533_sc-223260.jpg,2,0,3,0,5,,train
0520534_as-0081380.jpg,4,0,0,0,4,,train
0520535_as-0080091.jpg,1,0,0,0,1,,train
0520536_as-0080091.jpg,1,0,0,0,1,,val
0520537_as-0080091.jpg,2,0,1,0,3,,val
0520538_as-0080091.jpg,2,0,0,0,2,,test
0520539_as-0080091.jpg,1,0,0,0,1,,train
0520544_as-0015219.jpg,2,0,0,0,2,,train
0520545_as-0015219.jpg,2,0,0,0,2,,train
0520546_as-0015219.jpg,2,0,0,0,2,,train
0520547_as-0015219.jpg,1,0,0,0,1,,train
0520548_as-0015219.jpg,6,0,0,0,6,,train
0520549_as-0015219.jpg,4,0,0,0,4,,train
0520550_as-0034922.jpg,1,0,1,0,2,,val
0520551_sc-216818.jpg,3,0,1,0,4,,val
0520552_sc-216818.jpg,2,0,1,0,3,,test
0520553_sc-216818.jpg,2,0,0,1,3,,train
0520554_sc-216818.jpg,4,0,0,1,5,,train
0520555_sc-216818.jpg,3,0,1,1,5,,train
0520556_sc-216818.jpg,3,0,1,1,5,,train
0520557_sc-216818.jpg,2,0,1,0,3,,train
0520558_sc-216818.jpg,1,0,1,1,3,,train
0520559_sc-216818.jpg,1,0,1,1,3,,train
0520560_as-0048772.jpg,0,1,0,0,1,,val
0520561_as-0048772.jpg,0,1,0,0,1,,val
0520562_as-0048772.jpg,0,1,0,0,1,,test
0520563_as-0048772.jpg,1,1,0,0,2,,train
0520564_as-0048772.jpg,1,1,0,0,2,,train
0520566_as-0093762.jpg,2,0,0,0,2,,train
0520567_sc-160765.jpg,7,0,0,1,8,,train
0520568_sc-160765.jpg,4,0,0,2,6,,train
0520569_sc-160765.jpg,3,0,0,1,4,,train
0520571_sc-216428.jpg,3,0,0,0,3,,train
0520572_sc-216428.jpg,5,0,0,1,6,,val
0520573_sc-216428.jpg,4,0,0,1,5,,val
0520574_sc-216428.jpg,4,0,0,1,5,,test
0520575_sc-216428.jpg,1,0,0,0,1,,train
0520576_sc-216428.jpg,0,0,0,1,1,,train
0520577_sc-216428.jpg,3,0,0,0,3,,train
0520578_sc-216428.jpg,2,0,0,0,2,,train
0520579_sc-216428.jpg,1,0,0,0,1,,train
0520580_sc-216428.jpg,0,0,0,1,1,,train
0520581_as-2733921.jpg,3,0,0,0,3,,train
0520582_sc-1021330.jpg,0,0,1,0,1,,val
0520583_sc-1021330.jpg,1,2,1,0,4,,val
0520584_sc-1021330.jpg,0,0,1,0,1,,test
0520585_sc-1021330.jpg,2,2,1,1,6,,train
0520586_sc-1021330.jpg,0,0,1,0,1,,train
0520587_sc-203217.jpg,1,0,0,0,1,,train
0520588_as-3287207.jpg,1,0,1,0,2,,train
0520590_sc-106040.jpg,1,0,0,0,1,,train
0520591_sc-106040.jpg,3,0,1,1,5,,train
0520592_sc-106040.jpg,1,0,1,1,3,,train
0520593_sc-106040.jpg,2,0,1,1,4,,val
0520594_sc-106040.jpg,3,0,0,1,4,,val
0520595_sc-106040.jpg,1,0,1,1,3,,test
0520596_sc-106040.jpg,1,0,0,1,2,,train
0520597_sc-106040.jpg,1,0,1,1,3,,train
0520598_sc-106040.jpg,3,0,2,1,6,,train
0520599_sc-106040.jpg,1,0,0,0,1,,train
0520600_sc-106040.jpg,1,0,0,0,1,,train
0520602_sc-204477.jpg,3,0,0,0,3,,train
0520603_sc-204477.jpg,2,0,0,0,2,,train
0520604_sc-204477.jpg,2,0,0,0,2,,val
0520606_as-0026875.jpg,2,0,0,0,2,,val
0520607_as-0026875.jpg,3,0,0,0,3,,test
0520608_as-0026875.jpg,2,0,0,0,2,,train
0520609_as-0026875.jpg,3,0,0,0,3,,train
0520610_as-0026875.jpg,2,0,0,0,2,,train
0520611_sc-208628.jpg,2,0,1,0,3,,train
0520612_sc-208628.jpg,4,0,1,0,5,,train
0520613_sc-208628.jpg,3,0,1,0,4,,train
0520614_sc-208628.jpg,3,0,0,0,3,,train
0520615_as-9024409.jpg,4,0,0,0,4,,val
0520616_as-3437720.jpg,2,0,0,0,2,,val
0520617_as-0002233.jpg,0,1,0,1,2,,test
0520618_as-0002233.jpg,0,0,2,0,2,,train
0520619_sc-124896.jpg,3,1,1,0,5,,train
0520620_as-2851617.jpg,1,0,0,0,1,,train
0520621_as-7534805.jpg,2,1,1,0,4,,train
0520622_sc-112641.jpg,4,0,1,0,5,,train
0520625_sc-112641.jpg,4,0,1,2,7,,train
0520626_sc-112641.jpg,5,0,1,0,6,,train
0520627_sc-112641.jpg,4,0,0,1,5,,val
0520629_sc-112641.jpg,3,0,0,0,3,,val
0520631_sc-213977.jpg,4,0,0,0,4,,test
0520632_sc-213977.jpg,1,0,0,0,1,,train
0520636_sc-226918.jpg,3,0,0,0,3,,train
0520637_as-2564917.jpg,0,0,1,0,1,,train
0520638_as-2564917.jpg,1,0,0,0,1,,train
0520639_as-0052761.jpg,1,1,0,0,2,,train
0520640_as-0052761.jpg,1,0,0,0,1,,train
0520641_as-0052761.jpg,3,0,0,0,3,,train
0520643_as-0073651.jpg,1,0,0,0,1,,val
0520644_as-0073651.jpg,1,0,0,0,1,,val
0520645_as-0073651.jpg,1,0,0,0,1,,test
0520647_as-0073651.jpg,1,0,0,0,1,,train
0520648_as-0073651.jpg,1,0,0,0,1,,train
0520649_as-0025571.jpg,1,0,0,0,1,,train
0520650_as-3467320.jpg,1,0,0,0,1,,train
0520651_as-0036991.jpg,0,1,0,0,1,,train
0520652_as-0036991.jpg,1,0,0,0,1,,train
0520653_sc-221053.jpg,1,0,2,0,3,,train
0520655_as-0045236.jpg,7,0,0,0,7,,val
0520656_as-0045236.jpg,3,0,0,0,3,,val
0520657_as-0045236.jpg,6,0,1,0,7,,test
0520658_as-0045236.jpg,8,0,1,0,9,,train
0520659_as-9026427.jpg,1,0,0,0,1,,train
0520662_as-0071029.jpg,2,0,0,0,2,,train
0520663_as-0071029.jpg,4,0,0,2,6,,train
0520664_as-0071029.jpg,2,0,0,0,2,,train
0520665_as-0071029.jpg,2,0,0,0,2,,train
0520666_as-0071029.jpg,2,0,0,2,4,,train
0520668_sc-174419.jpg,1,0,1,1,3,,val
0520669_sc-174419.jpg,1,0,0,1,2,,val
0520670_sc-174419.jpg,1,0,1,1,3,,test
0520671_sc-174419.jpg,1,0,0,0,1,,train
0520672_sc-145111.jpg,3,0,0,0,3,,train
0520674_sc-145111.jpg,1,0,1,0,2,,train
0520675_as-7055513.jpg,4,0,0,0,4,,train
0520676_sc-200343.jpg,1,0,0,0,1,,train
0520677_sc-200343.jpg,2,0,0,0,2,,train
0520678_sc-200343.jpg,3,0,0,1,4,,train
0520679_sc-200343.jpg,5,0,0,1,6,,val
0520680_as-0088677.jpg,5,0,0,0,5,,val
0520681_as-0088677.jpg,3,0,0,0,3,,test
0520682_sc-1006109.jpg,3,0,0,0,3,,train
0520684_as-3107267.jpg,1,0,0,0,1,,train
0520686_as-0032894.jpg,8,0,1,0,9,,train
0520687_as-0032894.jpg,1,0,1,0,2,,train
0520688_sc-114583.jpg,3,2,0,0,5,,train
0520689_as-3380073.jpg,1,0,0,0,1,,train
0520690_sc-165126.jpg,3,0,0,0,3,,train
0520691_sc-165126.jpg,6,0,0,0,6,,val
0520692_sc-1013021.jpg,1,0,0,0,1,,val
0520693_sc-1013021.jpg,1,0,0,1,2,,test
0520694_sc-1013021.jpg,3,0,1,0,4,,train
0520695_sc-1013021.jpg,3,0,0,0,3,,train
0520696_sc-1013021.jpg,3,0,1,0,4,,train
0520697_sc-1013021.jpg,3,0,0,0,3,,train
0520698_sc-1013021.jpg,3,0,0,0,3,,train
0520699_sc-1013021.jpg,5,0,1,0,6,,train
0520700_sc-1013021.jpg,1,0,0,1,2,,train
0520701_sc-1013021.jpg,1,0,0,1,2,,val
0520702_sc-170771.jpg,2,0,0,0,2,,val
0520703_sc-170771.jpg,1,0,0,0,1,,test
0520704_as-2636774.jpg,2,1,0,0,3,,train
0520706_sc-1002921.jpg,1,0,0,0,1,,train
0520707_sc-1002921.jpg,1,0,0,0,1,,train
0520708_sc-1003904.jpg,1,0,1,1,3,,train
0520709_as-7101599.jpg,1,0,0,0,1,,train
0520710_sc-220332.jpg,1,0,0,0,1,,train
0520711_sc-220332.jpg,1,0,0,0,1,,train
0520712_sc-220240.jpg,1,0,2,2,5,,val
0520713_sc-126266.jpg,0,0,0,1,1,,val
0520714_sc-126266.jpg,0,1,0,0,1,,test
0520715_as-0041603.jpg,3,0,0,0,3,,train
0520719_as-0041603.jpg,3,0,0,0,3,,train
0520720_as-0041603.jpg,3,0,0,0,3,,train
0520721_sc-215716.jpg,3,0,0,0,3,,train
0520722_sc-215716.jpg,3,0,0,0,3,,train
0520723_sc-215716.jpg,2,0,0,0,2,,train
0520724_sc-215716.jpg,2,0,0,0,2,,train
0520725_sc-1035029.jpg,1,0,0,0,1,,val
0520726_sc-1035029.jpg,1,0,0,0,1,,val
0520727_sc-1035029.jpg,1,0,1,0,2,,test
0520728_sc-169561.jpg,1,0,0,0,1,,train
0520729_sc-169561.jpg,1,0,0,0,1,,train
0520730_as-2958111.jpg,1,1,0,0,2,,train
0520731_as-2562845.jpg,1,0,0,0,1,,train
0520732_as-7232420.jpg,2,2,0,0,4,,train
0520733_sc-201575.jpg,4,1,3,1,9,,train
0520734_sc-201575.jpg,1,1,1,1,4,,train
0520735_as-3269188.jpg,1,0,1,0,2,,val
0520736_sc-109321.jpg,3,1,0,0,4,,val
0520737_sc-201029.jpg,1,0,0,0,1,,test
0520738_sc-201029.jpg,1,0,0,0,1,,train
0520739_sc-201029.jpg,1,0,0,1,2,,train
0520740_sc-201029.jpg,1,0,0,1,2,,train
0520741_sc-201029.jpg,1,0,0,0,1,,train
0520742_as-3023530.jpg,0,1,0,0,1,,train
0520745_as-0017784.jpg,0,1,1,0,2,,train
0520746_as-0017784.jpg,1,0,0,0,1,,train
0520747_as-3478603.jpg,0,1,0,0,1,,val
0520750_as-0019153.jpg,2,0,1,1,4,,val
0520752_as-0019153.jpg,2,0,1,1,4,,test
0520754_sc-164322.jpg,1,0,0,0,1,,train
0520755_sc-181580.jpg,0,1,0,0,1,,train
0520758_as-0049426.jpg,2,0,0,0,2,,train
0520760_as-0049426.jpg,1,0,1,0,2,,train
0520761_as-0049426.jpg,1,0,0,0,1,,train
0520762_as-0049426.jpg,1,0,0,0,1,,train
0520763_as-0049426.jpg,1,0,0,0,1,,train
0520764_as-0049426.jpg,0,0,1,0,1,,val
0520765_as-0049426.jpg,0,0,1,0,1,,val
0520766_as-0049426.jpg,0,0,1,0,1,,test
0520767_as-0049426.jpg,0,0,1,0,1,,train
0520768_as-0049426.jpg,0,0,1,0,1,,train
0520769_as-0049426.jpg,0,0,1,0,1,,train
0520770_as-0049426.jpg,2,0,1,0,3,,train
0520772_as-0069541.jpg,4,0,4,1,9,,train
0520773_as-3143372.jpg,0,1,0,0,1,,train
0520774_sc-118428.jpg,1,1,1,0,3,,train
0520775_sc-118428.jpg,0,1,2,0,3,,val
0520776_sc-159263.jpg,3,0,0,0,3,,val
0520777_sc-1026327.jpg,2,0,0,0,2,,test
0520779_as-0075190.jpg,1,0,0,0,1,,train
0520780_as-0075190.jpg,1,0,0,0,1,,train
0520781_as-0075190.jpg,1,0,0,0,1,,train
0520782_as-0075190.jpg,1,0,0,0,1,,train
0520783_as-0075190.jpg,1,0,0,0,1,,train
0520784_as-3310219.jpg,2,0,0,0,2,,train
0520786_sc-221005.jpg,4,0,1,0,5,,train
0520787_sc-221005.jpg,3,0,1,0,4,,val
0520788_sc-221005.jpg,5,0,1,0,6,,val
0520789_sc-221005.jpg,1,0,0,0,1,,test
0520790_sc-221005.jpg,1,0,0,0,1,,train
0520791_sc-221005.jpg,3,0,2,0,5,,train
0520792_sc-221005.jpg,2,0,1,0,3,,train
0520793_sc-221005.jpg,2,0,1,0,3,,train
0520794_sc-199013.jpg,1,0,0,0,1,,train
0520795_sc-199013.jpg,2,0,0,1,3,,train
0520796_sc-199013.jpg,1,0,1,0,2,,train
0520797_sc-199013.jpg,1,0,1,0,2,,val
0520798_as-0069929.jpg,0,0,2,1,3,,val
0520799_as-0069929.jpg,1,0,1,0,2,,test
0520802_as-0059986.jpg,1,0,1,2,4,,train
0520803_as-0059986.jpg,1,0,1,2,4,,train
0520804_as-0059986.jpg,1,0,1,2,4,,train
0520805_as-2792910.jpg,0,0,1,0,1,,train
0520806_sc-1017168.jpg,4,1,4,2,11,,train
0520807_as-3462699.jpg,2,0,0,1,3,,train
0520809_as-2660932.jpg,3,0,0,0,3,,train
0520811_sc-171121.jpg,0,1,0,0,1,,val
0520812_as-3012881.jpg,9,2,0,8,19,,val
0520813_sc-118687.jpg,3,0,0,0,3,,test
0520814_sc-118687.jpg,1,0,0,0,1,,train
0520815_sc-118687.jpg,4,0,0,0,4,,train
0520816_sc-118687.jpg,2,0,0,0,2,,train
0520817_sc-181153.jpg,4,0,1,2,7,,train
0520818_sc-181153.jpg,2,0,2,1,5,,train
0520819_sc-181153.jpg,3,0,1,1,5,,train
0520820_sc-181153.jpg,6,0,1,1,8,,train
0520821_as-2895986.jpg,1,0,0,1,2,,val
0520822_sc-204611.jpg,2,1,2,0,5,,val
0520823_sc-204611.jpg,2,1,2,0,5,,test
0520824_sc-204611.jpg,0,1,1,0,2,,train
0520825_sc-204611.jpg,3,2,3,0,8,,train
0520826_sc-204611.jpg,0,0,2,0,2,,train
0520827_sc-1031978.jpg,1,0,1,1,3,,train
0520828_sc-1031978.jpg,1,0,2,1,4,,train
0520829_sc-1031978.jpg,2,0,0,0,2,,train
0520831_sc-172985.jpg,1,0,0,0,1,,train
0520832_sc-172985.jpg,1,0,0,0,1,,val
0520835_as-0002760.jpg,2,0,0,0,2,,val
0520836_as-0002760.jpg,2,0,0,0,2,,test
0520838_as-0071351.jpg,1,0,1,1,3,,train
0520839_as-0071351.jpg,2,0,1,1,4,,train
0520840_as-0071351.jpg,6,0,3,2,11,,train
0520841_as-0071351.jpg,3,0,1,0,4,,train
0520842_as-0071351.jpg,2,0,2,1,5,,train
0520843_as-0071351.jpg,0,1,0,0,1,,train
0520844_sc-1007412.jpg,2,1,0,0,3,,train
0520845_sc-1007412.jpg,1,0,0,1,2,,val
0520846_sc-1007412.jpg,1,0,0,1,2,,val
0520847_sc-1007412.jpg,1,0,0,1,2,,test
0520848_sc-1037977.jpg,1,0,0,1,2,,train
0520849_sc-1037977.jpg,1,0,0,1,2,,train
0520850_sc-154465.jpg,3,0,0,0,3,,train
0520852_sc-1024489.jpg,2,0,1,2,5,,train
0520853_sc-1024489.jpg,2,0,1,1,4,,train
0520854_sc-1024489.jpg,2,0,0,0,2,,train
0520855_sc-1024489.jpg,1,0,1,0,2,,train
0520856_as-0050064.jpg,1,2,3,1,7,,val
0520857_as-0050064.jpg,2,2,3,1,8,,val
0520858_as-0050064.jpg,3,2,3,2,10,,test
0520859_sc-110778.jpg,1,0,0,0,1,,train
0520860_sc-219716.jpg,2,1,0,0,3,,train
0520861_sc-201418.jpg,1,0,0,0,1,,train
0520862_sc-201418.jpg,1,0,0,0,1,,train
0520863_as-2791712.jpg,1,0,0,0,1,,train
0520864_sc-147714.jpg,1,0,0,0,1,,train
0520865_sc-147714.jpg,2,0,0,0,2,,train
0520866_sc-222226.jpg,1,0,0,1,2,,val
0520867_sc-222226.jpg,2,0,0,1,3,,val
0520868_sc-222226.jpg,1,0,0,0,1,,test
0520869_as-3499297.jpg,3,0,0,0,3,,train
0520871_sc-1041099.jpg,4,0,0,2,6,,train
0520872_sc-1041099.jpg,2,0,0,1,3,,train
0520873_sc-1041099.jpg,4,0,0,0,4,,train
0520874_sc-1041099.jpg,2,0,0,0,2,,train
0520875_sc-1041099.jpg,3,0,0,0,3,,train
0520878_sc-1041099.jpg,8,0,0,1,9,,train
0520879_as-7344244.jpg,2,1,0,1,4,,val
0520882_as-0027919.jpg,2,1,1,1,5,,val
0520883_as-0027919.jpg,1,0,1,0,2,,test
0520884_as-0027919.jpg,2,1,1,1,5,,train
0520885_as-0027919.jpg,2,1,0,1,4,,train
0520887_as-0045732.jpg,1,0,0,0,1,,train
0520890_as-0055223.jpg,12,0,0,0,12,,train
0520891_as-0055223.jpg,14,0,0,0,14,,train
0520892_sc-1038738.jpg,1,0,0,0,1,,train
0520893_as-3324709.jpg,5,3,2,2,12,,train
0520895_as-0073681.jpg,1,0,0,0,1,,val
0520896_sc-226639.jpg,1,1,0,0,2,,val
0520897_sc-226639.jpg,3,1,0,0,4,,test
0520898_as-2643279.jpg,1,0,0,0,1,,train
0520899_as-2780975.jpg,4,0,0,0,4,,train
0520900_as-2590416.jpg,2,0,0,0,2,,train
0520901_as-0078488.jpg,2,0,0,0,2,,train
0520902_as-0078488.jpg,2,1,1,2,6,,train
0520903_as-0078488.jpg,0,1,0,0,1,,train
0520904_as-0078488.jpg,0,1,0,1,2,,train
0520905_as-0078488.jpg,1,1,2,1,5,,val
0520906_as-0078488.jpg,0,0,1,0,1,,val
0520907_as-0078488.jpg,0,1,0,0,1,,test
0520908_as-2501969.jpg,1,2,2,0,5,,train
0520910_as-0000218.jpg,2,0,0,0,2,,train
0520911_as-0000218.jpg,2,0,1,0,3,,train
0520912_sc-209618.jpg,0,0,1,0,1,,train
0520913_sc-209618.jpg,2,0,1,0,3,,train
0520914_sc-209618.jpg,3,0,1,1,5,,train
0520915_sc-209618.jpg,3,1,2,0,6,,train
0520916_sc-209618.jpg,4,1,1,0,6,,val
0520917_sc-209618.jpg,1,1,1,0,3,,val
0520918_sc-209618.jpg,0,0,1,0,1,,test
0520919_sc-209618.jpg,2,0,0,0,2,,train
0520920_sc-209618.jpg,3,1,1,0,5,,train
0520921_sc-209618.jpg,1,0,2,1,4,,train
0520922_sc-209618.jpg,1,0,0,0,1,,train
0520923_sc-209618.jpg,1,0,0,0,1,,train
0520924_as-9037191.jpg,4,1,1,1,7,,train
0520925_as-3101434.jpg,1,0,0,0,1,,train
0520926_as-3359220.jpg,1,0,0,0,1,,val
0520927_as-2692469.jpg,0,0,1,0,1,,val
0520928_sc-1022587.jpg,1,1,1,0,3,,test
0520929_sc-1022587.jpg,1,1,1,1,4,,train
0520930_sc-1022587.jpg,1,0,2,1,4,,train
0520932_sc-1022587.jpg,4,0,1,0,5,,train
0520933_sc-1022587.jpg,2,0,1,0,3,,train
0520935_as-3043167.jpg,1,0,0,0,1,,train
0520936_sc-1019433.jpg,1,0,0,0,1,,train
0520938_sc-1019433.jpg,3,0,0,1,4,,train
0520939_as-0008215.jpg,2,0,0,0,2,,val
0520940_as-0008215.jpg,2,0,0,0,2,,val
0520941_as-0008215.jpg,2,0,0,0,2,,test
0520942_as-0008215.jpg,1,0,0,0,1,,train
0520943_as-0008215.jpg,2,0,0,0,2,,train
0520944_as-0008215.jpg,1,0,0,0,1,,train
0520945_as-0008215.jpg,2,0,0,0,2,,train
0520946_as-0008215.jpg,2,0,0,0,2,,train
0520947_as-0008215.jpg,1,0,0,0,1,,train
0520948_as-0008215.jpg,3,0,0,0,3,,train
0520949_as-0008215.jpg,3,0,0,0,3,,val
0520950_as-0008215.jpg,1,0,0,0,1,,val
0520951_as-0008215.jpg,1,0,0,0,1,,test
0520952_as-0008215.jpg,2,0,0,0,2,,train
0520953_as-0008215.jpg,1,0,0,0,1,,train
0520954_as-0008215.jpg,1,0,0,0,1,,train
0520955_as-0008215.jpg,1,0,0,0,1,,train
0520956_as-0008215.jpg,2,0,0,0,2,,train
0520957_as-0008215.jpg,1,0,0,0,1,,train
0520958_as-0008215.jpg,2,0,0,0,2,,train
0520959_as-0008215.jpg,1,0,0,0,1,,val
0520960_as-0008215.jpg,1,0,0,0,1,,val
0520961_as-0008215.jpg,1,0,0,0,1,,test
0520962_as-0008215.jpg,3,0,0,0,3,,train
0520963_as-0008215.jpg,4,0,0,0,4,,train
0520964_as-0008215.jpg,2,0,0,0,2,,train
0520965_as-0008215.jpg,2,0,0,0,2,,train
0520966_as-0008691.jpg,1,1,0,0,2,,train
0520967_as-0008691.jpg,1,0,0,0,1,,train
0520968_as-0008691.jpg,1,1,0,0,2,,train
0520969_as-0008691.jpg,1,1,0,0,2,,val
0520970_as-0011064.jpg,1,0,0,0,1,,val
0520971_as-0011064.jpg,1,0,0,0,1,,test
0520972_as-3287954.jpg,2,0,0,0,2,,train
0520973_as-2529180.jpg,3,0,1,1,5,,train
0520974_as-2519964.jpg,1,0,0,0,1,,train
0520975_sc-127720.jpg,1,0,0,0,1,,train
0520976_sc-127720.jpg,2,0,0,0,2,,train
0520977_sc-127720.jpg,1,0,0,1,2,,train
0520978_as-0043608.jpg,0,0,1,0,1,,train
0520979_as-0043608.jpg,0,1,0,0,1,,val
0520980_as-3337188.jpg,1,0,0,0,1,,val
0520981_sc-1011293.jpg,6,0,0,0,6,,test
0520982_as-0017394.jpg,2,0,0,1,3,,train
0520983_as-0017394.jpg,2,0,0,0,2,,train
0520984_as-0017394.jpg,5,0,0,0,5,,train
0520985_as-0017394.jpg,4,0,0,0,4,,train
0520986_as-0017394.jpg,5,0,0,0,5,,train
0520990_as-0016922.jpg,3,0,0,0,3,,train
0520991_as-0016922.jpg,6,3,1,0,10,,train
0520992_as-0016922.jpg,4,4,1,0,9,,val
0520993_as-0016922.jpg,4,2,1,0,7,,val
0520994_as-0016922.jpg,3,0,3,0,6,,test
0520995_as-0016922.jpg,2,0,1,0,3,,train
0520996_as-0016922.jpg,1,1,1,0,3,,train
0520998_as-0016922.jpg,2,0,1,0,3,,train
0520999_as-2540549.jpg,3,0,0,0,3,,train
0521000_as-3272028.jpg,0,1,0,0,1,,train
0521001_as-9055505.jpg,1,0,0,0,1,,train
0521002_as-3028584.jpg,2,1,0,0,3,,train
0521004_as-0071662.jpg,2,1,0,2,5,,val
0521005_as-0071662.jpg,2,1,0,1,4,,val
0521008_as-2974518.jpg,0,2,1,0,3,,test
0521009_sc-212552.jpg,2,0,0,1,3,,train
0521010_sc-212552.jpg,3,0,1,1,5,,train
0521011_sc-212552.jpg,2,0,0,1,3,,train
0521012_sc-212552.jpg,2,0,1,0,3,,train
0521013_sc-212552.jpg,1,0,1,0,2,,train
0521014_sc-136583.jpg,0,1,0,0,1,,train
0521015_sc-136583.jpg,1,0,0,0,1,,train
0521016_sc-136583.jpg,0,0,1,0,1,,val
0521017_sc-136583.jpg,0,0,1,0,1,,val
0521018_sc-136583.jpg,0,1,0,0,1,,test
0521019_sc-136583.jpg,0,1,0,0,1,,train
0521020_sc-108390.jpg,2,0,0,0,2,,train
0521021_sc-108390.jpg,2,0,0,0,2,,train
0521023_sc-108390.jpg,3,0,0,0,3,,train
0521026_as-2581019.jpg,4,0,0,0,4,,train
0521028_as-0074541.jpg,4,0,0,0,4,,train
0521030_as-0074541.jpg,3,0,0,0,3,,train
0521032_as-0074541.jpg,2,0,0,0,2,,val
0521034_as-0074541.jpg,3,0,0,1,4,,val
0521035_as-0074541.jpg,4,0,0,1,5,,test
0521036_as-0074541.jpg,2,0,0,1,3,,train
0521038_sc-211969.jpg,1,1,0,0,2,,train
0521039_sc-194210.jpg,0,1,0,0,1,,train
0521040_sc-194210.jpg,0,1,0,0,1,,train
0521041_sc-194210.jpg,1,0,0,0,1,,train
0521042_sc-194210.jpg,3,0,0,0,3,,train
0521043_sc-194210.jpg,3,0,0,0,3,,train
0521044_sc-194210.jpg,1,0,0,0,1,,val
0521045_sc-1020884.jpg,5,1,0,0,6,,val
0521047_sc-1020884.jpg,1,3,0,0,4,,test
0521048_as-0020740.jpg,0,0,1,0,1,,train
0521049_as-0065818.jpg,3,2,1,0,6,,train
0521050_as-0065818.jpg,1,1,0,1,3,,train
0521051_as-0065818.jpg,0,1,0,1,2,,train
0521052_as-0065818.jpg,0,1,0,0,1,,train
0521053_as-0065818.jpg,0,2,0,0,2,,train
0521054_as-0065818.jpg,0,1,0,0,1,,train
0521055_as-0065818.jpg,0,1,1,0,2,,val
0521056_as-0073841.jpg,4,2,0,0,6,,val
0521057_as-0073841.jpg,8,2,0,1,11,,test
0521061_sc-187567.jpg,2,1,1,0,4,,train
0521062_sc-187567.jpg,2,0,0,0,2,,train
0521063_sc-187567.jpg,2,2,1,0,5,,train
0521064_sc-187567.jpg,2,2,1,0,5,,train
0521065_sc-150376.jpg,2,0,1,2,5,,train
0521067_sc-1008238.jpg,1,0,1,0,2,,train
0521068_sc-138011.jpg,1,0,0,0,1,,train
0521069_sc-138011.jpg,1,0,0,0,1,,val
0521070_sc-138011.jpg,1,0,0,0,1,,val
0521071_sc-138011.jpg,1,0,0,0,1,,test
0521073_as-0084433.jpg,1,0,1,1,3,,train
0521074_as-0084433.jpg,1,1,0,0,2,,train
0521075_as-0084433.jpg,0,1,0,0,1,,train
0521076_as-0084433.jpg,1,1,0,0,2,,train
0521077_as-0084433.jpg,1,0,0,0,1,,train
0521079_as-0094723.jpg,1,0,0,0,1,,train
0521080_as-0094723.jpg,2,0,0,0,2,,train
0521082_as-0094723.jpg,0,0,1,0,1,,val
0521083_as-0094723.jpg,1,0,0,0,1,,val
0521084_as-0094723.jpg,1,0,0,1,2,,test
0521086_as-3363594.jpg,4,0,2,1,7,,train
0521087_sc-209862.jpg,2,0,0,0,2,,train
0521088_sc-209862.jpg,3,0,0,0,3,,train
0521089_sc-209862.jpg,3,0,1,0,4,,train
0521090_sc-209862.jpg,2,0,1,0,3,,train
0521091_as-0035035.jpg,0,1,0,0,1,,train
0521092_as-0035035.jpg,1,0,0,0,1,,train
0521093_as-0056766.jpg,2,0,0,0,2,,val
0521094_as-0056766.jpg,0,0,1,0,1,,val
0521095_as-0056766.jpg,0,0,1,0,1,,test
0521097_sc-199009.jpg,1,1,0,1,3,,train
0521099_as-0085085.jpg,5,0,0,0,5,,train
0521100_as-0085085.jpg,3,0,1,0,4,,train
0521101_as-0085085.jpg,0,1,2,0,3,,train
0521102_sc-209796.jpg,5,0,0,0,5,,train
0521103_as-3165550.jpg,7,0,0,0,7,,train
0521104_as-3395282.jpg,1,0,1,1,3,,train
0521106_sc-132403.jpg,2,0,0,0,2,,val
0521107_sc-132403.jpg,3,0,1,0,4,,val
0521108_sc-132403.jpg,6,0,1,0,7,,test
0521109_sc-132403.jpg,1,1,1,0,3,,train
0521110_sc-228810.jpg,2,0,0,1,3,,train
0521111_sc-228810.jpg,2,0,0,0,2,,train
0521112_sc-228810.jpg,2,0,0,0,2,,train
0521113_sc-228810.jpg,4,0,0,0,4,,train
0521114_sc-186664.jpg,2,0,0,0,2,,train
0521115_sc-180970.jpg,1,0,1,0,2,,train
0521116_sc-180970.jpg,1,0,1,1,3,,val
0521117_sc-180970.jpg,1,0,1,1,3,,val
0521118_sc-180970.jpg,2,0,1,1,4,,test
0521119_sc-180970.jpg,2,0,1,1,4,,train
0521120_sc-180970.jpg,1,0,1,1,3,,train
0521121_sc-180970.jpg,3,0,1,0,4,,train
0521122_sc-180970.jpg,3,0,1,0,4,,train
0521123_sc-180970.jpg,3,0,1,0,4,,train
0521124_sc-180970.jpg,2,0,0,0,2,,train
0521125_sc-229133.jpg,1,0,1,2,4,,train
0521126_sc-229133.jpg,2,0,1,1,4,,val
0521127_sc-229133.jpg,4,1,1,2,8,,val
0521128_sc-229133.jpg,3,0,1,2,6,,test
0521129_sc-229133.jpg,2,0,2,2,6,,train
0521130_sc-229133.jpg,4,1,1,2,8,,train
0521131_sc-229133.jpg,4,0,1,0,5,,train
0521132_sc-229133.jpg,3,1,1,2,7,,train
0521133_sc-229133.jpg,3,1,1,2,7,,train
0521134_as-3445651.jpg,1,1,0,0,2,,train
0521136_as-0028935.jpg,2,0,1,0,3,,train
0521137_as-0028935.jpg,1,0,1,0,2,,val
0521138_as-0028935.jpg,0,0,1,0,1,,val
0521141_as-0057545.jpg,3,0,2,0,5,,test
0521142_as-0057545.jpg,4,0,2,2,8,,train
0521143_as-0057545.jpg,3,0,2,2,7,,train
0521145_sc-223557.jpg,0,1,0,0,1,,train
0521147_as-0026381.jpg,1,0,0,0,1,,train
0521148_as-0026381.jpg,1,0,0,0,1,,train
0521149_as-0026381.jpg,1,0,0,0,1,,train
0521150_as-9032209.jpg,2,1,0,0,3,,train
0521151_as-3059055.jpg,1,1,1,0,3,,val
0521152_sc-208330.jpg,0,0,1,0,1,,val
0521153_sc-208330.jpg,4,0,0,0,4,,test
0521154_sc-208330.jpg,4,0,2,0,6,,train
0521155_as-2645702.jpg,5,0,1,0,6,,train
0521158_as-0062266.jpg,3,0,0,0,3,,train
0521159_as-0062266.jpg,2,0,0,0,2,,train
0521160_as-0062266.jpg,3,1,0,1,5,,train
0521162_as-2817414.jpg,2,0,0,0,2,,train
0521163_as-3071462.jpg,5,0,0,0,5,,train
0521164_as-0044736.jpg,1,0,0,0,1,,val
0521165_as-2611988.jpg,1,0,1,0,2,,val
0521166_sc-1002004.jpg,1,0,0,1,2,,test
0521167_sc-1002004.jpg,4,0,0,0,4,,train
0521168_sc-1002004.jpg,4,0,1,0,5,,train
0521170_as-7230008.jpg,1,0,0,0,1,,train
0521171_as-0054944.jpg,10,0,0,0,10,,train
0521172_sc-188070.jpg,1,0,0,0,1,,train
0521173_sc-188070.jpg,1,0,0,0,1,,train
0521175_as-2843362.jpg,0,1,1,0,2,,train
0521176_sc-1026075.jpg,2,0,0,0,2,,val
0521177_sc-1026075.jpg,2,0,2,0,4,,val
0521178_as-0081421.jpg,4,0,0,0,4,,test
0521179_as-0081421.jpg,6,0,1,0,7,,train
0521180_as-0081421.jpg,6,0,0,0,6,,train
0521181_as-0081421.jpg,2,0,1,0,3,,train
0521182_as-0081421.jpg,1,0,1,0,2,,train
0521183_as-0081421.jpg,1,0,1,0,2,,train
0521184_as-0081421.jpg,2,0,0,0,2,,train
0521185_as-0081421.jpg,6,0,0,0,6,,train
0521186_as-0081421.jpg,3,0,0,0,3,,val
0521187_as-0081421.jpg,3,0,0,0,3,,val
0521188_as-0081421.jpg,2,0,0,0,2,,test
0521189_as-0081421.jpg,2,0,0,0,2,,train
0521190_as-0081421.jpg,2,0,0,0,2,,train
0521191_as-0081421.jpg,1,0,0,0,1,,train
0521192_sc-196188.jpg,1,1,0,0,2,,train
0521193_sc-1034429.jpg,2,0,0,0,2,,train
0521195_sc-1034429.jpg,1,0,1,1,3,,train
0521196_sc-1034429.jpg,1,0,0,1,2,,train
0521197_sc-1034429.jpg,1,0,1,1,3,,val
0521199_sc-185467.jpg,2,0,0,1,3,,val
0521200_as-3490227.jpg,2,0,0,0,2,,test
0521201_as-0062764.jpg,0,0,1,0,1,,train
0521202_as-0062764.jpg,0,0,1,0,1,,train
0521203_as-0062764.jpg,0,0,0,1,1,,train
0521204_as-3393849.jpg,2,0,0,0,2,,train
0521206_as-0039150.jpg,3,1,1,0,5,,train
0521207_as-0039150.jpg,2,1,0,0,3,,train
0521208_as-0039150.jpg,2,2,0,0,4,,train
0521211_as-2552355.jpg,2,0,0,0,2,,val
0521212_sc-213992.jpg,1,1,1,0,3,,val
0521214_sc-224831.jpg,2,1,1,3,7,,test
0521215_sc-224831.jpg,0,1,0,0,1,,train
0521219_as-0049675.jpg,1,5,1,2,9,,train
0521220_as-0049675.jpg,1,5,1,2,9,,train
0521221_as-0049675.jpg,1,3,0,0,4,,train
0521222_as-0049675.jpg,0,1,0,1,2,,train
0521223_sc-162999.jpg,1,0,0,0,1,,train
0521224_sc-162999.jpg,3,0,0,0,3,,train
0521225_as-0004578.jpg,1,0,0,0,1,,val
0521226_as-7917491.jpg,0,0,1,0,1,,val
0521227_as-0016942.jpg,4,1,0,0,5,,test
0521228_as-0016942.jpg,3,0,0,0,3,,train
0521229_as-0016942.jpg,2,1,0,0,3,,train
0521230_as-0016942.jpg,1,0,0,0,1,,train
0521231_as-0016942.jpg,1,0,0,0,1,,train
0521232_as-0016942.jpg,2,0,0,0,2,,train
0521233_as-0016942.jpg,1,0,0,0,1,,train
0521234_as-7671561.jpg,1,0,1,1,3,,train
0521235_as-3454457.jpg,4,1,0,0,5,,val
0521237_sc-105196.jpg,5,0,2,1,8,,val
0521238_sc-105196.jpg,4,0,1,1,6,,test
0521239_sc-105196.jpg,4,0,2,1,7,,train
0521240_sc-105196.jpg,2,1,1,0,4,,train
0521242_as-0013385.jpg,4,1,1,0,6,,train
0521243_as-0013385.jpg,1,1,1,0,3,,train
0521244_as-0013385.jpg,2,0,1,0,3,,train
0521245_as-0013385.jpg,2,0,1,1,4,,train
0521246_as-0013385.jpg,0,0,1,1,2,,train
0521247_as-0013385.jpg,0,0,1,0,1,,val
0521248_as-0013385.jpg,0,0,1,0,1,,val
0521249_as-0013385.jpg,0,0,1,0,1,,test
0521250_as-0013385.jpg,0,0,1,0,1,,train
0521251_as-0013385.jpg,3,0,0,0,3,,train
0521252_sc-1013345.jpg,1,0,0,0,1,,train
0521253_sc-1013345.jpg,1,1,0,0,2,,train
0521256_sc-1013345.jpg,1,1,1,0,3,,train
0521257_sc-1013345.jpg,1,1,1,0,3,,train
0521258_as-3272002.jpg,2,0,0,0,2,,train
0521259_sc-148595.jpg,2,0,1,1,4,,val
0521260_sc-148595.jpg,1,0,1,1,3,,val
0521262_sc-107261.jpg,1,0,0,0,1,,test
0521263_as-0036364.jpg,2,0,4,1,7,,train
0521264_as-0036364.jpg,2,0,1,0,3,,train
0521265_as-0036364.jpg,0,1,1,0,2,,train
0521266_as-0036364.jpg,1,0,0,0,1,,train
0521267_as-0036364.jpg,1,0,1,0,2,,train
0521268_sc-151618.jpg,5,1,1,1,8,,train
0521269_sc-151618.jpg,0,5,3,2,10,,train
0521270_as-9000121.jpg,0,1,0,0,1,,val
0521271_sc-1031262.jpg,0,1,0,0,1,,val
0521272_sc-1031262.jpg,0,1,0,0,1,,test
0521274_sc-1031262.jpg,0,0,1,0,1,,train
0521275_as-2829271.jpg,1,0,1,0,2,,train
0521278_as-7584635.jpg,1,0,0,0,1,,train
0521279_sc-200709.jpg,1,1,0,0,2,,train
0521280_sc-200709.jpg,1,1,0,0,2,,train
0521281_sc-200709.jpg,10,1,0,0,11,,train
0521282_sc-200709.jpg,6,1,0,0,7,,train
0521283_as-3001490.jpg,4,0,1,0,5,,val
0521284_as-0008278.jpg,1,0,0,0,1,,val
0521285_as-2516812.jpg,2,1,0,1,4,,test
0521286_sc-152467.jpg,1,0,0,0,1,,train
0521287_sc-152467.jpg,2,0,0,0,2,,train
0521288_sc-152467.jpg,3,0,0,0,3,,train
0521289_sc-152467.jpg,1,0,0,0,1,,train
0521290_sc-152467.jpg,1,0,0,0,1,,train
0521291_sc-152467.jpg,2,0,0,0,2,,train
0521293_sc-152467.jpg,5,0,0,0,5,,train
0521297_as-0036708.jpg,1,0,0,0,1,,val
0521298_as-0036708.jpg,1,0,1,0,2,,val
0521299_as-0036708.jpg,0,1,1,0,2,,test
0521300_as-0036708.jpg,0,1,1,0,2,,train
0521301_as-7618210.jpg,1,0,0,0,1,,train
0521302_sc-175157.jpg,1,0,0,0,1,,train
0521303_sc-175157.jpg,1,0,0,0,1,,train
0521304_sc-175157.jpg,1,0,0,2,3,,train
0521306_sc-175157.jpg,5,0,0,1,6,,train
0521307_sc-206534.jpg,5,1,0,0,6,,train
0521308_sc-206534.jpg,3,3,0,0,6,,val
0521309_sc-1003890.jpg,7,0,0,0,7,,val
0521310_sc-1003890.jpg,3,0,0,0,3,,test
0521311_sc-1003890.jpg,2,0,0,0,2,,train
0521312_sc-200322.jpg,0,0,1,0,1,,train
0521313_sc-200322.jpg,3,0,0,0,3,,train
0521314_sc-200322.jpg,2,0,0,0,2,,train
0521315_sc-200322.jpg,0,0,1,0,1,,train
0521316_sc-200322.jpg,1,0,0,0,1,,train
0521317_sc-200322.jpg,0,0,2,0,2,,train
0521319_sc-1005355.jpg,8,0,0,0,8,,val
0521320_as-0024320.jpg,0,1,0,0,1,,val
0521321_as-0024320.jpg,1,0,0,0,1,,test
0521322_as-0024320.jpg,0,1,1,0,2,,train
0521324_as-0024320.jpg,1,0,0,0,1,,train
0521325_as-0024320.jpg,1,0,0,0,1,,train
0521326_as-0024320.jpg,0,0,0,1,1,,train
0521327_as-0024320.jpg,1,0,0,0,1,,train
0521328_as-0024320.jpg,0,0,0,1,1,,train
0521329_as-0024320.jpg,1,0,0,1,2,,train
0521330_as-0024320.jpg,1,0,0,0,1,,val
0521331_as-2906502.jpg,1,0,0,0,1,,val
0521332_sc-189141.jpg,0,1,1,0,2,,test
0521333_as-0054465.jpg,2,0,0,0,2,,train
0521334_as-0054465.jpg,2,0,0,0,2,,train
0521335_sc-121858.jpg,8,0,0,0,8,,train
0521336_sc-121858.jpg,8,0,0,0,8,,train
0521337_as-0067815.jpg,1,0,0,0,1,,train
0521338_as-0077833.jpg,1,0,0,0,1,,train
0521339_as-0024116.jpg,2,0,0,0,2,,train
0521340_as-0024116.jpg,1,0,1,0,2,,val
0521341_as-0024116.jpg,0,0,1,0,1,,val
0521342_as-0024116.jpg,0,0,1,0,1,,test
0521343_as-0024116.jpg,0,0,1,0,1,,train
0521344_as-2650923.jpg,2,0,0,0,2,,train
0521345_as-0031739.jpg,2,0,0,0,2,,train
0521347_as-3006206.jpg,2,0,1,0,3,,train
0521348_as-7558916.jpg,1,0,0,0,1,,train
0521349_as-0009223.jpg,1,0,0,0,1,,train
0521350_as-0009223.jpg,1,0,0,0,1,,train
0521351_as-0070125.jpg,0,0,1,0,1,,val
0521353_sc-135636.jpg,3,0,0,0,3,,val
0521354_sc-135636.jpg,4,0,0,1,5,,test
0521355_sc-135636.jpg,2,0,0,0,2,,train
0521356_as-7934279.jpg,2,0,0,1,3,,train
0521357_as-0017900.jpg,4,0,1,0,5,,train
0521358_sc-1041743.jpg,1,0,2,1,4,,train
0521363_as-0005789.jpg,3,0,0,1,4,,train
0521364_as-0005789.jpg,2,0,0,1,3,,train
0521366_as-0005789.jpg,5,0,0,0,5,,train
0521368_as-0052085.jpg,1,0,1,0,2,,val
0521372_as-0064117.jpg,5,0,1,2,8,,val
0521373_as-0064117.jpg,1,0,1,0,2,,test
0521374_as-0064117.jpg,7,0,1,1,9,,train
0521376_as-0064117.jpg,8,0,2,0,10,,train
0521377_as-0064117.jpg,7,0,2,0,9,,train
0521378_as-0064117.jpg,3,0,1,1,5,,train
0521379_as-3176181.jpg,1,0,0,1,2,,train
0521380_as-3176181.jpg,0,0,0,2,2,,train
0521381_sc-124123.jpg,3,0,1,1,5,,train
0521382_sc-124123.jpg,1,0,0,0,1,,val
0521383_sc-124123.jpg,1,0,0,0,1,,val
0521384_sc-124123.jpg,1,0,0,0,1,,test
0521385_sc-124123.jpg,1,0,0,0,1,,train
0521386_sc-124123.jpg,2,0,1,0,3,,train
0521389_as-0009329.jpg,4,0,0,0,4,,train
0521390_as-0009329.jpg,5,0,0,1,6,,train
0521391_as-0009329.jpg,5,0,0,0,5,,train
0521392_as-0009329.jpg,4,0,0,0,4,,train
0521393_as-0009329.jpg,2,0,0,1,3,,train
0521394_as-0009329.jpg,5,0,0,1,6,,val
0521396_sc-183022.jpg,1,2,1,0,4,,val
0521398_sc-183022.jpg,1,1,0,0,2,,test
0521399_sc-1031358.jpg,4,0,1,0,5,,train
0521400_sc-1031358.jpg,4,0,0,0,4,,train
0521402_as-0033482.jpg,0,1,2,0,3,,train
0521403_as-0033482.jpg,2,1,0,1,4,,train
0521404_as-0033482.jpg,0,0,2,0,2,,train
0521408_as-0081655.jpg,3,1,1,1,6,,train
0521409_as-0081655.jpg,1,2,2,1,6,,train
0521410_as-0081655.jpg,1,0,1,0,2,,val
0521411_as-0081655.jpg,2,0,1,0,3,,val
0521412_as-0081655.jpg,2,1,1,0,4,,test
0521413_as-0081655.jpg,2,0,2,0,4,,train
0521414_as-3461979.jpg,1,0,0,0,1,,train
0521415_sc-111526.jpg,0,1,0,0,1,,train
0521416_sc-111526.jpg,1,0,1,0,2,,train
0521418_as-0056783.jpg,1,0,0,0,1,,train
0521419_as-0056783.jpg,2,0,0,0,2,,train
0521420_as-0056783.jpg,1,0,0,1,2,,train
0521421_as-0056783.jpg,2,0,0,1,3,,val
0521422_as-0056783.jpg,1,0,1,1,3,,val
0521423_as-0056783.jpg,2,0,0,0,2,,test
0521424_as-0056783.jpg,1,0,0,0,1,,train
0521425_as-0056783.jpg,1,0,0,0,1,,train
0521426_as-0056783.jpg,1,0,0,1,2,,train
0521427_as-0056783.jpg,1,0,0,0,1,,train
0521428_as-0056783.jpg,1,0,0,0,1,,train
0521429_as-0056783.jpg,1,0,0,0,1,,train
0521430_sc-204226.jpg,4,0,1,2,7,,train
0521431_sc-204226.jpg,1,0,1,1,3,,val
0521432_sc-204226.jpg,3,0,1,1,5,,val
0521433_sc-1040121.jpg,1,1,0,0,2,,test
0521434_sc-1040121.jpg,1,2,1,0,4,,train
0521435_sc-1040121.jpg,1,1,0,0,2,,train
0521436_as-2973315.jpg,1,1,2,1,5,,train
0521438_as-0094981.jpg,5,0,0,1,6,,train
0521439_as-0094981.jpg,5,0,0,1,6,,train
0521440_as-0094981.jpg,2,0,1,0,3,,train
0521441_as-0094981.jpg,1,0,1,0,2,,train
0521442_as-0094981.jpg,1,1,0,0,2,,val
0521443_as-0094981.jpg,5,1,0,0,6,,val
0521445_as-0094981.jpg,1,1,0,0,2,,test
0521446_sc-1031296.jpg,3,0,1,1,5,,train
0521447_sc-1031296.jpg,3,0,1,1,5,,train
0521448_sc-1031296.jpg,3,0,1,1,5,,train
0521449_as-2701630.jpg,0,0,2,0,2,,train
0521451_as-0001840.jpg,8,1,2,0,11,,train
0521452_as-0001840.jpg,13,1,1,0,15,,train
0521453_as-0001840.jpg,3,0,0,0,3,,train
0521456_sc-191842.jpg,5,0,0,0,5,,val
0521457_sc-191842.jpg,1,0,0,0,1,,val
0521461_sc-126516.jpg,1,0,1,0,2,,test
0521464_as-0046622.jpg,2,0,1,0,3,,train
0521465_as-0046622.jpg,1,0,1,2,4,,train
0521466_as-0046622.jpg,3,0,1,1,5,,train
0521467_as-0046622.jpg,1,1,0,1,3,,train
0521468_as-0046622.jpg,1,1,1,0,3,,train
0521469_as-0046622.jpg,3,1,1,1,6,,train
0521470_as-0046622.jpg,2,1,1,1,5,,train
0521471_as-0046622.jpg,1,0,0,0,1,,val
0521472_as-0046622.jpg,2,1,0,0,3,,val
0521473_as-0046622.jpg,2,1,0,0,3,,test
0521474_as-0036383.jpg,1,0,0,0,1,,train
0521475_as-0036383.jpg,2,0,0,0,2,,train
0521477_sc-1034205.jpg,1,0,0,0,1,,train
0521478_sc-1028238.jpg,7,0,0,0,7,,train
0521479_sc-1028238.jpg,5,0,0,0,5,,train
0521480_sc-1028238.jpg,4,0,1,0,5,,train
0521481_sc-1028238.jpg,5,0,0,0,5,,train
0521482_sc-146075.jpg,3,0,1,1,5,,val
0521483_sc-146075.jpg,2,0,2,1,5,,val
0521485_as-0024047.jpg,3,0,0,0,3,,test
0521486_as-0024047.jpg,1,0,0,0,1,,train
0521487_as-0024047.jpg,4,0,0,0,4,,train
0521488_as-0024047.jpg,1,0,0,1,2,,train
0521489_as-0024047.jpg,1,0,0,1,2,,train
0521490_as-0039937.jpg,3,0,0,0,3,,train
0521491_as-0039937.jpg,1,0,1,0,2,,train
0521492_sc-220227.jpg,2,0,0,0,2,,train
0521493_sc-220227.jpg,1,0,0,0,1,,val
0521495_as-0068659.jpg,1,0,1,0,2,,val
0521496_as-0068659.jpg,1,0,1,0,2,,test
0521497_as-0068659.jpg,0,1,1,0,2,,train
0521499_as-0044328.jpg,0,1,0,0,1,,train
0521501_as-0044328.jpg,0,1,0,0,1,,train
0521503_sc-1031286.jpg,1,0,0,0,1,,train
0521504_sc-1031286.jpg,1,0,0,0,1,,train
0521506_sc-1031286.jpg,1,0,0,0,1,,train
0521507_as-0030048.jpg,0,0,0,1,1,,train
0521509_as-0030048.jpg,1,0,1,3,5,,val
0521510_as-0030048.jpg,0,0,1,1,2,,val
0521511_as-0030048.jpg,0,0,1,2,3,,test
0521514_sc-190149.jpg,1,0,1,0,2,,train
0521516_sc-190149.jpg,1,0,1,0,2,,train
0521517_sc-190149.jpg,1,0,0,0,1,,train
0521518_sc-190149.jpg,1,0,0,0,1,,train
0521519_sc-190149.jpg,2,0,1,0,3,,train
0521521_sc-1030894.jpg,4,0,0,0,4,,train
0521523_as-2534814.jpg,1,0,0,0,1,,train
0521524_as-0029185.jpg,2,1,2,0,5,,val
0521525_as-0029185.jpg,3,3,2,0,8,,val
0521526_as-0029185.jpg,2,5,1,0,8,,test
0521527_as-0029185.jpg,3,2,1,0,6,,train
0521529_sc-166879.jpg,1,0,1,1,3,,train
0521530_sc-166879.jpg,0,0,1,1,2,,train
0521531_sc-166879.jpg,0,0,1,1,2,,train
0521532_sc-115038.jpg,3,0,1,0,4,,train
0521534_as-0033352.jpg,1,0,1,0,2,,train
0521535_as-0033352.jpg,3,0,2,0,5,,train
0521536_as-0033352.jpg,4,0,1,0,5,,val
0521537_as-0033352.jpg,5,0,0,0,5,,val
0521539_as-0007417.jpg,1,1,0,0,2,,test
0521540_as-0007417.jpg,1,0,0,0,1,,train
0521541_as-0007417.jpg,1,0,0,0,1,,train
0521542_as-0007417.jpg,1,0,0,0,1,,train
0521543_as-0007417.jpg,1,2,1,0,4,,train
0521544_as-0007417.jpg,1,2,1,0,4,,train
0521545_as-0007417.jpg,0,0,1,0,1,,train
0521546_as-0007417.jpg,1,0,0,0,1,,train
0521547_sc-111368.jpg,1,0,1,0,2,,val
0521548_sc-160751.jpg,0,1,1,0,2,,val
0521549_sc-160751.jpg,0,1,0,0,1,,test
0521550_sc-160751.jpg,1,1,1,0,3,,train
0521551_sc-160751.jpg,0,1,2,0,3,,train
0521552_sc-160751.jpg,0,1,1,0,2,,train
0521556_sc-162920.jpg,1,0,1,0,2,,train
0521557_as-3455585.jpg,3,0,0,0,3,,train
0521558_sc-1011906.jpg,2,0,0,1,3,,train
0521559_sc-1011906.jpg,2,0,0,1,3,,train
0521560_sc-167457.jpg,0,1,0,0,1,,val
0521561_as-2751390.jpg,5,0,0,0,5,,val
0521562_as-7032909.jpg,2,0,0,2,4,,test
0521564_as-0024431.jpg,1,1,0,0,2,,train
0521565_sc-103194.jpg,4,0,0,0,4,,train
0521566_sc-103194.jpg,4,0,0,0,4,,train
0521567_sc-103194.jpg,3,0,2,0,5,,train
0521568_sc-103194.jpg,5,1,0,0,6,,train
0521569_as-2670294.jpg,1,0,0,0,1,,train
0521571_as-0068966.jpg,1,1,1,0,3,,train
0521572_as-0068966.jpg,3,1,0,0,4,,val
0521573_as-0068966.jpg,0,0,1,0,1,,val
0521574_as-0068966.jpg,0,0,1,0,1,,test
0521575_as-0068966.jpg,0,0,1,0,1,,train
0521576_as-0068966.jpg,1,1,0,0,2,,train
0521577_sc-179614.jpg,3,0,0,1,4,,train
0521578_sc-179614.jpg,4,0,0,1,5,,train
0521580_sc-179614.jpg,4,0,0,0,4,,train
0521581_sc-204838.jpg,2,0,0,0,2,,train
0521582_sc-204838.jpg,2,0,1,0,3,,train
0521583_sc-204838.jpg,2,0,0,0,2,,val
0521584_sc-204838.jpg,2,0,0,0,2,,val
0521585_sc-204838.jpg,2,0,0,0,2,,test
0521586_as-0078504.jpg,1,0,1,1,3,,train
0521587_as-0078504.jpg,6,0,2,1,9,,train
0521589_sc-177701.jpg,0,0,1,0,1,,train
0521590_sc-142246.jpg,3,0,0,0,3,,train
0521591_sc-142246.jpg,1,0,0,0,1,,train
0521592_sc-142246.jpg,2,0,0,0,2,,train
0521593_as-3434668.jpg,3,0,0,1,4,,train
0521594_as-2956828.jpg,1,1,0,0,2,,val
0521595_as-0036407.jpg,3,1,1,0,5,,val
0521596_as-0036407.jpg,1,1,1,0,3,,test
0521597_as-0036407.jpg,4,2,3,0,9,,train
0521598_as-0036407.jpg,1,2,2,0,5,,train
0521599_as-3153784.jpg,2,0,0,1,3,,train
0521600_as-2963185.jpg,13,1,2,2,18,,train
0521601_sc-111198.jpg,1,0,0,0,1,,train
0521602_sc-111198.jpg,2,0,0,0,2,,train
0521603_sc-111198.jpg,0,0,1,0,1,,train
0521604_sc-111198.jpg,1,0,0,0,1,,val
0521606_sc-111198.jpg,2,0,0,0,2,,val
0521607_sc-111198.jpg,1,0,0,0,1,,test
0521608_sc-111198.jpg,2,0,0,0,2,,train
0521611_as-0058094.jpg,2,0,1,0,3,,train
0521612_as-0058094.jpg,1,1,0,0,2,,train
0521613_as-0058094.jpg,3,1,2,0,6,,train
0521614_as-0058094.jpg,0,0,2,0,2,,train
0521618_as-0053575.jpg,3,0,0,2,5,,train
0521619_as-0053575.jpg,2,0,0,2,4,,train
0521623_as-2972390.jpg,1,1,1,1,4,,val
0521624_as-2972390.jpg,1,0,1,0,2,,val
0521626_sc-120902.jpg,0,1,0,0,1,,test
0521628_sc-120902.jpg,0,1,0,0,1,,train
0521629_as-3066154.jpg,1,0,1,0,2,,train
0521630_sc-140735.jpg,3,0,0,1,4,,train
0521631_sc-140735.jpg,4,2,1,1,8,,train
0521632_sc-140735.jpg,2,0,0,2,4,,train
0521633_sc-1007972.jpg,3,0,0,0,3,,train
0521634_sc-1007972.jpg,1,0,0,0,1,,train
0521635_sc-1007972.jpg,1,0,0,0,1,,val
0521636_sc-1007972.jpg,1,0,0,0,1,,val
0521637_sc-1007972.jpg,2,0,0,0,2,,test
0521640_sc-1007972.jpg,4,0,0,0,4,,train
0521644_as-0091955.jpg,3,0,1,2,6,,train
0521645_as-0091955.jpg,2,0,1,1,4,,train
0521646_as-0091955.jpg,2,0,1,2,5,,train
0521648_as-0091955.jpg,6,0,1,2,9,,train
0521649_as-0091955.jpg,4,0,1,1,6,,train
0521651_as-0091955.jpg,3,0,1,2,6,,train
0521653_as-0091955.jpg,3,0,1,2,6,,val
0521654_as-0091955.jpg,2,0,1,2,5,,val
0521655_as-0050898.jpg,3,0,3,3,9,,test
0521656_as-0050898.jpg,0,0,1,1,2,,train
0521657_as-0050898.jpg,1,1,2,1,5,,train
0521658_as-0050898.jpg,6,1,1,0,8,,train
0521659_as-3021497.jpg,1,0,0,0,1,,train
0521660_sc-154899.jpg,2,0,0,0,2,,train
0521661_sc-227694.jpg,2,0,0,1,3,,train
0521662_sc-227694.jpg,3,0,0,1,4,,train
0521663_sc-227694.jpg,4,0,0,0,4,,val
0521664_sc-227694.jpg,5,0,0,0,5,,val
0521665_sc-227694.jpg,4,0,0,0,4,,test
0521666_sc-227694.jpg,4,0,0,0,4,,train
0521667_as-2768298.jpg,0,0,1,0,1,,train
0521668_sc-162222.jpg,1,0,0,0,1,,train
0521669_sc-162222.jpg,2,0,0,0,2,,train
0521670_sc-162222.jpg,1,0,0,0,1,,train
0521671_sc-162222.jpg,2,0,0,0,2,,train
0521672_sc-222269.jpg,1,1,0,2,4,,train
0521673_sc-222269.jpg,3,0,0,0,3,,val
0521674_sc-222269.jpg,2,0,0,0,2,,val
0521675_sc-222269.jpg,2,1,0,2,5,,test
0521676_sc-222269.jpg,0,0,0,2,2,,train
0521677_as-2745977.jpg,1,0,1,0,2,,train
0521678_as-9007072.jpg,1,0,0,0,1,,train
0521679_as-0015796.jpg,2,1,0,1,4,,train
0521681_sc-1010532.jpg,3,0,0,1,4,,train
0521682_sc-1010532.jpg,2,0,0,1,3,,train
0521683_sc-1010532.jpg,2,0,0,1,3,,train
0521684_as-2932698.jpg,3,1,3,1,8,,val
0521685_as-0015078.jpg,1,0,0,0,1,,val
0521687_as-0015078.jpg,0,0,0,1,1,,test
0521688_as-0015078.jpg,2,0,0,0,2,,train
0521689_as-0015078.jpg,1,0,0,0,1,,train
0521690_as-0015078.jpg,1,0,0,0,1,,train
0521693_as-0039106.jpg,1,1,0,0,2,,train
0521694_as-0039106.jpg,1,1,0,0,2,,train
0521697_sc-1033636.jpg,2,0,0,0,2,,train
0521698_sc-142102.jpg,1,0,0,0,1,,train
0521699_sc-142102.jpg,1,1,0,0,2,,val
0521700_sc-142102.jpg,1,1,0,0,2,,val
0521701_sc-148555.jpg,3,0,0,0,3,,test
0521702_sc-148555.jpg,1,0,0,0,1,,train
0521703_sc-148555.jpg,1,0,0,0,1,,train
0521704_sc-148555.jpg,1,0,0,0,1,,train
0521705_sc-148555.jpg,3,0,0,0,3,,train
0521706_sc-148555.jpg,1,0,0,0,1,,train
0521707_sc-148555.jpg,1,0,0,0,1,,train
0521708_sc-148555.jpg,2,0,0,0,2,,train
0521709_as-9026422.jpg,1,0,0,0,1,,val
0521710_sc-1033840.jpg,12,1,2,1,16,,val
0521711_sc-1033840.jpg,7,1,3,1,12,,test
0521712_sc-1033840.jpg,5,1,2,0,8,,train
0521713_sc-1033840.jpg,9,1,2,1,13,,train
0521714_sc-1033840.jpg,2,0,1,0,3,,train
0521715_sc-1033840.jpg,9,1,3,1,14,,train
0521718_as-0052661.jpg,2,1,2,1,6,,train
0521719_as-0052661.jpg,1,0,2,1,4,,train
0521720_as-0052661.jpg,1,1,2,1,5,,train
0521721_as-0052661.jpg,3,2,0,2,7,,val
0521722_as-0052661.jpg,1,2,0,0,3,,val
0521723_as-0052661.jpg,1,2,0,1,4,,test
0521724_as-2607708.jpg,5,0,0,0,5,,train
0521725_as-3182413.jpg,1,0,1,1,3,,train
0521726_as-7048321.jpg,1,0,0,0,1,,train
0521729_as-2810635.jpg,0,2,0,0,2,,train
0521730_as-0057765.jpg,1,0,0,0,1,,train
0521732_as-0057765.jpg,0,0,0,1,1,,train
0521733_as-0057765.jpg,1,0,0,0,1,,train
0521734_as-0057765.jpg,1,0,0,0,1,,val
0521739_as-2863379.jpg,1,0,1,0,2,,val
0521740_sc-1005698.jpg,3,0,0,1,4,,test
0521741_sc-1005698.jpg,7,0,0,0,7,,train
0521742_sc-1005698.jpg,2,0,0,1,3,,train
0521744_sc-1005698.jpg,5,1,0,1,7,,train
0521745_sc-1005698.jpg,1,0,0,0,1,,train
0521746_sc-1005698.jpg,4,1,0,0,5,,train
0521747_as-2865902.jpg,1,0,0,0,1,,train
0521748_sc-179412.jpg,1,0,0,1,2,,train
0521749_sc-179412.jpg,1,0,0,0,1,,val
0521750_sc-179412.jpg,1,0,0,0,1,,val
0521751_sc-161123.jpg,2,5,0,0,7,,test
0521752_sc-161123.jpg,1,3,0,0,4,,train
0521753_as-3243706.jpg,1,0,0,0,1,,train
0521754_sc-183812.jpg,0,3,0,0,3,,train
0521755_sc-183812.jpg,1,1,0,0,2,,train
0521758_as-0058314.jpg,2,0,0,0,2,,train
0521759_as-0058314.jpg,1,0,0,0,1,,train
0521761_sc-173121.jpg,3,0,0,0,3,,train
0521762_sc-173121.jpg,1,0,0,1,2,,val
0521763_sc-1037657.jpg,1,0,0,1,2,,val
0521764_sc-1037657.jpg,2,0,0,0,2,,test
0521765_sc-112827.jpg,0,1,0,0,1,,train
0521771_as-0081432.jpg,6,2,1,1,10,,train
0521772_as-0081432.jpg,9,1,0,0,10,,train
0521774_as-7440058.jpg,4,1,1,0,6,,train
0521775_sc-171652.jpg,2,0,1,0,3,,train
0521777_as-3315096.jpg,1,0,1,0,2,,train
0521778_as-2840685.jpg,3,0,2,1,6,,train
0521779_sc-142504.jpg,1,0,0,0,1,,val
0521780_sc-142504.jpg,1,0,0,0,1,,val
0521782_as-0052814.jpg,4,0,0,0,4,,test
0521783_as-0052814.jpg,2,0,0,0,2,,train
0521784_as-0052814.jpg,2,0,0,0,2,,train
0521785_as-0052814.jpg,5,0,1,0,6,,train
0521786_as-0052814.jpg,6,0,1,0,7,,train
0521787_as-0052814.jpg,1,0,1,0,2,,train
0521788_sc-212130.jpg,4,0,0,0,4,,train
0521789_sc-110158.jpg,2,0,1,0,3,,train
0521790_sc-110158.jpg,1,0,0,0,1,,val
0521791_sc-110158.jpg,1,0,0,0,1,,val
0521792_sc-110158.jpg,4,0,0,0,4,,test
0521793_as-2860591.jpg,3,0,0,0,3,,train
0521794_as-7878912.jpg,6,0,0,1,7,,train
0521795_sc-137465.jpg,0,1,0,0,1,,train
0521796_sc-137465.jpg,0,2,0,0,2,,train
0521798_sc-137465.jpg,0,1,0,0,1,,train
0521799_sc-137465.jpg,0,1,0,0,1,,train
0521800_sc-137465.jpg,2,1,0,0,3,,train
0521801_sc-1010375.jpg,1,0,0,0,1,,val
0521802_as-3070155.jpg,1,0,0,0,1,,val
0521804_sc-1009411.jpg,5,1,0,0,6,,test
0521805_sc-121289.jpg,2,1,1,1,5,,train
0521806_sc-121289.jpg,1,2,0,1,4,,train
0521807_as-2608915.jpg,2,0,0,0,2,,train
0521808_sc-205946.jpg,1,0,1,1,3,,train
0521809_sc-205946.jpg,3,0,1,1,5,,train
0521810_sc-205946.jpg,2,0,1,1,4,,train
0521811_sc-205946.jpg,3,0,0,1,4,,train
0521812_as-3284457.jpg,2,1,0,0,3,,val
0521815_as-3178410.jpg,2,0,0,0,2,,val
0521816_as-0022484.jpg,1,0,1,0,2,,test
0521817_as-0022484.jpg,2,0,1,0,3,,train
0521818_as-0022484.jpg,1,0,1,0,2,,train
0521819_as-0022484.jpg,2,0,1,0,3,,train
0521820_as-0022484.jpg,1,0,1,0,2,,train
0521821_as-0067629.jpg,1,0,0,0,1,,train
0521823_sc-111955.jpg,1,0,0,0,1,,train
0521824_sc-111955.jpg,3,1,0,0,4,,train
0521825_as-0040088.jpg,1,0,0,0,1,,val
0521826_as-0040088.jpg,2,0,0,0,2,,val
0521829_as-0069708.jpg,11,0,0,0,11,,test
0521830_as-0069708.jpg,6,0,1,0,7,,train
0521831_as-0069708.jpg,5,0,0,0,5,,train
0521832_as-0083885.jpg,1,0,0,0,1,,train
0521833_as-0083885.jpg,1,0,1,0,2,,train
0521834_as-2779259.jpg,2,0,0,0,2,,train
0521835_as-2666430.jpg,1,0,0,0,1,,train
0521836_sc-1014730.jpg,3,0,0,0,3,,train
0521837_sc-1014730.jpg,1,0,1,0,2,,val
0521838_sc-1014730.jpg,1,1,1,0,3,,val
0521839_as-0022970.jpg,2,0,0,0,2,,test
0521840_as-0022970.jpg,1,0,0,0,1,,train
0521842_as-7869329.jpg,2,0,1,0,3,,train
0521843_as-0029190.jpg,3,0,1,0,4,,train
0521844_as-0029190.jpg,3,0,0,1,4,,train
0521845_as-0029190.jpg,1,0,0,0,1,,train
0521846_as-0029190.jpg,2,0,0,0,2,,train
0521847_as-0029190.jpg,5,0,0,0,5,,train
0521848_as-0029190.jpg,1,0,1,1,3,,val
0521850_as-0029190.jpg,2,0,0,1,3,,val
0521852_as-0029761.jpg,1,0,0,0,1,,test
0521853_as-0029761.jpg,1,0,0,0,1,,train
0521854_sc-111901.jpg,2,1,0,1,4,,train
0521855_sc-111901.jpg,2,0,0,1,3,,train
0521856_sc-111901.jpg,1,0,1,1,3,,train
0521857_sc-111901.jpg,1,0,1,1,3,,train
0521861_as-0026564.jpg,1,0,0,0,1,,train
0521863_as-0026564.jpg,1,0,0,0,1,,train
0521864_as-0026564.jpg,1,0,0,0,1,,val
0521866_sc-1005249.jpg,3,0,0,0,3,,val
0521867_sc-1005249.jpg,3,0,0,0,3,,test
0521868_as-7895853.jpg,0,0,2,0,2,,train
0521869_as-0064484.jpg,0,0,1,0,1,,train
0521870_as-0064484.jpg,1,0,0,0,1,,train
0521871_as-0064484.jpg,1,0,0,0,1,,train
0521872_as-0064484.jpg,1,0,0,0,1,,train
0521873_as-0064484.jpg,1,0,0,0,1,,train
0521874_as-0064484.jpg,1,0,0,0,1,,train
0521875_as-0064484.jpg,1,0,0,0,1,,val
0521876_as-0064484.jpg,1,0,0,0,1,,val
0521878_as-0039606.jpg,1,0,1,1,3,,test
0521879_as-0039606.jpg,1,0,1,1,3,,train
0521880_as-0039606.jpg,1,0,0,0,1,,train
0521882_as-0039606.jpg,0,1,0,0,1,,train
0521884_sc-167296.jpg,1,0,0,0,1,,train
0521885_sc-167296.jpg,1,0,0,1,2,,train
0521887_as-0015641.jpg,1,1,1,0,3,,train
0521888_as-0015641.jpg,0,0,2,1,3,,train
0521889_as-0015641.jpg,9,0,0,2,11,,val
0521890_as-0015641.jpg,6,0,0,2,8,,val
0521891_as-0015641.jpg,7,0,0,1,8,,test
0521892_as-0015641.jpg,0,1,0,0,1,,train
0521893_as-0015641.jpg,0,1,1,0,2,,train
0521894_as-0015641.jpg,6,0,0,0,6,,train
0521895_as-7921498.jpg,3,0,1,1,5,,train
0521896_sc-204479.jpg,0,0,0,1,1,,train
0521897_sc-204479.jpg,1,0,0,0,1,,train
0521899_as-0050129.jpg,5,0,0,0,5,,train
0521900_as-0050129.jpg,4,0,0,0,4,,val
0521901_as-0050129.jpg,4,0,0,0,4,,val
0521902_as-0050129.jpg,10,0,0,0,10,,test
0521903_as-0050129.jpg,4,1,0,0,5,,train
0521904_as-0050129.jpg,5,0,0,0,5,,train
0521905_as-0050129.jpg,12,0,0,0,12,,train
0521906_as-0061682.jpg,1,0,0,0,1,,train
0521907_sc-112384.jpg,3,1,0,0,4,,train
0521911_as-0089208.jpg,0,1,2,1,4,,train
0521914_sc-148678.jpg,6,0,1,0,7,,train
0521915_as-3415358.jpg,3,1,0,0,4,,val
0521916_as-2961535.jpg,1,0,1,1,3,,val
0521917_sc-217370.jpg,2,1,2,0,5,,test
0521918_sc-217370.jpg,2,1,2,0,5,,train
0521919_sc-217370.jpg,2,1,2,0,5,,train
0521921_as-9023073.jpg,1,0,0,0,1,,train
0521923_sc-130172.jpg,1,0,0,0,1,,train
0521924_sc-130172.jpg,4,0,0,0,4,,train
0521925_sc-130172.jpg,0,0,0,1,1,,train
0521926_as-0003084.jpg,1,0,0,0,1,,train
0521927_as-0003084.jpg,1,1,0,0,2,,val
0521928_as-0003084.jpg,2,0,1,0,3,,val
0521930_as-0002313.jpg,4,0,1,0,5,,test
0521934_sc-1012501.jpg,2,1,3,1,7,,train
0521937_sc-1012501.jpg,1,0,5,0,6,,train
0521939_sc-1012501.jpg,1,0,1,0,2,,train
0521940_sc-1012501.jpg,1,0,1,0,2,,train
0521941_as-2976365.jpg,0,0,1,0,1,,train
0521942_sc-114403.jpg,1,0,0,0,1,,train
0521943_sc-114403.jpg,2,0,0,0,2,,train
0521944_sc-114403.jpg,1,0,1,0,2,,val
0521945_sc-114403.jpg,2,0,0,0,2,,val
0521946_sc-114403.jpg,2,0,0,0,2,,test
0521947_as-0008059.jpg,1,0,1,0,2,,train
0521948_as-0008059.jpg,1,0,0,0,1,,train
0521952_as-0086118.jpg,5,0,2,1,8,,train
0521953_as-2902572.jpg,2,0,0,1,3,,train
0521954_as-2902572.jpg,2,0,0,0,2,,train
0521955_as-3128580.jpg,0,1,1,0,2,,train
0521956_as-2700569.jpg,2,1,1,0,4,,train
0521957_as-9091780.jpg,3,0,1,2,6,,val
0521961_as-0092286.jpg,1,0,0,1,2,,val
0521962_as-0092286.jpg,3,0,1,1,5,,test
0521963_as-0092286.jpg,2,0,0,0,2,,train
0521964_as-0092286.jpg,3,0,0,0,3,,train
0521965_as-0092286.jpg,3,0,0,0,3,,train
0521966_as-0092286.jpg,1,0,0,1,2,,train
0521967_as-0092286.jpg,4,0,0,0,4,,train
0521968_as-0092286.jpg,1,0,0,0,1,,train
0521969_as-0092286.jpg,1,0,1,0,2,,train
0521971_as-0013869.jpg,3,0,0,1,4,,val
0521972_as-0013869.jpg,1,0,1,0,2,,val
0521973_as-0013869.jpg,1,0,1,0,2,,test
0521974_as-0013869.jpg,3,0,0,1,4,,train
0521975_sc-110060.jpg,1,0,1,0,2,,train
0521977_sc-110060.jpg,0,0,1,0,1,,train
0521979_as-2935408.jpg,1,0,0,0,1,,train
0521980_sc-118991.jpg,1,0,0,0,1,,train
0521981_as-0009434.jpg,3,0,0,0,3,,train
0521982_as-0009434.jpg,2,0,0,0,2,,train
0521983_as-0009434.jpg,2,0,0,0,2,,val
0521984_as-0009434.jpg,6,0,0,0,6,,val
0521985_as-0009434.jpg,1,0,0,0,1,,test
0521986_as-0049304.jpg,2,1,0,0,3,,train
0521987_as-0049304.jpg,1,0,2,0,3,,train
0521988_as-0049304.jpg,3,1,1,0,5,,train
0521989_as-0049304.jpg,1,1,1,0,3,,train
0521990_as-0049304.jpg,1,1,1,0,3,,train
0521992_as-2923566.jpg,1,0,0,1,2,,train
0521993_as-3349639.jpg,1,0,0,0,1,,train
0521995_sc-135989.jpg,6,1,1,1,9,,val
0521996_as-0034428.jpg,3,0,0,0,3,,val
0521997_as-0034428.jpg,1,0,0,0,1,,test
0521999_as-0077424.jpg,1,0,0,0,1,,train
0522001_as-0058222.jpg,7,3,0,0,10,,train
0522002_as-0058222.jpg,2,0,0,0,2,,train
0522003_as-0058222.jpg,2,1,0,0,3,,train
0522004_as-0027743.jpg,0,1,0,0,1,,train
0522005_as-0049097.jpg,1,0,0,0,1,,train
0522006_as-0049097.jpg,1,0,0,0,1,,train
0522007_as-0049097.jpg,1,0,0,0,1,,val
0522008_as-0049097.jpg,1,0,0,0,1,,val
0522009_as-0049097.jpg,1,0,0,0,1,,test
0522010_as-0049097.jpg,1,0,0,0,1,,train
0522012_as-3064191.jpg,8,0,0,0,8,,train
0522015_as-0019808.jpg,1,1,1,0,3,,train
0522016_as-0019808.jpg,4,0,0,0,4,,train
0522017_as-0019808.jpg,2,0,1,1,4,,train
0522018_as-0019808.jpg,3,0,1,1,5,,train
0522019_as-0019808.jpg,1,0,1,1,3,,train
0522020_as-0019808.jpg,2,0,2,2,6,,val
0522021_as-0019808.jpg,0,0,1,1,2,,val
0522022_as-0019808.jpg,0,0,1,1,2,,test
0522023_sc-116331.jpg,1,0,0,0,1,,train
0522025_sc-217822.jpg,1,0,1,0,2,,train
0522026_sc-217822.jpg,4,0,1,0,5,,train
0522027_sc-217822.jpg,2,0,1,0,3,,train
0522028_sc-181313.jpg,1,0,0,0,1,,train
0522029_sc-181313.jpg,0,0,1,0,1,,train
0522030_sc-181313.jpg,0,0,1,0,1,,train
0522033_sc-160549.jpg,2,0,2,0,4,,val
0522034_as-0077788.jpg,1,0,1,0,2,,val
0522035_as-0077788.jpg,0,0,1,0,1,,test
0522036_as-0077788.jpg,0,0,1,0,1,,train
0522037_as-0036122.jpg,1,1,0,0,2,,train
0522038_sc-132870.jpg,3,0,0,1,4,,train
0522039_sc-132870.jpg,0,0,1,0,1,,train
0522040_sc-132870.jpg,0,0,1,0,1,,train
0522041_sc-132870.jpg,2,1,0,0,3,,train
0522042_sc-132870.jpg,1,0,0,0,1,,train
0522043_sc-132870.jpg,1,0,0,1,2,,val
0522044_sc-132870.jpg,1,0,0,0,1,,val
0522045_sc-164437.jpg,3,0,0,0,3,,test
0522046_sc-164437.jpg,1,0,0,0,1,,train
0522047_sc-164437.jpg,1,0,0,0,1,,train
0522049_sc-164437.jpg,1,0,1,0,2,,train
0522050_sc-164437.jpg,0,1,0,0,1,,train
0522051_sc-164437.jpg,2,0,0,0,2,,train
0522052_sc-164437.jpg,1,0,1,0,2,,train
0522053_sc-164437.jpg,0,0,1,0,1,,train
0522054_sc-1037204.jpg,1,1,0,0,2,,val
0522055_sc-1037204.jpg,3,0,0,0,3,,val
0522056_sc-1037204.jpg,8,0,0,0,8,,test
0522057_sc-1037204.jpg,9,0,0,0,9,,train
0522059_sc-130781.jpg,2,0,1,1,4,,train
0522061_sc-130781.jpg,2,1,2,1,6,,train
0522062_sc-130781.jpg,2,1,2,0,5,,train
0522063_as-0071528.jpg,1,0,0,0,1,,train
0522064_as-0071528.jpg,1,0,1,1,3,,train
0522065_as-0071528.jpg,1,0,1,1,3,,train
0522066_as-0071528.jpg,1,0,1,1,3,,val
0522067_as-0071528.jpg,1,0,1,1,3,,val
0522068_as-0071528.jpg,1,0,0,0,1,,test
0522069_as-0071528.jpg,1,0,0,1,2,,train
0522070_sc-130402.jpg,1,0,1,1,3,,train
0522071_as-3446132.jpg,1,0,0,0,1,,train
0522072_as-7841792.jpg,0,0,0,1,1,,train
0522074_sc-152233.jpg,5,0,0,0,5,,train
0522075_sc-152233.jpg,4,0,0,0,4,,train
0522076_sc-152233.jpg,3,0,0,0,3,,train
0522077_sc-152233.jpg,4,0,0,0,4,,val
0522079_sc-106499.jpg,1,0,0,0,1,,val
0522081_sc-106499.jpg,2,0,0,0,2,,test
0522082_sc-106499.jpg,1,0,0,0,1,,train
0522083_sc-166145.jpg,4,0,1,1,6,,train
0522086_as-7155455.jpg,11,0,2,1,14,,train
0522087_as-0027454.jpg,1,0,0,0,1,,train
0522088_as-0027454.jpg,4,0,0,0,4,,train
0522089_as-7829391.jpg,0,1,0,0,1,,train
0522090_as-0048515.jpg,1,0,0,0,1,,train
0522091_as-0048515.jpg,2,0,0,0,2,,val
0522092_as-0048515.jpg,3,0,0,0,3,,val
0522094_as-0019730.jpg,1,1,1,0,3,,test
0522096_as-0006888.jpg,2,2,1,1,6,,train
0522100_sc-121509.jpg,1,0,0,0,1,,train
0522103_as-0060991.jpg,1,0,0,0,1,,train
0522104_as-7138442.jpg,1,0,0,0,1,,train
0522106_as-0064678.jpg,3,0,0,0,3,,train
0522107_as-0064678.jpg,5,0,0,0,5,,train
0522108_as-0064678.jpg,3,0,0,0,3,,train
0522110_sc-1022838.jpg,1,0,0,0,1,,val
0522111_sc-1022838.jpg,2,0,0,0,2,,val
0522114_as-0073692.jpg,1,1,0,1,3,,test
0522115_as-0073692.jpg,1,1,1,2,5,,train
0522116_sc-200647.jpg,3,2,2,1,8,,train
0522117_sc-200647.jpg,3,4,1,1,9,,train
0522118_sc-200647.jpg,4,1,2,1,8,,train
0522119_sc-200647.jpg,2,1,1,1,5,,train
0522120_sc-200647.jpg,4,0,2,0,6,,train
0522122_sc-1020235.jpg,4,0,0,0,4,,train
0522123_sc-1020235.jpg,3,0,0,0,3,,val
0522124_sc-1000578.jpg,2,0,0,0,2,,val
0522125_sc-1000578.jpg,5,0,1,0,6,,test
0522126_as-2840615.jpg,2,0,0,0,2,,train
0522127_sc-205882.jpg,2,0,1,1,4,,train
0522128_sc-205882.jpg,1,0,1,1,3,,train
0522129_sc-205882.jpg,2,0,1,1,4,,train
0522130_as-7863776.jpg,3,0,0,0,3,,train
0522131_sc-121358.jpg,1,0,1,0,2,,train
0522133_as-7986292.jpg,1,0,2,1,4,,train
0522135_as-3429621.jpg,1,0,1,0,2,,val
0522136_as-3249692.jpg,4,0,0,0,4,,val
0522137_sc-1030461.jpg,1,0,2,1,4,,test
0522138_sc-1030461.jpg,3,0,1,0,4,,train
0522139_sc-1030461.jpg,1,0,2,1,4,,train
0522140_sc-131395.jpg,0,1,0,0,1,,train
0522141_as-3450031.jpg,1,0,0,0,1,,train
0522142_sc-1019538.jpg,2,1,1,0,4,,train
0522143_sc-1019538.jpg,1,0,1,0,2,,train
0522144_sc-1019538.jpg,0,0,2,0,2,,train
0522145_sc-1019538.jpg,2,1,1,1,5,,val
0522148_as-0054324.jpg,1,0,0,0,1,,val
0522149_as-0054324.jpg,3,0,1,0,4,,test
0522150_as-0054324.jpg,2,0,0,0,2,,train
0522151_as-0054324.jpg,1,0,0,0,1,,train
0522152_as-0054324.jpg,1,0,0,0,1,,train
0522153_as-0054324.jpg,1,0,1,0,2,,train
0522154_as-0054324.jpg,0,0,1,0,1,,train
0522155_as-0054324.jpg,1,0,0,0,1,,train
0522156_sc-1000998.jpg,1,0,0,1,2,,train
0522157_sc-1000998.jpg,1,0,0,1,2,,val
0522158_sc-1000998.jpg,4,0,0,0,4,,val
0522159_sc-1000998.jpg,2,1,0,0,3,,test
0522160_sc-1000998.jpg,2,0,0,0,2,,train
0522161_sc-204378.jpg,1,1,0,0,2,,train
0522163_as-2665038.jpg,1,0,0,0,1,,train
0522165_sc-115669.jpg,1,2,2,1,6,,train
0522166_sc-115669.jpg,1,0,0,0,1,,train
0522167_sc-115669.jpg,4,3,1,0,8,,train
0522168_sc-115669.jpg,2,1,1,1,5,,train
0522169_sc-115669.jpg,2,1,2,2,7,,val
0522170_as-3334560.jpg,1,0,0,0,1,,val
0522171_as-0092374.jpg,1,0,0,0,1,,test
0522173_sc-1018163.jpg,1,0,1,0,2,,train
0522174_sc-1018163.jpg,4,0,0,0,4,,train
0522176_sc-1012989.jpg,2,0,0,0,2,,train
0522177_sc-1031445.jpg,1,0,1,1,3,,train
0522178_sc-1031445.jpg,2,0,0,1,3,,train
0522180_sc-175133.jpg,1,0,0,0,1,,train
0522181_sc-175133.jpg,3,0,0,0,3,,train
0522182_sc-175133.jpg,1,0,2,1,4,,val
0522183_sc-175133.jpg,2,0,1,2,5,,val
0522184_sc-175133.jpg,1,0,0,0,1,,test
0522185_sc-175133.jpg,3,0,0,0,3,,train
0522186_sc-175133.jpg,3,0,0,0,3,,train
0522187_sc-113259.jpg,1,2,0,0,3,,train
0522188_sc-113259.jpg,2,1,0,0,3,,train
0522190_sc-1022906.jpg,1,0,0,0,1,,train
0522191_sc-1022906.jpg,2,0,0,0,2,,train
0522192_sc-1022906.jpg,2,0,0,1,3,,train
0522193_as-0043098.jpg,0,0,0,1,1,,val
0522194_as-0043098.jpg,1,0,0,1,2,,val
0522195_as-3029321.jpg,0,0,1,0,1,,test
0522198_as-2671810.jpg,0,1,0,0,1,,train
0522199_as-7353539.jpg,1,0,0,1,2,,train
0522201_as-3218024.jpg,2,0,0,0,2,,train
0522202_sc-148877.jpg,3,0,0,2,5,,train
0522206_sc-1005335.jpg,1,0,0,0,1,,train
0522207_sc-1035987.jpg,2,0,0,0,2,,train
0522209_sc-1035987.jpg,3,0,0,0,3,,train
0522210_sc-1035987.jpg,1,0,0,0,1,,val
0522211_sc-196204.jpg,8,0,0,0,8,,val
0522212_sc-196204.jpg,7,0,0,0,7,,test
0522213_sc-212073.jpg,3,0,0,0,3,,train
0522214_sc-212073.jpg,2,0,0,0,2,,train
0522215_sc-170446.jpg,1,0,0,0,1,,train
0522216_sc-170446.jpg,1,0,0,0,1,,train
0522217_as-2810834.jpg,0,0,1,0,1,,train
0522219_sc-188364.jpg,2,0,0,0,2,,train
0522220_as-0036153.jpg,1,1,0,1,3,,train
0522221_as-0036153.jpg,0,2,3,0,5,,val
0522222_as-0036153.jpg,3,1,0,0,4,,val
0522223_as-0036153.jpg,5,2,1,0,8,,test
0522224_as-9006612.jpg,3,0,0,0,3,,train
0522226_sc-1014922.jpg,1,0,0,0,1,,train
0522227_sc-1014922.jpg,2,1,0,0,3,,train
0522229_sc-212681.jpg,1,1,0,0,2,,train
0522230_as-9041404.jpg,1,0,0,0,1,,train
0522231_as-0060424.jpg,0,1,1,0,2,,train
0522232_as-0060424.jpg,0,1,1,0,2,,train
0522234_as-0018081.jpg,4,0,0,0,4,,val
0522236_as-0018081.jpg,3,0,0,0,3,,val
0522237_sc-1019677.jpg,2,1,2,0,5,,test
0522238_sc-117041.jpg,5,0,0,0,5,,train
0522239_sc-214493.jpg,2,1,0,0,3,,train
0522240_as-7685277.jpg,6,0,0,0,6,,train
0522241_sc-152496.jpg,4,0,0,0,4,,train
0522243_as-0008616.jpg,3,1,2,0,6,,train
0522249_sc-215193.jpg,2,0,0,1,3,,train
0522250_sc-215193.jpg,3,0,0,1,4,,train
0522251_as-0002812.jpg,3,0,0,0,3,,val
0522252_as-3320446.jpg,2,0,1,1,4,,val
0522255_as-0079230.jpg,1,0,1,1,3,,test
0522256_as-0079230.jpg,1,1,1,1,4,,train
0522257_as-0079230.jpg,1,1,1,1,4,,train
0522258_as-0079230.jpg,3,1,1,1,6,,train
0522259_as-0079230.jpg,2,1,1,1,5,,train
0522260_as-0079230.jpg,2,1,1,1,5,,train
0522261_sc-228566.jpg,7,0,1,0,8,,train
0522262_sc-228566.jpg,7,0,0,0,7,,train
0522263_sc-228566.jpg,1,0,0,0,1,,val
0522264_sc-228566.jpg,9,0,0,0,9,,val
0522265_sc-145040.jpg,1,0,0,0,1,,test
0522266_sc-178404.jpg,6,0,0,0,6,,train
0522267_as-2763746.jpg,0,0,1,0,1,,train
0522268_sc-1040191.jpg,1,0,0,0,1,,train
0522269_sc-1040191.jpg,1,0,0,0,1,,train
0522270_sc-1040191.jpg,1,0,0,0,1,,train
0522271_sc-1040191.jpg,1,0,0,1,2,,train
0522272_sc-1040191.jpg,1,0,0,1,2,,train
0522275_as-7573522.jpg,1,0,0,0,1,,val
0522276_as-0037021.jpg,1,0,0,0,1,,val
0522277_as-0037021.jpg,1,0,0,0,1,,test
0522278_as-0037021.jpg,2,0,0,0,2,,train
0522279_as-0037021.jpg,1,0,0,0,1,,train
0522280_sc-199984.jpg,1,0,0,0,1,,train
0522281_sc-182898.jpg,2,1,0,0,3,,train
0522283_sc-147969.jpg,1,0,0,0,1,,train
0522286_as-2508348.jpg,1,0,0,0,1,,train
0522287_as-3364105.jpg,3,0,0,0,3,,train
0522288_sc-202238.jpg,2,0,1,0,3,,val
0522289_sc-202238.jpg,2,2,0,0,4,,val
0522290_as-7173543.jpg,1,0,0,1,2,,test
0522291_as-0089977.jpg,3,3,0,0,6,,train
0522292_as-0089977.jpg,3,0,0,0,3,,train
0522295_as-0062401.jpg,1,0,0,0,1,,train
0522297_sc-1034821.jpg,0,0,1,0,1,,train
0522298_sc-1034821.jpg,3,1,2,0,6,,train
0522299_sc-148113.jpg,0,0,1,0,1,,train
0522300_sc-148113.jpg,2,0,1,1,4,,train
0522301_as-2986552.jpg,2,0,0,0,2,,val
0522302_sc-1040925.jpg,1,0,1,0,2,,val
0522307_as-0093505.jpg,7,0,0,1,8,,test
0522308_as-0093505.jpg,5,0,0,0,5,,train
0522309_as-0093505.jpg,5,0,0,0,5,,train
0522310_as-0093505.jpg,7,0,0,0,7,,train
0522311_as-0093505.jpg,3,0,1,1,5,,train
0522312_as-0093505.jpg,4,0,0,0,4,,train
0522314_as-2636607.jpg,1,1,0,1,3,,train
0522315_as-7460887.jpg,3,0,2,1,6,,train
0522316_sc-219085.jpg,3,0,1,0,4,,val
0522317_sc-219085.jpg,1,0,1,0,2,,val
0522318_sc-219085.jpg,2,0,0,0,2,,test
0522319_sc-219085.jpg,5,0,0,0,5,,train
0522320_sc-219085.jpg,1,0,0,0,1,,train
0522321_as-0054898.jpg,5,0,0,0,5,,train
0522322_as-0054898.jpg,2,0,0,0,2,,train
0522323_as-3346283.jpg,1,0,0,1,2,,train
0522324_sc-226489.jpg,1,1,1,1,4,,train
0522325_sc-226489.jpg,4,0,0,1,5,,train
0522326_sc-226489.jpg,5,0,1,0,6,,val
0522327_as-3222063.jpg,1,1,1,0,3,,val
0522328_sc-1000415.jpg,1,0,1,0,2,,test
0522329_sc-193762.jpg,2,1,1,0,4,,train
0522331_sc-193762.jpg,5,1,1,0,7,,train
0522332_sc-193762.jpg,4,1,1,0,6,,train
0522333_sc-193762.jpg,3,1,1,0,5,,train
0522334_sc-193762.jpg,1,1,1,0,3,,train
0522335_sc-193762.jpg,2,1,0,0,3,,train
0522336_as-2842746.jpg,2,0,0,0,2,,train
0522337_as-9002984.jpg,1,0,0,0,1,,val
0522338_sc-124175.jpg,0,1,0,0,1,,val
0522339_sc-124175.jpg,0,1,0,0,1,,test
0522340_as-0014357.jpg,2,0,0,0,2,,train
0522341_as-0014357.jpg,6,0,0,0,6,,train
0522342_as-0014357.jpg,4,0,0,0,4,,train
0522343_as-0014357.jpg,3,0,0,0,3,,train
0522344_as-0014357.jpg,3,0,0,0,3,,train
0522345_as-0014357.jpg,2,0,0,0,2,,train
0522346_as-0014357.jpg,3,0,0,0,3,,train
0522347_sc-165319.jpg,1,0,0,0,1,,val
0522348_as-2812682.jpg,2,0,0,0,2,,val
0522349_sc-1005798.jpg,1,0,1,0,2,,test
0522350_sc-1005798.jpg,1,0,1,1,3,,train
0522351_as-3132879.jpg,3,0,0,0,3,,train
0522353_sc-152023.jpg,1,0,0,0,1,,train
0522354_sc-152023.jpg,1,0,0,0,1,,train
0522355_sc-152023.jpg,2,0,0,0,2,,train
0522357_sc-191109.jpg,2,2,1,0,5,,train
0522358_sc-191109.jpg,1,1,0,0,2,,train
0522359_sc-133411.jpg,5,0,0,0,5,,val
0522360_as-0034774.jpg,1,1,1,1,4,,val
0522361_as-0034774.jpg,1,1,1,1,4,,test
0522363_as-2531207.jpg,1,0,0,0,1,,train
0522364_sc-203622.jpg,2,0,0,0,2,,train
0522365_sc-203622.jpg,1,0,1,0,2,,train
0522366_sc-203622.jpg,1,0,0,0,1,,train
0522367_sc-203622.jpg,1,0,0,0,1,,train
0522368_sc-203622.jpg,1,0,0,0,1,,train
0522369_sc-203622.jpg,1,0,0,0,1,,train
0522370_as-0063888.jpg,0,0,1,0,1,,val
0522371_as-0063888.jpg,0,0,0,1,1,,val
0522372_as-0063888.jpg,1,1,0,1,3,,test
0522373_as-0063888.jpg,0,1,1,0,2,,train
0522374_as-0063888.jpg,0,0,1,0,1,,train
0522375_as-0063888.jpg,0,0,3,0,3,,train
0522376_as-0063888.jpg,1,0,0,0,1,,train
0522377_as-0063888.jpg,0,0,1,0,1,,train
0522379_sc-130984.jpg,1,0,0,0,1,,train
0522381_as-3441665.jpg,2,0,1,1,4,,train
0522383_sc-128192.jpg,1,1,0,0,2,,val
0522384_sc-125200.jpg,1,0,0,0,1,,val
0522385_sc-125200.jpg,2,0,0,0,2,,test
0522386_as-2999665.jpg,1,0,0,0,1,,train
0522387_sc-156583.jpg,2,0,1,0,3,,train
0522388_sc-156583.jpg,0,0,1,0,1,,train
0522389_sc-156583.jpg,1,0,1,0,2,,train
0522390_sc-172992.jpg,2,0,0,0,2,,train
0522391_sc-172992.jpg,1,0,0,0,1,,train
0522392_sc-172992.jpg,1,0,0,0,1,,train
0522394_as-0000835.jpg,1,0,0,0,1,,val
0522395_as-3197381.jpg,3,1,1,1,6,,val
0522396_as-7860887.jpg,3,0,0,0,3,,test
0522398_as-0075229.jpg,3,1,0,0,4,,train
0522399_as-0075229.jpg,2,1,0,0,3,,train
0522400_as-9031185.jpg,1,0,0,0,1,,train
0522401_sc-1001726.jpg,3,0,2,0,5,,train
0522402_sc-1001726.jpg,1,1,3,0,5,,train
0522404_sc-1001726.jpg,4,0,0,0,4,,train
0522405_as-0079807.jpg,0,0,1,0,1,,train
0522409_as-0079807.jpg,1,0,0,0,1,,val
0522410_as-0076725.jpg,2,1,0,0,3,,val
0522411_as-0076725.jpg,2,0,0,0,2,,test
0522412_as-0076725.jpg,0,1,0,0,1,,train
0522413_as-0076725.jpg,0,1,0,0,1,,train
0522414_as-0076725.jpg,1,1,0,0,2,,train
0522416_sc-103665.jpg,1,0,0,0,1,,train
0522417_sc-103665.jpg,1,0,1,0,2,,train
0522418_as-3123203.jpg,1,0,0,0,1,,train
0522420_as-0028882.jpg,3,1,0,0,4,,train
0522421_sc-1027445.jpg,0,0,1,0,1,,val
0522422_sc-1027445.jpg,0,0,1,0,1,,val
0522423_sc-1027445.jpg,0,0,1,0,1,,test
0522424_as-2717986.jpg,2,0,0,0,2,,train
0522426_as-0082260.jpg,1,0,0,0,1,,train
0522428_as-0082260.jpg,9,0,0,1,10,,train
0522430_as-0082260.jpg,4,0,1,0,5,,train
0522431_sc-134783.jpg,1,0,3,0,4,,train
0522432_sc-134783.jpg,3,0,1,1,5,,train
0522433_as-0004617.jpg,0,2,0,0,2,,train
0522434_as-0004617.jpg,1,1,0,0,2,,val
0522435_as-0011137.jpg,0,0,1,0,1,,val
0522436_as-0000436.jpg,1,0,1,0,2,,test
0522437_as-0000436.jpg,1,0,1,0,2,,train
0522438_as-0000436.jpg,2,0,0,1,3,,train
0522439_as-2598064.jpg,6,0,0,0,6,,train
0522443_as-0026871.jpg,1,0,0,1,2,,train
0522444_as-0026871.jpg,1,0,0,1,2,,train
0522445_as-0026871.jpg,0,0,0,1,1,,train
0522447_sc-153205.jpg,4,0,0,0,4,,train
0522448_sc-153205.jpg,0,0,1,0,1,,val
0522449_sc-153205.jpg,5,0,0,0,5,,val
0522450_as-2805842.jpg,1,0,0,0,1,,test
0522452_as-0063981.jpg,1,0,0,0,1,,train
0522453_as-0063981.jpg,1,0,0,0,1,,train
0522454_as-0063981.jpg,1,0,0,0,1,,train
0522455_as-0063981.jpg,1,0,0,0,1,,train
0522457_sc-220624.jpg,0,1,0,0,1,,train
0522458_as-3332883.jpg,1,1,1,0,3,,train
0522459_as-0004286.jpg,1,0,1,0,2,,train
0522460_as-0004286.jpg,1,0,1,0,2,,val
0522461_sc-200067.jpg,0,0,2,0,2,,val
0522462_sc-200067.jpg,0,1,1,0,2,,test
0522463_sc-200067.jpg,0,2,2,2,6,,train
0522465_sc-118761.jpg,2,0,0,1,3,,train
0522466_sc-118761.jpg,2,0,0,0,2,,train
0522468_sc-161567.jpg,5,0,1,1,7,,train
0522469_sc-161567.jpg,5,0,2,2,9,,train
0522470_sc-161567.jpg,2,0,2,2,6,,train
0522471_sc-161567.jpg,2,0,2,0,4,,train
0522472_sc-161567.jpg,4,0,1,0,5,,val
0522473_as-0024450.jpg,2,0,0,0,2,,val
0522474_as-0024450.jpg,0,0,0,2,2,,test
0522475_as-0024450.jpg,1,1,1,1,4,,train
0522476_sc-150421.jpg,3,0,0,1,4,,train
0522477_sc-150421.jpg,2,0,0,1,3,,train
0522478_sc-150421.jpg,3,0,0,1,4,,train
0522479_sc-147804.jpg,2,2,3,1,8,,train
0522480_as-7826565.jpg,1,0,0,0,1,,train
0522481_sc-1028407.jpg,2,0,0,0,2,,train
0522482_as-0022286.jpg,2,0,0,1,3,,val
0522483_as-0022286.jpg,1,0,0,0,1,,val
0522486_as-0009632.jpg,1,0,0,0,1,,test
0522488_as-0009632.jpg,0,0,0,1,1,,train
0522490_as-0009632.jpg,4,0,0,0,4,,train
0522493_as-3261817.jpg,4,1,0,0,5,,train
0522494_as-3039674.jpg,1,0,0,0,1,,train
0522496_sc-1020098.jpg,0,0,1,0,1,,train
0522497_sc-1020098.jpg,0,0,1,0,1,,train
0522498_sc-1020098.jpg,0,0,1,0,1,,train
0522499_sc-143489.jpg,1,0,0,1,2,,val
0522501_sc-143489.jpg,1,0,0,1,2,,val
0522503_as-2573720.jpg,2,0,0,0,2,,test
0522504_as-0089974.jpg,1,0,0,0,1,,train
0522505_as-0089974.jpg,1,0,1,0,2,,train
0522506_as-0089974.jpg,0,2,0,0,2,,train
0522508_as-3365132.jpg,2,0,0,0,2,,train
0522509_sc-219182.jpg,1,0,0,1,2,,train
0522510_sc-219182.jpg,1,0,0,0,1,,train
0522511_sc-219182.jpg,1,0,0,0,1,,train
0522512_sc-219182.jpg,2,0,0,0,2,,val
0522513_sc-219182.jpg,1,0,1,0,2,,val
0522514_sc-219182.jpg,1,0,2,1,4,,test
0522515_sc-219182.jpg,1,0,1,1,3,,train
0522516_as-3292696.jpg,1,0,0,0,1,,train
0522518_as-0009836.jpg,4,0,0,0,4,,train
0522519_as-0009836.jpg,4,0,0,0,4,,train
0522520_as-0037685.jpg,1,0,1,1,3,,train
0522521_as-0037685.jpg,2,0,1,0,3,,train
0522523_as-0037685.jpg,2,0,0,1,3,,train
0522525_as-0037685.jpg,1,0,0,1,2,,val
0522526_as-0037685.jpg,1,0,0,0,1,,val
0522527_sc-206430.jpg,1,0,2,0,3,,test
0522528_sc-206430.jpg,1,1,0,0,2,,train
0522530_as-0089890.jpg,1,0,0,0,1,,train
0522531_as-0089890.jpg,1,0,0,0,1,,train
0522532_as-0089890.jpg,1,0,0,0,1,,train
0522533_as-0089890.jpg,1,0,0,0,1,,train
0522534_as-0089890.jpg,2,0,0,0,2,,train
0522535_as-0089890.jpg,1,0,0,0,1,,train
0522537_as-7248886.jpg,1,0,0,0,1,,val
0522538_as-3449862.jpg,2,0,0,0,2,,val
0522539_as-7577522.jpg,1,0,0,1,2,,test
0522540_sc-219503.jpg,1,0,0,1,2,,train
0522541_sc-219503.jpg,1,0,0,0,1,,train
0522542_sc-219503.jpg,1,0,0,1,2,,train
0522543_sc-207019.jpg,3,0,0,0,3,,train
0522544_sc-207019.jpg,4,0,0,0,4,,train
0522545_as-9015948.jpg,1,0,1,0,2,,train
0522546_sc-172281.jpg,0,1,0,0,1,,train
0522547_sc-172281.jpg,0,1,0,0,1,,val
0522548_as-2841942.jpg,2,0,1,0,3,,val
0522550_sc-196748.jpg,2,1,0,0,3,,test
0522551_sc-196748.jpg,3,1,0,0,4,,train
0522552_sc-196748.jpg,2,0,0,0,2,,train
0522553_as-2610838.jpg,1,1,0,1,3,,train
0522554_sc-156801.jpg,1,1,1,0,3,,train
0522555_sc-156801.jpg,7,1,2,0,10,,train
0522556_sc-156801.jpg,5,1,1,0,7,,train
0522557_sc-156801.jpg,3,0,0,0,3,,train
0522558_sc-156801.jpg,2,1,1,1,5,,val
0522559_sc-156801.jpg,6,2,1,0,9,,val
0522560_sc-156801.jpg,3,1,1,0,5,,test
0522561_sc-204834.jpg,2,1,0,0,3,,train
0522562_sc-204834.jpg,1,1,0,0,2,,train
0522564_as-0076844.jpg,1,0,0,0,1,,train
0522565_as-0076844.jpg,1,0,0,0,1,,train
0522567_sc-197854.jpg,1,0,1,0,2,,train
0522568_sc-197854.jpg,1,0,1,0,2,,train
0522569_sc-197854.jpg,0,1,1,0,2,,train
0522570_as-0081168.jpg,3,1,0,0,4,,val
0522571_as-7283701.jpg,8,0,0,0,8,,val
0522572_as-2625517.jpg,0,0,1,0,1,,test
0522573_sc-183313.jpg,0,1,0,0,1,,train
0522579_as-0016441.jpg,1,0,0,0,1,,train
0522580_as-0016441.jpg,3,0,3,2,8,,train
0522581_as-0016441.jpg,0,0,1,0,1,,train
0522582_as-0080391.jpg,1,0,0,0,1,,train
0522583_as-0080391.jpg,2,0,1,1,4,,train
0522584_as-2887577.jpg,0,0,1,0,1,,train
0522585_as-3195730.jpg,1,0,0,0,1,,val
0522586_sc-199629.jpg,1,2,0,0,3,,val
0522587_sc-199629.jpg,2,2,0,0,4,,test
0522588_sc-199629.jpg,3,1,0,0,4,,train
0522589_as-2602056.jpg,3,0,0,0,3,,train
0522590_sc-164201.jpg,3,0,0,0,3,,train
0522591_sc-171944.jpg,1,0,0,0,1,,train
0522592_sc-217149.jpg,5,0,0,1,6,,train
0522593_sc-217149.jpg,3,0,0,1,4,,train
0522598_sc-218458.jpg,1,1,1,0,3,,train
0522601_as-0081985.jpg,1,0,2,0,3,,val
0522602_as-0081985.jpg,4,0,1,0,5,,val
0522603_as-0081985.jpg,2,0,1,0,3,,test
0522604_as-0081985.jpg,0,0,1,0,1,,train
0522605_as-0081985.jpg,0,0,1,0,1,,train
0522607_as-2904233.jpg,2,0,1,1,4,,train
0522608_as-2719027.jpg,4,4,2,1,11,,train
0522611_sc-1023275.jpg,3,0,3,1,7,,train
0522612_sc-1023275.jpg,2,0,2,2,6,,train
0522613_sc-1023275.jpg,2,0,1,0,3,,train
0522614_sc-201127.jpg,0,1,0,0,1,,val
0522615_sc-1041411.jpg,1,0,0,0,1,,val
0522616_sc-1041411.jpg,3,0,0,0,3,,test
0522617_sc-1041411.jpg,1,0,0,0,1,,train
0522618_sc-230564.jpg,1,0,0,0,1,,train
0522619_sc-230564.jpg,3,0,0,0,3,,train
0522620_sc-230564.jpg,1,0,0,0,1,,train
0522621_sc-230564.jpg,1,0,0,0,1,,train
0522622_sc-216201.jpg,2,0,0,0,2,,train
0522630_as-0041518.jpg,2,0,0,0,2,,train
0522631_as-0041518.jpg,1,0,0,0,1,,val
0522632_as-0029469.jpg,1,0,0,0,1,,val
0522634_sc-144438.jpg,1,0,0,0,1,,test
0522635_sc-144438.jpg,1,0,0,0,1,,train
0522637_as-0013114.jpg,3,0,0,0,3,,train
0522638_as-0013114.jpg,1,0,0,0,1,,train
0522639_as-0013114.jpg,3,0,0,0,3,,train
0522640_as-0013114.jpg,1,0,0,0,1,,train
0522641_as-0013114.jpg,1,0,0,0,1,,train
0522642_as-0013114.jpg,1,0,0,0,1,,train
0522643_as-2691185.jpg,1,0,0,0,1,,val
0522644_as-0051281.jpg,3,3,8,4,18,,val
0522645_as-0051281.jpg,2,1,6,4,13,,test
0522646_as-0051281.jpg,1,0,6,4,11,,train
0522648_as-0051281.jpg,0,0,2,0,2,,train
0522649_as-0051281.jpg,0,0,2,0,2,,train
0522650_as-2802486.jpg,3,0,0,2,5,,train
0522651_sc-187980.jpg,1,0,0,0,1,,train
0522654_sc-187980.jpg,2,0,1,2,5,,train
0522656_as-3167151.jpg,2,0,0,0,2,,train
0522657_sc-111778.jpg,3,0,0,0,3,,val
0522658_sc-111778.jpg,4,0,0,1,5,,val
0522660_as-3418942.jpg,1,1,1,1,4,,test
0522661_sc-1021761.jpg,1,0,1,0,2,,train
0522664_as-0064784.jpg,0,2,2,0,4,,train
0522665_as-0064784.jpg,5,2,2,0,9,,train
0522669_sc-186516.jpg,3,0,2,1,6,,train
0522670_sc-186516.jpg,1,0,2,1,4,,train
0522672_sc-186516.jpg,3,0,2,1,6,,train
0522673_sc-186516.jpg,0,0,1,1,2,,train
0522674_sc-186516.jpg,1,0,2,1,4,,val
0522675_sc-186516.jpg,3,0,2,1,6,,val
0522676_as-0058203.jpg,2,1,1,1,5,,test
0522677_as-0058203.jpg,1,1,1,1,4,,train
0522678_as-0058203.jpg,1,0,0,0,1,,train
0522679_as-0058203.jpg,2,1,0,1,4,,train
0522680_as-0058203.jpg,1,0,0,0,1,,train
0522682_as-0058203.jpg,1,0,0,0,1,,train
0522683_as-0058203.jpg,2,0,0,0,2,,train
0522684_as-0058203.jpg,2,0,0,0,2,,train
0522688_sc-186379.jpg,1,1,0,0,2,,val
0522692_as-0017092.jpg,1,1,0,0,2,,val
0522693_as-0017092.jpg,1,1,0,0,2,,test
0522694_as-0017092.jpg,1,0,0,0,1,,train
0522695_as-0017092.jpg,1,1,0,0,2,,train
0522696_sc-1017738.jpg,3,0,1,0,4,,train
0522697_sc-1017738.jpg,3,0,1,0,4,,train
0522698_as-9051131.jpg,1,0,0,0,1,,train
0522699_sc-196827.jpg,4,0,0,1,5,,train
0522700_sc-196827.jpg,3,0,0,0,3,,train
0522701_sc-196827.jpg,3,0,0,1,4,,val
0522702_sc-1008812.jpg,0,0,1,0,1,,val
0522703_sc-1008812.jpg,1,0,1,0,2,,test
0522705_as-3025225.jpg,2,0,0,0,2,,train
0522706_as-3476968.jpg,1,0,0,0,1,,train
0522707_as-0055077.jpg,1,1,0,0,2,,train
0522708_sc-202959.jpg,4,0,0,0,4,,train
0522709_sc-202959.jpg,1,0,0,0,1,,train
0522710_sc-202959.jpg,1,0,0,0,1,,train
0522711_sc-202959.jpg,2,0,0,0,2,,train
0522712_sc-202959.jpg,1,0,0,0,1,,val
0522713_sc-202959.jpg,2,0,0,0,2,,val
0522714_sc-202959.jpg,2,0,0,0,2,,test
0522715_sc-202959.jpg,1,0,0,0,1,,train
0522716_sc-182132.jpg,0,0,1,1,2,,train
0522717_sc-182132.jpg,2,0,0,0,2,,train
0522718_sc-182132.jpg,1,0,1,1,3,,train
0522719_sc-182132.jpg,0,0,0,2,2,,train
0522720_sc-182132.jpg,1,0,0,1,2,,train
0522721_sc-182132.jpg,0,0,0,1,1,,train
0522722_as-0039790.jpg,1,0,0,0,1,,val
0522723_as-0039790.jpg,2,0,0,0,2,,val
0522724_as-0039790.jpg,2,0,0,0,2,,test
0522725_sc-200524.jpg,1,0,2,1,4,,train
0522726_sc-200524.jpg,2,0,1,1,4,,train
0522728_as-0037000.jpg,0,0,1,0,1,,train
0522729_as-0037000.jpg,0,0,1,1,2,,train
0522730_as-2654867.jpg,1,0,0,1,2,,train
0522732_as-0055648.jpg,2,0,1,0,3,,train
0522733_as-0055648.jpg,1,0,0,0,1,,train
0522734_as-0055648.jpg,1,0,0,0,1,,val
0522735_as-0055648.jpg,1,0,0,0,1,,val
0522736_as-0055648.jpg,1,0,1,0,2,,test
0522738_as-0061865.jpg,1,0,0,0,1,,train
0522739_as-0061865.jpg,3,0,0,0,3,,train
0522741_sc-1009146.jpg,1,0,0,0,1,,train
0522742_sc-1002734.jpg,1,0,0,0,1,,train
0522743_sc-1002734.jpg,1,0,0,0,1,,train
0522744_sc-180336.jpg,0,0,1,0,1,,train
0522745_as-3159548.jpg,6,2,2,1,11,,train
0522746_as-0027244.jpg,4,0,0,0,4,,val
0522747_as-0027244.jpg,5,0,0,0,5,,val
0522748_as-0027244.jpg,9,0,0,0,9,,test
0522749_as-0027244.jpg,1,0,0,0,1,,train
0522750_as-0027244.jpg,1,0,0,0,1,,train
0522751_as-0027244.jpg,1,0,0,0,1,,train
0522752_sc-219316.jpg,3,0,0,1,4,,train
0522753_sc-219316.jpg,2,0,0,0,2,,train
0522754_sc-219316.jpg,1,0,0,1,2,,train
0522755_sc-219316.jpg,3,0,0,0,3,,train
0522756_sc-219316.jpg,2,0,0,0,2,,val
0522757_sc-219316.jpg,3,0,0,0,3,,val
0522758_sc-219316.jpg,9,0,0,0,9,,test
0522759_sc-219316.jpg,9,0,0,0,9,,train
0522760_sc-1016634.jpg,7,2,1,1,11,,train
0522761_sc-1016634.jpg,5,3,1,1,10,,train
0522762_sc-1016634.jpg,2,1,1,1,5,,train
0522763_sc-1016634.jpg,7,1,1,1,10,,train
0522765_as-0082755.jpg,2,0,0,0,2,,train
0522768_as-0082755.jpg,1,0,1,1,3,,train
0522769_as-0082755.jpg,2,0,1,2,5,,val
0522770_as-0082755.jpg,2,0,1,2,5,,val
0522771_as-0082755.jpg,2,0,0,0,2,,test
0522772_as-0082755.jpg,3,0,0,0,3,,train
0522773_as-0082755.jpg,2,0,1,1,4,,train
0522774_as-0082755.jpg,1,0,2,2,5,,train
0522775_as-0082755.jpg,2,0,0,0,2,,train
0522776_as-0082755.jpg,2,0,1,1,4,,train
0522778_sc-159472.jpg,5,0,0,2,7,,train
0522779_sc-159472.jpg,5,0,0,2,7,,train
0522780_sc-159472.jpg,0,0,0,1,1,,val
0522781_sc-1018066.jpg,1,0,0,0,1,,val
0522782_sc-1029524.jpg,1,0,0,0,1,,test
0522784_as-0078095.jpg,2,0,1,1,4,,train
0522785_as-0078095.jpg,2,0,0,1,3,,train
0522786_as-0078095.jpg,2,0,0,0,2,,train
0522787_as-0078095.jpg,3,0,1,1,5,,train
0522788_as-9019455.jpg,2,0,1,0,3,,train
0522790_sc-225301.jpg,1,0,0,0,1,,train
0522792_sc-225301.jpg,1,0,0,0,1,,train
0522793_sc-166552.jpg,1,0,1,1,3,,val
0522794_sc-166552.jpg,2,0,0,1,3,,val
0522795_sc-166552.jpg,1,0,0,1,2,,test
0522796_sc-166552.jpg,2,0,0,1,3,,train
0522797_sc-166552.jpg,1,0,1,0,2,,train
0522799_as-0070291.jpg,1,0,0,0,1,,train
0522800_as-0070291.jpg,1,0,0,0,1,,train
0522802_as-0072602.jpg,2,0,2,0,4,,train
0522803_as-0072602.jpg,2,0,2,0,4,,train
0522804_as-0072602.jpg,3,0,2,0,5,,train
0522808_sc-161886.jpg,4,0,0,0,4,,val
0522809_sc-161886.jpg,4,0,0,0,4,,val
0522811_sc-161886.jpg,1,0,1,0,2,,test
0522812_as-0090284.jpg,1,1,0,0,2,,train
0522820_as-0090284.jpg,1,1,1,2,5,,train
0522821_as-0090284.jpg,0,1,1,0,2,,train
0522822_as-9058484.jpg,1,0,0,0,1,,train
0522825_as-0030152.jpg,2,0,0,0,2,,train
0522826_as-0030152.jpg,1,1,0,1,3,,train
0522827_as-0030152.jpg,1,1,1,1,4,,train
0522829_as-3102867.jpg,2,0,0,0,2,,val
0522831_as-2504090.jpg,1,0,0,0,1,,val
0522833_sc-105068.jpg,3,1,0,0,4,,test
0522834_sc-105068.jpg,1,1,0,1,3,,train
0522835_sc-124347.jpg,1,0,0,0,1,,train
0522837_as-2526459.jpg,1,0,0,0,1,,train
0522840_sc-213648.jpg,1,0,1,0,2,,train
0522841_sc-213648.jpg,1,0,1,0,2,,train
0522842_sc-213648.jpg,1,0,0,0,1,,train
0522843_sc-138540.jpg,0,1,0,0,1,,train
0522844_as-0073899.jpg,2,3,1,0,6,,val
0522845_as-9014619.jpg,1,0,0,0,1,,val
0522846_as-0034721.jpg,3,0,3,1,7,,test
0522847_as-0034721.jpg,7,0,1,0,8,,train
0522848_as-0034721.jpg,4,0,3,1,8,,train
0522849_as-0034721.jpg,6,0,2,1,9,,train
0522852_as-0000571.jpg,1,0,1,0,2,,train
0522853_as-0000571.jpg,2,0,0,0,2,,train
0522854_as-0000571.jpg,1,0,0,2,3,,train
0522855_as-0000571.jpg,0,1,0,0,1,,train
0522856_as-2619459.jpg,2,0,0,0,2,,val
0522857_sc-209639.jpg,3,0,1,0,4,,val
0522858_sc-197517.jpg,1,0,0,0,1,,test
0522859_sc-197517.jpg,2,0,0,0,2,,train
0522860_as-7910796.jpg,1,0,1,0,2,,train
0522861_as-0069786.jpg,1,0,1,0,2,,train
0522862_as-0012481.jpg,2,0,0,0,2,,train
0522863_sc-189330.jpg,3,0,0,0,3,,train
0522864_sc-1029147.jpg,1,0,0,0,1,,train
0522865_sc-1029147.jpg,2,0,0,0,2,,train
0522867_sc-208009.jpg,1,0,1,0,2,,val
0522868_sc-208009.jpg,1,0,1,0,2,,val
0522869_sc-208009.jpg,1,0,1,0,2,,test
0522870_sc-208009.jpg,1,0,0,0,1,,train
0522871_sc-208009.jpg,1,0,0,0,1,,train
0522873_as-0056642.jpg,4,1,0,2,7,,train
0522874_as-0056642.jpg,2,1,1,1,5,,train
0522875_as-0056642.jpg,2,0,1,1,4,,train
0522876_as-0056642.jpg,0,1,0,0,1,,train
0522877_as-0056642.jpg,1,0,0,0,1,,train
0522878_as-0056642.jpg,1,0,0,0,1,,val
0522879_as-0056642.jpg,0,0,1,0,1,,val
0522880_as-0056642.jpg,0,0,1,0,1,,test
0522881_as-0056642.jpg,0,0,1,0,1,,train
0522882_as-0056642.jpg,1,0,0,0,1,,train
0522883_as-0056642.jpg,1,0,0,0,1,,train
0522884_as-0056642.jpg,1,0,0,0,1,,train
0522885_as-0056642.jpg,1,0,0,1,2,,train
0522886_as-0056642.jpg,0,0,0,1,1,,train
0522887_sc-215474.jpg,1,0,1,0,2,,train
0522888_sc-215474.jpg,1,0,0,0,1,,val
0522889_sc-215474.jpg,2,0,1,1,4,,val
0522890_sc-215474.jpg,1,0,0,1,2,,test
0522891_as-0062592.jpg,1,0,1,0,2,,train
0522893_as-0062592.jpg,2,0,0,0,2,,train
0522895_as-0062592.jpg,3,0,0,0,3,,train
0522896_as-0062592.jpg,3,0,1,1,5,,train
0522897_as-0062592.jpg,2,0,0,0,2,,train
0522898_as-0062592.jpg,3,0,0,0,3,,train
0522901_as-0062592.jpg,3,0,1,0,4,,train
0522902_as-0062592.jpg,1,0,0,0,1,,val
0522903_sc-1032882.jpg,1,1,3,0,5,,val
0522904_as-2663874.jpg,2,0,1,1,4,,test
0522906_as-7096606.jpg,1,0,0,0,1,,train
0522907_as-2835464.jpg,1,0,0,0,1,,train
0522909_sc-119961.jpg,1,0,0,0,1,,train
0522910_sc-119961.jpg,1,0,0,0,1,,train
0522911_sc-119961.jpg,1,0,0,0,1,,train
0522912_sc-119961.jpg,1,0,0,0,1,,train
0522913_sc-179263.jpg,6,0,0,0,6,,train
0522914_as-3466732.jpg,2,0,0,0,2,,val
0522915_sc-1035619.jpg,2,0,0,0,2,,val
0522916_sc-1035619.jpg,2,0,0,0,2,,test
0522917_sc-1035619.jpg,2,0,0,0,2,,train
0522918_as-3475784.jpg,4,0,0,0,4,,train
0522919_sc-128608.jpg,1,2,1,0,4,,train
0522920_sc-128608.jpg,0,0,1,0,1,,train
0522925_sc-187560.jpg,4,0,0,0,4,,train
0522927_as-3431187.jpg,2,0,0,0,2,,train
0522929_sc-176801.jpg,0,1,5,0,6,,train
0522931_as-2526162.jpg,3,0,0,0,3,,val
0522933_sc-148289.jpg,1,0,0,0,1,,val
0522935_sc-148289.jpg,0,0,1,0,1,,test
0522936_sc-148289.jpg,3,0,0,2,5,,train
0522937_sc-148289.jpg,0,1,0,2,3,,train
0522938_sc-148289.jpg,3,0,0,1,4,,train
0522939_sc-148289.jpg,1,0,0,1,2,,train
0522940_sc-148289.jpg,0,1,0,0,1,,train
0522942_sc-148289.jpg,0,1,0,0,1,,train
0522943_sc-148289.jpg,0,2,1,1,4,,train
0522944_sc-148289.jpg,1,0,0,2,3,,val
0522945_sc-148289.jpg,2,0,0,1,3,,val
0522946_sc-148289.jpg,2,0,0,1,3,,test
0522947_sc-148289.jpg,0,3,1,0,4,,train
0522948_sc-148289.jpg,0,1,2,0,3,,train
0522949_sc-148289.jpg,0,3,0,3,6,,train
0522950_sc-148289.jpg,1,1,2,1,5,,train
0522951_sc-148289.jpg,0,1,0,0,1,,train
0522952_sc-148289.jpg,2,1,3,2,8,,train
0522953_sc-148289.jpg,2,1,3,2,8,,train
0522954_sc-148289.jpg,2,3,4,2,11,,val
0522955_sc-137984.jpg,1,0,0,0,1,,val
0522956_sc-137984.jpg,0,0,1,0,1,,test
0522957_sc-137984.jpg,0,0,1,0,1,,train
0522958_sc-229399.jpg,0,1,0,0,1,,train
0522959_sc-1018375.jpg,9,0,0,0,9,,train
0522960_sc-1018375.jpg,6,0,0,0,6,,train
0522961_sc-1018375.jpg,4,0,0,0,4,,train
0522962_sc-1018375.jpg,5,0,0,0,5,,train
0522963_sc-1018375.jpg,9,0,0,0,9,,train
0522964_sc-1018375.jpg,6,0,1,0,7,,val
0522966_sc-1018375.jpg,8,0,0,1,9,,val
0522967_sc-1018375.jpg,7,0,0,1,8,,test
0522968_as-2891361.jpg,1,0,1,1,3,,train
0522970_as-0068474.jpg,2,3,2,0,7,,train
0522971_as-0068474.jpg,2,3,2,0,7,,train
0522972_as-0008255.jpg,2,0,0,0,2,,train
0522973_as-0008255.jpg,1,0,0,0,1,,train
0522977_as-7214511.jpg,1,0,0,0,1,,train
0522979_as-0086097.jpg,3,0,0,1,4,,train
0522980_as-0086097.jpg,1,0,0,1,2,,val
0522981_as-0086097.jpg,2,0,0,1,3,,val
0522982_as-0086097.jpg,1,0,0,1,2,,test
0522983_sc-201389.jpg,3,0,0,1,4,,train
0522984_sc-201389.jpg,4,0,0,0,4,,train
0522985_sc-201389.jpg,3,0,0,1,4,,train
0522986_sc-201389.jpg,3,0,0,0,3,,train
0522987_as-0012291.jpg,3,0,0,0,3,,train
0522988_as-0012291.jpg,1,0,0,0,1,,train
0522989_sc-1041656.jpg,3,0,1,0,4,,train
0522990_sc-1041656.jpg,0,0,1,0,1,,val
0522991_sc-1041656.jpg,1,0,1,0,2,,val
0522992_sc-205640.jpg,1,0,0,0,1,,test
0522993_sc-205640.jpg,1,0,0,0,1,,train
0522994_sc-202736.jpg,8,0,0,2,10,,train
0522995_sc-202736.jpg,6,0,0,0,6,,train
0522996_sc-134407.jpg,1,0,0,0,1,,train
0522997_sc-134407.jpg,1,0,0,0,1,,train
0522998_sc-134407.jpg,1,0,0,0,1,,train
0522999_as-2555092.jpg,2,0,1,1,4,,train
0523000_sc-1032418.jpg,1,0,0,0,1,,val
0523001_sc-1032418.jpg,1,0,0,0,1,,val
0523002_sc-1032418.jpg,1,0,0,0,1,,test
0523003_sc-1032418.jpg,1,0,0,0,1,,train
0523004_as-3247021.jpg,3,1,0,0,4,,train
0523005_sc-168214.jpg,1,0,0,0,1,,train
0523006_sc-168214.jpg,1,0,0,0,1,,train
0523007_sc-168214.jpg,1,0,0,0,1,,train
0523008_as-0089420.jpg,1,0,2,2,5,,train
0523009_as-0089420.jpg,1,0,1,1,3,,train
0523010_as-0089420.jpg,1,0,1,1,3,,val
0523011_sc-1013306.jpg,1,0,0,0,1,,val
0523012_sc-1013306.jpg,7,0,1,0,8,,test
0523013_sc-1013306.jpg,2,0,0,0,2,,train
0523014_sc-1013306.jpg,6,0,0,0,6,,train
0523015_sc-1013306.jpg,5,0,1,0,6,,train
0523016_as-2750533.jpg,2,0,1,0,3,,train
0523018_sc-1019889.jpg,0,1,0,0,1,,train
0523019_sc-1019889.jpg,1,0,0,0,1,,train
0523020_sc-1019889.jpg,3,1,0,1,5,,train
0523021_sc-1019889.jpg,1,0,0,0,1,,val
0523022_sc-1019889.jpg,1,0,0,0,1,,val
0523024_sc-1019889.jpg,1,0,0,1,2,,test
0523025_sc-159415.jpg,3,0,1,4,8,,train
0523026_sc-212148.jpg,4,0,0,0,4,,train
0523027_sc-212148.jpg,1,0,0,0,1,,train
0523028_sc-212148.jpg,1,0,0,0,1,,train
0523029_sc-212148.jpg,3,0,0,0,3,,train
0523030_sc-1018472.jpg,1,1,0,0,2,,train
0523031_sc-213566.jpg,4,0,0,0,4,,train
0523032_sc-213566.jpg,3,0,0,0,3,,val
0523033_sc-213566.jpg,5,0,0,0,5,,val
0523034_as-2748058.jpg,1,0,1,0,2,,test
0523035_as-2868138.jpg,2,0,0,0,2,,train
0523036_as-3070041.jpg,3,0,0,0,3,,train
0523037_as-0021060.jpg,0,0,2,1,3,,train
0523041_as-0071561.jpg,4,0,2,1,7,,train
0523042_as-0071561.jpg,4,0,2,1,7,,train
0523043_sc-217369.jpg,2,0,0,0,2,,train
0523044_as-3498061.jpg,1,0,0,0,1,,train
0523045_sc-190652.jpg,4,0,1,1,6,,val
0523046_sc-190652.jpg,3,0,1,1,5,,val
0523047_sc-190652.jpg,4,0,1,1,6,,test
0523049_as-0056093.jpg,0,0,2,0,2,,train
0523051_as-0056093.jpg,1,0,1,0,2,,train
0523052_as-0056093.jpg,1,0,1,0,2,,train
0523053_as-0056093.jpg,1,0,1,0,2,,train
0523054_as-0056093.jpg,1,0,1,0,2,,train
0523055_as-7450670.jpg,2,0,0,0,2,,train
0523056_sc-1032099.jpg,2,0,0,0,2,,train
0523057_sc-161217.jpg,1,0,0,0,1,,val
0523060_sc-213920.jpg,0,1,1,0,2,,val
0523061_sc-213920.jpg,0,1,0,0,1,,test
0523062_sc-213920.jpg,0,1,1,0,2,,train
0523063_sc-1031355.jpg,4,0,0,1,5,,train
0523066_sc-1031355.jpg,2,0,0,1,3,,train
0523067_sc-1031355.jpg,2,0,0,1,3,,train
0523068_sc-179385.jpg,1,0,0,1,2,,train
0523069_sc-179385.jpg,1,0,0,1,2,,train
0523070_as-0065801.jpg,2,0,0,1,3,,train
0523071_as-0065801.jpg,2,0,0,1,3,,val
0523072_as-0065801.jpg,2,0,0,1,3,,val
0523073_sc-230342.jpg,1,0,0,0,1,,test
0523074_sc-230342.jpg,1,0,0,0,1,,train
0523075_as-0040893.jpg,3,0,1,0,4,,train
0523076_as-0040893.jpg,3,0,1,0,4,,train
0523077_as-0040893.jpg,2,0,0,0,2,,train
0523078_as-0040893.jpg,1,0,0,0,1,,train
0523079_as-0040893.jpg,3,0,1,0,4,,train
0523080_sc-109292.jpg,2,1,0,0,3,,train
0523081_sc-109292.jpg,2,1,0,0,3,,val
0523084_sc-148200.jpg,1,0,0,0,1,,val
0523085_sc-148200.jpg,2,0,0,0,2,,test
0523086_sc-148200.jpg,2,0,0,0,2,,train
0523087_sc-148200.jpg,2,0,0,0,2,,train
0523088_sc-148200.jpg,1,0,0,2,3,,train
0523089_sc-148200.jpg,1,0,0,1,2,,train
0523090_as-0062341.jpg,0,1,0,0,1,,train
0523091_sc-1018443.jpg,2,1,0,1,4,,train
0523092_sc-1018443.jpg,2,1,0,2,5,,train
0523093_sc-1018443.jpg,2,0,0,1,3,,val
0523094_sc-1018443.jpg,2,2,0,1,5,,val
0523095_sc-1018443.jpg,1,1,0,1,3,,test
0523096_as-0039537.jpg,7,0,0,0,7,,train
0523098_as-0039537.jpg,10,0,0,0,10,,train
0523099_as-0024560.jpg,0,1,1,0,2,,train
0523100_as-0024560.jpg,2,1,0,0,3,,train
0523104_as-0061371.jpg,2,0,0,0,2,,train
0523106_as-0061371.jpg,0,0,0,1,1,,train
0523107_as-0061371.jpg,10,0,0,1,11,,train
0523108_as-0061371.jpg,4,0,0,1,5,,val
0523109_as-0061371.jpg,4,0,0,2,6,,val
0523110_as-0061371.jpg,8,0,0,2,10,,test
0523111_sc-1005967.jpg,1,0,0,0,1,,train
0523112_as-0015359.jpg,1,0,0,0,1,,train
0523113_as-0015359.jpg,1,0,0,1,2,,train
0523114_as-0015359.jpg,1,0,0,1,2,,train
0523115_as-0015359.jpg,1,0,0,0,1,,train
0523116_as-0015359.jpg,2,0,0,0,2,,train
0523117_as-0015359.jpg,1,0,0,0,1,,train
0523118_as-7725160.jpg,1,0,0,0,1,,val
0523119_as-0088920.jpg,6,0,0,0,6,,val
0523120_as-0088920.jpg,1,0,0,0,1,,test
0523121_sc-134552.jpg,1,0,0,0,1,,train
0523123_sc-134552.jpg,1,0,0,0,1,,train
0523124_as-0048253.jpg,1,0,0,0,1,,train
0523125_as-0048253.jpg,1,0,0,0,1,,train
0523126_as-0048253.jpg,1,1,0,0,2,,train
0523127_as-0048253.jpg,1,1,0,0,2,,train
0523128_as-0048253.jpg,1,1,0,0,2,,train
0523129_as-0048253.jpg,1,1,0,0,2,,val
0523130_as-0048253.jpg,2,2,0,0,4,,val
0523131_as-0048253.jpg,2,0,0,0,2,,test
0523132_as-0048253.jpg,2,1,0,0,3,,train
0523133_as-0045645.jpg,5,0,1,0,6,,train
0523134_as-0045645.jpg,6,0,2,0,8,,train
0523135_as-0045645.jpg,3,1,1,0,5,,train
0523136_as-0045645.jpg,2,1,0,0,3,,train
0523137_as-0045645.jpg,1,0,1,0,2,,train
0523138_as-0045645.jpg,2,0,0,1,3,,train
0523141_as-0058608.jpg,2,0,0,0,2,,val
0523142_sc-192979.jpg,1,0,0,0,1,,val
0523143_sc-192979.jpg,2,0,0,0,2,,test
0523144_sc-192979.jpg,1,0,1,0,2,,train
0523148_as-0058254.jpg,3,0,0,0,3,,train
0523149_as-0058254.jpg,2,0,0,0,2,,train
0523150_sc-180114.jpg,7,0,1,0,8,,train
0523151_sc-180114.jpg,6,0,1,0,7,,train
0523152_sc-180114.jpg,1,0,1,0,2,,train
0523154_as-0073764.jpg,3,1,1,1,6,,train
0523155_as-0073764.jpg,3,0,1,0,4,,val
0523156_as-0073764.jpg,1,0,0,0,1,,val
0523157_as-0079467.jpg,0,1,0,0,1,,test
0523160_sc-153603.jpg,2,1,1,0,4,,train
0523161_sc-153603.jpg,1,1,0,0,2,,train
0523162_sc-153603.jpg,1,0,1,0,2,,train
0523164_as-2795390.jpg,1,0,0,0,1,,train
0523165_as-7467440.jpg,4,0,0,0,4,,train
0523166_sc-197691.jpg,4,0,1,1,6,,train
0523167_sc-197691.jpg,6,0,1,1,8,,train
0523168_sc-184337.jpg,9,0,1,0,10,,val
0523170_sc-150060.jpg,1,0,0,1,2,,val
0523171_as-2655150.jpg,2,0,1,0,3,,test
0523172_sc-192550.jpg,1,0,0,1,2,,train
0523173_sc-1037476.jpg,1,0,0,0,1,,train
0523175_as-0073033.jpg,3,1,0,0,4,,train
0523176_as-0073033.jpg,2,4,0,0,6,,train
0523177_sc-206490.jpg,1,0,0,0,1,,train
0523178_sc-206490.jpg,2,0,0,0,2,,train
0523179_sc-170655.jpg,5,1,0,1,7,,train
0523180_sc-170655.jpg,8,0,0,1,9,,val
0523181_as-2635296.jpg,1,0,0,0,1,,val
0523182_sc-138016.jpg,1,0,0,0,1,,test
0523184_sc-196145.jpg,2,1,0,0,3,,train
0523186_sc-196145.jpg,2,0,0,0,2,,train
0523187_sc-196145.jpg,5,2,1,0,8,,train
0523188_sc-204835.jpg,1,0,0,0,1,,train
0523189_sc-204835.jpg,1,0,0,0,1,,train
0523190_as-3315813.jpg,2,0,1,0,3,,train
0523192_sc-199209.jpg,4,1,1,1,7,,train
0523194_sc-199209.jpg,2,0,0,0,2,,val
0523195_sc-199209.jpg,2,0,0,0,2,,val
0523196_sc-199209.jpg,1,0,0,0,1,,test
0523197_sc-199209.jpg,1,0,0,0,1,,train
0523198_sc-199209.jpg,2,0,0,1,3,,train
0523199_sc-199209.jpg,0,0,1,1,2,,train
0523200_sc-199209.jpg,3,0,0,0,3,,train
0523201_as-2738884.jpg,1,0,2,0,3,,train
0523202_as-7431708.jpg,7,0,0,0,7,,train
0523204_as-3313348.jpg,0,0,2,0,2,,train
0523205_as-3313348.jpg,1,0,0,0,1,,val
0523206_sc-206118.jpg,13,0,0,0,13,,val
0523207_sc-206118.jpg,4,0,0,0,4,,test
0523208_sc-206118.jpg,13,1,0,0,14,,train
0523210_as-3359338.jpg,1,0,0,0,1,,train
0523211_as-9079402.jpg,2,0,0,0,2,,train
0523212_sc-190451.jpg,2,0,0,1,3,,train
0523213_sc-203207.jpg,0,2,4,1,7,,train
0523214_sc-203207.jpg,1,2,1,0,4,,train
0523215_as-3362502.jpg,1,0,0,0,1,,train
0523217_as-9051757.jpg,1,0,0,0,1,,val
0523218_sc-142737.jpg,2,0,0,0,2,,val
0523219_sc-142737.jpg,5,0,0,0,5,,test
0523220_sc-142737.jpg,4,0,0,0,4,,train
0523221_sc-142737.jpg,3,0,0,0,3,,train
0523222_as-7430828.jpg,1,0,0,0,1,,train
0523223_sc-122888.jpg,1,1,0,0,2,,train
0523225_sc-122888.jpg,2,1,0,0,3,,train
0523228_sc-115950.jpg,4,2,1,0,7,,train
0523229_as-3392849.jpg,2,0,2,1,5,,train
0523230_as-2527705.jpg,1,0,1,0,2,,val
0523231_as-2657862.jpg,8,0,0,0,8,,val
0523232_as-2751815.jpg,2,0,1,0,3,,test
0523234_as-0023160.jpg,3,0,0,0,3,,train
0523235_as-0023160.jpg,3,0,0,0,3,,train
0523236_as-3167292.jpg,0,0,0,1,1,,train
0523238_sc-178992.jpg,4,0,0,0,4,,train
0523239_sc-178992.jpg,2,0,0,0,2,,train
0523240_sc-178992.jpg,1,0,1,0,2,,train
0523242_as-0032042.jpg,2,0,0,0,2,,train
0523243_as-0032042.jpg,2,0,0,0,2,,val
0523245_as-0032042.jpg,1,0,1,0,2,,val
0523246_as-0032042.jpg,0,1,1,0,2,,test
0523247_as-0032042.jpg,1,1,0,0,2,,train
0523248_as-0032042.jpg,1,1,0,0,2,,train
0523249_as-0032042.jpg,3,1,1,0,5,,train
0523250_sc-1033916.jpg,5,0,0,0,5,,train
0523251_sc-1033916.jpg,2,0,0,0,2,,train
0523252_sc-1033916.jpg,3,0,0,0,3,,train
0523253_sc-1033916.jpg,2,0,0,0,2,,train
0523257_as-0059627.jpg,6,1,0,1,8,,val
0523258_as-0059627.jpg,1,1,1,0,3,,val
0523259_as-0059627.jpg,1,1,1,0,3,,test
0523261_as-0059627.jpg,5,0,1,0,6,,train
0523263_as-0058561.jpg,5,0,2,1,8,,train
0523264_as-0058561.jpg,2,0,1,1,4,,train
0523265_sc-218784.jpg,2,0,2,1,5,,train
0523268_as-0077956.jpg,1,0,1,1,3,,train
0523269_as-0077956.jpg,3,0,0,0,3,,train
0523270_as-0077956.jpg,1,0,1,1,3,,train
0523272_sc-215311.jpg,1,0,1,0,2,,val
0523273_sc-215311.jpg,2,0,0,0,2,,val
0523274_sc-215311.jpg,2,0,1,0,3,,test
0523275_sc-215311.jpg,1,0,1,0,2,,train
0523276_sc-188490.jpg,3,0,0,0,3,,train
0523277_sc-188490.jpg,2,0,0,0,2,,train
0523280_sc-182225.jpg,2,0,1,0,3,,train
0523281_sc-182225.jpg,1,0,1,0,2,,train
0523282_sc-182225.jpg,6,0,1,1,8,,train
0523283_as-7714506.jpg,1,0,1,1,3,,train
0523284_as-0021151.jpg,1,0,4,2,7,,val
0523285_as-0021151.jpg,1,0,2,1,4,,val
0523286_as-0021151.jpg,1,0,3,2,6,,test
0523287_as-0021151.jpg,2,0,2,1,5,,train
0523288_sc-115583.jpg,0,0,1,0,1,,train
0523289_sc-115583.jpg,1,0,0,0,1,,train
0523291_sc-115583.jpg,1,0,0,0,1,,train
0523292_sc-115583.jpg,0,0,0,1,1,,train
0523293_as-9095600.jpg,1,0,0,0,1,,train
0523294_sc-206274.jpg,1,0,0,0,1,,train
0523295_sc-206274.jpg,1,0,0,0,1,,val
0523296_sc-206274.jpg,2,0,1,0,3,,val
0523297_sc-206274.jpg,3,0,1,0,4,,test
0523298_sc-206274.jpg,2,0,0,0,2,,train
0523299_sc-206274.jpg,0,1,0,0,1,,train
0523300_sc-206274.jpg,3,0,0,0,3,,train
0523301_sc-206274.jpg,2,0,0,0,2,,train
0523302_sc-206274.jpg,3,0,0,0,3,,train
0523303_as-0031536.jpg,2,0,0,0,2,,train
0523304_as-3286170.jpg,3,0,0,0,3,,train
0523309_sc-200311.jpg,6,1,1,2,10,,val
0523310_sc-200311.jpg,0,1,0,0,1,,val
0523311_sc-200311.jpg,3,1,0,0,4,,test
0523313_sc-200311.jpg,6,1,4,1,12,,train
0523314_sc-200311.jpg,3,0,1,2,6,,train
0523315_sc-200311.jpg,5,0,1,0,6,,train
0523316_sc-200311.jpg,0,1,1,0,2,,train
0523317_sc-200311.jpg,6,3,3,0,12,,train
0523318_sc-200311.jpg,2,0,0,0,2,,train
0523319_sc-200311.jpg,0,1,0,0,1,,train
0523320_sc-200311.jpg,5,0,1,0,6,,val
0523322_sc-200311.jpg,9,0,3,0,12,,val
0523323_sc-200311.jpg,1,0,1,0,2,,test
0523325_sc-200311.jpg,4,0,0,0,4,,train
0523326_sc-200311.jpg,2,0,0,0,2,,train
0523328_as-2641284.jpg,3,0,0,0,3,,train
0523329_as-0070753.jpg,1,0,0,0,1,,train
0523330_as-0070753.jpg,1,0,0,1,2,,train
0523333_as-0056633.jpg,1,1,3,0,5,,train
0523336_as-0056633.jpg,4,0,1,1,6,,train
0523337_as-0056633.jpg,1,1,1,0,3,,val
0523338_as-0056633.jpg,0,0,2,1,3,,val
0523339_sc-183549.jpg,9,0,0,0,9,,test
0523340_sc-183549.jpg,0,0,1,0,1,,train
0523341_sc-183549.jpg,0,0,1,0,1,,train
0523342_sc-183549.jpg,0,0,1,0,1,,train
0523343_sc-183549.jpg,0,1,1,0,2,,train
0523344_sc-192273.jpg,1,0,1,1,3,,train
0523345_sc-192273.jpg,1,0,1,0,2,,train
0523346_sc-192273.jpg,3,0,1,0,4,,train
0523347_sc-192273.jpg,1,0,1,0,2,,val
0523348_sc-192273.jpg,3,0,1,0,4,,val
0523349_sc-207018.jpg,4,0,0,0,4,,test
0523350_sc-207018.jpg,2,0,0,0,2,,train
0523351_sc-207018.jpg,2,0,0,0,2,,train
0523352_sc-126762.jpg,2,1,0,0,3,,train
0523353_sc-126762.jpg,0,0,1,0,1,,train
0523354_sc-176657.jpg,4,1,0,0,5,,train
0523355_sc-176657.jpg,2,0,0,0,2,,train
0523358_as-0038003.jpg,9,0,0,0,9,,train
0523360_sc-1005995.jpg,0,0,1,0,1,,val
0523361_sc-1005995.jpg,1,1,2,0,4,,val
0523362_sc-1005995.jpg,2,2,2,0,6,,test
0523363_sc-1005995.jpg,1,1,0,0,2,,train
0523364_sc-1005995.jpg,1,1,3,0,5,,train
0523365_sc-1005995.jpg,2,2,6,0,10,,train
0523366_sc-192205.jpg,1,0,0,0,1,,train
0523367_sc-192205.jpg,1,0,0,0,1,,train
0523368_sc-192205.jpg,1,0,0,0,1,,train
0523369_as-3208043.jpg,3,0,0,0,3,,train
0523370_sc-1007826.jpg,0,0,2,1,3,,val
0523372_sc-115697.jpg,1,0,0,0,1,,val
0523374_as-0083989.jpg,3,2,1,1,7,,test
0523376_as-0083989.jpg,0,0,0,1,1,,train
0523377_sc-152840.jpg,0,1,0,1,2,,train
0523378_sc-152840.jpg,4,1,0,1,6,,train
0523379_sc-152840.jpg,1,2,1,1,5,,train
0523380_sc-152840.jpg,1,2,1,1,5,,train
0523381_sc-152840.jpg,4,1,0,1,6,,train
0523382_sc-206883.jpg,3,0,0,0,3,,train
0523383_sc-206883.jpg,4,0,0,1,5,,val
0523384_sc-206883.jpg,1,0,0,0,1,,val
0523385_sc-206883.jpg,2,0,0,0,2,,test
0523386_sc-206883.jpg,4,0,0,0,4,,train
0523387_sc-206883.jpg,2,0,1,2,5,,train
0523388_sc-206883.jpg,3,0,1,3,7,,train
0523389_sc-206883.jpg,3,0,1,4,8,,train
0523390_as-3126731.jpg,1,0,1,0,2,,train
0523394_sc-203806.jpg,1,0,0,0,1,,train
0523395_sc-203806.jpg,2,0,0,0,2,,train
0523398_as-0080198.jpg,2,1,0,0,3,,val
0523399_as-0080198.jpg,1,0,0,0,1,,val
0523401_as-0080198.jpg,1,0,0,0,1,,test
0523402_sc-138265.jpg,1,0,0,0,1,,train
0523403_sc-138265.jpg,1,0,0,0,1,,train
0523404_sc-138265.jpg,1,0,0,0,1,,train
0523405_sc-138265.jpg,1,0,0,0,1,,train
0523406_sc-170530.jpg,1,1,0,0,2,,train
0523408_as-0020129.jpg,0,0,0,1,1,,train
0523409_as-0020129.jpg,1,0,0,1,2,,train
0523410_as-0020129.jpg,1,0,0,1,2,,val
0523411_as-0020129.jpg,0,1,0,3,4,,val
0523412_as-0020129.jpg,0,1,0,2,3,,test
0523413_sc-1032497.jpg,0,0,4,0,4,,train
0523414_sc-1032497.jpg,0,1,0,0,1,,train
0523416_as-0022482.jpg,2,0,0,0,2,,train
0523417_as-0022482.jpg,2,0,0,0,2,,train
0523418_as-0022482.jpg,1,0,0,0,1,,train
0523419_sc-211250.jpg,3,0,1,0,4,,train
0523420_as-0075799.jpg,1,0,0,0,1,,train
0523423_sc-158365.jpg,1,0,0,0,1,,val
0523424_sc-158365.jpg,1,1,3,2,7,,val
0523425_as-7416544.jpg,1,0,0,0,1,,test
0523426_sc-134415.jpg,1,0,0,1,2,,train
0523427_sc-134415.jpg,2,0,0,1,3,,train
0523428_sc-134415.jpg,2,0,0,1,3,,train
0523429_sc-154951.jpg,1,0,0,0,1,,train
0523430_sc-154951.jpg,1,0,0,0,1,,train
0523431_as-2711526.jpg,2,0,0,0,2,,train
0523432_as-0015789.jpg,1,0,0,0,1,,train
0523433_as-0015789.jpg,0,0,1,0,1,,val
0523434_as-0015789.jpg,1,0,1,0,2,,val
0523436_as-0038834.jpg,3,0,1,1,5,,test
0523437_as-0038834.jpg,2,0,0,0,2,,train
0523438_as-0038834.jpg,1,0,0,0,1,,train
0523439_as-0038834.jpg,1,0,0,0,1,,train
0523440_as-0038834.jpg,1,0,0,0,1,,train
0523441_as-9083498.jpg,1,0,0,0,1,,train
0523443_sc-229655.jpg,5,2,0,1,8,,train
0523444_sc-229655.jpg,2,2,0,1,5,,train
0523447_sc-112868.jpg,6,0,0,0,6,,val
0523448_sc-112868.jpg,1,0,0,0,1,,val
0523449_sc-112868.jpg,1,0,0,0,1,,test
0523451_sc-138329.jpg,2,0,0,0,2,,train
0523452_sc-138329.jpg,7,1,0,2,10,,train
0523453_sc-138329.jpg,1,0,0,1,2,,train
0523454_sc-138329.jpg,4,0,0,2,6,,train
0523455_sc-137453.jpg,2,0,0,0,2,,train
0523456_sc-137453.jpg,1,0,0,0,1,,train
0523457_sc-137453.jpg,1,0,0,0,1,,train
0523458_sc-137453.jpg,1,0,1,0,2,,val
0523460_sc-137453.jpg,2,0,1,0,3,,val
0523461_sc-137453.jpg,1,0,0,0,1,,test
0523462_sc-137453.jpg,1,0,0,0,1,,train
0523463_as-9018821.jpg,1,0,0,0,1,,train
0523464_as-3245553.jpg,3,0,0,0,3,,train
0523465_sc-1033615.jpg,1,0,0,0,1,,train
0523466_sc-1033615.jpg,1,0,0,1,2,,train
0523467_sc-1033615.jpg,1,0,0,0,1,,train
0523468_as-2608129.jpg,1,1,0,0,2,,train
0523473_as-0041583.jpg,1,0,1,0,2,,val
0523475_as-0041583.jpg,2,0,1,1,4,,val
0523477_as-0041583.jpg,1,0,1,1,3,,test
0523478_as-0041583.jpg,1,0,2,1,4,,train
0523479_as-0041583.jpg,1,0,0,0,1,,train
0523480_as-0041583.jpg,1,0,0,0,1,,train
0523483_sc-142724.jpg,0,0,1,0,1,,train
0523484_sc-142724.jpg,1,0,1,0,2,,train
0523486_sc-142724.jpg,6,0,1,0,7,,train
0523487_sc-142724.jpg,5,0,0,0,5,,train
0523488_sc-142724.jpg,3,0,0,0,3,,val
0523489_sc-142724.jpg,5,0,0,0,5,,val
0523491_sc-142724.jpg,3,0,0,0,3,,test
0523492_sc-142724.jpg,3,0,0,0,3,,train
0523493_sc-142724.jpg,6,0,1,0,7,,train
0523494_sc-206325.jpg,1,0,0,0,1,,train
0523495_as-5045702.jpg,2,0,0,0,2,,train
0523496_sc-173104.jpg,2,0,0,0,2,,train
0523498_sc-226239.jpg,2,0,1,0,3,,train
0523499_sc-1022379.jpg,4,0,0,0,4,,train
0523501_sc-132890.jpg,2,0,2,0,4,,val
0523502_sc-132890.jpg,7,0,1,0,8,,val
0523504_sc-132890.jpg,0,1,0,0,1,,test
0523505_sc-132890.jpg,4,0,0,0,4,,train
0523506_sc-132890.jpg,4,0,0,0,4,,train
0523507_sc-132890.jpg,1,0,0,0,1,,train
0523508_sc-132890.jpg,0,1,0,0,1,,train
0523510_as-0022727.jpg,1,0,1,0,2,,train
0523511_as-0022727.jpg,3,0,0,0,3,,train
0523512_as-0022727.jpg,4,0,0,0,4,,train
0523513_as-7723242.jpg,3,2,2,0,7,,val
0523514_as-7580394.jpg,1,0,0,1,2,,val
0523517_as-0060371.jpg,3,0,0,0,3,,test
0523518_as-0060371.jpg,1,0,0,0,1,,train
0523519_as-3374709.jpg,1,0,0,0,1,,train
0523521_sc-128046.jpg,1,0,0,0,1,,train
0523522_as-3229166.jpg,1,0,0,0,1,,train
0523524_as-0064944.jpg,9,1,0,0,10,,train
0523525_as-0064944.jpg,7,1,0,0,8,,train
0523527_as-0064944.jpg,2,0,0,0,2,,train
0523528_sc-146133.jpg,2,0,0,0,2,,val
0523529_as-3327261.jpg,6,0,0,0,6,,val
0523530_sc-1004421.jpg,6,0,0,0,6,,test
0523531_sc-1004421.jpg,3,0,0,0,3,,train
0523532_as-2651650.jpg,1,0,0,0,1,,train
0523533_as-3300688.jpg,2,1,0,0,3,,train
0523534_sc-227589.jpg,1,0,1,1,3,,train
0523535_sc-227589.jpg,3,0,3,1,7,,train
0523536_sc-227589.jpg,3,0,1,1,5,,train
0523537_sc-227589.jpg,2,0,2,2,6,,train
0523539_sc-173171.jpg,2,0,0,0,2,,val
0523541_sc-146151.jpg,1,0,0,0,1,,val
0523545_sc-146151.jpg,0,1,0,0,1,,test
0523546_sc-146151.jpg,0,2,0,0,2,,train
0523547_sc-146151.jpg,1,0,0,0,1,,train
0523548_sc-146151.jpg,2,0,0,0,2,,train
0523549_sc-146151.jpg,1,0,0,0,1,,train
0523550_sc-146151.jpg,1,0,0,0,1,,train
0523551_sc-146151.jpg,1,0,1,1,3,,train
0523552_sc-146151.jpg,1,0,0,0,1,,train
0523554_as-7395075.jpg,1,0,0,0,1,,val
0523555_sc-205770.jpg,1,0,0,0,1,,val
0523556_sc-188953.jpg,1,0,2,0,3,,test
0523557_sc-188953.jpg,2,0,2,0,4,,train
0523558_sc-220601.jpg,1,0,0,0,1,,train
0523559_sc-220601.jpg,2,0,0,0,2,,train
0523560_sc-220601.jpg,1,0,0,0,1,,train
0523561_sc-220601.jpg,3,0,1,1,5,,train
0523562_sc-220601.jpg,1,0,1,1,3,,train
0523563_sc-220601.jpg,1,0,1,1,3,,train
0523564_sc-220601.jpg,1,0,1,0,2,,val
0523565_sc-220601.jpg,1,0,1,1,3,,val
0523566_sc-220601.jpg,1,0,0,0,1,,test
0523567_sc-220601.jpg,3,0,0,0,3,,train
0523568_sc-225406.jpg,1,0,1,0,2,,train
0523569_sc-225406.jpg,2,0,1,1,4,,train
0523570_sc-225406.jpg,1,0,2,1,4,,train
0523571_sc-225406.jpg,1,0,1,1,3,,train
0523573_sc-225406.jpg,1,0,0,1,2,,train
0523574_sc-225406.jpg,3,0,1,1,5,,train
0523575_sc-225406.jpg,2,1,0,0,3,,val
0523576_sc-225406.jpg,3,1,0,0,4,,val
0523577_sc-225406.jpg,2,0,1,0,3,,test
0523578_sc-225406.jpg,1,3,0,0,4,,train
0523579_as-2712694.jpg,3,0,1,0,4,,train
0523580_sc-215098.jpg,1,1,2,0,4,,train
0523581_sc-215098.jpg,1,1,1,0,3,,train
0523582_sc-215098.jpg,1,1,1,0,3,,train
0523583_as-9002638.jpg,1,0,0,0,1,,train
0523584_as-2990084.jpg,1,1,1,0,3,,train
0523585_as-0075014.jpg,1,0,1,1,3,,val
0523586_as-0075014.jpg,1,0,0,1,2,,val
0523587_as-0075014.jpg,3,0,0,2,5,,test
0523589_sc-136060.jpg,0,1,0,0,1,,train
0523591_as-0074980.jpg,1,0,0,1,2,,train
0523592_sc-205558.jpg,6,0,1,0,7,,train
0523593_sc-205558.jpg,8,0,1,0,9,,train
0523594_as-2747587.jpg,3,3,4,3,13,,train
0523596_sc-1026044.jpg,1,0,1,2,4,,train
0523597_sc-129312.jpg,1,1,0,0,2,,train
0523598_sc-129312.jpg,3,1,0,0,4,,val
0523599_sc-129312.jpg,1,1,0,0,2,,val
0523600_sc-129312.jpg,1,0,0,0,1,,test
0523601_as-2882311.jpg,1,0,0,0,1,,train
0523602_as-0047337.jpg,1,0,0,0,1,,train
0523604_as-0004390.jpg,0,1,1,1,3,,train
0523605_as-0004390.jpg,0,3,0,1,4,,train
0523606_as-0004390.jpg,0,1,0,1,2,,train
0523607_as-3208507.jpg,0,0,1,0,1,,train
0523610_as-0051846.jpg,0,1,1,0,2,,train
0523611_as-0094922.jpg,1,0,0,1,2,,val
0523612_as-0094922.jpg,3,0,0,0,3,,val
0523614_as-3479073.jpg,1,0,0,1,2,,test
0523615_sc-199672.jpg,1,1,0,0,2,,train
0523616_sc-199672.jpg,1,1,0,0,2,,train
0523617_sc-199672.jpg,1,1,0,0,2,,train
0523619_sc-199672.jpg,1,0,0,0,1,,train
0523620_sc-199672.jpg,1,0,1,0,2,,train
0523621_sc-199672.jpg,1,0,1,0,2,,train
0523622_as-0028847.jpg,3,1,1,0,5,,train
0523623_as-0028847.jpg,3,1,0,0,4,,val
0523624_as-0028847.jpg,0,0,1,0,1,,val
0523627_sc-162680.jpg,1,0,0,0,1,,test
0523628_sc-162680.jpg,1,0,0,0,1,,train
0523629_sc-162680.jpg,1,0,0,0,1,,train
0523632_as-2777418.jpg,1,0,1,2,4,,train
0523633_sc-130185.jpg,3,0,0,0,3,,train
0523634_sc-1022628.jpg,2,0,1,0,3,,train
0523635_sc-214080.jpg,2,0,0,0,2,,train
0523636_sc-214080.jpg,1,0,1,0,2,,train
0523637_sc-214080.jpg,1,0,1,0,2,,val
0523638_sc-214080.jpg,1,0,0,0,1,,val
0523639_as-2972036.jpg,2,3,1,0,6,,test
0523640_sc-175786.jpg,3,0,0,0,3,,train
0523641_as-0076781.jpg,1,2,0,0,3,,train
0523642_as-0076781.jpg,2,0,1,0,3,,train
0523644_as-2769248.jpg,1,0,0,0,1,,train
0523645_sc-167417.jpg,0,0,1,0,1,,train
0523647_as-0046534.jpg,0,0,1,0,1,,train
0523648_as-0046534.jpg,0,0,1,0,1,,train
0523649_as-0046534.jpg,0,0,1,0,1,,val
0523650_as-0046534.jpg,0,0,1,0,1,,val
0523651_as-0095972.jpg,8,0,1,4,13,,test
0523653_sc-219094.jpg,1,0,1,1,3,,train
0523654_sc-219094.jpg,2,1,0,0,3,,train
0523655_sc-219094.jpg,1,1,0,0,2,,train
0523656_sc-219094.jpg,1,1,1,0,3,,train
0523657_sc-219094.jpg,1,1,1,0,3,,train
0523658_sc-219094.jpg,1,1,1,0,3,,train
0523659_sc-219094.jpg,1,0,1,1,3,,train
0523660_sc-1023024.jpg,1,0,0,0,1,,val
0523661_as-7528628.jpg,1,1,0,0,2,,val
0523662_sc-145627.jpg,9,0,0,0,9,,test
0523663_sc-145627.jpg,2,0,0,0,2,,train
0523664_sc-145627.jpg,3,0,0,0,3,,train
0523668_as-0029264.jpg,4,3,0,3,10,,train
0523671_as-0093699.jpg,5,3,0,0,8,,train
0523673_sc-140816.jpg,1,0,0,0,1,,train
0523674_sc-186107.jpg,0,1,0,0,1,,train
0523677_as-0010827.jpg,4,1,0,0,5,,train
0523680_as-0010827.jpg,3,0,0,1,4,,val
0523681_as-3142044.jpg,1,0,0,0,1,,val
0523682_sc-1002288.jpg,2,0,0,1,3,,test
0523683_sc-1002288.jpg,2,0,0,1,3,,train
0523684_sc-1002288.jpg,1,0,0,0,1,,train
0523686_sc-1031011.jpg,1,0,0,0,1,,train
0523687_sc-1031011.jpg,1,0,0,0,1,,train
0523688_as-3186747.jpg,1,0,0,0,1,,train
0523689_sc-160045.jpg,1,0,0,0,1,,train
0523690_sc-160045.jpg,2,0,0,0,2,,train
0523691_sc-160045.jpg,2,0,0,0,2,,val
0523692_sc-143691.jpg,5,0,0,0,5,,val
0523693_sc-143691.jpg,5,1,1,2,9,,test
0523694_sc-143691.jpg,2,1,0,0,3,,train
0523695_sc-143691.jpg,3,1,1,2,7,,train
0523696_sc-143691.jpg,3,1,1,2,7,,train
0523697_sc-143691.jpg,2,1,0,0,3,,train
0523699_sc-1026217.jpg,6,1,1,0,8,,train
0523700_sc-1026217.jpg,6,1,0,0,7,,train
0523702_sc-1026217.jpg,4,0,1,0,5,,train
0523703_sc-1026217.jpg,13,0,2,0,15,,val
0523705_as-0064704.jpg,2,0,0,0,2,,val
0523706_as-0064704.jpg,0,0,2,0,2,,test
0523709_as-0064704.jpg,1,0,0,0,1,,train
0523710_as-0064704.jpg,1,0,0,0,1,,train
0523712_as-0064704.jpg,2,0,0,0,2,,train
0523713_as-0064704.jpg,1,0,0,0,1,,train
0523716_as-0071969.jpg,2,0,0,1,3,,train
0523717_as-0071969.jpg,2,0,0,1,3,,train
0523718_sc-179280.jpg,0,0,1,0,1,,train
0523719_sc-179280.jpg,1,1,0,0,2,,val
0523720_sc-179280.jpg,0,0,1,0,1,,val
0523721_sc-179280.jpg,0,0,0,1,1,,test
0523722_sc-123257.jpg,2,0,0,0,2,,train
0523723_sc-123257.jpg,2,0,0,0,2,,train
0523725_sc-123257.jpg,7,0,0,0,7,,train
0523726_sc-123257.jpg,5,0,0,0,5,,train
0523727_sc-123257.jpg,3,0,0,0,3,,train
0523728_sc-123257.jpg,1,0,0,0,1,,train
0523729_as-2859471.jpg,1,0,0,0,1,,train
0523730_sc-223813.jpg,1,0,1,1,3,,val
0523731_sc-214696.jpg,2,0,0,0,2,,val
0523732_sc-214696.jpg,4,0,0,0,4,,test
0523733_sc-214696.jpg,3,0,0,0,3,,train
0523734_sc-214696.jpg,4,0,0,0,4,,train
0523735_sc-214696.jpg,2,0,1,0,3,,train
0523737_as-2749663.jpg,0,0,1,0,1,,train
0523738_as-0072686.jpg,9,0,0,0,9,,train
0523739_sc-210288.jpg,6,0,0,0,6,,train
0523740_sc-210288.jpg,5,0,0,0,5,,train
0523741_sc-210288.jpg,3,0,0,0,3,,val
0523743_sc-210288.jpg,4,0,0,0,4,,val
0523744_sc-210288.jpg,1,0,0,0,1,,test
0523745_sc-210288.jpg,2,0,0,0,2,,train
0523746_sc-210288.jpg,1,0,0,0,1,,train
0523747_sc-210288.jpg,1,0,0,0,1,,train
0523748_sc-210288.jpg,1,0,0,0,1,,train
0523750_sc-1027007.jpg,5,1,0,0,6,,train
0523751_sc-1027007.jpg,1,0,0,0,1,,train
0523752_as-2710612.jpg,3,0,0,0,3,,train
0523753_sc-131050.jpg,1,0,0,0,1,,val
0523755_sc-131050.jpg,1,0,0,0,1,,val
0523756_as-3224046.jpg,1,0,0,0,1,,test
0523757_sc-1007475.jpg,1,1,0,0,2,,train
0523758_sc-1007475.jpg,0,1,0,0,1,,train
0523759_as-0055679.jpg,1,0,0,0,1,,train
0523760_sc-153471.jpg,1,1,0,0,2,,train
0523761_sc-153471.jpg,7,1,0,0,8,,train
0523762_sc-204435.jpg,4,0,0,0,4,,train
0523763_sc-204435.jpg,1,0,0,0,1,,train
0523765_as-0065141.jpg,1,2,3,2,8,,val
0523766_as-0065141.jpg,5,6,2,0,13,,val
0523767_as-0065141.jpg,2,1,0,0,3,,test
0523768_as-0065141.jpg,0,2,2,0,4,,train
0523769_as-0065141.jpg,1,0,1,1,3,,train
0523770_as-0065141.jpg,0,0,1,0,1,,train
0523773_as-0065141.jpg,3,1,1,2,7,,train
0523774_as-0065141.jpg,3,2,2,1,8,,train
0523776_as-0065141.jpg,0,1,0,0,1,,train
0523778_as-0073000.jpg,1,0,0,0,1,,train
0523779_as-0073000.jpg,1,0,1,0,2,,val
0523780_as-0073000.jpg,0,0,1,0,1,,val
0523781_as-0048513.jpg,0,1,1,1,3,,test
0523782_as-0048513.jpg,0,0,1,0,1,,train
0523783_as-0078811.jpg,4,0,0,0,4,,train
0523786_sc-1010519.jpg,0,0,1,0,1,,train
0523787_sc-1010519.jpg,0,0,1,0,1,,train
0523788_sc-1023892.jpg,5,0,0,2,7,,train
0523789_sc-1023892.jpg,4,0,0,0,4,,train
0523790_as-3203734.jpg,1,0,0,0,1,,train
0523791_as-0034593.jpg,0,1,0,0,1,,val
0523792_as-0034593.jpg,1,1,0,0,2,,val
0523793_as-0034593.jpg,2,0,1,0,3,,test
0523794_as-0034593.jpg,1,1,0,1,3,,train
0523795_as-0034593.jpg,3,0,0,2,5,,train
0523796_as-0034593.jpg,2,1,0,1,4,,train
0523797_as-0034593.jpg,3,0,0,0,3,,train
0523798_sc-110752.jpg,2,0,0,0,2,,train
0523799_sc-110752.jpg,1,0,0,0,1,,train
0523800_as-0093753.jpg,2,0,1,0,3,,train
0523802_as-0093753.jpg,3,0,0,0,3,,val
0523803_as-0093753.jpg,1,0,1,0,2,,val
0523804_as-3170415.jpg,1,0,0,0,1,,test
0523805_as-3170415.jpg,0,0,0,1,1,,train
0523806_as-7647033.jpg,1,0,0,0,1,,train
0523809_as-0087970.jpg,1,0,0,0,1,,train
0523811_as-0018108.jpg,1,0,0,0,1,,train
0523812_as-0018108.jpg,1,0,0,0,1,,train
0523813_sc-226383.jpg,2,1,0,1,4,,train
0523814_as-0065587.jpg,1,1,1,0,3,,train
0523816_as-0065587.jpg,2,0,0,0,2,,val
0523817_as-0051343.jpg,0,1,1,1,3,,val
0523820_sc-144031.jpg,1,0,0,0,1,,test
0523821_sc-144031.jpg,1,0,0,0,1,,train
0523822_sc-144031.jpg,1,0,0,0,1,,train
0523823_sc-144031.jpg,1,0,1,0,2,,train
0523824_sc-144031.jpg,1,0,1,0,2,,train
0523825_sc-144031.jpg,1,0,0,0,1,,train
0523826_sc-144031.jpg,1,0,0,0,1,,train
0523827_as-2981382.jpg,2,1,1,2,6,,train
0523828_sc-122215.jpg,2,0,1,0,3,,val
0523829_sc-122215.jpg,1,1,0,0,2,,val
0523830_sc-122215.jpg,1,0,0,0,1,,test
0523831_sc-122215.jpg,1,0,0,0,1,,train
0523832_sc-122215.jpg,1,0,0,0,1,,train
0523833_sc-122215.jpg,1,0,1,0,2,,train
0523834_sc-122215.jpg,2,0,0,0,2,,train
0523835_sc-122215.jpg,1,1,0,0,2,,train
0523836_sc-122215.jpg,1,0,0,0,1,,train
0523837_sc-122215.jpg,1,0,0,0,1,,train
0523838_as-0095093.jpg,1,0,0,0,1,,val
0523839_as-0095093.jpg,1,1,0,0,2,,val
0523840_as-0095093.jpg,1,1,0,0,2,,test
0523841_as-0095093.jpg,1,1,0,0,2,,train
0523842_as-0095093.jpg,1,0,0,0,1,,train
0523844_sc-1016859.jpg,2,0,0,1,3,,train
0523845_sc-1016859.jpg,1,0,0,0,1,,train
0523846_sc-1016859.jpg,1,0,0,1,2,,train
0523847_sc-148495.jpg,3,2,2,3,10,,train
0523849_sc-148495.jpg,2,2,1,0,5,,train
0523850_sc-148495.jpg,0,0,1,3,4,,val
0523851_sc-148495.jpg,0,1,0,0,1,,val
0523852_sc-148495.jpg,5,1,1,3,10,,test
0523855_sc-169717.jpg,1,0,0,0,1,,train
0523856_sc-169717.jpg,2,0,0,1,3,,train
0523857_sc-169717.jpg,3,1,0,0,4,,train
0523858_sc-169717.jpg,2,0,0,2,4,,train
0523862_sc-169717.jpg,1,2,0,0,3,,train
0523863_sc-169717.jpg,5,0,0,0,5,,train
0523864_sc-169717.jpg,1,1,0,0,2,,train
0523865_sc-169717.jpg,1,0,1,1,3,,val
0523866_sc-169717.jpg,2,0,0,1,3,,val
0523871_as-0041759.jpg,2,0,0,0,2,,test
0523872_as-0041759.jpg,2,2,0,0,4,,train
0523873_as-0041759.jpg,1,1,0,0,2,,train
0523874_as-0041759.jpg,1,1,0,0,2,,train
0523875_as-0041759.jpg,2,1,0,0,3,,train
0523876_as-0041759.jpg,3,0,0,0,3,,train
0523877_as-0041759.jpg,1,1,0,0,2,,train
0523878_as-0041759.jpg,1,1,0,0,2,,train
0523879_as-0041759.jpg,2,1,0,0,3,,val
0523880_sc-204260.jpg,1,0,1,0,2,,val
0523881_sc-204260.jpg,1,0,1,0,2,,test
0523882_sc-204260.jpg,2,0,0,0,2,,train
0523883_sc-204260.jpg,1,0,1,0,2,,train
0523884_sc-204260.jpg,2,0,1,0,3,,train
0523885_sc-204260.jpg,1,0,0,0,1,,train
0523886_sc-204260.jpg,1,0,0,0,1,,train
0523887_sc-204260.jpg,1,0,0,0,1,,train
0523888_sc-204260.jpg,4,0,0,0,4,,train
0523889_sc-204260.jpg,2,0,0,0,2,,val
0523890_sc-204260.jpg,1,0,1,0,2,,val
0523891_sc-204260.jpg,1,0,0,0,1,,test
0523892_sc-204260.jpg,2,0,1,0,3,,train
0523893_sc-204260.jpg,1,1,0,0,2,,train
0523895_as-0039970.jpg,3,2,3,0,8,,train
0523896_sc-1018700.jpg,1,0,0,1,2,,train
0523899_sc-1018700.jpg,1,0,0,1,2,,train
0523900_sc-140598.jpg,3,0,0,0,3,,train
0523901_sc-140598.jpg,1,0,0,0,1,,train
0523902_sc-140598.jpg,2,0,0,0,2,,val
0523903_sc-140598.jpg,2,0,0,0,2,,val
0523904_sc-140598.jpg,2,0,0,0,2,,test
0523905_sc-140598.jpg,3,0,0,0,3,,train
0523906_sc-140598.jpg,1,0,0,0,1,,train
0523907_sc-110466.jpg,2,0,0,0,2,,train
0523908_sc-110466.jpg,2,0,0,1,3,,train
0523909_sc-110466.jpg,1,0,0,0,1,,train
0523910_sc-110466.jpg,2,0,0,0,2,,train
0523911_sc-110466.jpg,2,0,0,0,2,,train
0523912_sc-110466.jpg,2,0,0,0,2,,val
0523914_as-0088478.jpg,1,0,0,0,1,,val
0523915_as-0088478.jpg,2,0,0,0,2,,test
0523916_as-0088478.jpg,2,0,0,0,2,,train
0523917_as-0088478.jpg,2,0,0,0,2,,train
0523918_as-0088478.jpg,3,0,0,0,3,,train
0523921_sc-1018691.jpg,3,0,0,1,4,,train
0523922_sc-1018691.jpg,5,0,0,2,7,,train
0523923_sc-1018691.jpg,1,0,0,1,2,,train
0523924_sc-1018691.jpg,1,0,0,1,2,,train
0523925_sc-1018691.jpg,7,0,0,0,7,,val
0523926_sc-1018322.jpg,3,1,2,1,7,,val
0523927_sc-1018322.jpg,2,1,1,1,5,,test
0523928_sc-1018322.jpg,5,0,0,0,5,,train
0523930_sc-1018322.jpg,2,0,1,1,4,,train
0523931_sc-1018322.jpg,1,0,1,1,3,,train
0523933_sc-1018322.jpg,1,0,1,1,3,,train
0523934_sc-1018322.jpg,1,0,0,0,1,,train
0523937_sc-197668.jpg,1,0,0,0,1,,train
0523938_sc-197668.jpg,1,0,0,0,1,,train
0523940_as-2616049.jpg,2,1,0,0,3,,val
0523941_sc-1015800.jpg,2,0,0,0,2,,val
0523942_sc-1015800.jpg,2,0,0,0,2,,test
0523943_sc-1015800.jpg,1,0,0,0,1,,train
0523944_sc-1015800.jpg,2,0,0,1,3,,train
0523945_as-0053156.jpg,1,0,0,0,1,,train
0523946_as-0053156.jpg,1,0,0,0,1,,train
0523947_as-0053156.jpg,1,0,0,0,1,,train
0523948_as-0053156.jpg,0,0,1,0,1,,train
0523951_sc-130021.jpg,2,0,0,2,4,,train
0523952_sc-130021.jpg,2,1,1,1,5,,val
0523953_sc-130021.jpg,1,1,1,1,4,,val
0523954_sc-130021.jpg,2,1,0,1,4,,test
0523955_sc-130021.jpg,2,0,0,1,3,,train
0523956_sc-130021.jpg,1,0,0,0,1,,train
0523957_sc-130021.jpg,1,0,1,1,3,,train
0523958_sc-130021.jpg,1,1,0,0,2,,train
0523959_sc-130021.jpg,1,1,0,0,2,,train
0523960_sc-130021.jpg,5,1,0,1,7,,train
0523961_sc-1008606.jpg,1,0,0,0,1,,train
0523963_as-3421178.jpg,0,0,1,1,2,,val
0523964_sc-1019986.jpg,9,0,2,0,11,,val
0523965_as-2507689.jpg,1,0,0,0,1,,test
0523966_sc-159027.jpg,1,0,0,0,1,,train
0523967_sc-159027.jpg,3,0,0,0,3,,train
0523968_sc-159027.jpg,1,0,0,1,2,,train
0523969_as-3224540.jpg,1,0,0,0,1,,train
0523971_as-0011185.jpg,6,1,0,0,7,,train
0523972_as-0011185.jpg,2,0,0,0,2,,train
0523973_as-0011185.jpg,1,1,2,0,4,,train
0523974_as-0032174.jpg,2,0,0,0,2,,val
0523975_as-0032174.jpg,2,0,0,0,2,,val
0523976_as-0032174.jpg,2,0,0,0,2,,test
0523978_as-0038375.jpg,6,0,0,0,6,,train
0523980_as-3263817.jpg,1,0,0,0,1,,train
0523981_as-3271359.jpg,2,1,1,1,5,,train
0523982_sc-128219.jpg,1,0,0,1,2,,train
0523983_sc-128219.jpg,1,0,0,2,3,,train
0523984_sc-128219.jpg,2,0,0,0,2,,train
0523985_as-7693363.jpg,0,0,1,1,2,,train
0523986_as-7474514.jpg,3,0,1,0,4,,val
0523987_as-3370576.jpg,1,0,0,0,1,,val
0523988_as-0023357.jpg,4,2,1,1,8,,test
0523990_sc-165928.jpg,2,1,0,0,3,,train
0523991_sc-165928.jpg,2,0,0,0,2,,train
0523992_sc-156512.jpg,1,0,0,0,1,,train
0523993_sc-156512.jpg,1,0,0,0,1,,train
0523994_sc-156512.jpg,1,0,0,0,1,,train
0523995_as-3452367.jpg,1,0,0,0,1,,train
0523996_sc-1001933.jpg,7,0,0,0,7,,train
0523997_sc-1001933.jpg,1,0,0,0,1,,val
0523998_as-0094101.jpg,1,0,0,0,1,,val
0523999_as-0094101.jpg,1,0,0,0,1,,test
0524000_as-2787032.jpg,1,0,0,0,1,,train
0524002_as-0064113.jpg,5,0,0,0,5,,train
0524005_sc-213271.jpg,2,1,1,0,4,,train
0524006_sc-213271.jpg,3,1,0,0,4,,train
0524007_sc-213271.jpg,2,0,2,0,4,,train
0524008_sc-213271.jpg,2,0,0,0,2,,train
0524009_sc-213271.jpg,3,0,0,0,3,,train
0524010_sc-159768.jpg,1,0,0,0,1,,val
0524011_sc-159768.jpg,1,0,0,0,1,,val
0524013_sc-159768.jpg,1,0,0,0,1,,test
0524014_sc-1017813.jpg,2,0,1,0,3,,train
0524015_sc-1017813.jpg,1,0,0,0,1,,train
0524018_sc-229390.jpg,0,0,1,1,2,,train
0524019_sc-131159.jpg,1,0,0,1,2,,train
0524021_as-3100508.jpg,3,0,0,0,3,,train
0524023_as-7653350.jpg,3,0,0,0,3,,train
0524024_as-0027972.jpg,1,0,0,0,1,,train
0524025_as-0027972.jpg,1,0,0,0,1,,val
0524026_sc-218003.jpg,1,1,1,0,3,,val
0524031_as-0037673.jpg,1,0,0,0,1,,test
0524032_as-0037673.jpg,0,1,0,0,1,,train
0524033_as-0037673.jpg,0,1,0,0,1,,train
0524034_as-0037673.jpg,1,0,0,0,1,,train
0524035_sc-180749.jpg,2,0,0,0,2,,train
0524036_sc-180749.jpg,5,0,0,0,5,,train
0524037_sc-180749.jpg,6,0,0,0,6,,train
0524039_sc-176312.jpg,1,1,1,0,3,,train
0524040_sc-176312.jpg,3,0,0,0,3,,val
0524043_sc-120917.jpg,2,0,0,0,2,,val
0524044_sc-120917.jpg,1,0,0,0,1,,test
0524045_as-3107713.jpg,1,0,0,0,1,,train
0524046_sc-205198.jpg,6,1,0,0,7,,train
0524047_sc-205198.jpg,3,0,0,0,3,,train
0524048_as-3105265.jpg,0,1,0,0,1,,train
0524049_sc-219486.jpg,2,0,0,0,2,,train
0524050_as-7840592.jpg,2,0,0,1,3,,train
0524051_sc-1010799.jpg,7,2,1,0,10,,train
0524052_sc-1010799.jpg,12,1,2,0,15,,val
0524053_as-2961909.jpg,1,0,0,1,2,,val
0524054_sc-112617.jpg,3,0,0,1,4,,test
0524055_sc-112617.jpg,1,0,0,1,2,,train
0524056_sc-112617.jpg,2,0,0,1,3,,train
0524057_sc-205153.jpg,3,0,0,0,3,,train
0524058_sc-205153.jpg,1,0,0,0,1,,train
0524060_as-0030575.jpg,1,0,0,0,1,,train
0524062_as-0030575.jpg,2,0,0,2,4,,train
0524063_as-0030575.jpg,3,0,0,0,3,,train
0524064_as-0030575.jpg,1,0,1,0,2,,val
0524065_as-0030575.jpg,1,0,1,1,3,,val
0524067_sc-211764.jpg,2,0,0,0,2,,test
0524068_sc-211764.jpg,2,0,0,0,2,,train
0524069_sc-211764.jpg,1,1,0,1,3,,train
0524070_sc-211764.jpg,5,3,4,2,14,,train
0524071_sc-211764.jpg,4,3,1,0,8,,train
0524072_sc-211764.jpg,3,0,2,0,5,,train
0524073_sc-211764.jpg,6,4,4,3,17,,train
0524074_sc-211764.jpg,4,4,3,3,14,,train
0524075_sc-211764.jpg,2,0,0,0,2,,val
0524076_sc-211764.jpg,4,0,0,0,4,,val
0524077_sc-136977.jpg,2,0,0,1,3,,test
0524078_sc-136977.jpg,3,0,0,1,4,,train
0524079_sc-136977.jpg,2,0,0,0,2,,train
0524081_sc-136977.jpg,1,0,0,1,2,,train
0524082_sc-136977.jpg,1,0,0,0,1,,train
0524083_sc-1012534.jpg,4,0,0,0,4,,train
0524084_sc-1012534.jpg,3,0,0,0,3,,train
0524085_sc-1012534.jpg,1,0,0,0,1,,train
0524086_sc-1004964.jpg,5,0,0,0,5,,val
0524088_sc-1004964.jpg,2,1,0,0,3,,val
0524091_as-0050773.jpg,3,0,0,0,3,,test
0524092_as-0050773.jpg,3,0,0,0,3,,train
0524093_sc-1025309.jpg,2,0,0,2,4,,train
0524094_sc-1025309.jpg,6,0,0,1,7,,train
0524095_sc-1025309.jpg,5,0,0,1,6,,train
0524096_sc-1025309.jpg,4,0,0,2,6,,train
0524097_sc-1025309.jpg,4,0,0,0,4,,train
0524098_sc-1025309.jpg,1,0,1,1,3,,train
0524099_sc-1025309.jpg,2,0,1,1,4,,val
0524100_sc-125470.jpg,2,0,0,0,2,,val
0524101_sc-125470.jpg,0,0,0,1,1,,test
0524102_as-0006371.jpg,0,0,1,0,1,,train
0524103_as-0006371.jpg,1,0,1,0,2,,train
0524105_sc-191899.jpg,1,0,0,1,2,,train
0524106_sc-191899.jpg,1,0,0,1,2,,train
0524107_sc-191899.jpg,1,0,0,1,2,,train
0524108_as-0016719.jpg,0,0,1,0,1,,train
0524109_as-0016719.jpg,0,0,1,0,1,,train
0524111_as-0016719.jpg,0,0,1,1,2,,val
0524112_as-0016719.jpg,0,0,1,1,2,,val
0524114_as-3106167.jpg,0,0,1,0,1,,test
0524115_as-7748337.jpg,1,0,0,0,1,,train
0524116_sc-219865.jpg,6,0,0,3,9,,train
0524117_sc-219865.jpg,1,0,0,0,1,,train
0524118_sc-219865.jpg,1,0,0,0,1,,train
0524119_sc-219865.jpg,3,0,0,0,3,,train
0524120_sc-219865.jpg,2,0,0,0,2,,train
0524121_sc-219865.jpg,3,0,0,0,3,,train
0524122_sc-219865.jpg,3,0,1,0,4,,val
0524123_sc-219865.jpg,1,0,1,0,2,,val
0524124_sc-219865.jpg,1,0,0,0,1,,test
0524125_as-0028785.jpg,10,0,0,0,10,,train
0524126_as-2731235.jpg,3,0,0,1,4,,train
0524127_sc-174529.jpg,1,0,0,0,1,,train
0524128_sc-174529.jpg,1,1,0,0,2,,train
0524129_as-0006487.jpg,3,0,0,0,3,,train
0524130_as-0069544.jpg,1,0,0,0,1,,train
0524131_sc-218473.jpg,0,1,1,0,2,,train
0524132_sc-218473.jpg,0,1,1,0,2,,val
0524133_sc-218473.jpg,1,0,1,2,4,,val
0524134_sc-218473.jpg,0,0,0,1,1,,test
0524135_sc-218473.jpg,2,0,0,1,3,,train
0524136_sc-218473.jpg,1,0,0,1,2,,train
0524137_as-0079535.jpg,1,0,0,0,1,,train
0524139_as-0079535.jpg,3,0,1,1,5,,train
0524141_as-0079535.jpg,3,0,0,0,3,,train
0524143_sc-1034307.jpg,2,0,1,0,3,,train
0524144_sc-1034307.jpg,5,0,1,0,6,,train
0524146_sc-1008155.jpg,3,1,1,0,5,,val
0524147_sc-1008155.jpg,0,0,1,0,1,,val
0524148_sc-1008155.jpg,3,0,1,0,4,,test
0524150_sc-1008155.jpg,1,3,2,0,6,,train
0524151_sc-1008155.jpg,2,0,2,0,4,,train
0524152_sc-1008155.jpg,2,0,0,0,2,,train
0524153_sc-1008155.jpg,2,2,1,0,5,,train
0524154_sc-1008155.jpg,0,0,1,0,1,,train
0524155_sc-1008155.jpg,0,0,1,0,1,,train
0524156_sc-1008155.jpg,0,1,1,1,3,,train
0524157_sc-159162.jpg,1,1,0,0,2,,val
0524158_sc-159162.jpg,1,1,0,0,2,,val
0524161_as-2612620.jpg,1,0,0,0,1,,test
0524162_sc-171512.jpg,2,0,0,0,2,,train
0524163_sc-171512.jpg,1,1,1,0,3,,train
0524164_sc-1022717.jpg,4,0,0,0,4,,train
0524165_sc-1022717.jpg,3,0,0,0,3,,train
0524166_as-2935130.jpg,1,0,1,0,2,,train
0524167_as-3110024.jpg,1,0,0,1,2,,train
0524168_sc-204594.jpg,1,0,0,0,1,,train
0524169_sc-204594.jpg,1,0,0,0,1,,val
0524170_sc-117749.jpg,1,0,0,0,1,,val
0524171_sc-117749.jpg,1,0,0,0,1,,test
0524172_as-0090191.jpg,1,0,0,0,1,,train
0524173_as-0090191.jpg,1,0,0,1,2,,train
0524174_as-0090191.jpg,1,1,0,1,3,,train
0524175_as-0090191.jpg,1,0,0,1,2,,train
0524176_as-9012735.jpg,1,0,0,0,1,,train
0524179_as-0017232.jpg,1,0,2,1,4,,train
0524181_as-0017232.jpg,1,0,0,0,1,,train
0524183_sc-197009.jpg,1,0,0,0,1,,val
0524184_sc-197009.jpg,1,0,0,0,1,,val
0524185_as-0045970.jpg,1,0,0,0,1,,test
0524186_as-0050407.jpg,1,0,0,1,2,,train
0524191_sc-115575.jpg,6,0,1,0,7,,train
0524192_as-0027121.jpg,7,0,1,2,10,,train
0524194_as-0027121.jpg,1,0,0,1,2,,train
0524195_as-0041037.jpg,1,0,0,0,1,,train
0524196_as-0041037.jpg,2,0,1,0,3,,train
0524197_sc-1020064.jpg,2,0,0,0,2,,train
0524198_sc-1020064.jpg,5,1,1,0,7,,val
0524199_sc-1020064.jpg,3,0,0,0,3,,val
0524200_sc-150062.jpg,2,0,0,2,4,,test
0524201_sc-150062.jpg,2,0,0,2,4,,train
0524202_sc-150062.jpg,7,0,0,2,9,,train
0524203_sc-150062.jpg,3,0,0,1,4,,train
0524204_sc-150062.jpg,5,0,0,2,7,,train
0524206_as-5197918.jpg,0,0,2,0,2,,train
0524208_as-7295326.jpg,4,0,1,1,6,,train
0524209_sc-222776.jpg,2,1,0,0,3,,train
0524210_sc-132270.jpg,0,0,0,1,1,,val
0524211_sc-132270.jpg,0,0,0,1,1,,val
0524212_sc-132270.jpg,0,0,0,2,2,,test
0524213_sc-132270.jpg,0,0,0,1,1,,train
0524217_as-0002488.jpg,3,0,0,1,4,,train
0524218_as-7175920.jpg,0,0,0,1,1,,train
0524219_as-3258515.jpg,1,1,2,0,4,,train
0524220_sc-216803.jpg,1,0,1,0,2,,train
0524221_sc-216803.jpg,1,0,1,0,2,,train
0524222_sc-216803.jpg,2,0,1,1,4,,train
0524223_sc-216803.jpg,1,0,0,0,1,,val
0524224_sc-216803.jpg,3,0,0,0,3,,val
0524225_as-0067975.jpg,0,0,2,0,2,,test
0524227_as-2695702.jpg,3,0,1,1,5,,train
0524228_as-2865459.jpg,2,0,0,1,3,,train
0524231_as-3136574.jpg,1,0,1,0,2,,train
0524232_as-2507664.jpg,1,0,1,1,3,,train
0524233_sc-1002919.jpg,1,1,0,0,2,,train
0524234_sc-1002919.jpg,2,0,0,0,2,,train
0524235_sc-1002919.jpg,1,0,0,0,1,,train
0524237_as-0003126.jpg,4,0,2,0,6,,val
0524238_as-0003126.jpg,2,0,1,0,3,,val
0524239_as-0003126.jpg,1,0,1,0,2,,test
0524240_as-0003126.jpg,1,0,1,0,2,,train
0524242_as-0004174.jpg,6,0,1,1,8,,train
0524243_as-0004174.jpg,2,0,1,0,3,,train
0524244_as-0004174.jpg,7,0,0,1,8,,train
0524245_as-0004174.jpg,1,0,0,0,1,,train
0524246_as-7457739.jpg,0,0,0,1,1,,train
0524247_sc-207967.jpg,4,1,0,0,5,,train
0524248_sc-207967.jpg,6,0,1,0,7,,val
0524249_sc-207967.jpg,3,0,0,0,3,,val
0524250_sc-207967.jpg,2,0,0,1,3,,test
0524251_sc-207967.jpg,7,0,0,0,7,,train
0524252_sc-207967.jpg,3,0,0,0,3,,train
0524253_sc-207967.jpg,2,0,1,0,3,,train
0524254_sc-207967.jpg,0,1,0,0,1,,train
0524255_as-9001416.jpg,2,0,0,0,2,,train
0524256_as-3115622.jpg,2,0,0,1,3,,train
0524257_sc-107590.jpg,2,0,0,0,2,,train
0524258_as-3185257.jpg,2,1,0,0,3,,val
0524259_as-2641714.jpg,1,0,1,0,2,,val
0524260_sc-217512.jpg,4,0,0,0,4,,test
0524261_sc-217512.jpg,3,0,1,0,4,,train
0524262_as-0017824.jpg,1,0,0,0,1,,train
0524263_as-0017824.jpg,2,0,0,0,2,,train
0524264_as-0017824.jpg,1,0,0,0,1,,train
0524265_sc-203333.jpg,4,0,0,0,4,,train
0524266_sc-203333.jpg,2,0,0,0,2,,train
0524267_sc-203333.jpg,4,0,0,0,4,,train
0524268_sc-203333.jpg,6,0,0,0,6,,val
0524269_sc-203333.jpg,1,0,1,0,2,,val
0524270_sc-203333.jpg,1,0,0,0,1,,test
0524271_as-3123604.jpg,1,0,3,1,5,,train
0524272_as-2574101.jpg,1,0,0,0,1,,train
0524273_as-3206681.jpg,6,0,1,0,7,,train
0524274_as-3245840.jpg,4,0,0,0,4,,train
0524275_sc-206833.jpg,4,0,0,0,4,,train
0524276_sc-206833.jpg,4,1,0,0,5,,train
0524277_sc-206833.jpg,3,1,1,0,5,,train
0524278_sc-206833.jpg,4,0,0,0,4,,val
0524279_sc-206833.jpg,3,0,1,1,5,,val
0524280_sc-134027.jpg,1,0,0,0,1,,test
0524281_as-7284220.jpg,6,0,1,1,8,,train
0524282_as-0006616.jpg,3,0,1,0,4,,train
0524283_as-0006616.jpg,11,0,2,1,14,,train
0524284_as-0006616.jpg,9,0,0,1,10,,train
0524285_as-0006616.jpg,4,0,0,0,4,,train
0524287_as-0006616.jpg,0,0,0,1,1,,train
0524288_sc-137795.jpg,4,0,0,0,4,,train
0524289_sc-137795.jpg,1,0,0,0,1,,val
0524290_sc-137795.jpg,1,0,1,0,2,,val
0524291_sc-137795.jpg,3,0,1,0,4,,test
0524292_sc-137795.jpg,1,0,0,0,1,,train
0524293_sc-137795.jpg,4,0,0,0,4,,train
0524294_as-0082751.jpg,3,0,3,0,6,,train
0524296_as-0082751.jpg,3,0,3,1,7,,train
0524298_as-3004839.jpg,4,1,2,3,10,,train
0524299_as-9045581.jpg,2,0,0,1,3,,train
0524300_as-9045581.jpg,1,0,0,0,1,,train
0524302_as-0062055.jpg,1,0,0,0,1,,val
0524303_as-0031408.jpg,1,0,0,0,1,,val
0524304_sc-1019513.jpg,1,1,1,1,4,,test
0524305_sc-1019513.jpg,2,1,0,0,3,,train
0524306_sc-1019513.jpg,5,1,0,0,6,,train
0524309_sc-1036912.jpg,2,0,0,1,3,,train
0524310_sc-1036912.jpg,4,0,1,1,6,,train
0524311_sc-1036912.jpg,4,0,0,1,5,,train
0524312_sc-218700.jpg,1,0,0,0,1,,train
0524313_sc-218700.jpg,4,1,2,0,7,,train
0524314_sc-218700.jpg,2,1,1,0,4,,val
0524315_sc-218700.jpg,3,1,1,0,5,,val
0524316_sc-218700.jpg,0,2,1,0,3,,test
0524317_sc-218700.jpg,1,0,0,0,1,,train
0524318_sc-218700.jpg,1,0,0,0,1,,train
0524319_sc-204963.jpg,2,0,1,1,4,,train
0524320_sc-204963.jpg,2,0,0,0,2,,train
0524321_as-3127425.jpg,1,0,0,0,1,,train
0524322_as-2663908.jpg,1,0,0,0,1,,train
0524323_as-2925677.jpg,0,1,0,0,1,,train
0524326_as-2505824.jpg,1,0,1,1,3,,val
0524329_as-0037857.jpg,1,0,0,0,1,,val
0524330_as-0037857.jpg,1,0,0,0,1,,test
0524331_as-0037857.jpg,1,0,0,0,1,,train
0524332_as-0037857.jpg,1,0,0,0,1,,train
0524334_as-0037857.jpg,0,0,1,0,1,,train
0524336_as-0037857.jpg,0,0,1,0,1,,train
0524337_as-2986410.jpg,1,0,0,0,1,,train
0524339_as-0057191.jpg,0,0,1,1,2,,train
0524341_as-0057191.jpg,2,0,0,1,3,,train
0524342_as-0057191.jpg,1,0,1,1,3,,val
0524346_as-0085590.jpg,2,0,0,0,2,,val
0524347_as-0085590.jpg,3,0,0,0,3,,test
0524348_as-2571818.jpg,1,0,0,0,1,,train
0524349_as-0073350.jpg,1,0,0,0,1,,train
0524350_as-0073350.jpg,1,0,0,0,1,,train
0524351_as-0073350.jpg,1,0,0,0,1,,train
0524353_as-3000835.jpg,2,0,1,1,4,,train
0524354_as-7381154.jpg,1,0,3,1,5,,train
0524355_as-0068871.jpg,0,1,1,0,2,,train
0524356_as-0068871.jpg,1,1,2,0,4,,val
0524357_as-0068871.jpg,0,1,1,0,2,,val
0524358_as-0068871.jpg,1,1,1,0,3,,test
0524359_as-0068871.jpg,1,1,2,0,4,,train
0524361_as-0068871.jpg,2,0,1,0,3,,train
0524363_as-0004425.jpg,1,0,1,0,2,,train
0524364_as-0004425.jpg,2,0,2,0,4,,train
0524365_as-0004425.jpg,1,0,1,0,2,,train
0524366_sc-148544.jpg,3,0,0,0,3,,train
0524367_as-0049166.jpg,2,0,0,0,2,,train
0524369_as-0049166.jpg,15,0,3,3,21,,val
0524370_as-0049166.jpg,3,0,0,3,6,,val
0524371_as-0049166.jpg,3,0,0,1,4,,test
0524372_as-0049166.jpg,2,0,0,0,2,,train
0524373_as-0049166.jpg,2,0,0,0,2,,train
0524374_as-0049166.jpg,2,0,0,0,2,,train
0524375_as-0049166.jpg,2,0,1,1,4,,train
0524376_sc-212147.jpg,2,0,0,0,2,,train
0524379_as-0006818.jpg,2,2,1,2,7,,train
0524382_as-0083780.jpg,1,1,0,0,2,,train
0524383_as-0083780.jpg,1,0,0,0,1,,val
0524384_as-0083780.jpg,0,0,0,1,1,,val
0524385_as-0083780.jpg,3,0,1,3,7,,test
0524386_as-0083780.jpg,1,0,0,1,2,,train
0524387_as-0083780.jpg,3,1,1,3,8,,train
0524388_as-0083780.jpg,1,0,0,1,2,,train
0524389_as-0083780.jpg,2,0,1,1,4,,train
0524390_sc-202823.jpg,7,1,1,0,9,,train
0524391_sc-202823.jpg,7,0,1,0,8,,train
0524392_sc-1014083.jpg,1,1,2,0,4,,train
0524394_sc-1036222.jpg,3,0,1,0,4,,val
0524395_sc-1036222.jpg,1,1,0,0,2,,val
0524396_sc-194915.jpg,1,1,1,0,3,,test
0524397_as-3260052.jpg,2,0,1,0,3,,train
0524398_sc-188488.jpg,5,0,2,2,9,,train
0524400_sc-174012.jpg,3,2,1,0,6,,train
0524401_sc-174012.jpg,4,1,1,0,6,,train
0524403_sc-174012.jpg,2,1,1,0,4,,train
0524404_sc-174012.jpg,2,1,1,0,4,,train
0524405_sc-174012.jpg,3,0,0,0,3,,train
0524406_sc-174012.jpg,2,0,2,0,4,,val
0524407_sc-174012.jpg,3,2,1,0,6,,val
0524408_sc-174012.jpg,3,1,1,0,5,,test
0524409_as-2512863.jpg,1,0,0,0,1,,train
0524411_as-0026184.jpg,1,0,0,1,2,,train
0524412_as-0026184.jpg,0,0,0,1,1,,train
0524413_as-0026184.jpg,2,0,0,1,3,,train
0524414_as-0026184.jpg,1,0,0,1,2,,train
0524415_as-0026184.jpg,2,0,0,0,2,,train
0524416_as-3382497.jpg,2,0,0,0,2,,train
0524417_as-2816763.jpg,3,0,0,0,3,,val
0524418_as-0032749.jpg,2,0,0,0,2,,val
0524419_as-0032749.jpg,1,0,0,0,1,,test
0524420_as-0013864.jpg,1,0,0,0,1,,train
0524421_as-0013864.jpg,1,0,0,0,1,,train
0524422_as-0013864.jpg,2,0,0,0,2,,train
0524423_as-5056104.jpg,1,0,0,0,1,,train
0524424_sc-1031342.jpg,1,0,1,1,3,,train
0524426_as-0084437.jpg,1,0,0,0,1,,train
0524427_as-0084437.jpg,1,0,0,0,1,,train
0524428_as-0084437.jpg,1,0,0,0,1,,val
0524429_as-0049311.jpg,2,0,0,0,2,,val
0524430_as-0089723.jpg,1,0,2,0,3,,test
0524431_as-0089723.jpg,3,1,1,0,5,,train
0524432_as-0089723.jpg,1,0,0,0,1,,train
0524433_as-0089723.jpg,1,0,0,0,1,,train
0524435_as-0089723.jpg,1,0,1,1,3,,train
0524436_as-0089723.jpg,3,0,0,0,3,,train
0524437_as-0089723.jpg,1,0,0,0,1,,train
0524438_as-0089723.jpg,4,0,0,0,4,,train
0524439_sc-104484.jpg,0,0,1,0,1,,val
0524440_sc-104484.jpg,1,0,0,0,1,,val
0524442_sc-202835.jpg,0,1,0,0,1,,test
0524443_sc-173004.jpg,2,1,1,0,4,,train
0524445_sc-173004.jpg,2,1,1,1,5,,train
0524446_sc-190765.jpg,2,0,0,0,2,,train
0524447_sc-190765.jpg,1,1,0,0,2,,train
0524448_sc-190765.jpg,1,0,0,1,2,,train
0524449_sc-190765.jpg,1,2,0,1,4,,train
0524450_as-2844760.jpg,5,0,3,2,10,,train
0524451_sc-132451.jpg,0,0,1,0,1,,val
0524452_sc-132451.jpg,0,0,1,0,1,,val
0524453_sc-132451.jpg,0,0,1,0,1,,test
0524454_sc-132451.jpg,0,0,1,0,1,,train
0524455_sc-132451.jpg,0,0,1,0,1,,train
0524456_sc-132451.jpg,0,0,1,0,1,,train
0524457_sc-165919.jpg,1,0,0,0,1,,train
0524459_as-0081121.jpg,2,1,0,0,3,,train
0524460_as-0081121.jpg,1,0,0,0,1,,train
0524462_sc-112021.jpg,2,0,0,0,2,,train
0524463_sc-112021.jpg,1,1,0,0,2,,val
0524464_sc-112021.jpg,3,0,0,0,3,,val
0524465_as-0097231.jpg,2,0,1,0,3,,test
0524466_as-0097231.jpg,8,0,1,0,9,,train
0524467_as-0082296.jpg,1,0,0,0,1,,train
0524468_as-0082296.jpg,6,0,0,0,6,,train
0524469_as-0082296.jpg,6,0,2,0,8,,train
0524470_as-0082296.jpg,2,0,1,0,3,,train
0524471_as-0082296.jpg,1,0,2,0,3,,train
0524472_as-0082296.jpg,3,0,1,0,4,,train
0524473_as-0082296.jpg,3,0,0,0,3,,val
0524474_as-0082296.jpg,2,0,0,0,2,,val
0524475_as-0082296.jpg,2,0,0,0,2,,test
0524476_sc-189357.jpg,3,0,0,0,3,,train
0524477_sc-189357.jpg,2,0,0,0,2,,train
0524478_sc-189357.jpg,2,0,0,0,2,,train
0524485_as-0043303.jpg,0,1,1,1,3,,train
0524486_sc-1002832.jpg,1,0,0,0,1,,train
0524488_sc-1002832.jpg,1,0,0,0,1,,train
0524489_sc-201377.jpg,1,1,0,1,3,,train
0524490_sc-201377.jpg,0,0,1,0,1,,val
0524491_sc-201377.jpg,0,0,1,0,1,,val
0524492_as-0061704.jpg,0,1,0,0,1,,test
0524493_as-0061704.jpg,0,0,1,0,1,,train
0524494_as-0061704.jpg,0,0,1,0,1,,train
0524495_as-0061704.jpg,0,0,1,0,1,,train
0524496_as-0061704.jpg,1,0,0,1,2,,train
0524498_as-0061704.jpg,1,0,0,0,1,,train
0524499_as-0061704.jpg,1,0,0,0,1,,train
0524501_as-0061704.jpg,1,0,0,0,1,,train
0524502_as-0061704.jpg,1,0,0,0,1,,val
0524503_as-7509487.jpg,2,0,1,0,3,,val
0524504_as-0005091.jpg,1,0,0,0,1,,test
0524505_as-2799255.jpg,3,0,1,0,4,,train
0524506_sc-126309.jpg,0,1,1,0,2,,train
0524507_sc-126309.jpg,0,1,1,0,2,,train
0524508_sc-130434.jpg,1,1,1,0,3,,train
0524509_sc-161712.jpg,1,0,0,1,2,,train
0524510_sc-161712.jpg,4,0,0,0,4,,train
0524511_sc-161712.jpg,3,0,0,1,4,,train
0524512_sc-161712.jpg,3,0,0,0,3,,val
0524513_sc-161712.jpg,2,0,0,1,3,,val
0524515_sc-191913.jpg,1,1,0,0,2,,test
0524518_as-0094425.jpg,3,0,0,0,3,,train
0524519_as-0094425.jpg,2,0,0,0,2,,train
0524521_sc-182101.jpg,1,0,1,0,2,,train
0524522_sc-182101.jpg,2,0,0,0,2,,train
0524523_sc-182101.jpg,1,0,1,0,2,,train
0524525_sc-135128.jpg,1,0,0,0,1,,train
0524526_sc-135128.jpg,1,0,0,0,1,,train
0524528_as-2725290.jpg,3,0,0,0,3,,val
0524529_as-0021298.jpg,2,0,0,0,2,,val
0524530_as-0021298.jpg,3,0,0,0,3,,test
0524531_as-0021298.jpg,1,0,0,0,1,,train
0524532_as-2791767.jpg,1,0,0,0,1,,train
0524533_as-0030192.jpg,2,1,0,0,3,,train
0524534_as-0030192.jpg,1,1,0,1,3,,train
0524535_as-0030192.jpg,4,0,0,0,4,,train
0524536_as-0030192.jpg,2,0,0,0,2,,train
0524537_as-0030192.jpg,4,1,0,0,5,,train
0524539_sc-220197.jpg,1,0,0,0,1,,val
0524540_sc-220197.jpg,1,0,0,0,1,,val
0524541_sc-220197.jpg,1,0,0,0,1,,test
0524542_sc-167374.jpg,1,0,0,1,2,,train
0524543_as-2862429.jpg,2,0,0,0,2,,train
0524544_as-3123138.jpg,1,0,0,0,1,,train
0524545_sc-166586.jpg,3,0,0,0,3,,train
0524546_as-7118902.jpg,2,0,0,0,2,,train
0524549_sc-150632.jpg,4,2,1,0,7,,train
0524550_sc-150632.jpg,2,1,5,4,12,,train
0524551_sc-127837.jpg,2,0,0,0,2,,val
0524552_sc-229930.jpg,0,0,1,0,1,,val
0524553_sc-229930.jpg,0,0,1,0,1,,test
0524554_sc-229930.jpg,0,0,1,0,1,,train
0524555_sc-1009426.jpg,2,0,0,0,2,,train
0524556_sc-1009426.jpg,2,0,0,0,2,,train
0524557_sc-1009426.jpg,1,0,0,0,1,,train
0524558_sc-1009426.jpg,2,0,0,0,2,,train
0524559_sc-1040929.jpg,1,0,2,0,3,,train
0524560_sc-1040929.jpg,1,0,1,0,2,,train
0524561_sc-1040929.jpg,1,1,1,0,3,,val
0524564_sc-1040929.jpg,0,0,2,0,2,,val
0524565_sc-1003557.jpg,1,0,3,0,4,,test
0524566_sc-1003557.jpg,0,0,1,0,1,,train
0524568_sc-1039036.jpg,1,0,1,1,3,,train
0524569_sc-1039036.jpg,0,0,1,1,2,,train
0524570_sc-1039036.jpg,1,0,2,0,3,,train
0524571_sc-210702.jpg,3,0,2,0,5,,train
0524572_sc-210702.jpg,3,0,1,0,4,,train
0524573_sc-210702.jpg,1,0,1,0,2,,train
0524574_sc-210702.jpg,3,0,1,0,4,,val
0524576_as-0020703.jpg,0,0,0,1,1,,val
0524579_sc-186775.jpg,0,1,0,0,1,,test
0524580_sc-186775.jpg,0,1,0,0,1,,train
0524581_as-0086495.jpg,2,1,1,0,4,,train
0524582_as-0086495.jpg,2,1,1,1,5,,train
0524584_as-0086495.jpg,1,0,0,1,2,,train
0524585_as-0086495.jpg,1,0,0,1,2,,train
0524586_as-0086495.jpg,1,0,0,0,1,,train
0524587_as-2850450.jpg,4,0,1,1,6,,train
0524588_as-0035266.jpg,1,1,0,1,3,,val
0524589_as-0035266.jpg,1,1,0,1,3,,val
0524591_sc-116411.jpg,0,1,0,0,1,,test
0524592_as-3020819.jpg,1,0,0,0,1,,train
0524593_sc-206658.jpg,5,0,1,0,6,,train
0524594_sc-206658.jpg,6,0,1,0,7,,train
0524595_sc-206658.jpg,0,0,1,0,1,,train
0524596_sc-206658.jpg,0,0,2,0,2,,train
0524597_sc-206658.jpg,1,0,3,0,4,,train
0524598_sc-206658.jpg,4,1,2,0,7,,train
0524599_sc-206658.jpg,4,1,0,0,5,,val
0524600_sc-206658.jpg,3,0,0,0,3,,val
0524602_sc-182057.jpg,3,0,1,1,5,,test
0524603_sc-140389.jpg,0,1,0,0,1,,train
0524604_sc-140389.jpg,0,1,0,0,1,,train
0524605_sc-1012552.jpg,1,0,0,0,1,,train
0524606_sc-131656.jpg,2,1,0,0,3,,train
0524607_sc-131656.jpg,9,1,0,0,10,,train
0524608_sc-131656.jpg,3,1,0,0,4,,train
0524609_sc-131656.jpg,5,1,0,0,6,,train
0524610_sc-131656.jpg,3,1,0,0,4,,val
0524611_sc-131656.jpg,4,1,0,0,5,,val
0524612_sc-210455.jpg,1,0,0,1,2,,test
0524613_sc-210455.jpg,1,0,0,1,2,,train
0524614_sc-210455.jpg,2,0,0,0,2,,train
0524615_sc-210455.jpg,1,0,0,0,1,,train
0524616_as-2850268.jpg,6,1,2,1,10,,train
0524617_as-3474233.jpg,1,0,0,0,1,,train
0524618_as-0049224.jpg,4,2,0,0,6,,train
0524619_as-0049224.jpg,3,2,0,0,5,,train
0524620_as-0049224.jpg,3,2,0,0,5,,val
0524621_as-0049224.jpg,1,0,1,1,3,,val
0524622_as-3054603.jpg,1,0,1,0,2,,test
0524623_sc-1039357.jpg,1,0,0,0,1,,train
0524624_sc-229234.jpg,3,0,0,0,3,,train
0524625_sc-202126.jpg,5,0,0,1,6,,train
0524626_sc-202126.jpg,4,0,1,1,6,,train
0524627_sc-202126.jpg,2,0,0,1,3,,train
0524628_sc-202126.jpg,3,0,0,0,3,,train
0524629_sc-202126.jpg,1,0,0,1,2,,train
0524630_sc-202126.jpg,1,0,1,0,2,,val
0524631_sc-1023102.jpg,4,0,0,0,4,,val
0524632_sc-1023102.jpg,3,0,0,0,3,,test
0524633_as-0093687.jpg,1,0,2,1,4,,train
0524634_as-7545198.jpg,1,0,0,0,1,,train
0524636_as-0067389.jpg,3,0,0,0,3,,train
0524637_as-0067389.jpg,2,0,0,0,2,,train
0524638_as-0067389.jpg,2,0,0,0,2,,train
0524639_sc-207855.jpg,1,0,1,0,2,,train
0524640_sc-207855.jpg,0,0,1,0,1,,train
0524641_sc-207855.jpg,3,0,1,0,4,,val
0524642_sc-207855.jpg,1,0,1,0,2,,val
0524643_sc-207855.jpg,2,0,1,0,3,,test
0524644_sc-157763.jpg,0,0,0,1,1,,train
0524646_sc-157763.jpg,2,0,0,1,3,,train
0524647_as-2511690.jpg,1,0,1,1,3,,train
0524648_as-0012075.jpg,1,0,0,0,1,,train
0524649_sc-176382.jpg,1,0,0,0,1,,train
0524650_sc-176382.jpg,1,0,0,0,1,,train
0524651_sc-117710.jpg,2,0,0,0,2,,train
0524652_sc-117710.jpg,2,0,0,0,2,,val
0524653_as-3302508.jpg,1,0,0,0,1,,val
0524654_sc-211368.jpg,3,1,1,0,5,,test
0524655_sc-211368.jpg,2,0,0,0,2,,train
0524656_sc-211368.jpg,3,1,1,0,5,,train
0524659_sc-172274.jpg,2,0,0,0,2,,train
0524660_sc-172274.jpg,1,0,0,0,1,,train
0524661_sc-172274.jpg,2,0,0,0,2,,train
0524662_sc-1030106.jpg,0,1,0,0,1,,train
0524663_as-3165723.jpg,0,1,1,0,2,,train
0524664_sc-205907.jpg,2,0,0,0,2,,val
0524665_sc-205907.jpg,6,0,0,0,6,,val
0524668_as-0073436.jpg,9,0,0,1,10,,test
0524669_as-0073436.jpg,10,0,0,0,10,,train
0524670_as-0073436.jpg,11,0,0,1,12,,train
0524671_as-0039952.jpg,1,0,0,1,2,,train
0524672_as-0039952.jpg,1,0,0,0,1,,train
0524673_as-0039952.jpg,2,0,0,0,2,,train
0524675_as-0039952.jpg,1,0,0,0,1,,train
0524676_as-2933603.jpg,5,0,0,0,5,,train
0524677_sc-213707.jpg,3,0,0,0,3,,val
0524679_sc-213707.jpg,6,0,1,0,7,,val
0524681_sc-183277.jpg,3,1,0,2,6,,test
0524683_sc-183277.jpg,2,0,1,2,5,,train
0524684_sc-183277.jpg,4,0,1,2,7,,train
0524685_sc-183277.jpg,1,1,0,0,2,,train
0524686_sc-183334.jpg,1,0,1,0,2,,train
0524687_sc-183334.jpg,1,0,0,0,1,,train
0524688_sc-183334.jpg,1,0,1,0,2,,train
0524689_as-0022370.jpg,1,0,1,1,3,,train
0524690_as-0022370.jpg,3,0,1,1,5,,val
0524691_as-0078448.jpg,4,0,0,0,4,,val
0524692_as-0078448.jpg,2,0,0,0,2,,test
0524693_sc-1007721.jpg,6,0,0,1,7,,train
0524694_sc-1007721.jpg,11,0,0,1,12,,train
0524695_sc-1007721.jpg,10,0,0,1,11,,train
0524697_as-3459074.jpg,2,0,0,0,2,,train
0524699_sc-206232.jpg,1,0,0,0,1,,train
0524700_sc-206232.jpg,1,0,0,0,1,,train
0524701_sc-206232.jpg,1,0,0,0,1,,train
0524703_as-0074756.jpg,3,2,1,1,7,,val
0524704_as-0074756.jpg,2,0,1,1,4,,val
0524705_as-0074756.jpg,2,0,0,2,4,,test
0524707_as-2760661.jpg,6,0,0,0,6,,train
0524708_as-2998734.jpg,1,0,0,1,2,,train
0524710_sc-170805.jpg,17,0,0,2,19,,train
0524711_sc-170805.jpg,8,0,0,2,10,,train
0524712_sc-170805.jpg,14,0,1,0,15,,train
0524713_sc-170805.jpg,9,0,0,0,9,,train
0524714_sc-170805.jpg,3,0,0,0,3,,train
0524715_sc-126723.jpg,4,1,0,1,6,,val
0524716_sc-126723.jpg,9,0,0,0,9,,val
0524717_sc-126723.jpg,3,1,1,0,5,,test
0524718_as-7193106.jpg,1,0,0,0,1,,train
0524719_as-3186437.jpg,1,0,0,1,2,,train
0524722_sc-128831.jpg,3,0,0,1,4,,train
0524723_sc-128831.jpg,2,0,0,1,3,,train
0524724_as-7350948.jpg,1,1,2,1,5,,train
0524726_sc-153579.jpg,0,0,1,0,1,,train
0524727_as-7904656.jpg,0,0,1,0,1,,train
0524729_sc-126899.jpg,1,1,0,0,2,,val
0524730_sc-126899.jpg,0,1,0,0,1,,val
0524732_as-2501953.jpg,1,0,0,0,1,,test
0524733_sc-122799.jpg,2,1,0,0,3,,train
0524734_sc-122799.jpg,2,1,0,0,3,,train
0524735_sc-122799.jpg,2,1,0,0,3,,train
0524736_sc-122799.jpg,0,1,0,0,1,,train
0524737_sc-163134.jpg,1,0,1,0,2,,train
0524738_sc-163134.jpg,1,0,0,0,1,,train
0524741_as-0071695.jpg,4,0,0,0,4,,train
0524742_as-0071695.jpg,2,0,0,0,2,,val
0524743_as-0071695.jpg,3,0,0,1,4,,val
0524744_as-3212276.jpg,5,0,1,1,7,,test
0524745_sc-1015296.jpg,1,1,0,0,2,,train
0524746_sc-1015296.jpg,1,0,0,0,1,,train
0524747_sc-1015296.jpg,1,1,0,0,2,,train
0524749_sc-145122.jpg,7,2,1,0,10,,train
0524751_as-3065724.jpg,5,1,2,1,9,,train
0524752_sc-155837.jpg,3,0,0,0,3,,train
0524753_sc-155837.jpg,4,0,0,0,4,,train
0524754_sc-155837.jpg,1,0,0,0,1,,val
0524755_sc-155837.jpg,1,0,0,0,1,,val
0524757_sc-147472.jpg,1,1,0,0,2,,test
0524759_sc-147472.jpg,1,1,0,0,2,,train
0524760_as-3130229.jpg,4,0,0,0,4,,train
0524761_as-3437911.jpg,1,0,1,0,2,,train
0524762_sc-180158.jpg,1,0,0,0,1,,train
0524763_sc-180158.jpg,2,0,1,0,3,,train
0524764_sc-180158.jpg,2,0,0,0,2,,train
0524765_sc-180158.jpg,3,0,0,0,3,,train
0524766_sc-180158.jpg,3,0,0,0,3,,val
0524767_as-7373787.jpg,1,0,0,0,1,,val
0524768_sc-212964.jpg,0,1,0,0,1,,test
0524769_sc-212964.jpg,0,1,0,0,1,,train
0524770_sc-217799.jpg,1,0,1,0,2,,train
0524771_sc-217799.jpg,1,0,1,0,2,,train
0524772_sc-217799.jpg,2,0,1,0,3,,train
0524773_sc-217799.jpg,2,0,0,0,2,,train
0524774_sc-217799.jpg,1,0,0,0,1,,train
0524775_sc-1006314.jpg,2,1,0,1,4,,train
0524776_sc-1006314.jpg,5,0,1,0,6,,val
0524777_as-9078258.jpg,7,0,1,1,9,,val
0524778_as-0051939.jpg,3,0,0,0,3,,test
0524779_as-0051939.jpg,2,0,0,0,2,,train
0524780_as-0051939.jpg,3,0,0,0,3,,train
0524781_as-0051939.jpg,1,0,0,0,1,,train
0524784_as-9072297.jpg,3,0,0,0,3,,train
0524786_sc-1030515.jpg,2,0,0,1,3,,train
0524787_sc-1030515.jpg,1,0,1,1,3,,train
0524788_sc-1030515.jpg,3,0,0,0,3,,train
0524792_as-0080841.jpg,4,1,2,1,8,,val
0524793_as-0080841.jpg,6,0,0,1,7,,val
0524794_as-0080841.jpg,8,1,2,1,12,,test
0524795_sc-143364.jpg,1,0,1,0,2,,train
0524797_sc-171681.jpg,1,1,1,0,3,,train
0524799_sc-171681.jpg,1,0,0,0,1,,train
0524800_sc-171681.jpg,1,1,1,0,3,,train
0524801_as-0018423.jpg,2,1,0,0,3,,train
0524802_as-0018423.jpg,2,0,0,1,3,,train
0524803_as-0018423.jpg,2,1,0,0,3,,train
0524804_as-0018423.jpg,2,0,0,0,2,,val
0524805_as-0018423.jpg,1,0,0,0,1,,val
0524806_as-0018423.jpg,2,0,0,0,2,,test
0524807_as-0018423.jpg,1,0,0,0,1,,train
0524808_as-0018423.jpg,2,2,0,0,4,,train
0524809_as-0018423.jpg,2,0,0,0,2,,train
0524810_as-0018423.jpg,4,1,0,0,5,,train
0524811_sc-1022440.jpg,3,0,1,0,4,,train
0524812_sc-1022440.jpg,6,1,1,0,8,,train
0524815_sc-228094.jpg,3,0,1,0,4,,train
0524816_sc-228094.jpg,3,0,0,0,3,,val
0524817_sc-1001002.jpg,1,1,0,0,2,,val
0524819_as-0061420.jpg,3,2,0,1,6,,test
0524820_as-0061420.jpg,2,2,0,1,5,,train
0524823_as-0006569.jpg,1,0,0,0,1,,train
0524825_as-0006569.jpg,1,0,0,0,1,,train
0524826_as-0006569.jpg,1,1,0,0,2,,train
0524829_sc-150901.jpg,5,0,1,0,6,,train
0524830_sc-1036724.jpg,2,2,1,0,5,,train
0524832_sc-212539.jpg,3,0,0,0,3,,train
0524833_sc-212539.jpg,6,0,0,0,6,,val
0524834_sc-212539.jpg,5,0,0,0,5,,val
0524835_sc-212539.jpg,1,0,0,0,1,,test
0524836_sc-212539.jpg,1,0,0,0,1,,train
0524837_sc-212539.jpg,2,0,0,0,2,,train
0524838_sc-212539.jpg,2,0,0,0,2,,train
0524839_sc-212539.jpg,1,0,0,0,1,,train
0524840_as-2951028.jpg,2,0,0,0,2,,train
0524841_as-3349238.jpg,1,0,0,0,1,,train
0524843_as-0078626.jpg,2,1,1,1,5,,train
0524844_as-7810124.jpg,1,0,1,1,3,,val
0524845_as-7254523.jpg,1,0,0,0,1,,val
0524846_as-0023860.jpg,2,1,0,0,3,,test
0524847_as-0023860.jpg,1,1,2,2,6,,train
0524848_as-0023860.jpg,3,1,2,1,7,,train
0524849_as-0023860.jpg,2,1,2,1,6,,train
0524850_as-0023860.jpg,2,1,1,0,4,,train
0524853_sc-226630.jpg,2,0,0,1,3,,train
0524854_sc-226630.jpg,2,0,0,1,3,,train
0524855_sc-226630.jpg,1,0,0,0,1,,train
0524856_sc-226630.jpg,0,0,1,0,1,,val
0524857_sc-226630.jpg,0,0,1,0,1,,val
0524858_sc-226630.jpg,1,0,1,0,2,,test
0524859_sc-226630.jpg,1,0,1,1,3,,train
0524860_sc-226630.jpg,1,0,0,1,2,,train
0524861_sc-226630.jpg,1,0,0,1,2,,train
0524862_sc-226630.jpg,1,0,0,1,2,,train
0524863_sc-226630.jpg,1,0,0,1,2,,train
0524865_as-0013474.jpg,2,1,0,0,3,,train
0524866_as-0013474.jpg,2,0,0,0,2,,train
0524867_as-0013474.jpg,1,0,0,0,1,,val
0524868_as-0013474.jpg,1,0,0,0,1,,val
0524869_as-0013474.jpg,1,0,0,0,1,,test
0524871_sc-1013228.jpg,1,0,0,1,2,,train
0524874_as-0093465.jpg,4,0,0,0,4,,train
0524876_as-0093465.jpg,4,0,0,0,4,,train
0524877_as-3342812.jpg,1,0,0,0,1,,train
0524879_as-7903382.jpg,1,0,0,1,2,,train
0524880_sc-124498.jpg,1,0,0,0,1,,train
0524881_as-2936537.jpg,1,0,0,0,1,,train
0524882_sc-109940.jpg,1,0,0,0,1,,val
0524883_sc-109940.jpg,1,0,0,0,1,,val
0524884_sc-124000.jpg,2,0,0,0,2,,test
0524886_sc-124000.jpg,1,0,0,0,1,,train
0524887_sc-1003866.jpg,1,0,0,0,1,,train
0524888_sc-1003866.jpg,1,0,0,0,1,,train
0524889_as-0051877.jpg,1,0,0,0,1,,train
0524890_as-0051877.jpg,3,1,1,0,5,,train
0524891_as-2809431.jpg,1,0,0,0,1,,train
0524892_as-3389679.jpg,5,0,0,0,5,,train
0524893_sc-1023590.jpg,1,0,1,0,2,,val
0524894_sc-1023590.jpg,2,0,1,0,3,,val
0524895_sc-1030302.jpg,1,0,0,1,2,,test
0524896_sc-1030302.jpg,3,0,0,0,3,,train
0524897_sc-1030302.jpg,0,0,0,1,1,,train
0524898_as-7405018.jpg,2,0,0,0,2,,train
0524900_as-0012088.jpg,6,0,1,0,7,,train
0524901_as-0012088.jpg,6,0,1,0,7,,train
0524902_as-0012088.jpg,4,0,0,1,5,,train
0524903_as-0012088.jpg,9,0,1,0,10,,train
0524904_as-0012088.jpg,3,0,1,1,5,,val
0524905_as-0012088.jpg,4,0,2,1,7,,val
0524906_sc-1001447.jpg,1,1,1,0,3,,test
0524907_sc-1001447.jpg,3,1,1,0,5,,train
0524908_as-3295995.jpg,1,0,1,0,2,,train
0524910_sc-169621.jpg,2,0,1,0,3,,train
0524911_as-0055705.jpg,2,0,0,1,3,,train
0524912_as-0096477.jpg,2,0,0,0,2,,train
0524913_as-2687238.jpg,1,0,1,0,2,,train
0524914_as-2777205.jpg,1,0,0,0,1,,train
0524915_as-3398254.jpg,1,0,0,0,1,,val
0524917_as-0070096.jpg,1,0,0,1,2,,val
0524918_as-0070096.jpg,1,0,0,0,1,,test
0524919_sc-224519.jpg,9,0,0,0,9,,train
0524920_sc-224519.jpg,2,0,0,0,2,,train
0524921_sc-147479.jpg,2,0,1,0,3,,train
0524922_sc-147479.jpg,3,0,1,0,4,,train
0524923_sc-147479.jpg,2,0,1,0,3,,train
0524924_sc-155692.jpg,2,0,0,0,2,,train
0524925_sc-1009172.jpg,0,1,0,0,1,,train
0524926_sc-1009172.jpg,1,0,0,0,1,,val
0524927_sc-1009172.jpg,1,0,0,0,1,,val
0524928_as-2503692.jpg,0,0,2,2,4,,test
0524929_as-3300835.jpg,2,0,0,0,2,,train
0524930_as-9060174.jpg,2,4,1,1,8,,train
0524931_as-3361120.jpg,1,0,2,0,3,,train
0524932_as-7648258.jpg,1,2,1,1,5,,train
0524935_as-0005453.jpg,0,1,0,0,1,,train
0524936_as-0031822.jpg,2,0,0,0,2,,train
0524937_as-0031822.jpg,2,0,0,0,2,,train
0524938_as-0031822.jpg,2,0,1,0,3,,val
0524940_sc-136137.jpg,2,0,1,0,3,,val
0524941_sc-136137.jpg,2,0,1,0,3,,test
0524942_sc-136137.jpg,4,0,0,0,4,,train
0524945_as-3396382.jpg,0,1,0,0,1,,train
0524946_sc-116424.jpg,2,0,0,0,2,,train
0524947_sc-116424.jpg,2,0,0,0,2,,train
0524948_sc-116424.jpg,4,0,0,0,4,,train
0524949_sc-116424.jpg,7,0,0,0,7,,train
0524950_sc-116424.jpg,2,1,0,0,3,,train
0524951_as-0035626.jpg,0,0,1,0,1,,val
0524952_as-0035626.jpg,4,0,0,0,4,,val
0524953_as-0035626.jpg,1,0,0,0,1,,test
0524954_as-0035626.jpg,1,0,0,0,1,,train
0524955_as-0035626.jpg,0,1,0,0,1,,train
0524956_as-0035626.jpg,0,1,0,0,1,,train
0524957_as-0035626.jpg,2,0,0,0,2,,train
0524958_as-0035626.jpg,3,2,0,0,5,,train
0524959_as-0035626.jpg,1,1,0,0,2,,train
0524960_as-0035626.jpg,2,2,0,0,4,,train
0524961_as-0035626.jpg,1,1,0,0,2,,val
0524962_as-0035626.jpg,3,3,0,0,6,,val
0524964_sc-194033.jpg,1,0,0,1,2,,test
0524967_sc-194033.jpg,1,0,0,0,1,,train
0524968_sc-194033.jpg,1,0,0,1,2,,train
0524969_sc-217812.jpg,3,1,0,1,5,,train
0524970_sc-217812.jpg,1,1,3,1,6,,train
0524971_sc-217812.jpg,2,1,0,0,3,,train
0524972_sc-217812.jpg,1,1,1,0,3,,train
0524973_sc-217812.jpg,1,0,1,0,2,,train
0524974_as-2718879.jpg,1,0,0,1,2,,val
0524976_as-7085761.jpg,0,0,1,1,2,,val
0524977_sc-173636.jpg,1,0,0,0,1,,test
0524978_sc-173636.jpg,5,0,0,0,5,,train
0524979_sc-173636.jpg,3,0,0,0,3,,train
0524980_as-3062695.jpg,2,1,1,1,5,,train
0524981_sc-1005397.jpg,11,0,1,0,12,,train
0524982_sc-1005397.jpg,3,0,1,0,4,,train
0524983_as-3351852.jpg,1,0,2,1,4,,train
0524984_as-7554346.jpg,0,1,0,0,1,,train
0524985_as-0034386.jpg,1,0,1,1,3,,val
0524986_sc-207139.jpg,2,0,0,0,2,,val
0524987_sc-207139.jpg,4,0,0,1,5,,test
0524988_sc-207139.jpg,1,0,0,0,1,,train
0524989_sc-207139.jpg,3,0,0,1,4,,train
0524990_sc-207139.jpg,4,2,1,0,7,,train
0524991_sc-207139.jpg,2,0,0,0,2,,train
0524992_sc-207139.jpg,4,1,0,0,5,,train
0524993_sc-207139.jpg,1,0,0,0,1,,train
0524994_sc-145905.jpg,2,0,0,1,3,,train
0524995_sc-145905.jpg,2,0,0,2,4,,val
0524996_sc-145905.jpg,0,0,0,1,1,,val
0524997_as-7022703.jpg,2,0,0,1,3,,test
0524998_as-2608621.jpg,1,0,1,0,2,,train
0524999_sc-221487.jpg,4,0,1,0,5,,train
0525000_sc-221487.jpg,1,0,0,0,1,,train
0525001_sc-221487.jpg,6,0,1,0,7,,train
0525002_sc-1013333.jpg,1,1,2,0,4,,train
0525003_sc-1013333.jpg,1,0,0,0,1,,train
0525004_sc-1013333.jpg,1,1,2,0,4,,train
0525006_sc-119341.jpg,2,0,0,0,2,,val
0525007_sc-129208.jpg,0,0,2,0,2,,val
0525008_sc-129208.jpg,3,0,1,0,4,,test
0525009_sc-129208.jpg,1,0,1,0,2,,train
0525010_sc-129208.jpg,2,0,0,0,2,,train
0525011_sc-129208.jpg,1,0,0,0,1,,train
0525012_sc-129208.jpg,2,0,0,0,2,,train
0525014_sc-129208.jpg,1,0,0,0,1,,train
0525015_sc-129208.jpg,1,0,0,0,1,,train
0525016_sc-129208.jpg,1,0,0,0,1,,train
0525017_sc-129208.jpg,2,0,1,0,3,,val
0525020_sc-129208.jpg,2,0,0,0,2,,val
0525021_sc-129208.jpg,1,0,0,0,1,,test
0525022_sc-129208.jpg,1,0,1,0,2,,train
0525023_as-7533863.jpg,0,2,1,1,4,,train
0525024_sc-1009666.jpg,1,0,0,0,1,,train
0525025_as-2658200.jpg,2,0,1,0,3,,train
0525028_as-0074256.jpg,1,0,0,1,2,,train
0525029_as-0074256.jpg,2,0,0,1,3,,train
0525032_as-0072109.jpg,2,0,0,0,2,,train
0525033_as-0072109.jpg,2,0,0,0,2,,val
0525036_sc-1022904.jpg,0,0,1,0,1,,val
0525037_sc-1021674.jpg,3,0,1,0,4,,test
0525038_sc-1021674.jpg,1,0,0,0,1,,train
0525041_as-3216667.jpg,1,0,0,0,1,,train
0525042_sc-132630.jpg,1,0,1,0,2,,train
0525043_sc-196536.jpg,0,0,1,0,1,,train
0525044_sc-196536.jpg,1,0,1,0,2,,train
0525045_sc-196536.jpg,2,3,1,0,6,,train
0525046_sc-196536.jpg,3,3,0,0,6,,train
0525047_sc-196536.jpg,3,1,0,0,4,,val
0525048_sc-196536.jpg,2,1,0,0,3,,val
0525049_sc-196536.jpg,0,0,1,0,1,,test
0525050_as-0024696.jpg,2,0,0,0,2,,train
0525051_sc-203096.jpg,4,0,0,0,4,,train
0525052_sc-203096.jpg,1,0,0,0,1,,train
0525053_sc-203096.jpg,2,2,1,0,5,,train
0525054_sc-203096.jpg,0,1,0,0,1,,train
0525055_sc-203096.jpg,1,1,1,0,3,,train
0525056_sc-203096.jpg,0,0,1,0,1,,train
0525060_sc-1006369.jpg,4,0,1,0,5,,val
0525061_sc-1006369.jpg,2,0,1,0,3,,val
0525065_as-0038608.jpg,1,0,0,0,1,,test
0525066_as-0038608.jpg,1,0,0,0,1,,train
0525067_as-0038608.jpg,2,0,0,0,2,,train
0525068_as-0038608.jpg,1,0,0,0,1,,train
0525069_as-0038608.jpg,1,0,0,0,1,,train
0525070_sc-111779.jpg,1,0,0,0,1,,train
0525071_sc-111779.jpg,1,0,0,0,1,,train
0525072_sc-183347.jpg,2,0,0,0,2,,train
0525073_sc-183347.jpg,2,0,0,0,2,,val
0525074_sc-183347.jpg,2,0,0,0,2,,val
0525075_sc-183347.jpg,2,0,0,0,2,,test
0525076_sc-202051.jpg,1,0,0,0,1,,train
0525077_as-9000411.jpg,1,0,1,0,2,,train
0525078_as-0084751.jpg,4,0,0,0,4,,train
0525079_as-0084751.jpg,2,0,0,0,2,,train
0525080_as-0084751.jpg,3,0,0,1,4,,train
0525081_as-0084751.jpg,3,0,1,1,5,,train
0525082_as-0079352.jpg,3,1,1,3,8,,train
0525083_as-0079352.jpg,4,1,1,3,9,,val
0525084_as-0079352.jpg,5,1,1,2,9,,val
0525085_as-0079352.jpg,3,0,0,0,3,,test
0525086_sc-1025838.jpg,3,2,1,0,6,,train
0525087_sc-1025838.jpg,2,0,0,0,2,,train
0525088_sc-1025838.jpg,2,0,0,1,3,,train
0525089_sc-1025838.jpg,1,0,0,0,1,,train
0525091_sc-1025838.jpg,1,0,0,0,1,,train
0525092_sc-1000079.jpg,2,0,0,1,3,,train
0525093_sc-1000079.jpg,0,0,0,1,1,,train
0525095_sc-168996.jpg,1,0,0,0,1,,val
0525097_as-0041085.jpg,1,0,2,0,3,,val
0525099_as-0041085.jpg,3,2,1,0,6,,test
0525100_as-0041085.jpg,4,0,1,0,5,,train
0525102_as-0041085.jpg,3,1,1,1,6,,train
0525103_sc-149638.jpg,4,1,1,1,7,,train
0525104_sc-149638.jpg,3,0,1,2,6,,train
0525105_sc-149638.jpg,4,1,1,1,7,,train
0525107_sc-149638.jpg,3,1,1,1,6,,train
0525109_sc-1028733.jpg,2,0,0,0,2,,train
0525110_sc-218063.jpg,1,0,0,0,1,,val
0525111_as-2542257.jpg,3,0,0,0,3,,val
0525112_sc-220969.jpg,1,3,1,0,5,,test
0525113_sc-220969.jpg,1,1,1,0,3,,train
0525115_as-3484212.jpg,0,0,1,0,1,,train
0525117_as-0076521.jpg,2,0,2,2,6,,train
0525118_as-0076521.jpg,0,0,1,0,1,,train
0525119_sc-121980.jpg,14,0,0,0,14,,train
0525120_sc-121980.jpg,5,0,0,0,5,,train
0525121_sc-198365.jpg,7,0,0,0,7,,train
0525122_sc-198365.jpg,1,0,0,0,1,,val
0525123_sc-198365.jpg,3,0,0,0,3,,val
0525124_as-0010381.jpg,1,0,0,0,1,,test
0525125_as-0010381.jpg,1,0,0,0,1,,train
0525127_as-2985554.jpg,0,0,2,1,3,,train
0525128_as-9064447.jpg,3,1,1,1,6,,train
0525129_sc-191983.jpg,0,1,0,0,1,,train
0525130_sc-1027482.jpg,1,0,0,1,2,,train
0525131_sc-1027482.jpg,1,0,0,0,1,,train
0525132_as-7844227.jpg,0,0,0,1,1,,train
0525133_as-3474478.jpg,1,1,1,0,3,,val
0525135_sc-103213.jpg,5,0,0,0,5,,val
0525136_sc-1038534.jpg,1,0,0,0,1,,test
0525137_sc-1038534.jpg,2,0,0,0,2,,train
0525138_sc-1038534.jpg,2,0,1,0,3,,train
0525139_sc-1038534.jpg,1,0,1,0,2,,train
0525141_as-2580388.jpg,6,0,0,0,6,,train
0525142_sc-215100.jpg,1,0,0,0,1,,train
0525143_sc-215100.jpg,1,0,0,0,1,,train
0525144_sc-215100.jpg,2,0,0,0,2,,train
0525145_sc-215100.jpg,1,1,0,0,2,,val
0525146_sc-215100.jpg,2,0,0,0,2,,val
0525147_sc-215100.jpg,1,0,1,0,2,,test
0525148_sc-215100.jpg,1,0,0,0,1,,train
0525149_sc-215100.jpg,1,1,0,0,2,,train
0525150_sc-215100.jpg,1,0,2,0,3,,train
0525151_sc-129221.jpg,1,1,0,0,2,,train
0525153_as-0033705.jpg,2,0,0,0,2,,train
0525154_as-0033705.jpg,1,0,0,0,1,,train
0525155_as-0063615.jpg,0,0,1,0,1,,train
0525156_as-0063615.jpg,1,0,0,0,1,,val
0525157_as-0076427.jpg,2,1,2,0,5,,val
0525158_as-0076427.jpg,2,0,1,0,3,,test
0525159_as-9079710.jpg,0,1,0,0,1,,train
0525160_as-0095047.jpg,0,1,0,0,1,,train
0525161_as-0095047.jpg,0,1,0,0,1,,train
0525162_as-7833515.jpg,2,0,1,1,4,,train
0525163_sc-224782.jpg,1,0,1,0,2,,train
0525164_sc-224782.jpg,2,0,3,0,5,,train
0525165_sc-224782.jpg,2,1,1,0,4,,train
0525166_sc-224782.jpg,1,0,3,0,4,,val
0525167_as-0062113.jpg,3,0,0,1,4,,val
0525170_as-0062113.jpg,1,0,0,0,1,,test
0525171_as-0062113.jpg,2,0,0,0,2,,train
0525172_as-3339037.jpg,0,0,0,1,1,,train
0525173_as-7838774.jpg,1,0,0,0,1,,train
0525174_sc-172605.jpg,2,0,0,0,2,,train
0525176_sc-172605.jpg,3,0,0,0,3,,train
0525177_sc-172605.jpg,0,0,1,0,1,,train
0525178_sc-172605.jpg,0,0,1,0,1,,train
0525180_sc-1004759.jpg,1,0,0,0,1,,val
0525184_as-0065353.jpg,1,1,0,1,3,,val
0525185_as-0065353.jpg,0,1,0,1,2,,test
0525186_as-0065353.jpg,3,1,0,0,4,,train
0525187_as-0065353.jpg,2,1,0,0,3,,train
0525188_as-0065353.jpg,3,0,0,0,3,,train
0525189_as-0065353.jpg,2,0,0,0,2,,train
0525190_as-0065353.jpg,1,0,0,0,1,,train
0525193_sc-172720.jpg,5,0,0,1,6,,train
0525194_sc-172720.jpg,2,0,0,1,3,,train
0525195_sc-153675.jpg,1,0,0,0,1,,val
0525197_as-9080520.jpg,4,0,0,0,4,,val
0525199_as-3083272.jpg,0,1,0,0,1,,test
0525200_sc-172878.jpg,3,0,0,0,3,,train
0525201_sc-172878.jpg,3,0,0,0,3,,train
0525203_as-7415974.jpg,1,1,2,1,5,,train
0525204_as-0006846.jpg,3,0,0,0,3,,train
0525205_as-0006846.jpg,2,0,0,0,2,,train
0525206_as-2804553.jpg,2,0,0,1,3,,train
0525207_sc-1005285.jpg,1,0,0,0,1,,train
0525208_sc-1005285.jpg,1,0,0,0,1,,val
0525209_sc-125553.jpg,1,0,0,0,1,,val
0525211_sc-125553.jpg,4,1,0,0,5,,test
0525212_sc-125553.jpg,2,0,0,0,2,,train
0525213_sc-125553.jpg,0,0,1,0,1,,train
0525214_sc-125553.jpg,1,0,0,0,1,,train
0525215_sc-125553.jpg,5,0,0,0,5,,train
0525216_sc-166424.jpg,0,0,1,2,3,,train
0525217_sc-166424.jpg,1,0,1,1,3,,train
0525218_sc-166424.jpg,0,1,1,2,4,,train
0525219_sc-1039064.jpg,1,0,0,1,2,,val
0525220_sc-197186.jpg,11,0,1,0,12,,val
0525221_sc-168020.jpg,4,0,0,0,4,,test
0525222_sc-168020.jpg,4,0,0,0,4,,train
0525223_sc-168020.jpg,5,0,0,0,5,,train
0525224_sc-168020.jpg,2,0,0,0,2,,train
0525225_sc-168020.jpg,7,0,0,0,7,,train
0525228_sc-127675.jpg,3,0,1,1,5,,train
0525230_as-3247739.jpg,1,0,0,1,2,,train
0525231_as-0008911.jpg,2,0,0,1,3,,train
0525232_as-0008911.jpg,2,0,0,0,2,,val
0525233_as-0008911.jpg,2,0,0,0,2,,val
0525234_as-0098171.jpg,2,0,0,0,2,,test
0525235_as-0098171.jpg,4,0,0,1,5,,train
0525236_as-0098171.jpg,4,2,2,0,8,,train
0525237_as-0098171.jpg,3,1,1,0,5,,train
0525238_as-0098171.jpg,4,1,1,0,6,,train
0525239_as-0098171.jpg,5,0,1,0,6,,train
0525240_as-0098171.jpg,4,3,1,1,9,,train
0525241_as-9096629.jpg,3,0,0,0,3,,train
0525242_as-2659255.jpg,2,0,0,0,2,,val
0525243_as-0030127.jpg,7,2,1,0,10,,val
0525249_as-2710364.jpg,1,0,0,0,1,,test
0525250_sc-1018635.jpg,1,0,0,0,1,,train
0525252_sc-1018635.jpg,2,0,0,0,2,,train
0525253_sc-1018635.jpg,1,0,1,0,2,,train
0525254_sc-1018635.jpg,1,0,0,0,1,,train
0525255_sc-1018635.jpg,1,0,0,0,1,,train
0525256_sc-142680.jpg,0,1,0,0,1,,train
0525258_sc-1005931.jpg,2,1,2,0,5,,train
0525259_sc-1005931.jpg,3,0,0,0,3,,val
0525262_as-0072906.jpg,3,0,1,0,4,,val
0525263_as-0072906.jpg,2,1,1,0,4,,test
0525265_sc-226507.jpg,2,0,0,2,4,,train
0525266_sc-226507.jpg,2,0,0,2,4,,train
0525267_sc-226507.jpg,3,0,0,1,4,,train
0525268_sc-226507.jpg,3,0,0,0,3,,train
0525269_as-0024281.jpg,2,0,0,2,4,,train
0525270_as-0024281.jpg,3,0,0,0,3,,train
0525271_as-0024281.jpg,1,0,0,1,2,,train
0525273_sc-1041152.jpg,5,0,0,0,5,,val
0525275_sc-1041152.jpg,4,1,1,0,6,,val
0525276_as-3052780.jpg,6,1,1,0,8,,test
0525278_as-7871103.jpg,1,1,0,0,2,,train
0525281_sc-222407.jpg,1,0,1,1,3,,train
0525282_sc-222407.jpg,1,0,1,1,3,,train
0525283_as-3201484.jpg,1,0,0,0,1,,train
0525284_as-7487279.jpg,3,1,0,0,4,,train
0525286_as-0013904.jpg,1,0,0,0,1,,train
0525287_as-0013904.jpg,1,0,0,0,1,,train
0525288_as-0013904.jpg,1,0,0,0,1,,val
0525289_as-0013904.jpg,1,0,1,0,2,,val
0525290_as-0013904.jpg,2,0,1,0,3,,test
0525291_sc-186284.jpg,3,0,0,0,3,,train
0525294_as-0052486.jpg,0,1,1,0,2,,train
0525295_as-0052486.jpg,2,0,0,0,2,,train
0525297_as-0001997.jpg,0,1,1,1,3,,train
0525298_as-0001997.jpg,0,0,1,0,1,,train
0525299_as-0001997.jpg,0,0,1,0,1,,train
0525300_sc-200025.jpg,0,1,0,0,1,,train
0525301_sc-200025.jpg,0,1,0,0,1,,val
0525303_as-2942793.jpg,3,0,0,0,3,,val
0525304_sc-165950.jpg,1,0,1,1,3,,test
0525305_as-0054629.jpg,1,0,0,0,1,,train
0525306_as-0034910.jpg,2,0,0,0,2,,train
0525307_sc-213635.jpg,0,1,0,0,1,,train
0525308_sc-213635.jpg,0,1,0,0,1,,train
0525311_as-0085748.jpg,1,0,0,0,1,,train
0525312_as-0085748.jpg,1,0,0,0,1,,train
0525313_as-0085748.jpg,1,0,0,0,1,,train
0525314_as-0085748.jpg,1,0,0,0,1,,val
0525315_as-7410051.jpg,1,0,0,0,1,,val
0525316_sc-1010296.jpg,3,0,1,0,4,,test
0525317_sc-1010296.jpg,3,1,1,0,5,,train
0525319_sc-105876.jpg,2,0,0,1,3,,train
0525320_sc-105876.jpg,2,0,0,1,3,,train
0525322_as-3415246.jpg,1,0,0,1,2,,train
0525323_as-0049567.jpg,1,0,0,0,1,,train
0525324_as-0049567.jpg,1,0,0,0,1,,train
0525325_as-0049567.jpg,1,0,0,0,1,,train
0525326_as-0049567.jpg,1,0,0,0,1,,val
0525327_as-0049567.jpg,1,0,0,0,1,,val
0525328_as-0049567.jpg,1,0,0,0,1,,test
0525329_as-0049567.jpg,1,0,0,0,1,,train
0525330_as-0049567.jpg,1,0,0,0,1,,train
0525331_as-3041108.jpg,1,2,1,0,4,,train
0525332_sc-115780.jpg,1,0,0,0,1,,train
0525333_sc-144760.jpg,1,2,0,0,3,,train
0525334_sc-172733.jpg,4,0,1,0,5,,train
0525335_as-7114984.jpg,0,0,2,0,2,,train
0525337_as-0065590.jpg,0,0,0,1,1,,val
0525338_as-0065590.jpg,0,1,1,0,2,,val
0525340_as-0065590.jpg,2,0,0,0,2,,test
0525345_sc-1014930.jpg,1,2,2,1,6,,train
0525346_sc-1014930.jpg,5,3,2,1,11,,train
0525348_sc-1037165.jpg,2,1,0,0,3,,train
0525349_sc-1037165.jpg,1,1,0,0,2,,train
0525351_as-2636350.jpg,1,0,0,0,1,,train
0525353_as-0089116.jpg,1,0,0,0,1,,train
0525354_as-0089116.jpg,0,0,1,0,1,,train
0525355_as-0089116.jpg,0,0,1,0,1,,val
0525356_as-0090988.jpg,1,0,0,0,1,,val
0525359_as-0090988.jpg,1,1,0,0,2,,test
0525360_as-0090988.jpg,0,1,0,0,1,,train
0525361_as-0090988.jpg,1,0,1,0,2,,train
0525362_as-2578418.jpg,2,1,0,0,3,,train
0525366_as-0034436.jpg,1,0,1,0,2,,train
0525367_as-0034436.jpg,2,0,1,0,3,,train
0525368_as-0034436.jpg,1,0,0,0,1,,train
0525369_as-0034436.jpg,3,1,0,0,4,,train
0525370_as-0034436.jpg,0,1,1,0,2,,val
0525371_as-0034436.jpg,2,1,1,0,4,,val
0525372_sc-1025062.jpg,1,0,0,0,1,,test
0525373_sc-1025062.jpg,2,0,0,1,3,,train
0525378_as-0091461.jpg,2,0,0,0,2,,train
0525379_as-0091461.jpg,2,0,0,0,2,,train
0525380_as-0091461.jpg,1,0,0,0,1,,train
0525381_as-2985174.jpg,0,1,1,0,2,,train
0525383_sc-1006164.jpg,2,1,1,1,5,,train
0525385_as-0021847.jpg,1,0,1,0,2,,train
0525386_as-0021847.jpg,1,0,1,0,2,,val
0525387_as-0021847.jpg,1,0,0,0,1,,val
0525388_as-0021847.jpg,1,0,0,0,1,,test
0525389_as-0021847.jpg,1,0,0,0,1,,train
0525390_sc-149934.jpg,2,0,1,0,3,,train
0525391_sc-149934.jpg,1,0,1,0,2,,train
0525392_sc-1027890.jpg,2,0,0,0,2,,train
0525393_as-0033659.jpg,1,0,0,0,1,,train
0525394_as-0033659.jpg,1,0,0,0,1,,train
0525395_as-0033659.jpg,1,1,2,0,4,,train
0525396_as-0033659.jpg,1,1,1,0,3,,val
0525397_as-0033659.jpg,1,1,0,1,3,,val
0525399_sc-209511.jpg,8,0,1,0,9,,test
0525400_sc-209511.jpg,2,0,0,0,2,,train
0525401_sc-209511.jpg,1,0,0,0,1,,train
0525402_as-3323554.jpg,0,0,0,2,2,,train
0525405_sc-1024898.jpg,1,0,1,1,3,,train
0525406_sc-213661.jpg,0,1,0,0,1,,train
0525409_as-0025267.jpg,7,1,2,4,14,,train
0525411_as-0025267.jpg,4,0,0,1,5,,train
0525412_as-0025267.jpg,2,0,0,0,2,,val
0525413_as-0025267.jpg,2,1,1,0,4,,val
0525414_as-0025267.jpg,3,2,1,1,7,,test
0525415_as-0025267.jpg,0,1,0,0,1,,train
0525416_as-0025267.jpg,5,0,1,3,9,,train
0525418_as-0025267.jpg,4,0,0,1,5,,train
0525419_sc-1016920.jpg,4,0,1,0,5,,train
0525421_sc-1016920.jpg,6,1,0,0,7,,train
0525422_sc-198669.jpg,0,1,0,0,1,,train
0525423_sc-198669.jpg,3,1,1,0,5,,train
0525424_sc-1002937.jpg,4,0,0,0,4,,val
0525425_sc-1002937.jpg,2,0,0,0,2,,val
0525426_sc-1002937.jpg,4,0,0,0,4,,test
0525428_sc-118379.jpg,1,0,0,0,1,,train
0525429_sc-118379.jpg,2,1,0,0,3,,train
0525431_as-0044252.jpg,1,0,0,0,1,,train
0525432_as-0044252.jpg,1,0,0,0,1,,train
0525433_as-0044252.jpg,1,0,0,0,1,,train
0525434_as-2937812.jpg,2,0,0,0,2,,train
0525435_as-3275165.jpg,1,0,0,0,1,,train
0525436_as-2910824.jpg,2,0,0,0,2,,val
0525438_sc-1029381.jpg,1,0,0,0,1,,val
0525439_as-2560153.jpg,4,0,1,2,7,,test
0525440_as-0045804.jpg,1,1,0,1,3,,train
0525441_as-0045804.jpg,2,0,1,1,4,,train
0525442_sc-119589.jpg,2,0,0,0,2,,train
0525443_as-0078259.jpg,3,0,0,0,3,,train
0525444_as-0078259.jpg,1,0,0,0,1,,train
0525446_as-0078259.jpg,3,0,0,0,3,,train
0525447_as-0078259.jpg,2,1,0,0,3,,train
0525448_as-0078259.jpg,3,0,0,0,3,,val
0525452_as-0054438.jpg,1,0,1,0,2,,val
0525453_as-0054438.jpg,1,0,1,0,2,,test
0525454_as-0054438.jpg,0,1,0,0,1,,train
0525456_as-0038015.jpg,0,0,1,1,2,,train
0525457_as-0038015.jpg,3,0,1,0,4,,train
0525458_as-0038015.jpg,0,1,0,0,1,,train
0525459_as-0038015.jpg,2,0,1,0,3,,train
0525460_as-0038015.jpg,0,0,1,1,2,,train
0525461_as-0038015.jpg,2,0,1,1,4,,train
0525462_sc-135864.jpg,1,0,0,0,1,,val
0525463_sc-135864.jpg,1,0,0,0,1,,val
0525464_as-0023272.jpg,1,0,0,1,2,,test
0525466_sc-216788.jpg,2,0,2,1,5,,train
0525467_sc-216788.jpg,2,0,1,1,4,,train
0525468_sc-216788.jpg,2,0,1,1,4,,train
0525469_sc-216788.jpg,1,0,1,0,2,,train
0525472_as-0028031.jpg,3,0,0,0,3,,train
0525473_as-0028031.jpg,2,0,0,0,2,,train
0525474_as-0028031.jpg,1,0,0,0,1,,train
0525477_as-0041415.jpg,3,0,2,0,5,,val
0525478_as-0041415.jpg,2,0,2,0,4,,val
0525479_as-0041415.jpg,2,0,1,1,4,,test
0525481_sc-187590.jpg,2,0,0,0,2,,train
0525482_sc-187590.jpg,1,0,0,0,1,,train
0525483_sc-161180.jpg,4,0,2,1,7,,train
0525484_sc-161180.jpg,2,0,2,1,5,,train
0525485_sc-161180.jpg,1,1,3,1,6,,train
0525486_sc-161180.jpg,1,0,2,1,4,,train
0525488_as-2958522.jpg,4,0,1,1,6,,train
0525489_as-0009427.jpg,1,0,0,1,2,,val
0525491_as-0097861.jpg,1,0,1,1,3,,val
0525494_sc-1028583.jpg,3,0,1,1,5,,test
0525495_sc-1028583.jpg,5,0,1,1,7,,train
0525496_sc-1028583.jpg,1,0,5,2,8,,train
0525497_sc-1028583.jpg,3,0,1,1,5,,train
0525498_sc-1028583.jpg,2,0,0,1,3,,train
0525499_sc-189822.jpg,4,0,0,0,4,,train
0525501_as-0073209.jpg,0,0,1,0,1,,train
0525502_sc-1006048.jpg,1,0,1,0,2,,train
0525503_sc-1006048.jpg,1,0,1,0,2,,val
0525506_as-0048748.jpg,1,2,0,2,5,,val
0525507_as-0048748.jpg,1,2,0,2,5,,test
0525508_as-0048748.jpg,1,2,0,2,5,,train
0525509_as-0048748.jpg,2,1,0,2,5,,train
0525510_as-0048748.jpg,1,1,0,1,3,,train
0525511_as-0048748.jpg,1,2,0,0,3,,train
0525512_as-0048748.jpg,1,2,0,0,3,,train
0525513_as-0048748.jpg,1,0,0,1,2,,train
0525515_sc-116652.jpg,5,0,0,0,5,,train
0525516_sc-116652.jpg,1,0,0,1,2,,val
0525517_as-2625821.jpg,2,0,1,0,3,,val
0525519_as-0069282.jpg,2,0,0,0,2,,test
0525520_as-0069282.jpg,3,0,0,0,3,,train
0525521_as-0069282.jpg,7,0,1,0,8,,train
0525522_sc-139429.jpg,1,0,0,0,1,,train
0525523_as-0046808.jpg,1,0,0,0,1,,train
0525524_as-0046808.jpg,1,0,0,0,1,,train
0525525_as-0046808.jpg,3,0,1,0,4,,train
0525526_sc-174508.jpg,1,0,0,0,1,,train
0525527_sc-174508.jpg,1,0,0,0,1,,val
0525528_sc-174508.jpg,1,0,0,0,1,,val
0525530_as-0097948.jpg,1,0,0,0,1,,test
0525531_as-0097948.jpg,1,0,0,0,1,,train
0525532_sc-1034125.jpg,0,0,1,1,2,,train
0525533_sc-1034125.jpg,0,0,1,1,2,,train
0525535_sc-1032910.jpg,4,0,1,0,5,,train
0525536_sc-1032910.jpg,3,0,1,0,4,,train
0525537_sc-1032910.jpg,8,0,1,0,9,,train
0525538_sc-120643.jpg,1,0,1,1,3,,train
0525539_sc-120643.jpg,1,0,0,1,2,,val
0525540_sc-168479.jpg,2,0,0,0,2,,val
0525541_sc-168479.jpg,3,0,0,0,3,,test
0525542_sc-109080.jpg,1,0,0,1,2,,train
0525543_sc-109080.jpg,4,0,0,1,5,,train
0525544_sc-109080.jpg,6,0,0,1,7,,train
0525545_sc-1034662.jpg,4,0,0,0,4,,train
0525546_sc-1034662.jpg,5,0,0,0,5,,train
0525547_sc-1035116.jpg,1,0,1,0,2,,train
0525550_as-0050543.jpg,1,1,0,0,2,,train
0525551_as-0050543.jpg,1,1,1,0,3,,val
0525552_as-0050543.jpg,2,1,1,0,4,,val
0525554_as-0050543.jpg,1,1,0,0,2,,test
0525555_as-0050543.jpg,4,1,1,0,6,,train
0525557_as-0043491.jpg,1,0,2,2,5,,train
0525558_as-0043491.jpg,1,1,2,2,6,,train
0525559_as-0043491.jpg,0,0,1,0,1,,train
0525560_as-0043491.jpg,1,1,0,1,3,,train
0525562_as-0043491.jpg,1,0,2,2,5,,train
0525563_as-0043491.jpg,2,0,2,3,7,,train
0525565_as-0053173.jpg,1,0,1,0,2,,val
0525566_as-0053173.jpg,1,0,1,0,2,,val
0525567_as-0053173.jpg,1,0,1,0,2,,test
0525568_as-0053173.jpg,1,0,1,0,2,,train
0525572_sc-229445.jpg,6,0,0,0,6,,train
0525573_sc-229445.jpg,3,0,0,0,3,,train
0525578_sc-222991.jpg,1,0,0,0,1,,train
0525579_sc-222991.jpg,6,1,0,0,7,,train
0525581_sc-144284.jpg,1,0,0,0,1,,train
0525584_as-0028611.jpg,0,0,0,1,1,,train
0525585_as-0028611.jpg,0,1,0,1,2,,val
0525589_as-0031018.jpg,1,0,1,0,2,,val
0525590_as-0031018.jpg,2,0,1,1,4,,test
0525592_sc-154806.jpg,2,0,2,0,4,,train
0525593_sc-154806.jpg,5,1,2,0,8,,train
0525594_sc-154806.jpg,5,1,1,0,7,,train
0525595_sc-210543.jpg,2,0,1,1,4,,train
0525596_sc-129125.jpg,8,1,1,0,10,,train
0525597_sc-129125.jpg,9,1,1,0,11,,train
0525599_sc-129125.jpg,1,0,1,0,2,,train
0525600_sc-129125.jpg,6,1,0,0,7,,val
0525602_as-0078736.jpg,7,0,2,1,10,,val
0525604_as-0078736.jpg,4,3,2,2,11,,test
0525605_as-0078736.jpg,2,0,0,0,2,,train
0525610_as-0078736.jpg,2,0,0,0,2,,train
0525611_as-0078736.jpg,1,0,0,0,1,,train
0525613_as-0078736.jpg,2,1,0,0,3,,train
0525616_sc-156557.jpg,4,1,1,1,7,,train
0525617_sc-156557.jpg,3,1,1,1,6,,train
0525618_sc-156557.jpg,0,1,1,1,3,,train
0525619_sc-156557.jpg,1,0,1,0,2,,val
0525620_as-0037341.jpg,1,0,0,0,1,,val
0525621_as-0037341.jpg,2,0,1,0,3,,test
0525622_as-3369064.jpg,1,1,1,0,3,,train
0525623_as-7177542.jpg,4,0,2,1,7,,train
0525624_sc-141062.jpg,4,4,3,0,11,,train
0525625_sc-141062.jpg,3,5,2,0,10,,train
0525626_sc-141062.jpg,3,2,2,1,8,,train
0525627_sc-141062.jpg,3,2,2,0,7,,train
0525630_as-9058409.jpg,2,0,1,1,4,,train
0525631_sc-1015067.jpg,1,0,0,1,2,,val
0525632_sc-1015067.jpg,1,0,0,1,2,,val
0525633_as-3375142.jpg,4,0,0,0,4,,test
0525634_as-7030953.jpg,2,0,0,0,2,,train
0525635_sc-146453.jpg,1,0,0,0,1,,train
0525636_as-3486108.jpg,1,0,1,1,3,,train
0525637_sc-1033833.jpg,2,0,1,0,3,,train
0525638_sc-1033833.jpg,4,0,1,0,5,,train
0525639_sc-1033833.jpg,4,0,1,0,5,,train
0525640_sc-1033833.jpg,3,0,0,0,3,,train
0525641_sc-1033833.jpg,3,0,0,0,3,,val
0525642_sc-1033833.jpg,3,0,0,0,3,,val
0525643_sc-1033833.jpg,3,0,1,0,4,,test
0525644_as-0038162.jpg,1,0,0,0,1,,train
0525645_as-0038162.jpg,3,0,0,0,3,,train
0525646_as-0038162.jpg,4,0,1,0,5,,train
0525647_as-0038162.jpg,1,0,0,0,1,,train
0525648_as-0038162.jpg,1,0,0,0,1,,train
0525649_as-0038162.jpg,1,0,1,0,2,,train
0525651_sc-116484.jpg,1,0,1,0,2,,train
0525652_sc-116484.jpg,1,0,1,0,2,,val
0525653_sc-116484.jpg,1,0,0,0,1,,val
0525655_sc-1031662.jpg,1,0,1,0,2,,test
0525656_sc-1031662.jpg,2,0,1,0,3,,train
0525657_sc-1031662.jpg,9,0,0,1,10,,train
0525658_sc-1031662.jpg,8,0,0,1,9,,train
0525660_sc-1031662.jpg,1,0,1,1,3,,train
0525663_as-3464985.jpg,1,0,0,0,1,,train
0525665_as-0084280.jpg,1,0,1,1,3,,train
0525666_as-0084280.jpg,1,0,1,0,2,,train
0525667_as-0084280.jpg,1,0,1,0,2,,val
0525668_sc-181419.jpg,2,0,0,1,3,,val
0525669_sc-181419.jpg,2,0,0,1,3,,test
0525670_sc-181419.jpg,1,0,0,1,2,,train
0525671_sc-181419.jpg,2,0,0,0,2,,train
0525672_sc-181419.jpg,2,0,0,0,2,,train
0525673_sc-181419.jpg,1,0,0,1,2,,train
0525674_sc-181419.jpg,2,0,0,1,3,,train
0525675_as-9062276.jpg,1,0,0,0,1,,train
0525676_as-2508539.jpg,3,0,0,1,4,,train
0525677_sc-220342.jpg,8,1,1,1,11,,val
0525678_sc-220342.jpg,2,3,1,0,6,,val
0525679_as-2681350.jpg,0,1,0,0,1,,test
0525681_as-7007461.jpg,1,0,0,0,1,,train
0525684_as-0086386.jpg,1,0,0,0,1,,train
0525685_as-0086386.jpg,0,0,1,0,1,,train
0525687_as-7591377.jpg,6,2,0,0,8,,train
0525688_as-2595091.jpg,1,0,1,1,3,,train
0525689_sc-1004217.jpg,1,0,0,0,1,,train
0525690_as-2764350.jpg,0,0,0,1,1,,train
0525691_as-3342161.jpg,2,0,0,0,2,,val
0525692_as-3342161.jpg,4,0,1,1,6,,val
0525693_sc-1026885.jpg,2,0,0,0,2,,test
0525694_sc-1026885.jpg,3,0,2,1,6,,train
0525695_sc-1026885.jpg,2,0,1,1,4,,train
0525696_sc-1026885.jpg,2,0,3,1,6,,train
0525697_sc-1026885.jpg,3,0,2,1,6,,train
0525698_sc-1026885.jpg,1,0,1,0,2,,train
0525699_sc-1026885.jpg,2,0,0,0,2,,train
0525700_sc-215702.jpg,0,1,2,0,3,,train
0525701_sc-215702.jpg,0,1,1,0,2,,val
0525702_sc-215702.jpg,3,1,3,0,7,,val
0525704_as-7823903.jpg,1,0,0,0,1,,test
0525706_sc-1032959.jpg,3,0,1,0,4,,train
0525708_as-0051218.jpg,2,0,1,0,3,,train
0525709_sc-125827.jpg,6,0,0,1,7,,train
0525711_sc-1014090.jpg,5,0,2,1,8,,train
0525713_sc-1014090.jpg,2,0,1,1,4,,train
0525714_sc-1014090.jpg,4,0,1,1,6,,train
0525715_sc-1014090.jpg,2,0,2,2,6,,train
0525716_sc-1014090.jpg,1,0,3,2,6,,val
0525717_sc-1014090.jpg,2,2,1,1,6,,val
0525719_sc-133916.jpg,2,0,0,0,2,,test
0525720_sc-182198.jpg,1,0,1,0,2,,train
0525721_sc-182198.jpg,3,0,1,0,4,,train
0525722_sc-182198.jpg,2,0,0,1,3,,train
0525723_sc-182198.jpg,0,0,1,0,1,,train
0525724_sc-182198.jpg,4,0,1,0,5,,train
0525725_as-7470253.jpg,1,0,0,0,1,,train
0525728_sc-165597.jpg,1,0,0,0,1,,train
0525729_sc-165597.jpg,2,0,0,0,2,,val
0525730_as-0046673.jpg,1,0,0,0,1,,val
0525731_as-0046673.jpg,3,0,0,0,3,,test
0525732_as-0046673.jpg,2,0,0,0,2,,train
0525733_as-0046673.jpg,1,0,0,0,1,,train
0525734_as-0046673.jpg,0,0,1,0,1,,train
0525736_as-0045882.jpg,3,0,0,0,3,,train
0525737_as-0045882.jpg,1,0,0,0,1,,train
0525738_sc-170143.jpg,1,0,0,1,2,,train
0525739_sc-170143.jpg,3,0,1,1,5,,train
0525740_sc-170143.jpg,2,0,1,1,4,,val
0525741_sc-170143.jpg,1,0,1,1,3,,val
0525742_as-0046261.jpg,1,0,0,0,1,,test
0525743_as-0046261.jpg,1,0,0,0,1,,train
0525744_as-0046261.jpg,1,0,0,0,1,,train
0525745_as-0046261.jpg,1,0,0,0,1,,train
0525746_sc-188119.jpg,1,1,0,0,2,,train
0525747_sc-188119.jpg,1,2,1,0,4,,train
0525748_sc-188119.jpg,2,2,0,0,4,,train
0525749_sc-188119.jpg,1,1,0,0,2,,train
0525750_sc-175646.jpg,5,0,0,0,5,,val
0525751_sc-148521.jpg,1,0,0,0,1,,val
0525752_sc-148521.jpg,1,0,0,0,1,,test
0525753_sc-157914.jpg,3,0,1,0,4,,train
0525754_sc-157914.jpg,4,0,1,0,5,,train
0525755_sc-157914.jpg,2,0,2,0,4,,train
0525756_sc-157914.jpg,2,0,2,0,4,,train
0525757_sc-157914.jpg,3,0,1,0,4,,train
0525758_sc-138964.jpg,1,0,0,1,2,,train
0525759_sc-104384.jpg,3,1,1,0,5,,train
0525760_sc-104384.jpg,4,0,0,0,4,,val
0525761_sc-104384.jpg,5,1,1,0,7,,val
0525762_as-0047516.jpg,1,0,1,0,2,,test
0525765_as-0001631.jpg,0,1,1,0,2,,train
0525768_as-0060351.jpg,0,0,1,0,1,,train
0525769_as-0060351.jpg,0,0,1,0,1,,train
0525771_sc-207805.jpg,1,0,1,0,2,,train
0525772_sc-207805.jpg,1,0,1,0,2,,train
0525773_sc-207805.jpg,2,0,1,0,3,,train
0525777_sc-186713.jpg,2,0,0,1,3,,train
0525778_sc-186713.jpg,1,0,1,1,3,,val
0525779_sc-144500.jpg,1,0,0,0,1,,val
0525780_sc-144500.jpg,1,0,0,0,1,,test
0525781_sc-144500.jpg,1,0,0,0,1,,train
0525783_as-0042459.jpg,1,0,0,0,1,,train
0525785_as-0042459.jpg,0,0,1,0,1,,train
0525786_as-0042459.jpg,1,0,1,0,2,,train
0525787_as-2867334.jpg,0,0,1,1,2,,train
0525789_as-0020018.jpg,5,0,0,0,5,,train
0525790_as-0020018.jpg,5,0,0,0,5,,train
0525791_as-0020018.jpg,3,0,0,0,3,,val
0525792_as-0020018.jpg,1,0,1,0,2,,val
0525793_as-0020018.jpg,2,0,0,1,3,,test
0525794_as-0020018.jpg,1,0,1,1,3,,train
0525795_as-0020018.jpg,1,0,1,1,3,,train
0525796_as-0020018.jpg,1,0,1,0,2,,train
0525797_as-2652256.jpg,1,0,1,0,2,,train
0525799_sc-166660.jpg,4,0,0,0,4,,train
0525802_as-0036905.jpg,6,0,0,0,6,,train
0525804_as-0036905.jpg,5,0,0,0,5,,train
0525805_sc-1037833.jpg,0,0,0,1,1,,val
0525806_sc-1037833.jpg,0,0,0,1,1,,val
0525807_as-3377450.jpg,3,0,0,0,3,,test
0525808_as-0003531.jpg,4,0,0,0,4,,train
0525809_as-0003531.jpg,1,0,0,0,1,,train
0525810_as-0003531.jpg,4,0,0,0,4,,train
0525811_as-0003531.jpg,3,0,0,0,3,,train
0525812_sc-205553.jpg,2,2,1,1,6,,train
0525813_sc-205553.jpg,2,2,1,1,6,,train
0525814_sc-205553.jpg,2,2,1,1,6,,train
0525815_sc-205553.jpg,1,1,0,0,2,,val
0525817_sc-205553.jpg,2,0,1,1,4,,val
0525818_sc-205553.jpg,1,1,1,1,4,,test
0525819_sc-205553.jpg,2,1,1,2,6,,train
0525820_sc-205553.jpg,1,0,0,1,2,,train
0525821_sc-205553.jpg,3,0,0,1,4,,train
0525822_sc-205553.jpg,1,0,0,1,2,,train
0525824_as-0071324.jpg,1,1,1,0,3,,train
0525825_as-0071324.jpg,1,0,0,0,1,,train
0525826_as-0071324.jpg,1,1,1,0,3,,train
0525827_as-0071324.jpg,1,0,1,0,2,,val
0525828_as-0071324.jpg,1,0,0,0,1,,val
0525829_as-0071324.jpg,1,0,0,0,1,,test
0525830_as-7875091.jpg,4,0,0,0,4,,train
0525831_as-2575364.jpg,1,0,1,0,2,,train
0525833_sc-186639.jpg,1,1,0,1,3,,train
0525835_sc-186639.jpg,5,0,1,0,6,,train
0525837_as-0038482.jpg,1,0,0,0,1,,train
0525838_as-0038482.jpg,1,0,0,0,1,,train
0525839_as-0038482.jpg,2,0,0,0,2,,train
0525840_sc-206278.jpg,0,1,1,0,2,,val
0525841_sc-206278.jpg,4,0,0,0,4,,val
0525842_sc-206278.jpg,4,0,0,0,4,,test
0525843_sc-206278.jpg,2,0,0,0,2,,train
0525844_sc-206278.jpg,2,1,1,0,4,,train
0525845_sc-206278.jpg,1,0,0,0,1,,train
0525846_sc-206278.jpg,0,0,1,0,1,,train
0525847_sc-206278.jpg,2,0,0,0,2,,train
0525849_as-0054906.jpg,2,0,0,0,2,,train
0525850_as-0054906.jpg,1,0,0,0,1,,train
0525851_as-0054906.jpg,1,0,0,0,1,,val
0525852_as-0054906.jpg,1,0,0,0,1,,val
0525853_as-0054906.jpg,8,0,0,0,8,,test
0525854_as-0054906.jpg,1,0,0,0,1,,train
0525855_as-0014192.jpg,2,0,0,0,2,,train
0525856_as-0014192.jpg,2,0,0,0,2,,train
0525857_as-0014192.jpg,1,0,0,0,1,,train
0525858_as-0095104.jpg,1,0,0,0,1,,train
0525859_as-0095104.jpg,1,0,1,0,2,,train
0525860_as-0037582.jpg,1,1,2,1,5,,train
0525861_as-0037582.jpg,1,0,0,0,1,,val
0525862_as-0037582.jpg,1,0,0,0,1,,val
0525863_as-0037582.jpg,3,1,2,1,7,,test
0525864_as-0037582.jpg,1,2,2,1,6,,train
0525865_sc-109951.jpg,0,0,0,1,1,,train
0525866_as-2521135.jpg,1,0,0,1,2,,train
0525867_sc-219480.jpg,4,0,0,0,4,,train
0525868_sc-219480.jpg,3,0,0,0,3,,train
0525869_sc-219480.jpg,1,0,0,0,1,,train
0525870_sc-181095.jpg,1,0,1,0,2,,train
0525871_sc-181095.jpg,5,0,0,0,5,,val
0525872_as-2922666.jpg,1,0,1,0,2,,val
0525873_sc-1029216.jpg,1,0,1,0,2,,test
0525875_sc-1029216.jpg,1,0,1,0,2,,train
0525876_as-3017044.jpg,1,0,0,0,1,,train
0525877_sc-169782.jpg,5,0,0,0,5,,train
0525878_sc-169782.jpg,3,0,0,0,3,,train
0525879_as-2649443.jpg,3,0,0,0,3,,train
0525880_as-0038018.jpg,1,0,0,0,1,,train
0525881_as-0038018.jpg,1,0,0,0,1,,train
0525883_as-0055071.jpg,2,0,1,0,3,,val
0525884_as-0055071.jpg,2,0,2,0,4,,val
0525885_as-0055071.jpg,2,0,2,0,4,,test
0525886_as-0055071.jpg,2,0,2,0,4,,train
0525888_as-0055071.jpg,2,0,2,0,4,,train
0525889_as-0055071.jpg,2,0,2,1,5,,train
0525890_sc-191974.jpg,1,0,0,0,1,,train
0525891_sc-191974.jpg,0,0,1,0,1,,train
0525892_sc-191974.jpg,1,0,0,0,1,,train
0525893_sc-191974.jpg,0,1,0,0,1,,train
0525894_sc-191974.jpg,0,0,1,0,1,,val
0525895_sc-191974.jpg,0,0,1,0,1,,val
0525896_as-0079339.jpg,2,1,1,0,4,,test
0525897_as-0079339.jpg,4,1,0,0,5,,train
0525898_as-0079339.jpg,0,4,0,0,4,,train
0525899_sc-224481.jpg,0,1,0,0,1,,train
0525900_sc-224481.jpg,3,1,1,1,6,,train
0525901_sc-224481.jpg,1,0,1,0,2,,train
0525902_sc-224481.jpg,2,0,1,1,4,,train
0525903_sc-224481.jpg,2,0,1,0,3,,train
0525904_sc-224481.jpg,1,1,0,0,2,,val
0525905_sc-224481.jpg,7,0,1,1,9,,val
0525906_sc-224481.jpg,1,0,1,1,3,,test
0525907_sc-224481.jpg,2,0,1,0,3,,train
0525908_sc-224481.jpg,2,0,0,0,2,,train
0525909_as-0016706.jpg,3,0,0,0,3,,train
0525910_as-0016706.jpg,2,0,0,0,2,,train
0525911_sc-198360.jpg,0,1,0,0,1,,train
0525913_sc-219009.jpg,2,0,0,0,2,,train
0525914_sc-219009.jpg,1,0,1,0,2,,train
0525915_as-2518834.jpg,1,0,1,0,2,,val
0525916_sc-203507.jpg,4,0,0,0,4,,val
0525917_sc-203507.jpg,4,0,0,0,4,,test
0525918_as-7596640.jpg,1,0,0,1,2,,train
0525919_as-2958828.jpg,2,0,0,1,3,,train
0525920_as-2698793.jpg,1,2,0,0,3,,train
0525921_as-7672555.jpg,3,0,0,0,3,,train
0525922_sc-1013366.jpg,0,1,0,0,1,,train
0525923_as-7776034.jpg,2,0,0,0,2,,train
0525924_as-0077917.jpg,2,1,0,0,3,,train
0525926_as-0077917.jpg,1,0,1,2,4,,val
0525927_as-0077917.jpg,4,0,1,2,7,,val
0525929_as-0077917.jpg,1,2,0,3,6,,test
0525930_as-0077917.jpg,1,1,0,1,3,,train
0525931_as-0077917.jpg,1,1,0,1,3,,train
0525932_sc-187675.jpg,3,0,2,0,5,,train
0525933_sc-152877.jpg,1,2,0,0,3,,train
0525934_sc-152877.jpg,1,0,0,0,1,,train
0525937_sc-152877.jpg,3,1,0,0,4,,train
0525938_sc-152877.jpg,4,1,0,0,5,,train
0525939_as-2981644.jpg,0,1,1,0,2,,val
0525940_as-0051783.jpg,1,0,2,0,3,,val
0525941_as-0051783.jpg,1,1,0,0,2,,test
0525942_sc-1026570.jpg,1,0,0,0,1,,train
0525943_sc-1026570.jpg,2,0,0,0,2,,train
0525944_sc-1026570.jpg,1,0,0,0,1,,train
0525945_sc-1030064.jpg,2,0,0,0,2,,train
0525946_sc-179089.jpg,1,0,0,0,1,,train
0525947_sc-179089.jpg,6,0,0,0,6,,train
0525948_sc-179089.jpg,3,0,0,0,3,,train
0525949_sc-179089.jpg,4,0,0,0,4,,val
0525950_sc-179089.jpg,6,1,0,0,7,,val
0525951_sc-179089.jpg,3,0,0,0,3,,test
0525952_sc-179089.jpg,2,1,0,0,3,,train
0525953_sc-179089.jpg,1,1,0,0,2,,train
0525954_as-0026238.jpg,0,1,1,0,2,,train
0525955_as-0026238.jpg,2,0,0,1,3,,train
0525956_as-0026238.jpg,3,0,1,1,5,,train
0525959_sc-176033.jpg,3,0,0,0,3,,train
0525960_sc-176033.jpg,7,0,0,0,7,,train
0525961_sc-218869.jpg,1,0,0,1,2,,val
0525962_sc-218869.jpg,2,1,0,1,4,,val
0525963_sc-218869.jpg,2,0,1,1,4,,test
0525965_as-0054661.jpg,1,0,0,0,1,,train
0525966_as-0054661.jpg,1,0,0,0,1,,train
0525967_as-0054661.jpg,2,0,0,0,2,,train
0525972_as-0054661.jpg,2,0,0,0,2,,train
0525973_as-0054661.jpg,3,0,0,0,3,,train
0525975_as-0054661.jpg,2,0,0,0,2,,train
0525976_as-0054661.jpg,1,0,0,0,1,,train
0525977_as-2779960.jpg,0,0,1,0,1,,val
0525978_as-2779960.jpg,3,0,0,0,3,,val
0525979_as-2779960.jpg,2,0,3,0,5,,test
0525981_sc-224278.jpg,2,1,0,0,3,,train
0525982_as-0003720.jpg,1,0,0,0,1,,train
0525983_as-0003720.jpg,1,0,0,0,1,,train
0525986_as-0079922.jpg,4,0,2,1,7,,train
0525988_as-3155315.jpg,2,1,0,0,3,,train
0525989_as-0009249.jpg,1,0,0,0,1,,train
0525990_as-0009249.jpg,1,0,0,0,1,,train
0525991_as-0009249.jpg,1,0,0,0,1,,val
0525992_as-0009249.jpg,1,0,0,0,1,,val
0525993_as-0009249.jpg,1,0,0,0,1,,test
0525994_as-0009249.jpg,2,0,0,0,2,,train
0525995_as-0009249.jpg,2,0,0,0,2,,train
0525996_as-0009249.jpg,2,0,0,0,2,,train
0525997_as-0009249.jpg,1,0,1,0,2,,train
0525998_as-0009249.jpg,1,0,1,0,2,,train
0525999_as-0009249.jpg,2,0,0,0,2,,train
0526000_as-0009249.jpg,1,0,0,0,1,,train
0526002_as-0009249.jpg,1,0,0,0,1,,val
0526003_as-0009249.jpg,1,0,0,0,1,,val
0526004_as-0009249.jpg,1,0,0,0,1,,test
0526005_as-0009249.jpg,1,0,0,0,1,,train
0526006_as-0009249.jpg,1,0,0,0,1,,train
0526007_as-0009249.jpg,1,0,0,0,1,,train
0526008_as-0009249.jpg,1,0,0,0,1,,train
0526009_as-0009249.jpg,1,0,0,0,1,,train
0526010_as-0009249.jpg,2,0,0,0,2,,train
0526011_as-0009249.jpg,1,1,0,0,2,,train
0526012_as-0009249.jpg,1,1,0,0,2,,val
0526013_as-0009249.jpg,1,1,0,0,2,,val
0526014_as-0009249.jpg,1,1,0,0,2,,test
0526015_as-3223163.jpg,1,0,0,0,1,,train
0526016_sc-1010722.jpg,0,1,0,0,1,,train
0526018_sc-1010722.jpg,1,1,0,0,2,,train
0526019_sc-1010722.jpg,1,1,0,0,2,,train
0526020_sc-118326.jpg,0,0,1,0,1,,train
0526021_sc-118326.jpg,2,0,0,0,2,,train
0526022_sc-220351.jpg,2,0,2,0,4,,train
0526023_sc-220351.jpg,3,0,2,0,5,,val
0526024_sc-220351.jpg,5,0,0,0,5,,val
0526025_sc-220351.jpg,0,0,1,0,1,,test
0526026_sc-220351.jpg,2,0,0,0,2,,train
0526027_sc-220351.jpg,2,0,1,0,3,,train
0526028_as-2708030.jpg,1,0,0,0,1,,train
0526029_as-9054694.jpg,2,0,0,0,2,,train
0526030_as-0026708.jpg,1,0,0,0,1,,train
0526031_as-0026708.jpg,1,0,0,0,1,,train
0526033_as-7888579.jpg,3,0,0,0,3,,train
0526035_as-0044151.jpg,1,0,0,0,1,,val
0526036_as-2526113.jpg,1,0,0,0,1,,val
0526037_sc-225264.jpg,2,0,1,2,5,,test
0526038_sc-225264.jpg,3,0,1,1,5,,train
0526039_sc-225264.jpg,4,0,1,0,5,,train
0526040_sc-225264.jpg,3,0,0,0,3,,train
0526041_sc-225264.jpg,2,0,1,1,4,,train
0526042_sc-225264.jpg,2,0,1,1,4,,train
0526043_sc-225264.jpg,2,0,2,1,5,,train
0526044_as-3298520.jpg,4,0,0,0,4,,train
0526045_as-2857708.jpg,0,1,0,0,1,,val
0526046_sc-1028844.jpg,2,1,0,0,3,,val
0526047_sc-1028844.jpg,2,0,1,1,4,,test
0526048_sc-1028844.jpg,3,0,0,0,3,,train
0526050_sc-1028844.jpg,2,0,0,0,2,,train
0526051_as-2970307.jpg,0,0,1,0,1,,train
0526052_as-0096369.jpg,2,0,1,1,4,,train
0526053_sc-200150.jpg,2,2,0,0,4,,train
0526054_sc-200150.jpg,2,2,0,0,4,,train
0526055_sc-200150.jpg,2,2,0,1,5,,train
0526056_sc-200150.jpg,1,1,0,1,3,,val
0526057_as-2992278.jpg,2,1,1,0,4,,val
0526058_sc-209111.jpg,1,0,1,0,2,,test
0526059_sc-209111.jpg,0,0,0,2,2,,train
0526060_sc-209111.jpg,2,0,0,0,2,,train
0526061_sc-209111.jpg,1,0,0,0,1,,train
0526062_sc-209111.jpg,1,0,0,0,1,,train
0526063_sc-209111.jpg,2,0,0,0,2,,train
0526064_sc-209111.jpg,4,0,1,1,6,,train
0526065_sc-209111.jpg,1,0,1,1,3,,train
0526066_sc-209111.jpg,1,0,1,1,3,,val
0526067_sc-209111.jpg,3,0,0,0,3,,val
0526068_sc-209111.jpg,3,0,1,0,4,,test
0526069_sc-209111.jpg,1,0,0,0,1,,train
0526070_sc-209111.jpg,2,0,0,0,2,,train
0526071_sc-209111.jpg,2,0,0,1,3,,train
0526072_sc-209111.jpg,0,0,1,2,3,,train
0526073_sc-191500.jpg,10,0,0,0,10,,train
0526074_sc-191500.jpg,8,1,0,0,9,,train
0526075_sc-191500.jpg,4,0,0,0,4,,train
0526076_sc-191500.jpg,4,0,0,0,4,,val
0526077_sc-191500.jpg,7,2,0,0,9,,val
0526078_sc-191500.jpg,13,0,0,0,13,,test
0526079_sc-129449.jpg,1,0,0,0,1,,train
0526080_sc-1034030.jpg,1,0,0,0,1,,train
0526081_sc-1034030.jpg,1,0,0,0,1,,train
0526083_as-0033456.jpg,1,1,1,0,3,,train
0526084_as-0033456.jpg,2,1,1,0,4,,train
0526085_as-0033456.jpg,5,0,1,0,6,,train
0526086_as-0033456.jpg,2,1,1,0,4,,train
0526087_as-2804825.jpg,1,0,0,0,1,,val
0526088_as-7349817.jpg,2,2,0,0,4,,val
0526090_sc-104184.jpg,10,0,3,1,14,,test
0526091_sc-104184.jpg,1,0,2,1,4,,train
0526092_as-2950954.jpg,0,0,2,0,2,,train
0526093_as-0075824.jpg,4,0,2,3,9,,train
0526094_as-0075824.jpg,2,0,1,1,4,,train
0526095_as-0075824.jpg,1,1,1,0,3,,train
0526096_as-0075824.jpg,3,0,0,1,4,,train
0526097_as-0075824.jpg,1,0,0,0,1,,train
0526099_sc-125983.jpg,0,0,1,0,1,,val
0526100_sc-125983.jpg,4,1,1,1,7,,val
0526101_sc-125983.jpg,1,0,0,0,1,,test
0526102_sc-125983.jpg,4,0,0,0,4,,train
0526104_sc-125983.jpg,3,1,2,3,9,,train
0526106_as-0060020.jpg,2,0,0,1,3,,train
0526107_sc-195848.jpg,3,0,0,0,3,,train
0526108_sc-195848.jpg,1,0,0,0,1,,train
0526109_as-2694581.jpg,2,0,0,1,3,,train
0526110_sc-207942.jpg,1,0,0,1,2,,train
0526111_sc-207942.jpg,3,0,0,0,3,,val
0526112_sc-207942.jpg,2,0,0,0,2,,val
0526113_sc-207942.jpg,1,0,0,0,1,,test
0526114_sc-207942.jpg,1,0,0,0,1,,train
0526115_as-0030178.jpg,3,0,0,0,3,,train
0526116_as-0030178.jpg,2,0,0,0,2,,train
0526117_as-0030178.jpg,3,0,0,0,3,,train
0526118_as-0030178.jpg,6,0,0,0,6,,train
0526119_as-0030178.jpg,4,0,0,0,4,,train
0526120_as-2558143.jpg,1,0,0,0,1,,train
0526122_as-0061412.jpg,2,0,0,0,2,,val
0526123_as-3363092.jpg,1,0,0,0,1,,val
0526124_as-2824404.jpg,1,0,0,0,1,,test
0526126_as-0034710.jpg,2,0,0,0,2,,train
0526127_as-0034710.jpg,1,0,0,0,1,,train
0526128_as-0034710.jpg,1,0,0,0,1,,train
0526130_as-0034710.jpg,4,1,0,0,5,,train
0526131_as-0034710.jpg,1,0,0,0,1,,train
0526132_as-0034710.jpg,3,0,0,1,4,,train
0526133_sc-114359.jpg,1,0,0,0,1,,train
0526134_sc-114359.jpg,1,0,0,0,1,,val
0526135_sc-186428.jpg,0,5,1,0,6,,val
0526136_sc-186428.jpg,1,2,0,1,4,,test
0526137_sc-186428.jpg,0,2,1,0,3,,train
0526138_sc-1014685.jpg,1,0,1,0,2,,train
0526139_sc-150116.jpg,1,0,0,0,1,,train
0526140_sc-150116.jpg,2,1,0,0,3,,train
0526141_sc-150116.jpg,5,0,0,0,5,,train
0526142_sc-150116.jpg,6,1,0,0,7,,train
0526143_sc-150116.jpg,2,0,0,0,2,,train
0526144_sc-150116.jpg,1,1,0,0,2,,val
0526145_sc-150116.jpg,0,1,0,0,1,,val
0526146_sc-150116.jpg,2,1,0,0,3,,test
0526147_sc-213128.jpg,2,0,1,1,4,,train
0526148_sc-213128.jpg,1,0,1,0,2,,train
0526149_sc-213128.jpg,1,0,1,0,2,,train
0526150_sc-213128.jpg,0,1,0,0,1,,train
0526151_sc-213128.jpg,1,1,0,0,2,,train
0526152_sc-152821.jpg,1,0,1,0,2,,train
0526153_sc-152821.jpg,0,0,1,0,1,,train
0526154_sc-152821.jpg,0,0,1,1,2,,val
0526155_sc-176997.jpg,2,0,0,0,2,,val
0526156_sc-176997.jpg,2,0,0,0,2,,test
0526158_as-0070620.jpg,1,0,0,0,1,,train
0526159_as-0070620.jpg,1,0,0,0,1,,train
0526160_as-3452839.jpg,1,1,0,0,2,,train
0526161_as-0021952.jpg,4,0,0,0,4,,train
0526162_as-0021952.jpg,4,0,0,0,4,,train
0526163_as-0021952.jpg,1,0,0,0,1,,train
0526164_as-0011410.jpg,3,0,1,0,4,,train
0526165_as-0011410.jpg,1,0,1,0,2,,val
0526166_as-0011410.jpg,1,0,1,0,2,,val
0526169_sc-191970.jpg,2,0,0,0,2,,test
0526170_sc-191970.jpg,0,0,1,0,1,,train
0526171_sc-191970.jpg,1,1,0,0,2,,train
0526172_as-3233649.jpg,3,0,1,0,4,,train
0526174_sc-225592.jpg,0,0,1,0,1,,train
0526175_sc-225592.jpg,3,0,1,0,4,,train
0526176_sc-225592.jpg,4,0,1,0,5,,train
0526178_sc-143472.jpg,2,0,0,0,2,,train
0526179_sc-143472.jpg,1,1,0,0,2,,val
0526180_sc-143472.jpg,2,0,0,0,2,,val
0526181_sc-143472.jpg,1,0,0,0,1,,test
0526182_sc-143472.jpg,2,0,0,0,2,,train
0526183_sc-143472.jpg,2,0,0,0,2,,train
0526185_sc-143472.jpg,1,0,0,0,1,,train
0526186_as-3464943.jpg,1,1,2,1,5,,train
0526187_as-0036215.jpg,1,1,0,0,2,,train
0526188_as-0036215.jpg,1,1,0,0,2,,train
0526190_as-0002365.jpg,1,0,0,1,2,,train
0526193_sc-198377.jpg,3,0,1,0,4,,val
0526195_sc-198377.jpg,3,0,1,0,4,,val
0526196_sc-198377.jpg,2,0,0,1,3,,test
0526197_sc-198377.jpg,2,0,0,0,2,,train
0526198_as-3303663.jpg,2,1,1,1,5,,train
0526199_as-0075892.jpg,4,0,0,0,4,,train
0526200_as-0075892.jpg,1,0,0,0,1,,train
0526201_as-0075892.jpg,1,0,0,0,1,,train
0526202_as-0000916.jpg,1,0,0,0,1,,train
0526203_as-3311490.jpg,1,1,0,0,2,,train
0526204_as-0081761.jpg,2,0,1,0,3,,val
0526205_as-0081761.jpg,1,0,1,0,2,,val
0526206_sc-206048.jpg,0,0,1,0,1,,test
0526207_sc-206048.jpg,1,0,0,0,1,,train
0526208_sc-206048.jpg,0,0,1,0,1,,train
0526209_sc-206048.jpg,0,0,1,0,1,,train
0526210_sc-210858.jpg,1,1,0,0,2,,train
0526211_sc-210858.jpg,1,2,0,0,3,,train
0526212_sc-210858.jpg,0,1,0,0,1,,train
0526213_as-3383415.jpg,2,1,1,0,4,,train
0526215_sc-1017889.jpg,2,0,0,0,2,,val
0526216_sc-1017889.jpg,3,0,0,0,3,,val
0526217_sc-1017889.jpg,2,0,0,0,2,,test
0526220_as-0078126.jpg,5,1,0,0,6,,train
0526221_as-0078126.jpg,2,0,0,0,2,,train
0526222_as-0078126.jpg,1,0,0,0,1,,train
0526223_as-0078126.jpg,3,0,0,0,3,,train
0526224_as-0078126.jpg,3,1,0,0,4,,train
0526226_sc-137497.jpg,3,0,0,0,3,,train
0526227_sc-137497.jpg,1,0,0,0,1,,train
0526228_sc-130411.jpg,7,2,1,1,11,,val
0526229_sc-130411.jpg,4,1,1,1,7,,val
0526230_sc-130411.jpg,11,1,1,1,14,,test
0526231_sc-130411.jpg,11,2,1,2,16,,train
0526232_sc-130411.jpg,8,2,1,1,12,,train
0526233_sc-130411.jpg,6,3,1,1,11,,train
0526235_as-0058629.jpg,2,0,0,0,2,,train
0526236_as-0058629.jpg,2,0,0,0,2,,train
0526238_sc-1025024.jpg,4,1,0,0,5,,train
0526240_as-3235183.jpg,2,1,2,0,5,,train
0526241_sc-218246.jpg,4,0,0,0,4,,val
0526242_sc-218246.jpg,5,0,0,0,5,,val
0526243_sc-218246.jpg,1,0,0,0,1,,test
0526247_as-0086373.jpg,2,0,0,0,2,,train
0526249_as-0055693.jpg,0,1,2,0,3,,train
0526250_as-9098391.jpg,1,0,0,0,1,,train
0526251_as-0042765.jpg,2,0,0,0,2,,train
0526252_sc-225005.jpg,1,0,0,0,1,,train
0526253_as-0049814.jpg,2,0,0,0,2,,train
0526254_as-0049814.jpg,1,0,0,0,1,,train
0526255_as-0049814.jpg,0,1,0,0,1,,val
0526256_sc-216288.jpg,2,0,1,0,3,,val
0526257_sc-216288.jpg,2,0,0,1,3,,test
0526258_sc-116609.jpg,4,0,0,0,4,,train
0526259_sc-116609.jpg,3,0,0,0,3,,train
0526260_sc-116609.jpg,3,0,0,0,3,,train
0526261_sc-109820.jpg,3,0,2,0,5,,train
0526262_sc-109820.jpg,3,0,1,0,4,,train
0526263_sc-109820.jpg,3,0,2,0,5,,train
0526264_sc-109820.jpg,1,0,0,0,1,,train
0526265_sc-109820.jpg,3,0,2,0,5,,val
0526266_sc-109820.jpg,2,0,1,0,3,,val
0526267_sc-109820.jpg,1,0,0,0,1,,test
0526268_as-3230905.jpg,2,0,0,0,2,,train
0526269_as-3230905.jpg,3,2,1,1,7,,train
0526270_as-0074542.jpg,1,0,0,1,2,,train
0526271_as-0074542.jpg,1,0,0,1,2,,train
0526272_as-0074542.jpg,2,0,0,2,4,,train
0526273_as-0074542.jpg,3,0,0,0,3,,train
0526274_sc-110586.jpg,2,0,0,0,2,,train
0526275_sc-110586.jpg,5,1,0,0,6,,val
0526276_sc-110586.jpg,4,0,0,0,4,,val
0526279_as-0067752.jpg,1,0,1,0,2,,test
0526280_as-0067752.jpg,3,0,0,0,3,,train
0526281_as-9020647.jpg,1,0,0,0,1,,train
0526282_as-2735383.jpg,0,0,1,0,1,,train
0526283_as-2828658.jpg,5,0,1,1,7,,train
0526284_as-9090945.jpg,3,0,0,0,3,,train
0526288_as-3424254.jpg,2,0,0,0,2,,train
0526289_sc-230318.jpg,5,2,2,0,9,,train
0526290_sc-230318.jpg,5,2,2,0,9,,val
0526291_as-7987293.jpg,1,0,0,0,1,,val
0526292_as-3239501.jpg,0,1,0,0,1,,test
0526294_as-0040129.jpg,3,0,0,2,5,,train
0526295_sc-123540.jpg,1,0,1,0,2,,train
0526297_as-0059471.jpg,4,0,1,1,6,,train
0526298_as-0059471.jpg,7,0,0,0,7,,train
0526300_as-0059471.jpg,2,0,0,1,3,,train
0526308_sc-1017281.jpg,2,0,1,0,3,,train
0526309_sc-1017281.jpg,2,0,0,1,3,,train
0526310_as-0072088.jpg,1,0,0,0,1,,val
0526311_as-0072088.jpg,2,0,0,0,2,,val
0526312_as-0072088.jpg,1,0,0,0,1,,test
0526314_as-3178597.jpg,8,0,1,0,9,,train
0526315_as-3314615.jpg,1,1,1,0,3,,train
0526316_as-3357814.jpg,1,0,0,0,1,,train
0526318_sc-229063.jpg,12,0,1,0,13,,train
0526319_sc-229063.jpg,6,0,1,0,7,,train
0526320_sc-229063.jpg,10,0,1,0,11,,train
0526321_sc-229063.jpg,14,0,1,0,15,,train
0526322_sc-229063.jpg,10,0,0,0,10,,val
0526323_sc-229063.jpg,0,1,1,1,3,,val
0526325_as-0004878.jpg,6,2,0,0,8,,test
0526326_as-0004878.jpg,4,1,1,0,6,,train
0526327_as-0004878.jpg,1,4,2,4,11,,train
0526328_as-0004878.jpg,3,4,1,1,9,,train
0526329_as-0004878.jpg,0,0,1,0,1,,train
0526330_as-0033784.jpg,1,0,1,0,2,,train
0526331_as-0033784.jpg,1,1,2,1,5,,train
0526332_sc-149702.jpg,2,1,0,0,3,,train
0526334_as-0038843.jpg,5,1,4,0,10,,val
0526335_as-0038843.jpg,3,0,3,0,6,,val
0526336_as-0038843.jpg,7,2,3,0,12,,test
0526337_as-0038843.jpg,7,2,5,0,14,,train
0526338_as-0038843.jpg,1,2,0,0,3,,train
0526339_as-0038843.jpg,0,1,0,0,1,,train
0526340_as-0038843.jpg,1,2,0,0,3,,train
0526341_sc-149818.jpg,3,0,1,1,5,,train
0526342_sc-200094.jpg,2,1,0,0,3,,train
0526343_sc-200094.jpg,2,0,1,0,3,,train
0526344_sc-200094.jpg,5,0,0,0,5,,val
0526345_sc-200094.jpg,1,0,0,1,2,,val
0526346_sc-200094.jpg,2,0,0,1,3,,test
0526347_sc-200094.jpg,3,0,0,2,5,,train
0526349_as-0037131.jpg,1,1,0,0,2,,train
0526350_as-0037131.jpg,0,1,0,0,1,,train
0526351_as-0037131.jpg,1,0,1,0,2,,train
0526352_as-0037131.jpg,1,2,1,0,4,,train
0526353_sc-226693.jpg,3,0,0,0,3,,train
0526354_sc-226693.jpg,1,0,1,0,2,,train
0526355_sc-226693.jpg,1,0,1,0,2,,val
0526356_sc-226693.jpg,1,0,0,0,1,,val
0526357_sc-226693.jpg,2,1,1,0,4,,test
0526358_sc-226693.jpg,2,1,1,0,4,,train
0526359_sc-226693.jpg,4,0,0,0,4,,train
0526360_sc-205741.jpg,1,0,0,0,1,,train
0526361_sc-205741.jpg,4,0,0,1,5,,train
0526362_sc-205741.jpg,2,0,1,2,5,,train
0526363_sc-205741.jpg,1,0,0,2,3,,train
0526364_sc-205741.jpg,1,0,0,0,1,,train
0526365_as-3259115.jpg,1,0,0,0,1,,val
0526366_as-0036900.jpg,3,0,0,0,3,,val
0526367_as-0036900.jpg,2,0,0,0,2,,test
0526368_as-0036900.jpg,1,0,0,0,1,,train
0526369_as-7410560.jpg,1,0,0,0,1,,train
0526370_as-0094813.jpg,1,0,0,0,1,,train
0526371_as-0094813.jpg,1,0,0,1,2,,train
0526372_as-0094813.jpg,2,0,0,0,2,,train
0526373_sc-167364.jpg,5,0,1,0,6,,train
0526374_sc-167364.jpg,4,0,1,0,5,,train
0526375_as-0071217.jpg,1,2,3,0,6,,val
0526376_as-0071217.jpg,1,0,1,1,3,,val
0526377_as-0071217.jpg,0,0,1,0,1,,test
0526378_as-0071217.jpg,0,0,2,0,2,,train
0526379_as-0071217.jpg,0,0,1,0,1,,train
0526380_as-0064826.jpg,2,1,0,0,3,,train
0526381_as-0064826.jpg,2,0,0,0,2,,train
0526382_as-0064826.jpg,0,1,0,0,1,,train
0526383_sc-1027693.jpg,2,0,0,0,2,,train
0526384_as-3497387.jpg,3,1,0,1,5,,train
0526385_as-0092517.jpg,2,0,0,1,3,,val
0526386_as-0092517.jpg,1,0,2,1,4,,val
0526387_as-0092517.jpg,1,0,1,1,3,,test
0526388_as-0092517.jpg,3,0,1,1,5,,train
0526389_as-0092517.jpg,2,0,1,1,4,,train
0526390_as-0092517.jpg,2,0,1,1,4,,train
0526391_as-0092517.jpg,2,0,1,1,4,,train
0526392_as-0092517.jpg,3,0,1,0,4,,train
0526393_as-0092517.jpg,1,0,0,0,1,,train
0526394_sc-1013761.jpg,8,1,2,0,11,,train
0526395_sc-1013761.jpg,4,1,0,0,5,,val
0526396_sc-1013761.jpg,7,2,2,0,11,,val
0526397_sc-1012565.jpg,1,0,0,0,1,,test
0526398_sc-1012565.jpg,1,0,0,0,1,,train
0526399_sc-1012565.jpg,1,0,0,0,1,,train
0526400_sc-1012565.jpg,1,0,0,0,1,,train
0526401_as-3400493.jpg,1,0,1,0,2,,train
0526404_as-0044823.jpg,5,1,0,0,6,,train
0526405_as-0044823.jpg,4,2,1,0,7,,train
0526406_sc-176491.jpg,1,0,1,1,3,,train
0526407_sc-176491.jpg,1,0,1,1,3,,val
0526408_sc-176491.jpg,1,0,0,0,1,,val
0526409_as-3352115.jpg,1,0,1,0,2,,test
0526413_as-0063351.jpg,0,0,1,0,1,,train
0526414_as-0063351.jpg,4,4,2,1,11,,train
0526415_as-0063351.jpg,0,0,1,1,2,,train
0526416_as-5449561.jpg,1,0,2,1,4,,train
0526417_as-2674037.jpg,2,0,0,0,2,,train
0526419_as-0076045.jpg,0,1,0,0,1,,train
0526421_as-2762312.jpg,1,1,1,1,4,,train
0526423_as-0068453.jpg,1,0,0,0,1,,val
0526424_as-0068453.jpg,1,0,0,0,1,,val
0526425_as-0068453.jpg,1,0,0,0,1,,test
0526428_as-0077709.jpg,0,1,2,0,3,,train
0526429_as-0077709.jpg,1,0,1,0,2,,train
0526431_as-0077709.jpg,1,0,0,0,1,,train
0526432_as-3017197.jpg,2,0,0,0,2,,train
0526434_as-0056912.jpg,2,0,0,0,2,,train
0526435_as-0056912.jpg,1,0,0,0,1,,train
0526436_sc-136542.jpg,1,1,0,0,2,,train
0526437_sc-136542.jpg,1,1,0,0,2,,val
0526438_sc-136542.jpg,1,0,0,0,1,,val
0526440_as-0066100.jpg,1,0,0,0,1,,test
0526441_as-0066100.jpg,1,0,0,0,1,,train
0526443_sc-107422.jpg,4,0,1,0,5,,train
0526444_sc-107422.jpg,4,0,0,0,4,,train
0526448_sc-145110.jpg,0,0,1,0,1,,train
0526450_sc-145110.jpg,2,0,1,0,3,,train
0526451_sc-222828.jpg,1,0,2,0,3,,train
0526452_sc-222828.jpg,0,0,1,0,1,,train
0526453_sc-162932.jpg,1,0,0,1,2,,val
0526454_sc-162932.jpg,1,0,0,0,1,,val
0526455_sc-162932.jpg,1,0,2,0,3,,test
0526456_as-0072996.jpg,2,0,0,1,3,,train
0526457_sc-114178.jpg,0,0,0,1,1,,train
0526458_sc-114178.jpg,3,0,0,1,4,,train
0526459_as-7516062.jpg,1,0,0,0,1,,train
0526460_sc-1017430.jpg,4,0,0,2,6,,train
0526461_sc-193216.jpg,2,2,2,1,7,,train
0526462_sc-193216.jpg,3,2,1,1,7,,train
0526463_sc-193216.jpg,1,1,0,0,2,,val
0526465_as-0038970.jpg,1,1,0,1,3,,val
0526466_as-0038970.jpg,3,1,0,1,5,,test
0526467_as-0038970.jpg,2,1,0,1,4,,train
0526468_as-0038970.jpg,3,1,0,1,5,,train
0526469_as-0038970.jpg,2,1,1,1,5,,train
0526470_as-0030434.jpg,1,0,1,1,3,,train
0526473_as-0060370.jpg,3,2,1,0,6,,train
0526474_as-0060370.jpg,3,1,0,0,4,,train
0526475_as-0060370.jpg,2,1,1,1,5,,train
0526476_as-0060370.jpg,6,0,2,2,10,,val
0526478_as-0060370.jpg,1,0,1,0,2,,val
0526480_as-0013103.jpg,2,0,0,0,2,,test
0526481_as-0013103.jpg,5,0,0,0,5,,train
0526482_as-0013103.jpg,4,0,0,0,4,,train
0526483_as-0013103.jpg,1,0,1,0,2,,train
0526484_as-0005763.jpg,5,0,1,2,8,,train
0526485_as-3123514.jpg,3,0,1,1,5,,train
0526486_sc-220950.jpg,3,0,0,0,3,,train
0526487_sc-220950.jpg,2,1,0,0,3,,train
0526488_sc-220950.jpg,1,0,0,0,1,,val
0526489_sc-189069.jpg,1,0,0,1,2,,val
0526491_as-3276353.jpg,2,0,1,0,3,,test
0526492_as-3150642.jpg,3,2,1,1,7,,train
0526493_as-3102637.jpg,1,0,2,0,3,,train
0526494_sc-1015091.jpg,5,0,0,0,5,,train
0526495_sc-1015091.jpg,5,0,0,0,5,,train
0526496_sc-130950.jpg,1,0,0,0,1,,train
0526497_sc-130950.jpg,1,0,0,0,1,,train
0526498_sc-130950.jpg,1,0,0,0,1,,train
0526499_sc-130950.jpg,1,0,0,2,3,,val
0526500_sc-130950.jpg,1,0,0,1,2,,val
0526501_sc-130950.jpg,1,0,0,1,2,,test
0526503_as-2614193.jpg,1,1,0,0,2,,train
0526504_as-3204697.jpg,2,0,0,0,2,,train
0526505_as-2939125.jpg,1,0,0,0,1,,train
0526506_sc-1021469.jpg,1,0,1,1,3,,train
0526507_sc-1021469.jpg,2,0,1,1,4,,train
0526508_sc-1021469.jpg,1,0,1,1,3,,train
0526509_sc-127814.jpg,1,0,0,1,2,,train
0526512_sc-228166.jpg,2,1,0,0,3,,val
0526513_sc-228166.jpg,1,2,1,0,4,,val
0526514_sc-228166.jpg,2,1,2,0,5,,test
0526515_sc-228166.jpg,1,1,2,0,4,,train
0526516_sc-228166.jpg,2,1,3,0,6,,train
0526517_sc-228166.jpg,2,1,2,0,5,,train
0526518_sc-1021351.jpg,2,0,0,1,3,,train
0526520_sc-1021351.jpg,2,0,0,1,3,,train
0526523_as-0017339.jpg,2,0,1,0,3,,train
0526524_as-0017339.jpg,3,0,2,0,5,,train
0526525_as-0017339.jpg,1,0,1,0,2,,val
0526526_as-0017339.jpg,1,0,1,0,2,,val
0526527_as-0017339.jpg,1,0,1,0,2,,test
0526529_as-9070273.jpg,1,0,0,0,1,,train
0526530_as-3494664.jpg,5,0,0,1,6,,train
0526531_as-0056745.jpg,0,0,1,1,2,,train
0526532_as-0056745.jpg,0,0,0,1,1,,train
0526533_as-3022221.jpg,0,2,1,3,6,,train
0526534_as-0032358.jpg,3,0,1,1,5,,train
0526535_as-0032358.jpg,3,0,1,1,5,,train
0526536_as-0032358.jpg,2,0,1,0,3,,val
0526537_as-0032358.jpg,2,0,1,1,4,,val
0526538_as-0062546.jpg,1,0,0,1,2,,test
0526539_as-0062546.jpg,1,0,0,1,2,,train
0526540_as-0062546.jpg,1,0,0,2,3,,train
0526543_sc-194781.jpg,13,0,0,0,13,,train
0526544_sc-194781.jpg,14,0,0,0,14,,train
0526545_sc-194781.jpg,8,0,0,0,8,,train
0526546_sc-194781.jpg,4,0,0,0,4,,train
0526547_sc-194781.jpg,7,0,0,0,7,,train
0526548_sc-194781.jpg,11,0,0,0,11,,val
0526549_sc-194781.jpg,7,0,0,0,7,,val
0526550_sc-151797.jpg,3,1,2,0,6,,test
0526551_sc-220463.jpg,2,0,1,0,3,,train
0526552_sc-220463.jpg,5,1,2,1,9,,train
0526553_as-3326908.jpg,1,0,0,0,1,,train
0526555_as-2858297.jpg,2,1,0,0,3,,train
0526556_as-0061769.jpg,1,0,1,0,2,,train
0526557_sc-103919.jpg,0,1,1,0,2,,train
0526558_sc-103919.jpg,0,1,0,0,1,,train
0526559_as-0056070.jpg,1,0,1,0,2,,val
0526560_as-0056070.jpg,1,0,1,0,2,,val
0526561_as-0056070.jpg,1,0,0,0,1,,test
0526562_as-0026990.jpg,4,2,1,1,8,,train
0526563_as-0026990.jpg,6,2,0,1,9,,train
0526565_sc-217515.jpg,1,0,0,0,1,,train
0526566_sc-217515.jpg,2,0,2,1,5,,train
0526567_as-3048305.jpg,1,0,1,0,2,,train
0526568_sc-103888.jpg,3,1,0,0,4,,train
0526569_sc-103888.jpg,2,1,0,0,3,,train
0526573_as-0038841.jpg,1,0,0,1,2,,val
0526574_as-0038841.jpg,1,0,0,1,2,,val
0526575_as-0038841.jpg,1,0,0,0,1,,test
0526576_as-0038841.jpg,1,0,0,0,1,,train
0526577_as-0038841.jpg,1,0,0,1,2,,train
0526578_as-0038841.jpg,1,0,0,0,1,,train
0526579_as-0038841.jpg,1,0,0,0,1,,train
0526580_as-2809831.jpg,2,0,0,0,2,,train
0526582_sc-172971.jpg,1,0,0,0,1,,train
0526583_sc-172971.jpg,2,0,0,0,2,,train
0526584_sc-172971.jpg,1,0,0,0,1,,val
0526585_sc-172971.jpg,1,0,0,0,1,,val
0526586_sc-172971.jpg,1,0,1,1,3,,test
0526587_sc-172971.jpg,1,0,0,1,2,,train
0526588_sc-172971.jpg,1,0,0,0,1,,train
0526589_sc-172971.jpg,1,0,0,1,2,,train
0526590_sc-172971.jpg,1,0,0,0,1,,train
0526591_sc-172971.jpg,2,0,0,0,2,,train
0526592_sc-172971.jpg,1,0,0,0,1,,train
0526593_sc-172971.jpg,1,0,0,0,1,,train
0526594_sc-172971.jpg,1,0,0,0,1,,val
0526595_sc-172971.jpg,2,0,1,0,3,,val
0526596_sc-172971.jpg,3,0,1,0,4,,test
0526597_sc-172971.jpg,3,0,1,0,4,,train
0526600_sc-198686.jpg,1,1,0,0,2,,train
0526601_sc-198686.jpg,5,1,0,0,6,,train
0526602_sc-198686.jpg,1,1,0,0,2,,train
0526604_as-0077512.jpg,1,0,0,0,1,,train
0526605_as-0077512.jpg,1,0,0,0,1,,train
0526606_sc-125067.jpg,1,0,0,0,1,,train
0526607_sc-125067.jpg,2,0,0,0,2,,val
0526608_sc-125067.jpg,4,0,0,0,4,,val
0526609_sc-125067.jpg,3,0,0,0,3,,test
0526611_as-0045556.jpg,0,1,1,0,2,,train
0526613_as-0045556.jpg,5,1,2,1,9,,train
0526614_as-0045556.jpg,0,0,1,1,2,,train
0526615_as-0045556.jpg,0,1,1,0,2,,train
0526616_as-0045556.jpg,0,0,1,0,1,,train
0526617_as-0045556.jpg,2,2,1,0,5,,train
0526619_sc-120882.jpg,1,0,0,0,1,,train
0526620_sc-120882.jpg,1,0,0,0,1,,val
0526621_as-0030435.jpg,3,0,0,0,3,,val
0526622_as-0030435.jpg,3,0,0,0,3,,test
0526623_sc-1008569.jpg,1,0,2,1,4,,train
0526625_sc-1008569.jpg,2,0,3,0,5,,train
0526627_sc-1008569.jpg,1,0,2,0,3,,train
0526628_sc-1008569.jpg,0,0,2,0,2,,train
0526629_sc-1008569.jpg,1,0,2,0,3,,train
0526630_as-2670999.jpg,1,0,1,0,2,,train
0526634_as-0060927.jpg,2,0,1,0,3,,train
0526635_as-0060927.jpg,1,0,3,0,4,,val
0526637_as-0060927.jpg,2,0,1,0,3,,val
0526639_sc-1034856.jpg,7,1,1,0,9,,test
0526641_sc-1034856.jpg,4,1,2,0,7,,train
0526642_sc-1034856.jpg,5,2,2,0,9,,train
0526643_as-0058256.jpg,1,0,0,0,1,,train
0526644_as-0058256.jpg,2,0,0,0,2,,train
0526645_as-0058256.jpg,2,0,0,0,2,,train
0526646_as-3338173.jpg,2,0,0,0,2,,train
0526647_sc-179618.jpg,3,0,0,0,3,,train
0526648_sc-179618.jpg,4,0,0,1,5,,val
0526649_sc-179618.jpg,1,0,0,1,2,,val
0526650_sc-179618.jpg,1,0,0,1,2,,test
0526651_sc-179618.jpg,3,0,0,0,3,,train
0526654_as-0030526.jpg,1,0,0,0,1,,train
0526655_as-9080707.jpg,2,0,0,0,2,,train
0526658_as-0056569.jpg,2,0,0,0,2,,train
0526661_as-0056569.jpg,1,0,1,0,2,,train
0526663_as-0056569.jpg,1,0,1,0,2,,train
0526664_as-0056569.jpg,2,0,0,0,2,,train
0526665_as-3309466.jpg,1,0,0,1,2,,val
0526667_sc-1015634.jpg,2,0,2,0,4,,val
0526668_as-7212066.jpg,3,0,1,0,4,,test
0526670_as-0073030.jpg,7,0,0,0,7,,train
0526672_as-0073030.jpg,4,0,0,0,4,,train
0526673_as-0073030.jpg,6,0,0,0,6,,train
0526674_as-0073030.jpg,7,0,0,0,7,,train
0526675_as-0073030.jpg,3,0,0,0,3,,train
0526676_as-0073030.jpg,2,0,0,0,2,,train
0526677_as-2643875.jpg,0,0,1,0,1,,train
0526679_sc-178544.jpg,2,0,1,0,3,,val
0526680_sc-178544.jpg,2,0,1,0,3,,val
0526681_sc-178544.jpg,2,0,1,0,3,,test
0526682_as-2959370.jpg,1,0,1,0,2,,train
0526683_as-0081718.jpg,5,0,0,1,6,,train
0526684_as-0081718.jpg,5,1,0,1,7,,train
0526686_sc-110421.jpg,1,0,0,0,1,,train
0526687_sc-110421.jpg,4,0,0,0,4,,train
0526689_sc-110421.jpg,1,0,0,0,1,,train
0526691_as-0082570.jpg,1,0,0,0,1,,train
0526692_as-0082570.jpg,4,0,0,0,4,,val
0526693_sc-162818.jpg,4,0,3,1,8,,val
0526694_sc-162818.jpg,2,0,1,1,4,,test
0526695_sc-162818.jpg,5,0,3,1,9,,train
0526696_sc-162818.jpg,3,0,1,1,5,,train
0526697_sc-162818.jpg,1,0,2,1,4,,train
0526699_sc-203617.jpg,3,0,1,0,4,,train
0526700_as-0071188.jpg,1,0,0,0,1,,train
0526701_as-0071188.jpg,1,0,0,0,1,,train
0526702_as-0071188.jpg,2,0,0,0,2,,train
0526703_as-0071188.jpg,2,0,0,0,2,,val
0526704_as-0071188.jpg,2,0,0,0,2,,val
0526705_as-0071188.jpg,1,0,0,0,1,,test
0526706_as-0071188.jpg,1,0,0,0,1,,train
0526707_as-0071188.jpg,4,0,0,0,4,,train
0526708_sc-203252.jpg,1,0,0,0,1,,train
0526709_sc-203252.jpg,1,1,0,0,2,,train
0526710_sc-1021785.jpg,1,0,1,0,2,,train
0526711_sc-1021785.jpg,2,0,0,0,2,,train
0526712_as-3081904.jpg,6,0,0,0,6,,train
0526713_as-4600406.jpg,3,0,1,1,5,,val
0526714_as-3368425.jpg,3,0,0,2,5,,val
0526715_sc-213425.jpg,1,0,0,0,1,,test
0526716_sc-213425.jpg,1,0,0,0,1,,train
0526717_sc-213425.jpg,1,0,0,0,1,,train
0526718_sc-213425.jpg,1,0,0,0,1,,train
0526719_sc-213425.jpg,1,0,0,0,1,,train
0526720_sc-213425.jpg,1,0,0,0,1,,train
0526721_sc-228610.jpg,1,0,1,0,2,,train
0526722_sc-228610.jpg,1,0,1,0,2,,train
0526723_sc-1017627.jpg,3,0,0,2,5,,val
0526724_sc-1017627.jpg,2,0,0,2,4,,val
0526725_sc-1017627.jpg,3,0,0,1,4,,test
0526726_as-3037738.jpg,5,1,0,0,6,,train
0526727_sc-138939.jpg,5,2,0,1,8,,train
0526729_sc-138939.jpg,3,0,0,0,3,,train
0526732_as-2916030.jpg,1,0,0,0,1,,train
0526733_as-7584617.jpg,1,0,0,0,1,,train
0526735_as-0083729.jpg,2,0,0,1,3,,train
0526736_as-0083729.jpg,2,0,0,0,2,,train
0526737_sc-223124.jpg,2,1,0,1,4,,val
0526738_sc-223124.jpg,3,0,0,1,4,,val
0526739_sc-223124.jpg,5,0,0,0,5,,test
0526740_sc-223124.jpg,3,0,0,1,4,,train
0526741_sc-223124.jpg,1,1,0,1,3,,train
0526742_sc-223124.jpg,2,1,0,1,4,,train
0526743_sc-223124.jpg,2,1,1,1,5,,train
0526744_sc-223124.jpg,1,1,0,1,3,,train
0526745_sc-223124.jpg,4,1,0,0,5,,train
0526747_as-0053106.jpg,1,0,0,0,1,,train
0526748_as-0053106.jpg,2,0,0,1,3,,val
0526749_as-0053106.jpg,1,0,0,1,2,,val
0526750_as-0053106.jpg,1,0,0,1,2,,test
0526751_as-0053106.jpg,1,0,0,1,2,,train
0526752_sc-203881.jpg,1,1,0,0,2,,train
0526754_as-0048817.jpg,2,1,0,0,3,,train
0526755_as-0048817.jpg,1,1,0,1,3,,train
0526756_as-0048817.jpg,0,1,1,0,2,,train
0526757_as-0048817.jpg,0,0,0,1,1,,train
0526758_as-0048817.jpg,1,0,0,1,2,,train
0526759_as-0048817.jpg,1,0,0,1,2,,val
0526760_as-0048817.jpg,0,0,0,1,1,,val
0526761_as-0048817.jpg,0,0,2,0,2,,test
0526762_as-0048817.jpg,1,0,2,0,3,,train
0526763_as-0048817.jpg,0,0,1,0,1,,train
0526764_as-0048817.jpg,1,1,0,1,3,,train
0526765_sc-131510.jpg,2,0,0,1,3,,train
0526767_as-0024966.jpg,0,1,0,0,1,,train
0526768_as-0024966.jpg,1,1,0,0,2,,train
0526769_as-0024966.jpg,1,0,0,1,2,,train
0526770_sc-1014897.jpg,2,0,1,1,4,,val
0526771_sc-1014897.jpg,1,0,1,1,3,,val
0526772_sc-1014897.jpg,3,0,0,0,3,,test
0526773_sc-1014897.jpg,2,1,0,0,3,,train
0526774_sc-1014897.jpg,2,1,0,0,3,,train
0526776_sc-1014897.jpg,1,0,0,0,1,,train
0526778_as-0039812.jpg,2,0,0,0,2,,train
0526779_as-0039812.jpg,1,0,0,0,1,,train
0526780_as-3472842.jpg,4,0,1,0,5,,train
0526781_as-0062881.jpg,0,1,0,0,1,,train
0526782_as-0062881.jpg,2,0,0,0,2,,val
0526784_as-0062881.jpg,2,1,0,0,3,,val
0526786_as-0062881.jpg,3,2,0,0,5,,test
0526787_as-0062881.jpg,8,1,0,0,9,,train
0526793_sc-145915.jpg,1,0,0,0,1,,train
0526794_as-2727035.jpg,2,0,1,0,3,,train
0526795_sc-177975.jpg,4,0,0,0,4,,train
0526796_sc-177975.jpg,2,0,0,0,2,,train
0526797_sc-177975.jpg,3,1,0,0,4,,train
0526799_sc-177975.jpg,3,0,0,0,3,,train
0526800_sc-177975.jpg,1,1,0,0,2,,val
0526801_as-2524141.jpg,2,2,1,1,6,,val
0526803_as-7467010.jpg,0,1,1,0,2,,test
0526806_as-0073853.jpg,2,2,1,0,5,,train
0526807_as-0073853.jpg,2,2,1,0,5,,train
0526808_as-3306866.jpg,1,0,1,0,2,,train
0526809_as-0035537.jpg,2,0,0,0,2,,train
0526810_as-0035537.jpg,2,0,0,0,2,,train
0526812_as-0075969.jpg,1,0,0,1,2,,train
0526813_sc-1027299.jpg,1,1,0,0,2,,train
0526814_sc-1027299.jpg,1,0,0,0,1,,val
0526815_as-7765200.jpg,1,0,0,1,2,,val
0526816_as-3367528.jpg,1,0,0,0,1,,test
0526817_as-3116500.jpg,2,0,0,0,2,,train
0526819_as-0025639.jpg,0,1,0,0,1,,train
0526820_sc-1031775.jpg,1,0,0,0,1,,train
0526822_as-0063755.jpg,1,1,0,0,2,,train
0526823_as-0063755.jpg,4,0,0,0,4,,train
0526824_as-0063755.jpg,6,1,0,0,7,,train
0526825_as-3172697.jpg,1,1,0,0,2,,train
0526826_sc-147129.jpg,7,0,0,0,7,,val
0526827_sc-1018464.jpg,3,1,2,0,6,,val
0526828_sc-1018464.jpg,8,2,2,0,12,,test
0526829_sc-1018464.jpg,4,1,2,0,7,,train
0526830_sc-1018464.jpg,4,1,2,0,7,,train
0526831_as-3313227.jpg,1,0,1,0,2,,train
0526832_as-0096394.jpg,1,1,1,0,3,,train
0526833_as-0096394.jpg,1,1,1,0,3,,train
0526834_as-0096394.jpg,1,1,0,0,2,,train
0526835_as-0096394.jpg,0,0,1,0,1,,train
0526836_sc-206572.jpg,2,0,1,0,3,,val
0526837_sc-206572.jpg,3,0,0,0,3,,val
0526838_sc-206572.jpg,1,0,1,0,2,,test
0526839_as-2716970.jpg,8,0,0,1,9,,train
0526840_as-3430200.jpg,2,0,3,0,5,,train
0526841_as-2640660.jpg,1,0,1,0,2,,train
0526842_as-3422323.jpg,1,0,0,0,1,,train
0526844_sc-1034612.jpg,2,1,1,0,4,,train
0526845_sc-1034612.jpg,0,2,0,0,2,,train
0526846_as-7225550.jpg,2,0,0,0,2,,train
0526847_sc-194585.jpg,1,0,0,1,2,,val
0526848_as-0074205.jpg,0,1,1,1,3,,val
0526851_sc-228170.jpg,2,0,1,2,5,,test
0526852_sc-228170.jpg,2,0,0,0,2,,train
0526853_sc-103813.jpg,4,0,0,0,4,,train
0526854_sc-103813.jpg,1,0,0,0,1,,train
0526855_sc-103813.jpg,2,0,0,0,2,,train
0526857_sc-1032577.jpg,1,0,0,0,1,,train
0526858_sc-1032577.jpg,3,0,0,0,3,,train
0526859_sc-1032577.jpg,2,0,0,0,2,,train
0526860_sc-1032577.jpg,3,0,0,0,3,,val
0526861_sc-1032577.jpg,2,0,0,1,3,,val
0526862_sc-1032577.jpg,1,0,0,0,1,,test
0526863_sc-1032577.jpg,3,0,0,0,3,,train
0526864_sc-1032577.jpg,3,0,0,0,3,,train
0526865_sc-110154.jpg,1,0,0,0,1,,train
0526866_sc-157151.jpg,4,0,0,0,4,,train
0526867_as-0048838.jpg,1,0,0,0,1,,train
0526868_as-0048838.jpg,0,0,1,0,1,,train
0526872_as-3326396.jpg,1,0,0,1,2,,train
0526873_sc-1022054.jpg,1,0,0,0,1,,val
0526874_sc-1022054.jpg,1,0,1,0,2,,val
0526877_as-0003403.jpg,1,2,0,0,3,,test
0526878_sc-220655.jpg,3,1,1,0,5,,train
0526879_sc-220655.jpg,0,1,1,0,2,,train
0526880_sc-220655.jpg,1,1,1,0,3,,train
0526881_sc-220655.jpg,1,0,0,0,1,,train
0526882_sc-220655.jpg,0,1,0,0,1,,train
0526883_sc-220655.jpg,4,1,0,0,5,,train
0526884_sc-132271.jpg,0,1,0,0,1,,train
0526885_sc-132271.jpg,1,1,0,0,2,,val
0526886_sc-225289.jpg,2,0,1,0,3,,val
0526887_sc-225289.jpg,2,1,0,0,3,,test
0526888_sc-225289.jpg,1,0,0,0,1,,train
0526889_sc-225289.jpg,2,0,1,0,3,,train
0526892_as-0079096.jpg,2,0,1,0,3,,train
0526893_as-3348980.jpg,1,0,0,0,1,,train
0526896_as-0041553.jpg,0,0,1,0,1,,train
0526897_as-0041553.jpg,8,3,1,0,12,,train
0526899_as-9044209.jpg,5,0,0,0,5,,train
0526900_as-3444293.jpg,1,0,0,0,1,,val
0526904_as-2936707.jpg,0,0,1,0,1,,val
0526905_as-7508624.jpg,5,0,0,0,5,,test
0526907_sc-186924.jpg,1,2,1,0,4,,train
0526908_sc-186924.jpg,1,2,1,0,4,,train
0526909_sc-186924.jpg,2,1,0,0,3,,train
0526910_sc-186924.jpg,1,2,0,0,3,,train
0526911_sc-186924.jpg,2,1,0,0,3,,train
0526912_sc-186924.jpg,1,1,0,0,2,,train
0526913_sc-1005664.jpg,1,1,1,0,3,,train
0526914_sc-1005664.jpg,1,1,0,0,2,,val
0526915_sc-1005664.jpg,2,1,0,0,3,,val
0526916_sc-1005664.jpg,1,1,0,0,2,,test
0526917_sc-139772.jpg,1,0,0,1,2,,train
0526918_sc-124734.jpg,4,0,1,0,5,,train
0526920_sc-112413.jpg,1,3,2,0,6,,train
0526922_sc-216522.jpg,8,0,0,0,8,,train
0526923_sc-216522.jpg,7,0,0,0,7,,train
0526924_sc-216522.jpg,5,0,0,0,5,,train
0526925_sc-216522.jpg,6,1,0,0,7,,train
0526926_sc-216522.jpg,7,0,0,0,7,,val
0526927_sc-216522.jpg,5,0,0,0,5,,val
0526928_sc-216522.jpg,4,0,0,0,4,,test
0526929_sc-216522.jpg,9,0,0,0,9,,train
0526931_sc-120083.jpg,3,0,0,0,3,,train
0526933_sc-120083.jpg,0,0,0,1,1,,train
0526934_as-2586317.jpg,0,1,0,0,1,,train
0526935_sc-1034209.jpg,1,0,0,1,2,,train
0526936_sc-1034209.jpg,2,0,1,1,4,,train
0526937_sc-1034209.jpg,1,0,0,0,1,,train
0526939_as-3439990.jpg,1,0,1,0,2,,val
0526940_sc-198803.jpg,0,1,0,0,1,,val
0526941_sc-198803.jpg,1,0,2,1,4,,test
0526942_sc-1021271.jpg,1,0,0,0,1,,train
0526944_sc-1021271.jpg,5,0,1,0,6,,train
0526945_sc-140642.jpg,1,1,1,0,3,,train
0526946_sc-140642.jpg,1,1,1,0,3,,train
0526947_sc-140642.jpg,1,1,1,0,3,,train
0526949_sc-140642.jpg,1,1,1,0,3,,train
0526950_sc-140642.jpg,1,1,1,0,3,,train
0526951_as-9098677.jpg,5,0,0,0,5,,val
0526952_sc-224350.jpg,0,1,0,0,1,,val
0526953_sc-224350.jpg,0,1,0,0,1,,test
0526954_sc-107561.jpg,1,0,0,0,1,,train
0526955_as-7592057.jpg,5,0,1,0,6,,train
0526956_as-0100100.jpg,5,0,1,0,6,,train
0526957_as-0100100.jpg,5,0,1,0,6,,train
0526958_as-7808135.jpg,1,0,0,0,1,,train
0526959_sc-205316.jpg,3,0,0,0,3,,train
0526960_sc-215381.jpg,1,0,0,0,1,,train
0526961_sc-215381.jpg,0,0,0,1,1,,val
0526962_sc-1014920.jpg,1,0,2,0,3,,val
0526963_sc-1014920.jpg,8,0,1,0,9,,test
0526964_sc-1014920.jpg,4,0,0,0,4,,train
0526965_as-2503981.jpg,1,0,0,0,1,,train
0526966_sc-133887.jpg,0,0,1,1,2,,train
0526967_as-7160541.jpg,4,0,0,0,4,,train
0526968_as-2548353.jpg,0,1,2,1,4,,train
0526969_sc-204404.jpg,2,0,0,0,2,,train
0526970_sc-204404.jpg,3,2,1,1,7,,train
0526971_sc-204404.jpg,2,2,1,1,6,,val
0526972_sc-204404.jpg,1,1,1,1,4,,val
0526973_sc-204404.jpg,5,0,1,0,6,,test
0526974_sc-204404.jpg,5,0,1,0,6,,train
0526975_sc-204404.jpg,0,0,1,1,2,,train
0526977_as-0049213.jpg,1,0,2,0,3,,train
0526978_as-0049213.jpg,2,0,1,0,3,,train
0526979_sc-218101.jpg,0,0,1,0,1,,train
0526980_sc-218101.jpg,1,0,3,2,6,,train
0526981_sc-218101.jpg,1,0,1,1,3,,train
0526982_sc-218101.jpg,1,0,1,1,3,,val
0526983_sc-218101.jpg,1,0,0,1,2,,val
0526984_sc-218101.jpg,1,0,1,1,3,,test
0526985_sc-218101.jpg,0,0,1,0,1,,train
0526986_as-0084589.jpg,1,2,0,0,3,,train
0526987_as-0084589.jpg,1,1,0,0,2,,train
0526988_as-0025076.jpg,2,0,0,1,3,,train
0526989_as-0025076.jpg,0,0,0,1,1,,train
0526990_as-0025076.jpg,2,0,0,0,2,,train
0526991_as-0025076.jpg,1,0,0,0,1,,train
0526993_as-0025076.jpg,0,0,0,1,1,,val
0526994_sc-1026339.jpg,3,0,0,0,3,,val
0526995_sc-1021379.jpg,3,0,2,0,5,,test
0526996_sc-1021379.jpg,2,0,1,0,3,,train
0526997_sc-1021379.jpg,3,0,1,0,4,,train
0526998_as-0030189.jpg,1,0,0,0,1,,train
0526999_sc-1040467.jpg,1,0,0,0,1,,train
0527000_sc-1040467.jpg,1,0,0,0,1,,train
0527001_sc-1040467.jpg,0,1,0,0,1,,train
0527002_sc-1040467.jpg,1,0,0,1,2,,train
0527003_sc-1040467.jpg,0,1,0,0,1,,val
0527004_sc-1040467.jpg,1,0,0,0,1,,val
0527005_sc-1040467.jpg,1,0,0,1,2,,test
0527007_sc-1040467.jpg,1,0,0,0,1,,train
0527008_as-2525980.jpg,1,0,1,1,3,,train
0527010_sc-1035218.jpg,1,0,1,0,2,,train
0527011_sc-151684.jpg,1,0,2,0,3,,train
0527012_sc-1026490.jpg,0,0,1,0,1,,train
0527013_sc-1026490.jpg,3,0,1,0,4,,train
0527015_as-3445411.jpg,1,0,1,0,2,,train
0527016_sc-1018994.jpg,0,1,0,0,1,,val
0527018_as-0078813.jpg,0,1,0,0,1,,val
0527019_as-3061122.jpg,2,2,0,0,4,,test
0527021_as-0072321.jpg,2,0,0,0,2,,train
0527022_as-0072321.jpg,3,0,0,0,3,,train
0527023_as-0072321.jpg,2,0,2,1,5,,train
0527024_as-0072321.jpg,3,0,1,2,6,,train
0527026_as-0072321.jpg,1,0,1,1,3,,train
0527027_as-0072321.jpg,1,0,0,0,1,,train
0527028_as-0072321.jpg,3,0,0,0,3,,train
0527029_as-0072321.jpg,4,0,0,0,4,,val
0527030_as-0072321.jpg,2,0,0,0,2,,val
0527031_sc-1022765.jpg,2,0,0,0,2,,test
0527032_sc-1022765.jpg,2,0,0,0,2,,train
0527034_as-3118128.jpg,1,0,0,1,2,,train
0527036_as-0071917.jpg,3,0,2,0,5,,train
0527037_as-0071917.jpg,1,0,1,0,2,,train
0527038_as-0071917.jpg,3,1,0,0,4,,train
0527040_as-0061277.jpg,1,0,0,0,1,,train
0527041_as-0061277.jpg,1,0,2,0,3,,train
0527042_as-0061277.jpg,1,0,1,0,2,,val
0527043_as-0015870.jpg,2,0,0,0,2,,val
0527044_as-0015870.jpg,0,0,0,1,1,,test
0527045_as-0015870.jpg,0,0,0,1,1,,train
0527046_sc-210331.jpg,2,0,0,0,2,,train
0527047_sc-210331.jpg,0,1,1,0,2,,train
0527052_as-0040371.jpg,3,0,0,0,3,,train
0527053_as-0040371.jpg,1,0,0,0,1,,train
0527054_as-0040371.jpg,3,2,1,1,7,,train
0527055_as-0040371.jpg,2,0,0,2,4,,train
0527056_as-0040371.jpg,1,0,0,1,2,,val
0527057_as-0040371.jpg,3,1,0,2,6,,val
0527058_as-0040371.jpg,4,1,0,1,6,,test
0527061_as-0040371.jpg,0,0,1,0,1,,train
0527063_as-0040371.jpg,1,0,0,0,1,,train
0527065_as-7294340.jpg,2,0,0,0,2,,train
0527066_as-2588980.jpg,4,0,1,1,6,,train
0527067_as-2661832.jpg,2,0,0,0,2,,train
0527068_as-2661832.jpg,1,0,0,0,1,,train
0527070_sc-125326.jpg,1,0,0,0,1,,train
0527071_as-0079962.jpg,1,0,0,1,2,,val
0527072_as-0079962.jpg,1,0,0,1,2,,val
0527073_as-0082456.jpg,5,0,1,0,6,,test
0527074_as-0082456.jpg,2,0,0,1,3,,train
0527075_as-0082456.jpg,1,0,0,1,2,,train
0527076_as-0082456.jpg,2,0,0,0,2,,train
0527077_as-0082456.jpg,3,0,0,1,4,,train
0527078_as-0082456.jpg,3,0,0,0,3,,train
0527079_as-0082456.jpg,3,0,0,1,4,,train
0527080_as-0082456.jpg,2,0,0,1,3,,train
0527082_as-0082456.jpg,2,0,0,0,2,,val
0527084_as-0020518.jpg,2,0,0,0,2,,val
0527085_as-0020518.jpg,2,0,0,0,2,,test
0527086_as-0020518.jpg,2,0,0,0,2,,train
0527088_as-0020518.jpg,0,0,1,0,1,,train
0527089_as-0020518.jpg,0,0,1,0,1,,train
0527090_as-0020518.jpg,3,0,1,0,4,,train
0527091_as-3286353.jpg,2,0,0,0,2,,train
0527092_sc-1038370.jpg,5,3,2,3,13,,train
0527093_sc-1038370.jpg,3,1,1,3,8,,train
0527094_sc-1038370.jpg,7,3,1,3,14,,val
0527096_as-0059965.jpg,1,0,0,0,1,,val
0527098_sc-228943.jpg,1,1,0,0,2,,test
0527099_sc-228943.jpg,1,2,0,0,3,,train
0527101_as-0029754.jpg,6,0,1,1,8,,train
0527102_as-0029754.jpg,4,0,1,0,5,,train
0527103_sc-178162.jpg,3,1,0,1,5,,train
0527104_sc-178162.jpg,1,0,1,1,3,,train
0527105_sc-178162.jpg,1,0,1,1,3,,train
0527106_sc-178162.jpg,2,0,1,1,4,,train
0527109_sc-118851.jpg,1,0,0,1,2,,val
0527110_sc-118851.jpg,1,0,0,0,1,,val
0527111_sc-118851.jpg,1,0,0,1,2,,test
0527112_sc-118851.jpg,1,0,0,0,1,,train
0527113_as-2553615.jpg,1,1,1,0,3,,train
0527114_as-2896589.jpg,0,1,0,0,1,,train
0527115_as-3015440.jpg,3,0,0,0,3,,train
0527116_as-0007511.jpg,1,1,0,0,2,,train
0527117_as-0007511.jpg,1,0,1,0,2,,train
0527118_as-0007511.jpg,1,1,1,0,3,,train
0527119_as-3081098.jpg,1,0,0,0,1,,val
0527121_as-7635264.jpg,2,0,1,1,4,,val
0527125_sc-218325.jpg,0,0,1,0,1,,test
0527126_sc-218325.jpg,0,0,1,0,1,,train
0527127_as-0030066.jpg,2,1,0,0,3,,train
0527128_as-0030066.jpg,1,1,0,0,2,,train
0527129_as-0030066.jpg,1,1,0,0,2,,train
0527130_as-0030066.jpg,1,1,0,0,2,,train
0527131_as-0030066.jpg,1,0,1,0,2,,train
0527134_as-0062614.jpg,1,0,0,0,1,,train
0527135_as-0062614.jpg,1,0,0,0,1,,val
0527138_as-0062614.jpg,1,0,0,0,1,,val
0527139_as-0062614.jpg,4,1,0,0,5,,test
0527140_as-0062614.jpg,3,1,0,1,5,,train
0527141_sc-201946.jpg,4,0,0,0,4,,train
0527148_as-0077755.jpg,2,0,0,0,2,,train
0527151_as-0075994.jpg,3,0,0,0,3,,train
0527152_as-0075994.jpg,4,0,0,0,4,,train
0527154_as-3027582.jpg,3,0,1,1,5,,train
0527155_as-2878726.jpg,1,0,0,0,1,,train
0527156_as-0039416.jpg,2,0,4,1,7,,val
0527157_as-0039416.jpg,1,0,1,1,3,,val
0527158_as-0039416.jpg,1,1,0,1,3,,test
0527159_sc-1035231.jpg,1,0,0,0,1,,train
0527160_sc-1035231.jpg,1,0,0,1,2,,train
0527161_sc-1035231.jpg,1,0,0,1,2,,train
0527162_sc-1035231.jpg,2,0,0,1,3,,train
0527163_sc-1035231.jpg,1,0,0,0,1,,train
0527164_sc-1035231.jpg,1,0,0,1,2,,train
0527165_sc-1035231.jpg,1,0,0,0,1,,train
0527166_sc-1035231.jpg,1,0,0,0,1,,val
0527167_sc-1035231.jpg,2,0,0,1,3,,val
0527168_sc-1035231.jpg,2,0,0,0,2,,test
0527169_sc-159707.jpg,0,2,1,0,3,,train
0527170_sc-159707.jpg,2,0,1,0,3,,train
0527171_sc-159707.jpg,0,1,1,0,2,,train
0527172_sc-159707.jpg,0,0,1,0,1,,train
0527174_sc-1022807.jpg,2,1,0,0,3,,train
0527176_sc-168207.jpg,4,1,0,3,8,,train
0527178_sc-168207.jpg,2,0,0,2,4,,train
0527179_as-7796064.jpg,1,0,0,0,1,,val
0527180_as-7796064.jpg,3,1,0,0,4,,val
0527181_as-3120225.jpg,2,0,0,0,2,,test
0527182_as-0080859.jpg,2,0,0,0,2,,train
0527187_as-0080859.jpg,6,0,0,0,6,,train
0527188_as-0080859.jpg,11,0,0,0,11,,train
0527189_as-0080859.jpg,2,0,1,0,3,,train
0527191_sc-114607.jpg,3,1,0,0,4,,train
0527192_sc-114607.jpg,4,1,0,0,5,,train
0527193_as-4738967.jpg,1,0,0,0,1,,train
0527194_sc-128552.jpg,1,0,1,1,3,,val
0527195_sc-128552.jpg,4,0,0,1,5,,val
0527196_sc-128552.jpg,2,0,0,1,3,,test
0527197_sc-128552.jpg,2,0,1,1,4,,train
0527198_sc-128552.jpg,0,0,0,1,1,,train
0527199_sc-128552.jpg,0,0,0,1,1,,train
0527200_as-7633361.jpg,2,0,0,0,2,,train
0527201_as-2743714.jpg,1,0,0,0,1,,train
0527202_as-0006650.jpg,1,0,0,1,2,,train
0527203_as-0006650.jpg,2,0,0,0,2,,train
0527204_as-2765224.jpg,2,0,0,0,2,,val
0527205_sc-135776.jpg,2,1,0,0,3,,val
0527207_sc-135776.jpg,1,1,0,0,2,,test
0527209_as-7872554.jpg,0,0,1,0,1,,train
0527211_as-2814461.jpg,2,4,2,1,9,,train
0527212_sc-230429.jpg,2,0,0,0,2,,train
0527213_sc-230429.jpg,1,0,0,0,1,,train
0527214_sc-200116.jpg,1,1,1,0,3,,train
0527217_as-0027961.jpg,5,0,3,2,10,,train
0527218_as-0027961.jpg,3,0,1,2,6,,train
0527219_as-0027961.jpg,2,0,2,2,6,,val
0527220_as-0027961.jpg,2,0,1,2,5,,val
0527221_sc-199591.jpg,2,0,0,1,3,,test
0527223_as-0014009.jpg,1,0,0,0,1,,train
0527224_as-0014009.jpg,2,0,0,0,2,,train
0527225_as-0014009.jpg,3,0,0,0,3,,train
0527226_as-0014009.jpg,5,1,0,0,6,,train
0527227_as-0014009.jpg,4,2,0,0,6,,train
0527229_as-0073351.jpg,4,0,0,0,4,,train
0527230_as-0073351.jpg,1,0,0,0,1,,train
0527231_as-0073351.jpg,1,0,0,0,1,,val
0527232_as-0073351.jpg,2,0,0,0,2,,val
0527233_as-0073351.jpg,1,0,0,0,1,,test
0527234_as-0073351.jpg,1,0,0,0,1,,train
0527235_as-0073351.jpg,2,0,0,0,2,,train
0527236_as-0073351.jpg,1,0,0,0,1,,train
0527238_sc-170639.jpg,3,0,1,0,4,,train
0527239_as-2647616.jpg,3,0,0,0,3,,train
0527240_as-0073852.jpg,2,1,1,1,5,,train
0527241_as-0073852.jpg,2,1,1,0,4,,train
0527242_as-0073852.jpg,0,1,0,0,1,,val
0527243_sc-209107.jpg,0,0,1,0,1,,val
0527244_sc-209107.jpg,3,0,0,0,3,,test
0527249_sc-209107.jpg,0,0,2,1,3,,train
0527250_sc-209107.jpg,1,1,1,1,4,,train
0527251_sc-209107.jpg,0,1,2,0,3,,train
0527252_sc-209107.jpg,1,0,2,2,5,,train
0527253_sc-209107.jpg,1,1,2,1,5,,train
0527254_sc-209107.jpg,0,0,2,2,4,,train
0527255_sc-1012894.jpg,2,0,0,0,2,,train
0527256_sc-1012894.jpg,4,1,1,1,7,,val
0527257_sc-1012894.jpg,5,0,0,1,6,,val
0527259_sc-1012894.jpg,3,0,0,0,3,,test
0527260_as-2530483.jpg,1,0,1,1,3,,train
0527262_sc-106034.jpg,3,1,0,0,4,,train
0527263_sc-202915.jpg,1,0,0,0,1,,train
0527264_sc-202915.jpg,1,0,0,0,1,,train
0527265_as-2602669.jpg,0,1,0,0,1,,train
0527266_sc-180591.jpg,1,0,0,0,1,,train
0527267_sc-180591.jpg,1,0,0,0,1,,train
0527268_sc-180591.jpg,1,0,0,0,1,,val
0527269_sc-194872.jpg,3,0,0,0,3,,val
0527270_sc-194872.jpg,2,0,0,0,2,,test
0527271_sc-194872.jpg,2,0,0,2,4,,train
0527273_as-0012571.jpg,0,1,0,0,1,,train
0527274_sc-1005526.jpg,2,0,0,1,3,,train
0527275_sc-1005526.jpg,2,0,0,0,2,,train
0527276_sc-1005526.jpg,3,0,1,1,5,,train
0527277_sc-1005526.jpg,1,0,1,1,3,,train
0527278_as-3186504.jpg,2,0,0,0,2,,train
0527283_sc-196822.jpg,1,0,2,1,4,,val
0527284_as-3125771.jpg,1,0,0,0,1,,val
0527285_as-0035305.jpg,0,0,1,1,2,,test
0527286_as-0035305.jpg,1,0,0,0,1,,train
0527287_as-0035305.jpg,1,0,1,1,3,,train
0527288_as-0035305.jpg,0,0,1,1,2,,train
0527289_as-0035305.jpg,1,0,2,0,3,,train
0527290_as-0035305.jpg,0,0,1,1,2,,train
0527293_sc-203093.jpg,1,0,1,0,2,,train
0527294_sc-203093.jpg,1,0,1,0,2,,train
0527295_sc-203093.jpg,1,0,1,0,2,,val
0527297_as-2814015.jpg,5,0,1,0,6,,val
0527298_sc-164632.jpg,3,0,2,0,5,,test
0527299_sc-213520.jpg,2,0,0,0,2,,train
0527300_as-3470834.jpg,3,0,2,1,6,,train
0527301_sc-223604.jpg,3,0,0,0,3,,train
0527303_sc-124732.jpg,1,0,0,0,1,,train
0527304_sc-124732.jpg,1,0,1,0,2,,train
0527306_sc-124732.jpg,1,0,0,0,1,,train
0527307_sc-124732.jpg,1,0,0,0,1,,train
0527308_sc-124732.jpg,1,0,0,0,1,,val
0527309_sc-124732.jpg,1,0,1,0,2,,val
0527310_sc-124732.jpg,1,0,1,0,2,,test
0527312_as-0046945.jpg,1,1,1,0,3,,train
0527313_as-0046945.jpg,2,1,1,2,6,,train
0527314_as-0046945.jpg,1,1,1,1,4,,train
0527315_as-0046945.jpg,1,0,1,0,2,,train
0527316_as-0046945.jpg,1,0,1,0,2,,train
0527317_as-0046945.jpg,1,0,1,0,2,,train
0527318_as-0046945.jpg,2,0,2,0,4,,train
0527319_as-3089024.jpg,0,0,1,0,1,,val
0527320_as-2921847.jpg,2,3,2,1,8,,val
0527321_sc-1013657.jpg,0,1,0,0,1,,test
0527323_sc-1013657.jpg,0,1,0,0,1,,train
0527324_sc-143961.jpg,3,0,0,0,3,,train
0527325_sc-143961.jpg,0,1,0,0,1,,train
0527326_as-0073562.jpg,2,0,0,0,2,,train
0527328_as-0073562.jpg,4,0,0,0,4,,train
0527329_as-0073562.jpg,6,0,0,0,6,,train
0527330_as-0073562.jpg,5,0,1,0,6,,train
0527331_as-0073562.jpg,5,0,1,0,6,,val
0527332_as-0073562.jpg,3,0,0,0,3,,val
0527333_as-0073562.jpg,6,0,1,0,7,,test
0527335_as-0013589.jpg,2,2,0,0,4,,train
0527336_sc-176151.jpg,5,0,0,0,5,,train
0527337_sc-176151.jpg,4,2,1,0,7,,train
0527338_sc-176151.jpg,6,0,0,0,6,,train
0527339_sc-176151.jpg,12,0,2,0,14,,train
0527341_as-0056866.jpg,2,0,0,0,2,,train
0527342_as-0056866.jpg,1,0,0,0,1,,train
0527343_as-0056866.jpg,2,0,0,0,2,,val
0527344_as-0056866.jpg,1,0,0,0,1,,val
0527345_as-0056866.jpg,2,0,0,1,3,,test
0527346_as-0056866.jpg,1,0,0,1,2,,train
0527347_as-0056866.jpg,0,0,0,1,1,,train
0527348_as-0056866.jpg,2,0,0,1,3,,train
0527350_as-0056866.jpg,2,0,0,0,2,,train
0527351_as-0056866.jpg,1,0,0,0,1,,train
0527352_sc-167148.jpg,2,2,1,0,5,,train
0527353_sc-167148.jpg,1,1,0,0,2,,train
0527354_sc-167148.jpg,1,1,1,0,3,,val
0527355_as-0083195.jpg,2,1,1,0,4,,val
0527356_as-0083195.jpg,1,1,0,0,2,,test
0527357_as-0083195.jpg,1,1,1,0,3,,train
0527362_as-0083195.jpg,1,0,0,0,1,,train
0527363_as-0083195.jpg,2,1,0,0,3,,train
0527364_as-0083195.jpg,1,2,0,1,4,,train
0527365_as-0083195.jpg,4,2,0,0,6,,train
0527366_as-0083195.jpg,2,2,0,0,4,,train
0527367_as-0083195.jpg,3,1,0,0,4,,train
0527368_as-0083195.jpg,1,1,0,0,2,,val
0527370_as-0083195.jpg,3,0,1,0,4,,val
0527371_as-0083195.jpg,2,0,1,0,3,,test
0527372_as-0083195.jpg,2,0,0,2,4,,train
0527373_as-0083195.jpg,1,0,0,0,1,,train
0527374_as-0083195.jpg,2,2,1,2,7,,train
0527375_as-0083195.jpg,2,2,1,0,5,,train
0527376_as-0083195.jpg,1,1,0,1,3,,train
0527377_as-0083195.jpg,1,0,0,0,1,,train
0527379_as-0083195.jpg,1,0,0,0,1,,train
0527380_as-0083195.jpg,0,0,0,1,1,,val
0527381_as-0074000.jpg,1,1,1,0,3,,val
0527382_as-2529514.jpg,1,0,0,0,1,,test
0527383_sc-1037395.jpg,1,0,0,0,1,,train
0527384_sc-1037395.jpg,3,0,0,1,4,,train
0527385_sc-1037395.jpg,3,0,0,1,4,,train
0527386_sc-1037395.jpg,1,0,0,1,2,,train
0527387_sc-1037395.jpg,4,0,0,1,5,,train
0527389_sc-193721.jpg,2,0,0,0,2,,train
0527390_sc-1013752.jpg,2,0,1,0,3,,train
0527391_sc-1013752.jpg,5,0,0,1,6,,val
0527393_sc-142693.jpg,5,0,0,0,5,,val
0527394_sc-142693.jpg,2,0,0,0,2,,test
0527395_sc-142693.jpg,1,0,0,0,1,,train
0527396_sc-221658.jpg,1,0,0,0,1,,train
0527397_sc-221658.jpg,0,1,0,0,1,,train
0527398_sc-221658.jpg,2,1,0,0,3,,train
0527400_as-0080557.jpg,5,4,4,0,13,,train
0527401_as-0080557.jpg,1,2,2,0,5,,train
0527402_as-0080557.jpg,1,0,4,0,5,,train
0527403_as-0080557.jpg,0,0,3,0,3,,val
0527404_as-0080557.jpg,1,0,1,0,2,,val
0527405_sc-143553.jpg,7,0,0,0,7,,test
0527406_sc-143553.jpg,4,0,0,0,4,,train
0527408_as-0022277.jpg,1,0,0,0,1,,train
0527409_as-0022277.jpg,2,0,0,0,2,,train
0527410_as-0022277.jpg,1,0,0,0,1,,train
0527411_as-0078866.jpg,6,0,1,0,7,,train
0527412_as-0078866.jpg,1,0,0,0,1,,train
0527413_sc-205076.jpg,5,0,0,0,5,,train
0527414_as-7348404.jpg,1,0,0,1,2,,val
0527415_as-3358336.jpg,2,0,0,0,2,,val
0527416_sc-222479.jpg,8,0,0,0,8,,test
0527417_sc-222479.jpg,4,1,1,0,6,,train
0527418_sc-222479.jpg,4,1,0,0,5,,train
0527419_sc-222479.jpg,1,0,0,0,1,,train
0527420_sc-222479.jpg,1,0,0,0,1,,train
0527421_sc-222479.jpg,4,0,0,0,4,,train
0527422_as-0046948.jpg,0,1,1,0,2,,train
0527423_as-0046948.jpg,2,0,0,0,2,,train
0527424_as-0046948.jpg,1,0,0,0,1,,val
0527425_as-0046948.jpg,3,0,0,0,3,,val
0527426_as-0046948.jpg,0,0,1,0,1,,test
0527427_as-0046948.jpg,0,0,1,0,1,,train
0527428_as-0046948.jpg,1,0,1,1,3,,train
0527429_as-0046948.jpg,1,0,1,0,2,,train
0527430_as-0046948.jpg,2,0,1,0,3,,train
0527431_as-0046948.jpg,1,1,1,0,3,,train
0527432_as-0046948.jpg,2,1,1,0,4,,train
0527433_as-0046948.jpg,1,0,0,0,1,,train
0527434_as-0046948.jpg,1,0,0,0,1,,val
0527435_as-0046948.jpg,1,1,0,0,2,,val
0527436_as-0046948.jpg,1,1,0,0,2,,test
0527437_as-0046948.jpg,2,0,0,0,2,,train
0527438_as-0046948.jpg,1,1,1,0,3,,train
0527439_as-0046948.jpg,0,1,0,0,1,,train
0527440_as-0046948.jpg,1,0,0,0,1,,train
0527441_as-0046948.jpg,2,0,0,0,2,,train
0527442_as-9041154.jpg,0,0,1,0,1,,train
0527443_as-3306665.jpg,2,0,1,0,3,,train
0527444_sc-154102.jpg,4,0,0,0,4,,val
0527445_sc-154102.jpg,6,0,0,0,6,,val
0527446_sc-154102.jpg,5,0,0,0,5,,test
0527447_sc-219161.jpg,1,0,2,0,3,,train
0527448_sc-219161.jpg,2,0,1,0,3,,train
0527449_sc-219161.jpg,2,0,1,1,4,,train
0527450_sc-219161.jpg,7,0,0,1,8,,train
0527451_as-7250972.jpg,3,0,0,0,3,,train
0527453_as-0098205.jpg,1,0,1,1,3,,train
0527456_sc-1034861.jpg,4,0,0,0,4,,train
0527457_sc-1034861.jpg,2,0,0,0,2,,val
0527458_sc-1034861.jpg,4,0,0,0,4,,val
0527459_sc-219004.jpg,2,0,0,0,2,,test
0527460_sc-219004.jpg,1,0,1,1,3,,train
0527461_sc-219004.jpg,1,0,1,1,3,,train
0527462_sc-219004.jpg,1,0,0,0,1,,train
0527463_sc-219004.jpg,1,0,0,0,1,,train
0527464_sc-172905.jpg,0,0,1,0,1,,train
0527469_as-0008783.jpg,1,0,0,0,1,,train
0527470_as-0008783.jpg,0,0,2,1,3,,train
0527471_as-0008783.jpg,2,0,1,2,5,,val
0527472_as-0008783.jpg,3,0,0,1,4,,val
0527473_as-0008783.jpg,1,0,1,0,2,,test
0527474_as-3149461.jpg,6,0,1,1,8,,train
0527475_as-2960464.jpg,2,0,1,1,4,,train
0527476_as-2824355.jpg,1,4,1,1,7,,train
0527477_sc-1002253.jpg,6,0,0,0,6,,train
0527478_sc-1002253.jpg,2,0,0,0,2,,train
0527479_sc-1002253.jpg,5,0,0,0,5,,train
0527480_sc-1000111.jpg,1,0,0,0,1,,train
0527481_sc-1000111.jpg,3,0,0,0,3,,val
0527483_sc-1000111.jpg,2,0,0,0,2,,val
0527484_sc-109997.jpg,2,0,0,1,3,,test
0527486_sc-203267.jpg,3,0,0,2,5,,train
0527487_sc-203267.jpg,3,0,0,2,5,,train
0527488_sc-203267.jpg,2,0,0,0,2,,train
0527489_sc-164559.jpg,2,0,0,0,2,,train
0527490_sc-164559.jpg,1,0,0,0,1,,train
0527491_sc-164559.jpg,3,0,0,0,3,,train
0527492_as-0045576.jpg,2,0,0,0,2,,train
0527493_as-0045576.jpg,2,1,0,0,3,,val
0527494_sc-193461.jpg,6,0,0,1,7,,val
0527497_as-0082810.jpg,2,0,1,1,4,,test
0527498_as-0082810.jpg,5,0,2,1,8,,train
0527499_as-0082810.jpg,5,0,3,1,9,,train
0527500_as-0082810.jpg,5,1,1,0,7,,train
0527501_as-0082810.jpg,1,0,1,0,2,,train
0527503_as-0082810.jpg,1,0,0,0,1,,train
0527505_as-0082810.jpg,1,2,0,0,3,,train
0527506_as-0082810.jpg,1,1,0,0,2,,train
0527507_as-0082810.jpg,2,0,2,0,4,,val
0527508_as-0082810.jpg,1,0,1,0,2,,val
0527509_as-2861146.jpg,1,0,2,1,4,,test
0527511_sc-1017790.jpg,2,0,0,0,2,,train
0527512_sc-1017790.jpg,1,0,0,0,1,,train
0527515_sc-117190.jpg,1,0,0,1,2,,train
0527516_as-3316171.jpg,1,0,0,0,1,,train
0527517_as-0029225.jpg,1,0,0,0,1,,train
0527518_as-7955775.jpg,1,0,1,1,3,,train
0527519_as-3174038.jpg,1,0,0,0,1,,train
0527521_as-0038146.jpg,2,0,0,2,4,,val
0527523_as-0038146.jpg,1,1,0,0,2,,val
0527524_as-0038146.jpg,2,1,0,0,3,,test
0527526_as-0038146.jpg,5,0,1,1,7,,train
0527527_sc-1019656.jpg,3,1,1,0,5,,train
0527528_sc-1019656.jpg,9,0,0,0,9,,train
0527529_sc-1019656.jpg,8,0,0,0,8,,train
0527530_sc-1019656.jpg,7,1,2,0,10,,train
0527531_as-0037525.jpg,1,0,0,0,1,,train
0527532_as-0037525.jpg,1,0,0,0,1,,train
0527533_as-0037525.jpg,1,0,0,0,1,,val
0527534_as-0037525.jpg,1,0,0,0,1,,val
0527538_as-0081785.jpg,1,0,1,0,2,,test
0527540_as-0061285.jpg,1,0,1,1,3,,train
0527541_as-0061285.jpg,1,0,1,1,3,,train
0527542_as-0061285.jpg,1,0,1,1,3,,train
0527543_as-0061285.jpg,1,0,1,1,3,,train
0527544_as-0061285.jpg,1,0,1,1,3,,train
0527545_as-0061285.jpg,1,0,1,1,3,,train
0527546_as-3027826.jpg,2,0,0,0,2,,train
0527547_as-2516958.jpg,1,0,0,0,1,,val
0527548_as-2928867.jpg,1,0,0,1,2,,val
0527549_as-9098739.jpg,5,0,1,4,10,,test
0527550_sc-135498.jpg,1,0,0,0,1,,train
0527551_sc-135498.jpg,2,0,0,0,2,,train
0527552_sc-207817.jpg,2,1,1,1,5,,train
0527553_sc-207817.jpg,2,0,0,1,3,,train
0527554_sc-207817.jpg,1,0,0,1,2,,train
0527555_sc-207817.jpg,1,0,0,1,2,,train
0527556_sc-207817.jpg,1,0,1,1,3,,train
0527557_as-0035676.jpg,2,0,0,0,2,,val
0527558_as-0035676.jpg,1,0,0,0,1,,val
0527559_as-0035676.jpg,1,0,0,1,2,,test
0527560_as-0035676.jpg,2,0,0,1,3,,train
0527561_as-0035676.jpg,4,1,0,0,5,,train
0527562_as-0035676.jpg,1,0,0,1,2,,train
0527563_as-0035676.jpg,1,0,0,0,1,,train
0527564_as-0035676.jpg,3,0,0,0,3,,train
0527565_as-0035676.jpg,2,0,0,1,3,,train
0527566_sc-142203.jpg,2,0,0,0,2,,train
0527567_sc-142203.jpg,3,0,0,0,3,,val
0527568_sc-142203.jpg,2,0,0,0,2,,val
0527569_sc-142203.jpg,1,0,0,0,1,,test
0527570_as-0035126.jpg,3,0,0,0,3,,train
0527571_as-7706096.jpg,3,0,1,0,4,,train
0527572_as-9064218.jpg,3,0,0,0,3,,train
0527574_as-0034446.jpg,4,2,0,0,6,,train
0527575_as-0034446.jpg,2,1,1,0,4,,train
0527576_as-0034446.jpg,3,1,1,0,5,,train
0527577_as-0034446.jpg,1,0,0,0,1,,train
0527578_as-0034446.jpg,1,2,0,0,3,,val
0527579_sc-206625.jpg,0,0,0,1,1,,val
0527580_sc-206625.jpg,0,0,0,1,1,,test
0527581_sc-206625.jpg,0,0,0,1,1,,train
0527582_sc-148953.jpg,3,0,0,0,3,,train
0527583_sc-148953.jpg,5,0,0,0,5,,train
0527584_as-2982009.jpg,2,0,0,0,2,,train
0527586_as-0069894.jpg,2,0,3,1,6,,train
0527587_as-0069894.jpg,2,0,1,1,4,,train
0527588_as-3351903.jpg,3,1,2,1,7,,train
0527589_as-0066588.jpg,0,2,1,0,3,,val
0527590_as-0066588.jpg,1,1,0,0,2,,val
0527591_as-0066588.jpg,1,2,0,0,3,,test
0527592_as-3338151.jpg,1,0,0,0,1,,train
0527593_as-0097633.jpg,1,0,0,0,1,,train
0527594_as-0097633.jpg,1,0,0,0,1,,train
0527595_as-7897412.jpg,1,0,1,1,3,,train
0527596_as-2759171.jpg,2,0,0,0,2,,train
0527597_as-7234295.jpg,2,0,0,0,2,,train
0527600_as-0051590.jpg,1,2,0,1,4,,train
0527601_as-0051590.jpg,3,2,1,0,6,,val
0527603_sc-140239.jpg,1,0,0,0,1,,val
0527604_sc-140239.jpg,4,0,0,0,4,,test
0527606_sc-173087.jpg,3,1,0,1,5,,train
0527607_sc-173087.jpg,1,1,0,1,3,,train
0527608_sc-173087.jpg,2,2,0,1,5,,train
0527609_sc-173087.jpg,3,1,0,0,4,,train
0527612_sc-173087.jpg,4,0,0,0,4,,train
0527613_sc-173087.jpg,2,0,0,0,2,,train
0527614_sc-173087.jpg,4,0,1,0,5,,train
0527615_sc-173087.jpg,3,0,0,0,3,,val
0527616_sc-173087.jpg,2,0,0,0,2,,val
0527618_sc-173087.jpg,3,1,0,1,5,,test
0527619_sc-173087.jpg,4,1,0,1,6,,train
0527620_sc-173087.jpg,1,1,0,1,3,,train
0527621_sc-173087.jpg,3,1,0,1,5,,train
0527623_as-0018941.jpg,3,1,0,0,4,,train
0527624_as-0018941.jpg,2,1,0,0,3,,train
0527625_as-0018941.jpg,2,1,0,0,3,,train
0527626_as-9056100.jpg,1,0,0,0,1,,train
0527628_sc-176171.jpg,1,1,1,2,5,,val
0527629_sc-176171.jpg,2,0,1,2,5,,val
0527630_sc-176171.jpg,4,0,1,1,6,,test
0527631_sc-176171.jpg,0,0,0,1,1,,train
0527632_sc-176171.jpg,4,0,1,1,6,,train
0527633_sc-176171.jpg,1,0,1,2,4,,train
0527634_sc-176171.jpg,1,0,1,2,4,,train
0527636_as-0097140.jpg,3,4,3,1,11,,train
0527637_as-0097140.jpg,2,3,1,0,6,,train
0527638_sc-1019504.jpg,3,3,5,0,11,,train
0527639_sc-1019504.jpg,1,3,1,0,5,,val
0527640_sc-1019504.jpg,0,1,0,0,1,,val
0527641_as-3466258.jpg,1,0,0,0,1,,test
0527642_sc-174213.jpg,0,1,0,0,1,,train
0527644_as-3121451.jpg,1,1,1,0,3,,train
0527645_sc-198711.jpg,2,0,0,1,3,,train
0527646_sc-198711.jpg,1,0,0,0,1,,train
0527647_sc-198711.jpg,2,0,0,0,2,,train
0527648_sc-198711.jpg,1,0,0,1,2,,train
0527649_sc-198711.jpg,1,0,0,1,2,,train
0527650_sc-198711.jpg,1,0,0,1,2,,val
0527651_sc-198711.jpg,2,0,0,0,2,,val
0527653_sc-198711.jpg,3,0,0,0,3,,test
0527654_sc-198711.jpg,2,0,0,0,2,,train
0527656_as-2940395.jpg,4,0,1,1,6,,train
0527658_sc-223684.jpg,0,0,1,0,1,,train
0527659_sc-223684.jpg,1,0,0,0,1,,train
0527661_as-0091782.jpg,0,1,2,0,3,,train
0527664_as-0091782.jpg,1,1,1,0,3,,train
0527665_as-0091782.jpg,2,1,2,0,5,,train
0527668_as-0091782.jpg,2,1,1,0,4,,val
0527669_as-0091782.jpg,3,1,1,0,5,,val
0527670_as-0091782.jpg,3,1,1,0,5,,test
0527672_as-0091782.jpg,0,0,1,0,1,,train
0527673_as-0091782.jpg,0,0,1,0,1,,train
0527674_as-0091782.jpg,1,0,1,0,2,,train
0527676_as-0091782.jpg,3,0,1,0,4,,train
0527681_as-0066493.jpg,1,0,0,2,3,,train
0527683_as-0085788.jpg,0,0,0,1,1,,train
0527684_as-0085788.jpg,0,0,0,1,1,,train
0527685_as-0085788.jpg,0,0,1,0,1,,val
0527686_as-0085788.jpg,0,0,1,0,1,,val
0527689_as-0085788.jpg,0,1,0,1,2,,test
0527691_as-0085788.jpg,2,0,0,0,2,,train
0527692_as-0085788.jpg,1,0,0,0,1,,train
0527693_as-3061477.jpg,2,0,1,0,3,,train
0527697_as-3367661.jpg,2,0,0,0,2,,train
0527698_as-2795129.jpg,3,0,2,0,5,,train
0527699_as-3325388.jpg,2,1,0,1,4,,train
0527700_sc-1019085.jpg,1,0,1,0,2,,train
0527701_sc-1019085.jpg,1,1,0,0,2,,val
0527702_sc-168643.jpg,1,1,0,0,2,,val
0527703_sc-168643.jpg,3,1,0,0,4,,test
0527705_sc-118547.jpg,2,0,0,0,2,,train
0527706_as-0058823.jpg,1,1,0,0,2,,train
0527707_as-3250135.jpg,0,0,0,1,1,,train
0527708_sc-142351.jpg,7,0,0,0,7,,train
0527709_as-9003032.jpg,1,0,0,0,1,,train
0527710_as-7262377.jpg,1,0,0,1,2,,train
0527711_as-0093539.jpg,3,3,0,0,6,,train
0527712_as-0093539.jpg,3,2,1,0,6,,val
0527715_as-0093539.jpg,0,0,1,0,1,,val
0527716_as-0053256.jpg,0,0,1,0,1,,test
0527718_as-0060975.jpg,2,1,1,0,4,,train
0527719_as-0060975.jpg,0,0,1,0,1,,train
0527720_as-0060975.jpg,0,0,1,0,1,,train
0527722_as-2822107.jpg,2,0,0,1,3,,train
0527723_as-0034631.jpg,2,0,0,0,2,,train
0527724_as-0034631.jpg,4,0,0,0,4,,train
0527725_sc-152586.jpg,1,1,0,0,2,,train
0527726_sc-152586.jpg,1,1,0,0,2,,val
0527727_sc-104453.jpg,1,0,0,0,1,,val
0527728_as-3222489.jpg,0,0,1,0,1,,test
0527729_sc-1013187.jpg,1,0,1,0,2,,train
0527730_sc-184583.jpg,2,0,0,0,2,,train
0527731_sc-184583.jpg,1,0,0,0,1,,train
0527732_as-0074505.jpg,0,2,0,0,2,,train
0527733_as-0074505.jpg,2,0,1,0,3,,train
0527734_as-0033470.jpg,6,0,0,1,7,,train
0527735_as-0033470.jpg,6,0,0,2,8,,train
0527736_as-0033470.jpg,4,5,0,0,9,,val
0527737_as-0033470.jpg,5,0,1,3,9,,val
0527740_as-0088653.jpg,2,0,0,0,2,,test
0527741_as-0088653.jpg,2,0,0,1,3,,train
0527742_as-0088653.jpg,2,0,0,1,3,,train
0527743_as-0088653.jpg,1,0,0,0,1,,train
0527744_sc-131007.jpg,2,0,0,0,2,,train
0527745_sc-131007.jpg,3,0,0,0,3,,train
0527749_sc-128821.jpg,2,1,2,0,5,,train
0527750_as-3466789.jpg,1,0,0,1,2,,train
0527752_as-0007980.jpg,0,1,0,0,1,,val
0527753_as-0007980.jpg,7,1,1,1,10,,val
0527756_as-0007980.jpg,1,1,1,1,4,,test
0527757_as-0007980.jpg,1,1,2,2,6,,train
0527760_sc-1037297.jpg,3,0,1,2,6,,train
0527761_as-2802593.jpg,1,0,0,0,1,,train
0527764_as-0072105.jpg,3,0,0,0,3,,train
0527765_sc-229491.jpg,1,0,1,0,2,,train
0527766_sc-229491.jpg,1,0,0,0,1,,train
0527767_sc-229491.jpg,1,0,0,0,1,,train
0527768_as-2553276.jpg,1,0,1,0,2,,val
0527773_as-0090189.jpg,5,3,1,0,9,,val
0527775_as-0090189.jpg,5,2,3,2,12,,test
0527776_as-0090189.jpg,2,1,2,2,7,,train
0527777_as-0090189.jpg,2,1,2,1,6,,train
0527778_as-0090189.jpg,2,0,0,0,2,,train
0527779_as-0090189.jpg,0,0,1,1,2,,train
0527780_as-0090189.jpg,4,1,2,2,9,,train
0527781_sc-206617.jpg,2,1,2,2,7,,train
0527782_sc-205516.jpg,0,1,0,0,1,,train
0527783_sc-205516.jpg,0,0,0,1,1,,val
0527784_sc-205516.jpg,0,1,0,1,2,,val
0527785_sc-205516.jpg,2,0,0,0,2,,test
0527787_as-0001322.jpg,6,0,1,0,7,,train
0527790_as-0001322.jpg,1,2,1,0,4,,train
0527791_sc-121822.jpg,1,0,0,0,1,,train
0527792_sc-1016228.jpg,1,0,0,0,1,,train
0527794_sc-1016228.jpg,2,0,0,0,2,,train
0527795_sc-131224.jpg,0,1,1,0,2,,train
0527796_sc-131224.jpg,0,1,1,1,3,,train
0527797_sc-131224.jpg,0,3,4,1,8,,val
0527798_sc-131224.jpg,0,0,2,0,2,,val
0527799_sc-131224.jpg,0,1,1,0,2,,test
0527800_as-3300937.jpg,5,1,1,1,8,,train
0527801_sc-1002905.jpg,2,1,0,0,3,,train
0527802_sc-1002905.jpg,3,0,0,0,3,,train
0527803_sc-1002905.jpg,2,0,0,0,2,,train
0527804_sc-1002905.jpg,1,1,0,0,2,,train
0527805_sc-1002905.jpg,2,0,0,0,2,,train
0527806_sc-1002905.jpg,1,0,0,0,1,,train
0527807_sc-1002905.jpg,2,0,0,0,2,,val
0527808_sc-1002905.jpg,4,0,0,0,4,,val
0527809_sc-1002905.jpg,1,0,0,0,1,,test
0527811_as-0028987.jpg,4,0,0,0,4,,train
0527812_as-0028987.jpg,2,0,0,0,2,,train
0527813_as-0028987.jpg,5,2,1,0,8,,train
0527814_as-0028987.jpg,1,0,0,0,1,,train
0527815_sc-107304.jpg,2,0,1,1,4,,train
0527816_sc-114599.jpg,0,0,2,0,2,,train
0527817_sc-114599.jpg,0,0,1,0,1,,train
0527819_as-0072387.jpg,3,0,0,1,4,,val
0527820_as-7999373.jpg,0,1,2,2,5,,val
0527821_as-0044175.jpg,1,0,1,0,2,,test
0527822_as-0044175.jpg,1,0,1,0,2,,train
0527824_as-0099606.jpg,9,1,1,0,11,,train
0527825_as-0099606.jpg,8,1,1,0,10,,train
0527826_sc-199041.jpg,6,0,1,0,7,,train
0527827_sc-199041.jpg,4,0,0,0,4,,train
0527828_sc-199041.jpg,2,0,0,0,2,,train
0527831_as-0024735.jpg,2,0,0,0,2,,train
0527832_as-0024735.jpg,1,0,0,0,1,,val
0527833_as-0024735.jpg,1,0,0,0,1,,val
0527834_as-0024735.jpg,1,0,0,0,1,,test
0527835_as-0024735.jpg,1,0,0,0,1,,train
0527836_as-0024735.jpg,1,0,0,0,1,,train
0527838_as-0040232.jpg,2,0,0,0,2,,train
0527839_as-0040232.jpg,4,0,0,0,4,,train
0527840_sc-153904.jpg,1,2,0,0,3,,train
0527842_sc-1016877.jpg,2,0,0,1,3,,train
0527843_sc-1016877.jpg,1,1,0,0,2,,train
0527844_sc-1039539.jpg,1,0,1,1,3,,val
0527845_sc-1039539.jpg,4,0,0,0,4,,val
0527846_sc-1039539.jpg,3,0,0,0,3,,test
0527847_sc-1039539.jpg,5,0,0,1,6,,train
0527848_sc-1039539.jpg,6,0,0,0,6,,train
0527849_sc-1039539.jpg,2,0,1,1,4,,train
0527850_sc-1039539.jpg,3,0,1,1,5,,train
0527853_sc-134288.jpg,3,0,0,0,3,,train
0527854_sc-134288.jpg,1,0,0,0,1,,train
0527855_sc-134288.jpg,4,0,0,0,4,,train
0527856_sc-134288.jpg,1,0,0,0,1,,val
0527857_sc-134288.jpg,1,0,0,0,1,,val
0527858_sc-1007497.jpg,1,0,0,0,1,,test
0527859_sc-1007497.jpg,1,0,0,0,1,,train
0527860_sc-213091.jpg,2,0,1,0,3,,train
0527861_sc-213091.jpg,2,0,1,0,3,,train
0527862_as-0048325.jpg,2,0,0,0,2,,train
0527863_as-0048325.jpg,1,0,0,0,1,,train
0527864_as-0048325.jpg,1,0,0,1,2,,train
0527865_as-0048325.jpg,1,0,0,1,2,,train
0527866_as-0048325.jpg,1,0,0,0,1,,val
0527867_as-0048325.jpg,1,0,0,0,1,,val
0527868_as-0048325.jpg,1,0,0,0,1,,test
0527869_as-0048325.jpg,1,0,0,0,1,,train
0527871_sc-177634.jpg,2,1,0,0,3,,train
0527872_sc-177634.jpg,2,1,0,0,3,,train
0527873_sc-177634.jpg,0,1,0,0,1,,train
0527874_sc-177634.jpg,2,1,0,0,3,,train
0527875_sc-177634.jpg,3,0,0,0,3,,train
0527876_sc-177634.jpg,2,1,0,0,3,,train
0527877_as-2880487.jpg,1,0,0,1,2,,val
0527878_sc-159822.jpg,1,0,0,0,1,,val
0527879_sc-159822.jpg,1,0,0,0,1,,test
0527880_sc-159822.jpg,1,0,0,0,1,,train
0527881_as-7854629.jpg,4,0,0,0,4,,train
0527890_sc-122327.jpg,3,1,0,1,5,,train
0527891_sc-122327.jpg,1,0,1,0,2,,train
0527892_sc-122327.jpg,1,0,0,1,2,,train
0527894_sc-122327.jpg,1,0,0,0,1,,train
0527895_as-3250880.jpg,1,0,0,0,1,,train
0527896_as-0004248.jpg,0,1,2,0,3,,val
0527897_as-0004248.jpg,0,1,0,0,1,,val
0527898_as-3241975.jpg,1,0,0,0,1,,test
0527901_as-0040819.jpg,2,1,1,0,4,,train
0527902_as-0040819.jpg,1,1,1,0,3,,train
0527903_sc-1036575.jpg,1,0,2,0,3,,train
0527904_sc-1036575.jpg,1,0,1,0,2,,train
0527906_sc-1036575.jpg,2,0,1,0,3,,train
0527907_sc-1036575.jpg,1,0,0,0,1,,train
0527908_sc-1036575.jpg,3,0,0,0,3,,train
0527909_sc-1036575.jpg,3,0,2,0,5,,val
0527910_sc-1036575.jpg,2,0,0,0,2,,val
0527911_sc-1036575.jpg,1,0,0,0,1,,test
0527914_as-3163658.jpg,1,0,0,0,1,,train
0527916_as-9086375.jpg,2,0,0,0,2,,train
0527918_as-0074277.jpg,2,1,1,0,4,,train
0527919_as-0074277.jpg,2,0,1,0,3,,train
0527920_as-0074277.jpg,2,1,1,0,4,,train
0527921_as-0074277.jpg,2,1,1,0,4,,train
0527922_as-0074277.jpg,3,0,1,0,4,,train
0527923_as-0074277.jpg,1,0,1,0,2,,val
0527924_as-0074277.jpg,2,2,1,0,5,,val
0527925_as-0074277.jpg,1,2,1,0,4,,test
0527926_as-0074277.jpg,0,0,1,0,1,,train
0527927_as-0074277.jpg,1,0,1,0,2,,train
0527928_as-0074277.jpg,0,1,1,0,2,,train
0527929_sc-161731.jpg,2,0,0,0,2,,train
0527930_sc-161731.jpg,0,0,2,0,2,,train
0527931_sc-161731.jpg,2,0,1,0,3,,train
0527932_sc-161731.jpg,2,0,0,0,2,,train
0527933_as-3239662.jpg,1,2,2,0,5,,val
0527938_as-0009775.jpg,1,2,0,1,4,,val
0527939_as-0009775.jpg,6,2,0,1,9,,test
0527946_as-0060373.jpg,1,0,0,0,1,,train
0527949_as-0060373.jpg,5,0,0,0,5,,train
0527950_as-0060373.jpg,1,0,2,0,3,,train
0527952_sc-209447.jpg,3,1,0,0,4,,train
0527953_sc-209447.jpg,2,0,0,0,2,,train
0527954_as-0078596.jpg,3,0,0,0,3,,train
0527957_sc-1026645.jpg,3,0,1,1,5,,train
0527958_sc-1026645.jpg,1,0,0,0,1,,val
0527959_sc-1026645.jpg,2,0,0,0,2,,val
0527960_sc-1026645.jpg,2,0,1,1,4,,test
0527963_sc-1026645.jpg,2,0,0,0,2,,train
0527965_sc-1026645.jpg,2,0,0,0,2,,train
0527966_sc-1026645.jpg,1,0,0,0,1,,train
0527967_sc-1026645.jpg,2,0,0,0,2,,train
0527968_sc-1026645.jpg,1,0,0,0,1,,train
0527969_as-2831393.jpg,1,0,0,0,1,,train
0527970_as-3435807.jpg,1,0,0,0,1,,train
0527972_sc-216048.jpg,5,0,1,0,6,,val
0527973_sc-216048.jpg,4,0,2,0,6,,val
0527974_sc-216048.jpg,2,0,1,0,3,,test
0527975_sc-216048.jpg,2,0,0,0,2,,train
0527976_sc-216048.jpg,1,0,2,0,3,,train
0527977_sc-216048.jpg,3,0,1,0,4,,train
0527978_sc-216048.jpg,2,1,2,0,5,,train
0527979_sc-216048.jpg,2,0,2,0,4,,train
0527980_sc-216048.jpg,2,0,1,0,3,,train
0527981_sc-216048.jpg,3,0,2,0,5,,train
0527982_sc-216048.jpg,3,0,2,0,5,,val
0527983_sc-216048.jpg,3,0,1,0,4,,val
0527984_sc-216048.jpg,3,0,1,0,4,,test
0527985_sc-216048.jpg,3,0,2,0,5,,train
0527986_sc-216048.jpg,2,0,1,0,3,,train
0527987_sc-216048.jpg,2,1,1,0,4,,train
0527988_sc-216048.jpg,3,1,1,0,5,,train
0527989_sc-216048.jpg,2,1,1,0,4,,train
0527990_sc-216048.jpg,1,0,1,0,2,,train
0527991_sc-104450.jpg,1,1,1,0,3,,train
0527992_sc-104450.jpg,1,1,1,0,3,,val
0527995_as-0071993.jpg,2,0,0,2,4,,val
0527996_as-0071993.jpg,1,0,0,2,3,,test
0527997_as-0071993.jpg,4,0,0,0,4,,train
0527998_as-0071993.jpg,1,0,0,1,2,,train
0527999_as-3214696.jpg,0,2,0,0,2,,train
0528000_sc-138867.jpg,1,0,0,0,1,,train
0528001_sc-138867.jpg,2,0,0,0,2,,train
0528002_as-2840138.jpg,1,0,0,0,1,,train
0528003_sc-211453.jpg,2,1,1,1,5,,train
0528005_sc-211453.jpg,2,1,1,0,4,,val
0528006_sc-211453.jpg,0,0,1,0,1,,val
0528008_as-7709853.jpg,1,0,0,0,1,,test
0528011_sc-1015837.jpg,1,0,0,0,1,,train
0528012_sc-1015837.jpg,2,0,0,0,2,,train
0528013_sc-1015837.jpg,1,0,0,0,1,,train
0528016_sc-141108.jpg,3,0,0,0,3,,train
0528018_sc-141108.jpg,1,0,0,0,1,,train
0528019_sc-203602.jpg,1,1,1,1,4,,train
0528020_sc-203602.jpg,3,1,2,0,6,,train
0528021_sc-203602.jpg,0,1,1,0,2,,val
0528022_sc-203602.jpg,1,1,3,0,5,,val
0528023_sc-1024027.jpg,1,0,0,0,1,,test
0528024_sc-1024027.jpg,2,0,0,0,2,,train
0528025_as-0085666.jpg,2,0,0,0,2,,train
0528027_as-0085666.jpg,2,0,0,1,3,,train
0528029_sc-1031177.jpg,3,0,0,0,3,,train
0528030_sc-1031177.jpg,2,0,0,0,2,,train
0528031_as-3446224.jpg,1,1,0,0,2,,train
0528032_sc-1033672.jpg,2,1,0,0,3,,train
0528033_sc-1033672.jpg,3,0,0,0,3,,val
0528035_sc-1033672.jpg,2,0,0,0,2,,val
0528036_sc-1033672.jpg,3,0,1,0,4,,test
0528037_sc-1033672.jpg,1,2,2,0,5,,train
0528038_as-2877993.jpg,3,0,0,0,3,,train
0528039_as-2626878.jpg,1,0,0,0,1,,train
0528040_as-3208560.jpg,1,0,0,0,1,,train
0528042_sc-1001615.jpg,3,1,0,0,4,,train
0528044_sc-209927.jpg,1,0,0,1,2,,train
0528045_sc-107718.jpg,2,0,1,1,4,,train
0528046_sc-107718.jpg,3,0,1,1,5,,val
0528047_as-0067749.jpg,1,1,0,0,2,,val
0528049_as-0067749.jpg,2,2,0,0,4,,test
0528050_as-0067749.jpg,3,2,0,0,5,,train
0528054_sc-1010130.jpg,1,0,0,0,1,,train
0528056_sc-198807.jpg,4,0,0,0,4,,train
0528057_as-3171137.jpg,3,0,0,1,4,,train
0528058_as-0039280.jpg,3,0,0,2,5,,train
0528059_as-0039280.jpg,2,1,2,0,5,,train
0528060_as-0092469.jpg,1,0,0,0,1,,train
0528061_as-3322628.jpg,1,1,0,0,2,,val
0528062_as-2744421.jpg,1,0,0,0,1,,val
0528063_as-2880031.jpg,1,0,1,2,4,,test
0528064_as-0006267.jpg,1,0,0,1,2,,train
0528065_as-0043446.jpg,1,1,1,0,3,,train
0528066_as-0043446.jpg,1,0,1,0,2,,train
0528067_as-0082943.jpg,1,0,0,0,1,,train
0528068_as-0082943.jpg,1,0,0,1,2,,train
0528069_as-0082943.jpg,1,0,0,1,2,,train
0528070_as-0082943.jpg,1,0,0,0,1,,train
0528071_as-0082943.jpg,1,1,0,0,2,,val
0528072_as-2657190.jpg,2,0,0,0,2,,val
0528074_as-7087277.jpg,1,0,1,0,2,,test
0528079_as-0052956.jpg,1,0,0,0,1,,train
0528080_as-0052956.jpg,1,0,0,0,1,,train
0528081_as-0052956.jpg,1,0,0,0,1,,train
0528082_as-0052956.jpg,0,0,0,1,1,,train
0528083_as-0052956.jpg,0,0,1,0,1,,train
0528084_as-0052956.jpg,0,0,2,0,2,,train
0528085_as-7391908.jpg,1,0,0,0,1,,train
0528087_as-2681545.jpg,1,0,0,0,1,,val
0528088_as-0048035.jpg,1,1,0,2,4,,val
0528089_sc-180023.jpg,1,1,1,0,3,,test
0528090_as-3474807.jpg,1,1,0,0,2,,train
0528093_as-0036658.jpg,1,0,1,0,2,,train
0528094_sc-158921.jpg,2,0,0,1,3,,train
0528096_as-0067943.jpg,1,0,0,1,2,,train
0528097_as-0067943.jpg,1,0,0,1,2,,train
0528098_as-0067943.jpg,1,1,0,1,3,,train
0528099_as-0067943.jpg,1,1,0,0,2,,train
0528100_as-2868711.jpg,1,2,0,0,3,,val
0528101_sc-1007935.jpg,9,0,0,0,9,,val
0528107_as-0016902.jpg,2,0,1,0,3,,test
0528108_as-7052934.jpg,3,0,0,0,3,,train
0528109_as-7203107.jpg,0,0,0,1,1,,train
0528111_as-2753762.jpg,0,0,1,0,1,,train
0528113_as-0037974.jpg,1,0,0,0,1,,train
0528114_as-0037974.jpg,1,0,0,0,1,,train
0528115_as-0037974.jpg,2,0,0,0,2,,train
0528116_as-0037974.jpg,2,0,0,0,2,,train
0528117_sc-1041864.jpg,2,0,0,0,2,,val
0528118_sc-1041864.jpg,2,0,0,1,3,,val
0528119_sc-1041864.jpg,1,0,0,0,1,,test
0528120_sc-1041864.jpg,1,0,0,0,1,,train
0528121_sc-1041864.jpg,1,0,0,1,2,,train
0528122_sc-1041864.jpg,0,1,1,0,2,,train
0528123_sc-229707.jpg,0,1,0,0,1,,train
0528124_sc-229707.jpg,0,1,0,0,1,,train
0528125_sc-229707.jpg,2,1,0,0,3,,train
0528126_sc-229707.jpg,1,0,1,0,2,,train
0528129_sc-159966.jpg,1,0,0,1,2,,val
0528130_sc-159966.jpg,7,0,2,1,10,,val
0528131_sc-159966.jpg,8,0,2,1,11,,test
0528132_sc-159966.jpg,1,0,0,1,2,,train
0528133_sc-159966.jpg,1,0,0,1,2,,train
0528134_sc-159966.jpg,4,0,3,1,8,,train
0528135_sc-1008645.jpg,1,0,0,0,1,,train
0528136_sc-1008645.jpg,1,0,0,0,1,,train
0528137_as-7365736.jpg,2,0,0,0,2,,train
0528138_as-0015935.jpg,4,3,0,0,7,,train
0528139_as-0015935.jpg,2,1,0,0,3,,val
0528140_as-0015935.jpg,1,1,0,0,2,,val
0528141_sc-1021681.jpg,1,1,0,0,2,,test
0528142_sc-1021681.jpg,1,0,1,0,2,,train
0528143_sc-1021681.jpg,3,0,1,0,4,,train
0528145_sc-1021681.jpg,0,0,0,1,1,,train
0528146_sc-1021681.jpg,4,0,1,1,6,,train
0528147_sc-1021681.jpg,2,0,2,2,6,,train
0528148_as-9084823.jpg,4,0,1,2,7,,train
0528149_as-7563127.jpg,6,0,1,1,8,,train
0528156_as-0019653.jpg,0,1,0,0,1,,val
0528157_as-0019653.jpg,1,0,0,0,1,,val
0528158_as-0019653.jpg,1,0,0,0,1,,test
0528159_as-0019653.jpg,4,1,0,0,5,,train
0528160_as-0019653.jpg,1,0,0,0,1,,train
0528163_as-0074842.jpg,1,0,0,0,1,,train
0528164_as-0074842.jpg,1,0,0,0,1,,train
0528165_as-0074842.jpg,2,0,0,0,2,,train
0528166_as-0074842.jpg,1,0,0,0,1,,train
0528167_as-0074842.jpg,1,0,0,0,1,,train
0528168_as-0074842.jpg,2,0,0,0,2,,val
0528170_as-0046318.jpg,2,0,0,0,2,,val
0528171_as-0046318.jpg,1,0,0,0,1,,test
0528172_as-0046318.jpg,2,0,0,0,2,,train
0528173_as-0046318.jpg,2,0,0,0,2,,train
0528174_as-0046318.jpg,4,0,0,0,4,,train
0528175_as-0046318.jpg,3,0,0,0,3,,train
0528176_as-0046318.jpg,5,0,0,0,5,,train
0528177_as-0046318.jpg,1,0,0,0,1,,train
0528178_as-0046318.jpg,2,0,0,0,2,,train
0528179_as-0046318.jpg,1,0,0,0,1,,val
0528180_as-0046318.jpg,4,0,0,0,4,,val
0528181_as-0046318.jpg,2,0,0,0,2,,test
0528182_as-0046318.jpg,2,0,0,0,2,,train
0528183_as-0046318.jpg,3,0,0,0,3,,train
0528184_as-0046318.jpg,1,0,1,0,2,,train
0528185_as-0046318.jpg,1,0,1,0,2,,train
0528186_as-0046318.jpg,1,0,0,0,1,,train
0528187_as-2675934.jpg,2,1,0,0,3,,train
0528188_sc-130184.jpg,1,0,0,0,1,,train
0528189_sc-130184.jpg,0,0,1,0,1,,val
0528190_as-3157051.jpg,5,0,2,4,11,,val
0528191_sc-120101.jpg,1,0,2,0,3,,test
0528192_sc-120101.jpg,1,0,1,0,2,,train
0528193_sc-120101.jpg,1,0,0,1,2,,train
0528194_sc-120101.jpg,1,0,0,2,3,,train
0528195_sc-201611.jpg,0,1,0,0,1,,train
0528196_sc-123730.jpg,1,0,0,0,1,,train
0528197_sc-123730.jpg,1,0,0,0,1,,train
0528198_as-7341503.jpg,2,0,2,1,5,,train
0528199_as-2503841.jpg,3,0,0,0,3,,val
0528200_as-0034480.jpg,1,0,0,0,1,,val
0528201_as-0034480.jpg,1,0,0,0,1,,test
0528202_as-0034480.jpg,1,0,0,1,2,,train
0528203_as-0034480.jpg,1,0,0,0,1,,train
0528204_sc-171067.jpg,4,0,0,0,4,,train
0528205_sc-171067.jpg,2,0,0,0,2,,train
0528208_sc-171067.jpg,2,0,1,2,5,,train
0528209_sc-171067.jpg,2,0,0,1,3,,train
0528210_sc-171067.jpg,2,0,0,1,3,,train
0528211_sc-171067.jpg,3,0,0,0,3,,val
0528212_sc-171067.jpg,2,0,0,1,3,,val
0528213_sc-171067.jpg,2,0,0,0,2,,test
0528216_as-0010318.jpg,2,1,1,1,5,,train
0528217_as-0010318.jpg,2,1,1,1,5,,train
0528219_sc-139273.jpg,1,0,0,0,1,,train
0528220_sc-139273.jpg,1,0,0,0,1,,train
0528221_sc-139273.jpg,1,0,0,0,1,,train
0528223_sc-183840.jpg,0,0,1,0,1,,train
0528225_sc-183840.jpg,6,3,2,0,11,,train
0528226_sc-183840.jpg,6,3,1,0,10,,val
0528227_sc-183840.jpg,0,0,1,0,1,,val
0528229_as-0062216.jpg,2,0,0,0,2,,test
0528230_as-0062216.jpg,2,0,0,0,2,,train
0528231_as-0062216.jpg,1,0,0,0,1,,train
0528232_as-0062216.jpg,1,0,0,0,1,,train
0528233_sc-105411.jpg,7,1,0,0,8,,train
0528234_sc-105411.jpg,4,0,0,0,4,,train
0528235_sc-105411.jpg,7,1,0,0,8,,train
0528236_as-2708534.jpg,2,0,3,0,5,,train
0528239_as-0059781.jpg,6,0,0,0,6,,val
0528241_as-0059781.jpg,3,0,0,0,3,,val
0528243_sc-199025.jpg,1,1,0,1,3,,test
0528244_sc-199025.jpg,1,1,0,1,3,,train
0528245_sc-199025.jpg,1,1,1,1,4,,train
0528246_sc-199025.jpg,1,1,1,0,3,,train
0528247_sc-199025.jpg,2,0,1,1,4,,train
0528248_sc-199025.jpg,4,0,0,0,4,,train
0528249_sc-199025.jpg,0,0,2,0,2,,train
0528250_sc-199025.jpg,2,0,0,0,2,,train
0528251_sc-199025.jpg,3,0,0,0,3,,val
0528252_sc-199025.jpg,1,0,0,0,1,,val
0528253_sc-199025.jpg,2,0,1,0,3,,test
0528255_sc-199025.jpg,1,0,1,0,2,,train
0528256_sc-185284.jpg,1,0,0,0,1,,train
0528257_sc-156567.jpg,1,0,1,0,2,,train
0528258_sc-156567.jpg,1,0,1,0,2,,train
0528259_sc-156567.jpg,2,0,1,1,4,,train
0528260_sc-156567.jpg,1,0,1,0,2,,train
0528261_sc-156567.jpg,2,0,1,1,4,,train
0528262_as-2624946.jpg,2,0,0,2,4,,val
0528264_sc-155981.jpg,3,0,1,0,4,,val
0528265_sc-155981.jpg,2,1,0,0,3,,test
0528266_sc-155981.jpg,4,1,0,0,5,,train
0528268_as-0070070.jpg,1,1,0,0,2,,train
0528270_as-0021816.jpg,1,0,1,0,2,,train
0528271_as-0021816.jpg,1,0,2,1,4,,train
0528272_as-0021816.jpg,2,0,1,0,3,,train
0528273_as-0021816.jpg,1,0,1,1,3,,train
0528274_sc-229524.jpg,0,1,0,0,1,,train
0528275_sc-152571.jpg,7,1,0,0,8,,val
0528276_sc-152571.jpg,6,1,0,0,7,,val
0528278_as-0067093.jpg,4,0,0,0,4,,test
0528280_sc-202172.jpg,13,2,1,0,16,,train
0528281_sc-202172.jpg,9,2,1,0,12,,train
0528282_sc-202172.jpg,4,0,0,0,4,,train
0528283_sc-202172.jpg,0,0,1,0,1,,train
0528284_sc-202172.jpg,0,0,1,0,1,,train
0528285_sc-202172.jpg,1,0,0,0,1,,train
0528286_as-3280137.jpg,5,1,2,1,9,,train
0528287_sc-1001979.jpg,4,0,0,1,5,,val
0528288_as-0029740.jpg,0,1,0,0,1,,val
0528289_as-0029740.jpg,1,1,0,0,2,,test
0528290_as-3174804.jpg,2,0,0,0,2,,train
0528293_as-0061607.jpg,1,2,2,2,7,,train
0528294_as-0061607.jpg,1,1,2,1,5,,train
0528295_as-0061607.jpg,1,2,3,1,7,,train
0528296_as-0061607.jpg,2,1,2,1,6,,train
0528297_as-0061607.jpg,2,1,2,2,7,,train
0528298_as-0061607.jpg,2,1,2,0,5,,train
0528300_as-0061607.jpg,0,0,1,0,1,,val
0528301_as-0061607.jpg,1,0,1,0,2,,val
0528304_as-0028187.jpg,0,1,0,1,2,,test
0528306_as-0028187.jpg,0,3,0,1,4,,train
0528308_as-0028187.jpg,4,1,0,0,5,,train
0528309_sc-1036537.jpg,0,0,1,1,2,,train
0528311_sc-119712.jpg,1,1,2,1,5,,train
0528312_sc-119712.jpg,1,1,2,1,5,,train
0528313_sc-119712.jpg,1,1,2,1,5,,train
0528314_as-2859954.jpg,1,0,0,0,1,,train
0528315_as-0068294.jpg,1,0,0,1,2,,val
0528317_as-0068294.jpg,1,0,0,0,1,,val
0528318_as-0068294.jpg,1,0,0,0,1,,test
0528320_sc-164088.jpg,2,0,1,0,3,,train
0528322_sc-164088.jpg,1,0,0,1,2,,train
0528323_sc-164088.jpg,1,0,0,1,2,,train
0528324_sc-164088.jpg,3,0,0,0,3,,train
0528325_sc-164088.jpg,2,0,0,1,3,,train
0528326_sc-164088.jpg,3,1,1,2,7,,train
0528327_sc-164088.jpg,4,0,1,1,6,,train
0528328_sc-164088.jpg,2,0,1,1,4,,val
0528330_sc-164088.jpg,0,0,1,0,1,,val
0528331_sc-164088.jpg,0,0,1,0,1,,test
0528333_as-3333838.jpg,1,0,1,0,2,,train
0528335_sc-1028070.jpg,3,0,1,0,4,,train
0528336_sc-1028070.jpg,6,0,1,0,7,,train
0528337_as-0081043.jpg,0,1,0,0,1,,train
0528338_as-0081043.jpg,1,0,0,0,1,,train
0528339_as-3311836.jpg,5,0,0,0,5,,train
0528340_as-3311836.jpg,0,0,0,1,1,,train
0528341_as-2855837.jpg,0,1,2,1,4,,val
0528342_as-7380573.jpg,6,0,1,2,9,,val
0528344_sc-153677.jpg,3,1,0,0,4,,test
0528345_as-0063614.jpg,3,0,0,0,3,,train
0528346_as-0063614.jpg,2,0,0,0,2,,train
0528347_sc-207969.jpg,7,0,0,0,7,,train
0528348_sc-207969.jpg,2,0,0,0,2,,train
0528349_sc-207969.jpg,9,0,0,0,9,,train
0528351_sc-207893.jpg,4,0,0,0,4,,train
0528352_sc-207893.jpg,4,0,0,0,4,,train
0528353_sc-207893.jpg,2,0,0,2,4,,val
0528354_sc-207893.jpg,6,0,0,0,6,,val
0528355_sc-156908.jpg,3,1,1,1,6,,test
0528357_sc-156908.jpg,3,1,2,1,7,,train
0528359_as-0090865.jpg,1,0,0,0,1,,train
0528360_sc-142986.jpg,1,0,0,0,1,,train
0528361_sc-142986.jpg,1,0,0,0,1,,train
0528362_as-0083432.jpg,1,0,0,0,1,,train
0528364_as-0090491.jpg,1,0,1,1,3,,train
0528365_as-0090491.jpg,1,0,1,1,3,,train
0528367_as-0090491.jpg,1,0,0,0,1,,val
0528368_as-0090491.jpg,1,0,0,0,1,,val
0528369_as-0090491.jpg,1,0,1,1,3,,test
0528370_sc-196923.jpg,2,1,0,0,3,,train
0528371_sc-196923.jpg,2,1,1,0,4,,train
0528372_sc-196923.jpg,2,1,1,0,4,,train
0528373_sc-192980.jpg,2,0,0,0,2,,train
0528374_sc-192980.jpg,3,0,0,0,3,,train
0528375_sc-192980.jpg,1,0,0,0,1,,train
0528376_sc-192980.jpg,2,0,0,0,2,,train
0528377_sc-192980.jpg,4,0,0,0,4,,val
0528378_sc-192980.jpg,3,0,0,0,3,,val
0528379_sc-192980.jpg,2,0,0,0,2,,test
0528380_sc-192980.jpg,2,0,0,0,2,,train
0528386_as-0062989.jpg,1,0,0,0,1,,train
0528387_as-0062989.jpg,1,0,0,0,1,,train
0528389_as-0062989.jpg,0,0,0,1,1,,train
0528390_as-0062989.jpg,1,0,0,0,1,,train
0528391_as-0062989.jpg,0,0,1,0,1,,train
0528393_as-9078580.jpg,1,0,0,0,1,,train
0528394_sc-149413.jpg,1,0,0,0,1,,val
0528395_sc-149413.jpg,1,0,0,0,1,,val
0528396_as-3167299.jpg,1,0,0,0,1,,test
0528398_sc-152235.jpg,3,0,0,1,4,,train
0528399_sc-152235.jpg,0,0,1,0,1,,train
0528400_sc-152235.jpg,2,0,1,1,4,,train
0528401_as-0021447.jpg,0,0,1,0,1,,train
0528402_as-0021447.jpg,1,0,0,0,1,,train
0528403_as-4970942.jpg,2,0,0,0,2,,train
0528404_as-0017974.jpg,1,0,0,0,1,,train
0528405_as-0017974.jpg,2,0,0,0,2,,val
0528407_as-0037148.jpg,1,0,0,0,1,,val
0528408_as-0037148.jpg,1,0,0,0,1,,test
0528409_as-0037148.jpg,1,0,0,0,1,,train
0528411_as-0037148.jpg,1,0,0,0,1,,train
0528412_as-0037148.jpg,1,0,0,0,1,,train
0528413_as-0037148.jpg,1,0,0,0,1,,train
0528414_as-0037148.jpg,1,0,0,0,1,,train
0528415_as-0037148.jpg,2,0,0,0,2,,train
0528418_as-2953480.jpg,1,1,0,0,2,,train
0528419_sc-193091.jpg,5,0,0,0,5,,val
0528420_sc-193091.jpg,1,1,0,0,2,,val
0528421_sc-193091.jpg,9,0,0,0,9,,test
0528423_sc-113008.jpg,1,0,0,0,1,,train
0528424_sc-113008.jpg,1,0,0,0,1,,train
0528426_sc-113008.jpg,2,0,0,0,2,,train
0528427_as-0029961.jpg,2,0,0,0,2,,train
0528428_as-0029961.jpg,1,0,0,3,4,,train
0528429_as-0029961.jpg,1,0,0,2,3,,train
0528430_as-0029961.jpg,4,1,0,3,8,,train
0528431_as-0029961.jpg,3,0,2,4,9,,val
0528432_as-0029961.jpg,2,0,1,0,3,,val
0528433_as-0029961.jpg,2,0,2,2,6,,test
0528434_sc-155930.jpg,1,0,0,0,1,,train
0528435_sc-155930.jpg,1,0,0,0,1,,train
0528436_as-0082048.jpg,2,0,1,1,4,,train
0528437_as-0082048.jpg,3,0,1,1,5,,train
0528438_as-0082048.jpg,1,0,1,1,3,,train
0528439_as-0082048.jpg,2,0,1,1,4,,train
0528440_sc-165363.jpg,2,0,0,0,2,,train
0528442_as-0002089.jpg,2,0,1,0,3,,val
0528443_as-0002089.jpg,1,0,0,0,1,,val
0528444_as-0002089.jpg,1,0,1,0,2,,test
0528445_as-0002089.jpg,2,0,1,1,4,,train
0528446_sc-196397.jpg,0,1,0,0,1,,train
0528447_sc-196397.jpg,1,0,0,0,1,,train
0528448_sc-196397.jpg,0,1,0,0,1,,train
0528449_sc-196397.jpg,1,0,0,0,1,,train
0528450_sc-105182.jpg,2,0,0,0,2,,train
0528451_sc-105182.jpg,2,0,0,0,2,,train
0528452_sc-105182.jpg,1,0,0,0,1,,val
0528453_sc-105182.jpg,2,0,0,0,2,,val
0528454_sc-1031615.jpg,3,0,1,0,4,,test
0528455_sc-1031615.jpg,2,0,1,0,3,,train
0528456_sc-1031615.jpg,1,3,1,0,5,,train
0528457_sc-1031615.jpg,2,0,3,0,5,,train
0528458_as-0080637.jpg,2,0,0,1,3,,train
0528459_as-0008365.jpg,1,0,0,0,1,,train
0528460_as-0008365.jpg,2,0,0,0,2,,train
0528461_as-0008365.jpg,1,0,0,0,1,,train
0528462_as-0008365.jpg,3,0,0,1,4,,val
0528463_as-0008365.jpg,4,0,0,0,4,,val
0528464_as-0008365.jpg,2,0,0,1,3,,test
0528465_as-0008365.jpg,1,0,0,0,1,,train
0528466_as-0008365.jpg,3,1,0,1,5,,train
0528468_as-2905981.jpg,2,0,1,2,5,,train
0528469_sc-225434.jpg,2,0,0,1,3,,train
0528470_sc-225434.jpg,2,0,0,1,3,,train
0528471_sc-225434.jpg,1,0,0,1,2,,train
0528473_as-0006629.jpg,1,0,0,0,1,,train
0528474_sc-124373.jpg,1,0,0,0,1,,val
0528475_sc-124373.jpg,1,0,0,0,1,,val
0528476_as-0014458.jpg,3,2,1,0,6,,test
0528477_as-0014458.jpg,3,1,0,1,5,,train
0528478_as-0014458.jpg,0,1,0,1,2,,train
0528479_as-0014458.jpg,2,1,0,1,4,,train
0528480_as-0038223.jpg,1,0,0,0,1,,train
0528481_as-0038223.jpg,5,0,0,0,5,,train
0528482_as-0038223.jpg,1,0,0,0,1,,train
0528484_as-0038223.jpg,2,0,0,0,2,,train
0528485_as-0038223.jpg,1,0,1,0,2,,val
0528486_as-0038223.jpg,2,0,1,0,3,,val
0528487_as-0038223.jpg,1,0,0,0,1,,test
0528488_as-0038223.jpg,2,0,0,0,2,,train
0528489_as-0038223.jpg,2,0,0,0,2,,train
0528491_as-0038223.jpg,3,0,0,0,3,,train
0528492_as-0038223.jpg,1,0,0,0,1,,train
0528495_as-0099076.jpg,0,0,0,1,1,,train
0528496_as-0099076.jpg,5,0,0,1,6,,train
0528498_as-0099076.jpg,4,1,0,0,5,,train
0528499_as-0099076.jpg,4,1,0,0,5,,val
0528500_as-0099076.jpg,2,0,0,0,2,,val
0528501_as-0099076.jpg,6,0,0,0,6,,test
0528502_as-0099076.jpg,1,0,0,0,1,,train
0528503_sc-1005507.jpg,2,1,0,1,4,,train
0528507_as-0080995.jpg,0,1,1,0,2,,train
0528509_sc-1021031.jpg,2,0,0,0,2,,train
0528511_sc-208066.jpg,6,0,1,1,8,,train
0528512_sc-208066.jpg,7,0,0,0,7,,train
0528513_sc-1014763.jpg,2,0,0,0,2,,train
0528514_sc-1014763.jpg,2,0,0,0,2,,val
0528515_sc-1014763.jpg,1,0,0,0,1,,val
0528516_sc-1014763.jpg,1,0,0,0,1,,test
0528517_sc-228091.jpg,3,0,0,2,5,,train
0528518_sc-153415.jpg,1,0,1,1,3,,train
0528521_sc-123472.jpg,5,0,2,1,8,,train
0528523_sc-123472.jpg,2,1,1,0,4,,train
0528524_sc-123472.jpg,1,0,0,1,2,,train
0528525_sc-123472.jpg,1,0,1,0,2,,train
0528526_sc-123472.jpg,1,0,1,1,3,,train
0528528_sc-123472.jpg,2,0,0,0,2,,val
0528529_sc-123472.jpg,0,0,1,0,1,,val
0528531_sc-191832.jpg,1,0,0,0,1,,test
0528532_sc-191832.jpg,2,0,1,0,3,,train
0528533_sc-191832.jpg,1,0,0,0,1,,train
0528534_sc-191832.jpg,0,0,1,0,1,,train
0528535_sc-191832.jpg,1,0,1,1,3,,train
0528536_sc-191832.jpg,1,0,1,0,2,,train
0528538_as-0017082.jpg,0,1,1,1,3,,train
0528539_as-0003347.jpg,0,0,1,0,1,,train
0528540_as-3260459.jpg,4,1,0,0,5,,val
0528541_sc-205238.jpg,3,0,1,1,5,,val
0528542_sc-205238.jpg,3,0,1,1,5,,test
0528543_sc-205238.jpg,4,0,0,0,4,,train
0528544_sc-182326.jpg,1,0,1,1,3,,train
0528545_as-2987386.jpg,0,0,1,0,1,,train
0528546_as-5057685.jpg,3,0,1,2,6,,train
0528547_as-3092540.jpg,1,0,0,0,1,,train
0528548_sc-1027655.jpg,7,0,0,0,7,,train
0528549_as-3188936.jpg,1,1,0,0,2,,train
0528550_as-0047385.jpg,3,2,1,1,7,,val
0528551_as-0047385.jpg,4,0,0,2,6,,val
0528552_as-0047385.jpg,2,1,0,1,4,,test
0528553_as-0047385.jpg,2,1,1,2,6,,train
0528554_as-0047385.jpg,4,1,1,1,7,,train
0528555_as-0047385.jpg,4,1,0,1,6,,train
0528556_as-0047385.jpg,3,1,0,4,8,,train
0528557_as-0047385.jpg,3,0,0,1,4,,train
0528559_sc-193703.jpg,0,0,1,0,1,,train
0528561_sc-193703.jpg,2,1,1,0,4,,train
0528562_sc-193703.jpg,2,1,2,1,6,,val
0528563_sc-193703.jpg,1,0,1,0,2,,val
0528564_sc-193703.jpg,1,0,1,0,2,,test
0528565_sc-217072.jpg,1,1,0,1,3,,train
0528566_sc-217072.jpg,1,1,0,1,3,,train
0528567_sc-217072.jpg,1,1,0,1,3,,train
0528568_sc-217072.jpg,1,1,0,0,2,,train
0528569_sc-217072.jpg,1,1,0,1,3,,train
0528570_sc-222267.jpg,3,0,0,0,3,,train
0528571_sc-222267.jpg,5,0,0,0,5,,train
0528572_sc-222267.jpg,2,0,0,0,2,,val
0528574_as-7687565.jpg,1,0,0,1,2,,val
0528575_sc-218401.jpg,3,0,0,0,3,,test
0528576_sc-218401.jpg,2,0,0,0,2,,train
0528577_sc-228454.jpg,3,2,1,0,6,,train
0528578_sc-228454.jpg,1,1,0,0,2,,train
0528579_sc-228454.jpg,0,1,0,0,1,,train
0528580_sc-228454.jpg,4,1,0,1,6,,train
0528581_sc-228454.jpg,2,1,0,2,5,,train
0528582_sc-228454.jpg,4,1,0,4,9,,train
0528585_as-0047357.jpg,0,1,1,0,2,,val
0528586_as-0047357.jpg,4,1,1,0,6,,val
0528587_as-0047357.jpg,1,2,1,0,4,,test
0528592_sc-127633.jpg,1,1,0,0,2,,train
0528593_sc-127633.jpg,6,2,0,0,8,,train
0528594_sc-127633.jpg,10,0,0,0,10,,train
0528595_sc-127633.jpg,6,0,0,0,6,,train
0528596_sc-127633.jpg,3,3,1,0,7,,train
0528597_sc-127633.jpg,2,0,1,0,3,,train
0528598_sc-127633.jpg,7,0,0,1,8,,train
0528599_as-3431192.jpg,2,0,0,0,2,,val
0528600_as-2556206.jpg,1,0,1,1,3,,val
0528602_sc-182594.jpg,1,0,0,0,1,,test
0528603_sc-1040834.jpg,4,0,0,0,4,,train
0528604_sc-1040834.jpg,9,0,0,0,9,,train
0528605_as-3441215.jpg,5,0,1,1,7,,train
0528607_sc-167022.jpg,1,0,2,1,4,,train
0528608_as-7397447.jpg,5,0,0,0,5,,train
0528609_sc-180917.jpg,4,2,1,0,7,,train
0528610_sc-180917.jpg,1,0,1,0,2,,train
0528611_sc-180917.jpg,1,0,0,0,1,,val
0528612_sc-180917.jpg,2,1,1,0,4,,val
0528613_sc-180917.jpg,5,1,1,0,7,,test
0528615_as-9045266.jpg,1,0,0,0,1,,train
0528616_sc-116601.jpg,1,0,0,0,1,,train
0528617_sc-116601.jpg,1,0,0,0,1,,train
0528618_sc-116601.jpg,1,0,0,0,1,,train
0528619_sc-116601.jpg,1,0,0,0,1,,train
0528620_as-3168456.jpg,2,0,1,0,3,,train
0528622_sc-230537.jpg,1,0,0,0,1,,train
0528623_sc-230537.jpg,1,0,1,0,2,,val
0528624_as-0017982.jpg,1,0,0,0,1,,val
0528626_as-0017982.jpg,0,0,1,0,1,,test
0528627_as-0017982.jpg,0,0,1,0,1,,train
0528629_as-0017982.jpg,0,0,0,1,1,,train
0528630_as-0017982.jpg,1,0,0,0,1,,train
0528631_as-0017982.jpg,1,0,0,0,1,,train
0528634_as-0036806.jpg,2,0,0,0,2,,train
0528635_as-0036806.jpg,1,0,0,0,1,,train
0528636_as-0036806.jpg,1,0,0,0,1,,train
0528637_as-0036806.jpg,1,0,1,0,2,,val
0528638_sc-205083.jpg,1,0,0,0,1,,val
0528639_as-0001223.jpg,1,0,0,0,1,,test
0528640_as-0001223.jpg,2,2,0,0,4,,train
0528641_sc-121440.jpg,1,0,1,0,2,,train
0528644_sc-121440.jpg,1,0,0,0,1,,train
0528645_sc-104598.jpg,2,0,0,0,2,,train
0528646_sc-104598.jpg,5,0,0,0,5,,train
0528647_sc-104598.jpg,1,1,0,1,3,,train
0528648_sc-104598.jpg,3,0,0,0,3,,train
0528649_sc-104598.jpg,1,0,0,0,1,,val
0528650_as-2564767.jpg,4,1,0,0,5,,val
0528651_as-0048125.jpg,3,0,1,1,5,,test
0528652_as-0048125.jpg,2,0,0,0,2,,train
0528653_as-0048125.jpg,2,1,0,0,3,,train
0528654_as-0048125.jpg,4,0,0,1,5,,train
0528655_as-0048125.jpg,3,0,0,0,3,,train
0528656_as-0048125.jpg,2,0,0,0,2,,train
0528657_sc-214848.jpg,3,0,0,0,3,,train
0528658_sc-214848.jpg,0,1,0,0,1,,train
0528659_sc-179885.jpg,2,0,0,0,2,,val
0528660_as-3276093.jpg,3,0,0,0,3,,val
0528661_sc-184640.jpg,0,0,1,0,1,,test
0528662_sc-184640.jpg,0,0,1,0,1,,train
0528663_sc-184640.jpg,1,3,1,0,5,,train
0528664_sc-184640.jpg,1,2,0,0,3,,train
0528665_sc-184640.jpg,2,3,1,0,6,,train
0528666_sc-225738.jpg,2,0,1,1,4,,train
0528667_sc-225738.jpg,1,0,1,0,2,,train
0528668_sc-225738.jpg,3,0,1,0,4,,train
0528669_as-3072923.jpg,3,1,3,1,8,,val
0528670_as-2894117.jpg,2,2,1,1,6,,val
0528671_as-7950495.jpg,2,0,0,1,3,,test
0528672_as-2959483.jpg,2,0,1,0,3,,train
0528673_as-0068526.jpg,2,0,0,0,2,,train
0528674_as-0068526.jpg,3,0,0,0,3,,train
0528675_as-0068526.jpg,1,0,0,0,1,,train
0528676_sc-213491.jpg,2,1,0,0,3,,train
0528677_sc-213491.jpg,5,1,0,0,6,,train
0528678_sc-213491.jpg,5,1,0,0,6,,train
0528679_sc-213491.jpg,5,0,1,0,6,,val
0528681_as-0035572.jpg,3,0,0,0,3,,val
0528683_as-0077191.jpg,2,2,1,0,5,,test
0528684_as-0077191.jpg,1,1,1,0,3,,train
0528685_sc-122636.jpg,1,0,1,1,3,,train
0528686_sc-122636.jpg,2,0,0,0,2,,train
0528688_as-7668265.jpg,3,0,0,0,3,,train
0528689_sc-146228.jpg,0,0,0,1,1,,train
0528690_sc-146228.jpg,4,0,0,0,4,,train
0528691_sc-146228.jpg,2,0,0,0,2,,train
0528692_sc-146228.jpg,1,0,0,0,1,,val
0528694_as-0003308.jpg,1,0,2,0,3,,val
0528695_as-0003308.jpg,1,1,0,0,2,,test
0528696_as-0003308.jpg,2,1,1,0,4,,train
0528699_as-0093022.jpg,0,0,1,0,1,,train
0528700_sc-125638.jpg,3,0,1,0,4,,train
0528702_sc-125638.jpg,1,0,0,0,1,,train
0528704_as-0001933.jpg,3,0,0,1,4,,train
0528705_sc-1027759.jpg,1,0,0,0,1,,train
0528706_sc-1027759.jpg,1,0,0,0,1,,train
0528709_as-0073587.jpg,1,0,0,0,1,,val
0528711_as-0036519.jpg,3,0,1,1,5,,val
0528712_as-0036519.jpg,0,0,2,0,2,,test
0528713_as-0036519.jpg,1,0,0,1,2,,train
0528714_as-0036519.jpg,1,0,0,1,2,,train
0528715_as-0036519.jpg,1,0,0,1,2,,train
0528716_as-0036519.jpg,1,0,0,0,1,,train
0528717_as-0036519.jpg,1,0,1,1,3,,train
0528718_as-0036519.jpg,1,0,0,2,3,,train
0528719_as-0036519.jpg,2,0,0,1,3,,train
0528721_sc-192825.jpg,1,0,1,0,2,,val
0528722_sc-192825.jpg,1,0,1,0,2,,val
0528725_as-0027937.jpg,4,0,1,0,5,,test
0528726_as-0027937.jpg,3,1,0,0,4,,train
0528727_as-0027937.jpg,2,1,0,0,3,,train
0528728_as-2974021.jpg,0,1,0,0,1,,train
0528731_as-0030197.jpg,6,0,0,0,6,,train
0528732_as-0030197.jpg,6,0,0,0,6,,train
0528733_as-0030197.jpg,7,0,0,0,7,,train
0528736_sc-143026.jpg,1,0,0,0,1,,train
0528737_sc-143026.jpg,1,0,0,0,1,,val
0528738_sc-143026.jpg,1,0,0,0,1,,val
0528740_as-9065996.jpg,1,0,0,0,1,,test
0528743_as-7608788.jpg,0,0,1,0,1,,train
0528744_as-2765462.jpg,2,0,1,1,4,,train
0528745_sc-137850.jpg,1,0,0,0,1,,train
0528747_sc-1008811.jpg,2,0,0,0,2,,train
0528748_sc-1008811.jpg,2,0,0,0,2,,train
0528749_sc-1008811.jpg,2,0,0,0,2,,train
0528751_as-0025265.jpg,0,1,1,0,2,,train
0528752_as-0037562.jpg,1,1,1,0,3,,val
0528753_as-0037562.jpg,2,0,1,1,4,,val
0528754_as-7549056.jpg,5,0,3,0,8,,test
0528755_as-2719912.jpg,2,0,0,0,2,,train
0528756_as-2871003.jpg,1,0,0,0,1,,train
0528757_sc-221426.jpg,1,5,0,0,6,,train
0528758_sc-221426.jpg,1,3,0,0,4,,train
0528759_sc-221426.jpg,1,6,0,0,7,,train
0528760_sc-1037591.jpg,1,0,0,1,2,,train
0528761_sc-1037591.jpg,2,0,0,1,3,,train
0528762_sc-1037591.jpg,1,0,0,1,2,,val
0528764_sc-1037591.jpg,1,0,0,1,2,,val
0528765_sc-1037591.jpg,1,0,0,1,2,,test
0528767_sc-1037591.jpg,1,0,0,1,2,,train
0528768_as-3416518.jpg,3,0,0,0,3,,train
0528770_as-0001407.jpg,1,0,0,0,1,,train
0528771_as-3456878.jpg,1,0,0,0,1,,train
0528772_as-0040193.jpg,1,0,0,1,2,,train
0528773_as-0040193.jpg,1,0,0,1,2,,train
0528774_as-2852960.jpg,1,0,0,0,1,,train
0528778_as-0000453.jpg,1,0,0,0,1,,val
0528779_as-3417203.jpg,1,0,1,1,3,,val
0528780_sc-220011.jpg,5,0,1,1,7,,test
0528781_sc-220011.jpg,3,0,1,1,5,,train
0528782_sc-220011.jpg,6,0,1,1,8,,train
0528783_sc-220011.jpg,8,0,0,1,9,,train
0528784_sc-220011.jpg,1,0,0,0,1,,train
0528785_as-0019250.jpg,1,1,0,1,3,,train
0528786_as-0019250.jpg,1,1,0,2,4,,train
0528788_sc-205903.jpg,0,0,1,0,1,,train
0528789_sc-205903.jpg,1,0,0,2,3,,val
0528790_sc-205903.jpg,1,0,0,1,2,,val
0528791_as-3117107.jpg,1,0,2,0,3,,test
0528792_sc-214799.jpg,1,0,0,0,1,,train
0528793_sc-214799.jpg,1,0,0,0,1,,train
0528795_as-3115966.jpg,1,0,0,1,2,,train
0528796_as-9014471.jpg,2,0,1,0,3,,train
0528797_as-7974590.jpg,1,1,1,0,3,,train
0528798_sc-1030360.jpg,1,0,1,0,2,,train
0528799_sc-1030360.jpg,1,0,1,0,2,,train
0528800_sc-1030360.jpg,1,0,1,0,2,,val
0528801_sc-1030360.jpg,1,0,1,0,2,,val
0528802_sc-1030360.jpg,1,0,1,0,2,,test
0528803_sc-1030360.jpg,1,0,1,0,2,,train
0528804_sc-103299.jpg,1,1,1,0,3,,train
0528805_sc-103299.jpg,1,1,0,0,2,,train
0528806_as-0054458.jpg,0,0,1,0,1,,train
0528807_as-3064228.jpg,1,0,0,1,2,,train
0528808_sc-120687.jpg,5,0,0,2,7,,train
0528809_sc-120687.jpg,1,0,1,1,3,,train
0528810_sc-120687.jpg,3,0,1,1,5,,val
0528811_sc-120687.jpg,1,0,1,1,3,,val
0528812_sc-120687.jpg,4,0,0,1,5,,test
0528813_sc-120687.jpg,4,0,1,0,5,,train
0528814_sc-120687.jpg,2,0,0,1,3,,train
0528815_sc-120687.jpg,3,0,0,1,4,,train
0528816_sc-120687.jpg,4,0,0,1,5,,train
0528817_sc-120687.jpg,2,0,0,0,2,,train
0528818_sc-120687.jpg,2,0,0,0,2,,train
0528819_sc-120687.jpg,5,0,0,0,5,,train
0528820_sc-120687.jpg,1,0,0,0,1,,val
0528822_sc-203270.jpg,6,1,0,1,8,,val
0528823_sc-203270.jpg,4,1,0,1,6,,test
0528824_as-3059666.jpg,4,0,0,0,4,,train
0528827_as-0079655.jpg,3,0,1,0,4,,train
0528829_as-0079655.jpg,1,0,2,1,4,,train
0528830_as-0079655.jpg,3,1,1,2,7,,train
0528831_as-0079655.jpg,2,1,1,2,6,,train
0528832_as-0079655.jpg,0,0,1,0,1,,train
0528833_as-0079655.jpg,0,1,0,0,1,,train
0528834_as-0079655.jpg,2,1,0,1,4,,val
0528835_as-0079655.jpg,1,1,0,1,3,,val
0528836_as-0079655.jpg,1,0,1,0,2,,test
0528837_as-0079655.jpg,1,0,2,0,3,,train
0528838_as-0079655.jpg,1,0,2,0,3,,train
0528839_as-0079655.jpg,1,0,0,0,1,,train
0528840_as-0079655.jpg,2,0,0,0,2,,train
0528841_as-0079655.jpg,1,0,0,0,1,,train
0528842_sc-183876.jpg,1,0,0,0,1,,train
0528843_sc-183876.jpg,2,0,0,0,2,,train
0528844_sc-183876.jpg,1,0,0,0,1,,val
0528845_sc-183876.jpg,3,0,0,0,3,,val
0528846_sc-183876.jpg,1,0,0,0,1,,test
0528847_as-0055785.jpg,2,1,0,0,3,,train
0528848_as-0055785.jpg,1,1,0,0,2,,train
0528849_as-0055785.jpg,1,0,0,0,1,,train
0528850_sc-1034747.jpg,1,0,0,0,1,,train
0528851_sc-1013896.jpg,0,1,1,0,2,,train
0528852_sc-1013896.jpg,0,1,1,0,2,,train
0528854_as-0023167.jpg,1,0,0,0,1,,train
0528855_as-0023167.jpg,4,0,0,0,4,,val
0528856_as-0023167.jpg,2,0,0,0,2,,val
0528857_as-0023167.jpg,1,0,0,0,1,,test
0528858_as-0023167.jpg,1,0,0,0,1,,train
0528859_as-0023167.jpg,1,0,0,0,1,,train
0528860_as-0023167.jpg,2,0,0,0,2,,train
0528861_as-0023167.jpg,1,0,0,0,1,,train
0528862_as-0023167.jpg,1,0,0,0,1,,train
0528865_as-0005508.jpg,3,0,0,0,3,,train
0528867_as-0005508.jpg,2,0,0,0,2,,train
0528868_sc-162093.jpg,2,0,0,0,2,,val
0528869_sc-162093.jpg,2,0,0,0,2,,val
0528870_sc-162093.jpg,3,1,0,0,4,,test
0528871_sc-162093.jpg,3,2,1,0,6,,train
0528872_sc-162093.jpg,4,1,0,0,5,,train
0528873_sc-162093.jpg,3,1,0,0,4,,train
0528874_sc-162093.jpg,3,2,1,0,6,,train
0528875_sc-162093.jpg,3,0,0,0,3,,train
0528877_sc-162093.jpg,3,0,0,1,4,,train
0528878_sc-162093.jpg,2,0,0,0,2,,train
0528879_sc-162093.jpg,3,1,0,0,4,,val
0528882_sc-127701.jpg,2,0,0,0,2,,val
0528883_sc-127701.jpg,5,0,0,1,6,,test
0528884_sc-127701.jpg,1,0,0,0,1,,train
0528885_sc-1037218.jpg,0,1,0,0,1,,train
0528886_sc-1037218.jpg,4,0,0,1,5,,train
0528887_sc-1037218.jpg,2,1,1,0,4,,train
0528890_as-0096726.jpg,1,0,2,0,3,,train
0528891_as-0096726.jpg,1,0,1,0,2,,train
0528895_as-0018685.jpg,4,0,1,3,8,,train
0528896_as-0018685.jpg,3,0,0,0,3,,val
0528897_as-0018685.jpg,4,0,0,0,4,,val
0528898_as-0018685.jpg,2,0,0,0,2,,test
0528899_sc-106802.jpg,2,2,0,0,4,,train
0528903_sc-106802.jpg,3,1,0,0,4,,train
0528904_as-3211065.jpg,0,1,0,0,1,,train
0528908_as-0019961.jpg,8,1,1,1,11,,train
0528909_as-0019961.jpg,4,0,0,1,5,,train
0528912_as-0019961.jpg,7,1,1,1,10,,train
0528913_as-0019961.jpg,2,0,0,0,2,,train
0528914_as-0019961.jpg,2,0,0,0,2,,val
0528915_as-0019961.jpg,2,0,0,0,2,,val
0528916_as-0019961.jpg,2,0,0,0,2,,test
0528917_as-3075595.jpg,1,0,0,0,1,,train
0528919_as-0029187.jpg,2,0,0,1,3,,train
0528920_as-0029187.jpg,2,0,0,1,3,,train
0528921_as-0029187.jpg,1,0,0,1,2,,train
0528922_sc-1002010.jpg,1,0,0,0,1,,train
0528923_as-7543495.jpg,2,0,0,0,2,,train
0528924_as-2801056.jpg,1,0,0,0,1,,train
0528925_sc-218251.jpg,1,0,0,3,4,,val
0528926_sc-218251.jpg,3,1,0,3,7,,val
0528927_sc-218251.jpg,3,2,1,1,7,,test
0528928_as-0025299.jpg,1,0,0,0,1,,train
0528929_as-2679616.jpg,4,0,4,0,8,,train
0528930_as-7814728.jpg,0,0,2,0,2,,train
0528931_sc-209044.jpg,2,0,0,0,2,,train
0528932_sc-209044.jpg,2,0,0,0,2,,train
0528933_sc-161063.jpg,5,0,0,1,6,,train
0528934_sc-161063.jpg,3,0,0,1,4,,train
0528935_sc-144268.jpg,1,1,0,0,2,,val
0528936_sc-144268.jpg,2,1,0,0,3,,val
0528937_sc-144268.jpg,0,1,0,0,1,,test
0528939_sc-1031482.jpg,0,1,1,1,3,,train
0528940_sc-1031482.jpg,3,1,2,1,7,,train
0528941_sc-1031482.jpg,2,1,1,1,5,,train
0528942_sc-1031482.jpg,1,1,2,1,5,,train
0528943_as-0007478.jpg,1,0,1,1,3,,train
0528944_as-0007478.jpg,6,0,3,1,10,,train
0528945_as-0007478.jpg,3,1,0,1,5,,train
0528946_as-0097122.jpg,2,0,0,0,2,,val
0528948_as-7034010.jpg,1,0,1,1,3,,val
0528951_as-0007244.jpg,1,0,0,0,1,,test
0528952_as-7784246.jpg,1,0,0,0,1,,train
0528955_as-0017694.jpg,1,2,1,1,5,,train
0528956_as-0017694.jpg,0,1,1,1,3,,train
0528957_as-0017694.jpg,1,2,1,1,5,,train
0528958_as-0017694.jpg,0,0,1,0,1,,train
0528959_as-0017694.jpg,1,2,2,1,6,,train
0528960_as-0017694.jpg,0,2,2,1,5,,train
0528961_as-0017694.jpg,1,2,1,1,5,,val
0528962_as-0017694.jpg,1,2,3,0,6,,val
0528963_as-0083531.jpg,1,0,0,0,1,,test
0528964_as-0083531.jpg,1,0,1,0,2,,train
0528965_as-0083531.jpg,2,0,0,0,2,,train
0528966_sc-1023062.jpg,5,0,0,0,5,,train
0528967_sc-1023062.jpg,5,0,0,0,5,,train
0528968_sc-1023062.jpg,3,0,0,0,3,,train
0528970_sc-1023062.jpg,2,0,0,0,2,,train
0528971_sc-1023062.jpg,2,0,0,0,2,,train
0528973_sc-1023062.jpg,2,0,0,0,2,,val
0528974_sc-1023062.jpg,2,0,0,0,2,,val
0528975_sc-1023062.jpg,2,0,0,1,3,,test
0528976_sc-1023062.jpg,1,0,0,1,2,,train
0528977_sc-1023062.jpg,2,0,0,1,3,,train
0528980_sc-177513.jpg,1,0,0,0,1,,train
0528982_sc-177513.jpg,1,0,0,0,1,,train
0528983_sc-177513.jpg,1,0,0,0,1,,train
0528984_sc-1013186.jpg,0,1,0,0,1,,train
0528985_sc-1013186.jpg,1,0,0,0,1,,train
0528986_sc-1013186.jpg,1,3,1,0,5,,val
0528987_sc-1013186.jpg,0,0,1,0,1,,val
0528988_sc-1013186.jpg,1,2,1,0,4,,test
0528989_sc-1013186.jpg,1,0,0,0,1,,train
0528990_sc-1013186.jpg,1,0,0,0,1,,train
0528991_sc-1013186.jpg,1,0,0,0,1,,train
0528992_sc-1013186.jpg,1,1,0,0,2,,train
0528993_sc-1013186.jpg,2,0,0,0,2,,train
0528994_sc-1013186.jpg,0,0,1,0,1,,train
0528995_sc-1013186.jpg,1,1,0,0,2,,train
0528996_sc-138103.jpg,1,0,0,0,1,,val
0528997_sc-138103.jpg,1,0,0,0,1,,val
0528998_sc-1015795.jpg,6,0,0,1,7,,test
0528999_sc-1015795.jpg,2,0,0,0,2,,train
0529000_sc-1015795.jpg,4,3,0,2,9,,train
0529002_as-0032353.jpg,2,0,1,0,3,,train
0529003_as-0032353.jpg,1,2,2,0,5,,train
0529004_sc-143847.jpg,2,0,0,0,2,,train
0529005_sc-143847.jpg,2,0,0,0,2,,train
0529006_sc-143847.jpg,1,0,0,0,1,,train
0529008_sc-143847.jpg,2,0,0,1,3,,val
0529009_sc-143847.jpg,0,0,1,0,1,,val
0529011_sc-143847.jpg,1,0,0,0,1,,test
0529012_sc-143847.jpg,1,0,0,0,1,,train
0529013_sc-143847.jpg,1,0,0,0,1,,train
0529014_sc-143847.jpg,1,0,0,0,1,,train
0529016_sc-143847.jpg,2,0,1,0,3,,train
0529017_sc-143847.jpg,2,0,0,1,3,,train
0529018_sc-143847.jpg,2,0,0,2,4,,train
0529019_sc-143847.jpg,3,0,0,0,3,,train
0529020_sc-143847.jpg,1,0,0,0,1,,val
0529023_as-0060933.jpg,6,0,0,1,7,,val
0529024_as-0060933.jpg,4,0,0,1,5,,test
0529025_as-0060933.jpg,5,0,0,2,7,,train
0529026_as-0060933.jpg,3,0,0,0,3,,train
0529027_as-0060933.jpg,3,0,2,1,6,,train
0529028_as-0060933.jpg,4,0,1,1,6,,train
0529029_as-7276820.jpg,1,0,0,0,1,,train
0529030_sc-217590.jpg,3,1,1,0,5,,train
0529031_sc-160632.jpg,2,0,0,1,3,,train
0529032_sc-160632.jpg,2,0,0,1,3,,val
0529033_sc-160632.jpg,3,0,0,1,4,,val
0529034_sc-145650.jpg,0,3,3,1,7,,test
0529035_as-0042361.jpg,0,0,1,0,1,,train
0529037_as-0042361.jpg,1,1,0,1,3,,train
0529038_as-0042361.jpg,1,1,1,0,3,,train
0529039_as-3245334.jpg,1,1,3,1,6,,train
0529040_sc-108200.jpg,1,0,0,1,2,,train
0529041_sc-108200.jpg,1,0,0,1,2,,train
0529043_sc-221687.jpg,3,0,0,0,3,,train
0529044_sc-221687.jpg,2,0,0,0,2,,val
0529046_sc-151720.jpg,1,0,0,1,2,,val
0529047_sc-151720.jpg,2,0,0,1,3,,test
0529048_sc-151720.jpg,1,0,1,2,4,,train
0529049_sc-151720.jpg,2,0,0,1,3,,train
0529050_as-9068911.jpg,1,0,1,0,2,,train
0529051_sc-202344.jpg,3,1,0,0,4,,train
0529053_sc-150120.jpg,1,0,0,0,1,,train
0529054_sc-150120.jpg,1,0,0,0,1,,train
0529055_sc-150120.jpg,1,0,0,0,1,,train
0529058_as-0057185.jpg,2,1,2,0,5,,val
0529059_as-0057185.jpg,3,0,4,1,8,,val
0529061_as-0057185.jpg,2,0,1,1,4,,test
0529062_as-0057185.jpg,6,0,0,0,6,,train
0529063_as-0057185.jpg,3,0,0,0,3,,train
0529065_sc-165191.jpg,7,0,0,1,8,,train
0529066_sc-165191.jpg,2,0,0,1,3,,train
0529069_sc-143079.jpg,1,1,0,0,2,,train
0529070_sc-143079.jpg,0,1,0,0,1,,train
0529071_as-2583862.jpg,1,2,2,2,7,,train
0529072_sc-196375.jpg,2,0,0,0,2,,val
0529073_sc-206691.jpg,1,0,2,0,3,,val
0529074_sc-206691.jpg,0,0,1,0,1,,test
0529075_sc-206691.jpg,1,0,1,0,2,,train
0529076_sc-206691.jpg,2,2,3,1,8,,train
0529077_sc-206691.jpg,2,2,5,1,10,,train
0529078_sc-206691.jpg,1,0,2,0,3,,train
0529079_sc-206691.jpg,0,0,2,0,2,,train
0529080_sc-206691.jpg,0,0,3,1,4,,train
0529081_sc-206691.jpg,3,2,1,0,6,,train
0529082_sc-206691.jpg,3,2,2,0,7,,val
0529083_sc-201178.jpg,1,0,1,0,2,,val
0529084_sc-201178.jpg,1,0,0,0,1,,test
0529085_sc-201178.jpg,1,0,0,0,1,,train
0529086_sc-201178.jpg,2,0,0,0,2,,train
0529087_sc-201178.jpg,1,0,0,0,1,,train
0529089_sc-201178.jpg,1,0,1,0,2,,train
0529090_sc-201178.jpg,1,0,1,0,2,,train
0529091_as-3305952.jpg,3,0,0,0,3,,train
0529092_as-7168067.jpg,4,0,0,0,4,,train
0529093_sc-216923.jpg,0,0,1,0,1,,val
0529095_as-0050504.jpg,1,0,1,1,3,,val
0529097_as-0050504.jpg,1,0,1,1,3,,test
0529098_as-0050504.jpg,1,0,1,1,3,,train
0529099_as-0050504.jpg,1,0,0,1,2,,train
0529100_as-0050504.jpg,1,0,0,1,2,,train
0529102_sc-160889.jpg,1,0,0,1,2,,train
0529103_sc-160889.jpg,1,1,1,0,3,,train
0529104_as-3414535.jpg,0,0,1,0,1,,train
0529105_as-3414535.jpg,1,0,0,1,2,,train
0529106_sc-106222.jpg,2,0,2,1,5,,val
0529107_sc-106222.jpg,4,0,1,1,6,,val
0529108_as-2988681.jpg,1,1,0,1,3,,test
0529111_as-0016837.jpg,14,0,1,0,15,,train
0529112_as-0016837.jpg,4,0,2,0,6,,train
0529113_as-0016837.jpg,0,0,1,0,1,,train
0529114_as-0016837.jpg,0,1,2,0,3,,train
0529116_as-0074177.jpg,2,0,0,0,2,,train
0529117_as-0074177.jpg,1,0,0,0,1,,train
0529119_as-0048691.jpg,1,1,2,1,5,,train
0529120_as-0048691.jpg,1,0,0,0,1,,val
0529121_as-0048691.jpg,1,0,0,0,1,,val
0529122_as-0048691.jpg,1,0,0,0,1,,test
0529123_as-0048691.jpg,2,1,2,1,6,,train
0529124_as-0048691.jpg,2,1,2,0,5,,train
0529125_as-0048691.jpg,1,0,0,0,1,,train
0529127_as-0048691.jpg,2,1,0,1,4,,train
0529128_as-0048691.jpg,2,0,0,0,2,,train
0529132_as-0048691.jpg,1,1,1,1,4,,train
0529133_as-0048691.jpg,1,1,1,1,4,,train
0529134_as-0048691.jpg,1,1,1,0,3,,val
0529135_as-0048691.jpg,1,0,1,0,2,,val
0529136_as-0048691.jpg,0,0,1,0,1,,test
0529137_as-0048691.jpg,0,0,1,0,1,,train
0529138_as-0048691.jpg,0,0,1,0,1,,train
0529139_as-0048691.jpg,2,0,0,0,2,,train
0529140_as-0033320.jpg,0,0,1,0,1,,train
0529141_as-0033320.jpg,2,0,0,0,2,,train
0529142_as-0033320.jpg,1,0,0,0,1,,train
0529143_as-0033320.jpg,1,0,0,1,2,,train
0529144_as-0033320.jpg,0,0,1,0,1,,val
0529147_as-0033320.jpg,1,0,0,0,1,,val
0529148_sc-207919.jpg,2,0,0,0,2,,test
0529150_sc-111483.jpg,4,0,0,0,4,,train
0529151_sc-111483.jpg,2,0,0,0,2,,train
0529156_as-0026678.jpg,2,1,0,0,3,,train
0529157_as-0026678.jpg,1,1,2,1,5,,train
0529158_as-0026678.jpg,1,1,1,0,3,,train
0529159_as-0026678.jpg,1,1,1,0,3,,train
0529161_as-0026678.jpg,0,1,0,0,1,,train
0529162_sc-193938.jpg,1,0,0,0,1,,val
0529164_sc-193938.jpg,1,0,1,1,3,,val
0529165_sc-193938.jpg,1,0,1,2,4,,test
0529166_sc-1036266.jpg,1,0,0,0,1,,train
0529167_sc-1036266.jpg,7,0,4,0,11,,train
0529170_sc-1036266.jpg,2,0,0,0,2,,train
0529171_sc-181883.jpg,6,1,0,0,7,,train
0529173_sc-181883.jpg,4,2,2,0,8,,train
0529174_sc-181883.jpg,6,5,2,0,13,,train
0529175_sc-181883.jpg,4,4,1,0,9,,train
0529177_as-3459519.jpg,1,0,1,0,2,,val
0529178_sc-226419.jpg,5,0,0,4,9,,val
0529179_sc-226419.jpg,6,0,1,4,11,,test
0529180_sc-219795.jpg,3,0,1,0,4,,train
0529181_sc-219795.jpg,2,1,1,0,4,,train
0529182_sc-116019.jpg,2,0,0,0,2,,train
0529183_as-0008205.jpg,0,0,1,1,2,,train
0529184_as-0008205.jpg,1,0,1,1,3,,train
0529185_as-0008205.jpg,0,0,1,1,2,,train
0529186_as-0008205.jpg,0,0,0,1,1,,train
0529187_as-0008205.jpg,0,0,0,1,1,,val
0529188_sc-224572.jpg,1,0,0,0,1,,val
0529189_sc-1011384.jpg,0,1,0,0,1,,test
0529193_sc-225851.jpg,4,0,0,0,4,,train
0529194_sc-225851.jpg,4,0,0,0,4,,train
0529195_sc-225851.jpg,5,0,0,0,5,,train
0529196_sc-225851.jpg,5,0,0,0,5,,train
0529197_as-0002454.jpg,2,0,0,0,2,,train
0529198_as-0002454.jpg,3,0,0,0,3,,train
0529199_as-0002454.jpg,1,0,0,0,1,,train
0529200_sc-135119.jpg,2,0,0,0,2,,val
0529201_sc-107653.jpg,0,1,0,0,1,,val
0529202_as-0088909.jpg,1,0,0,0,1,,test
0529203_as-7460407.jpg,2,0,0,0,2,,train
0529204_as-0069605.jpg,2,0,0,0,2,,train
0529205_as-0069605.jpg,0,0,1,0,1,,train
0529206_as-0069605.jpg,2,0,0,0,2,,train
0529207_as-2527642.jpg,1,0,0,0,1,,train
0529208_as-3003727.jpg,0,0,0,1,1,,train
0529211_sc-129015.jpg,4,0,2,0,6,,train
0529212_sc-129015.jpg,2,1,2,0,5,,val
0529213_sc-129015.jpg,1,0,2,1,4,,val
0529214_sc-129015.jpg,4,0,0,0,4,,test
0529216_sc-118422.jpg,1,2,1,1,5,,train
0529217_sc-118422.jpg,2,0,1,1,4,,train
0529218_sc-118422.jpg,1,2,0,0,3,,train
0529221_as-0082562.jpg,0,0,2,0,2,,train
0529222_as-0082562.jpg,5,0,2,1,8,,train
0529223_as-0082562.jpg,6,0,3,1,10,,train
0529224_as-0082562.jpg,7,0,1,1,9,,train
0529225_as-0082562.jpg,10,0,1,1,12,,val
0529226_as-0082562.jpg,8,0,1,0,9,,val
0529227_as-0082562.jpg,7,0,4,1,12,,test
0529228_as-0082562.jpg,1,0,2,1,4,,train
0529230_as-0082562.jpg,0,0,3,0,3,,train
0529232_as-0082562.jpg,4,0,0,0,4,,train
0529233_as-7243783.jpg,3,0,0,0,3,,train
0529234_as-3231262.jpg,1,0,0,0,1,,train
0529235_as-3231149.jpg,2,0,0,0,2,,train
0529236_as-2570947.jpg,1,0,1,0,2,,train
0529237_sc-149227.jpg,1,0,0,1,2,,val
0529238_sc-149227.jpg,1,0,0,1,2,,val
0529239_sc-149227.jpg,1,0,0,1,2,,test
0529243_as-0010880.jpg,2,1,1,1,5,,train
0529244_as-0010880.jpg,1,2,1,1,5,,train
0529245_as-0010880.jpg,2,0,0,0,2,,train
0529248_sc-152735.jpg,1,0,0,0,1,,train
0529250_sc-152735.jpg,1,0,0,0,1,,train
0529251_as-0026053.jpg,1,0,0,0,1,,train
0529252_as-0026053.jpg,2,0,0,0,2,,train
0529253_as-0034269.jpg,2,0,0,0,2,,val
0529254_as-0034269.jpg,1,0,0,0,1,,val
0529255_as-7988610.jpg,12,0,0,0,12,,test
0529256_sc-120853.jpg,1,0,0,0,1,,train
0529257_sc-1008676.jpg,3,0,1,1,5,,train
0529258_sc-1008676.jpg,1,1,3,0,5,,train
0529261_sc-1008676.jpg,1,0,1,0,2,,train
0529262_sc-1008676.jpg,5,1,1,0,7,,train
0529263_sc-1008676.jpg,5,1,1,0,7,,train
0529264_sc-1008676.jpg,1,1,1,0,3,,train
0529265_as-0089190.jpg,5,0,0,0,5,,val
0529266_as-0089190.jpg,0,0,1,0,1,,val
0529267_as-0089190.jpg,3,0,1,0,4,,test
0529270_as-0017101.jpg,1,0,1,0,2,,train
0529271_as-0017101.jpg,1,0,2,0,3,,train
0529273_as-0035029.jpg,3,0,0,0,3,,train
0529274_as-0035029.jpg,1,0,0,1,2,,train
0529275_as-0035029.jpg,2,0,0,0,2,,train
0529276_as-0035029.jpg,2,0,0,0,2,,train
0529277_as-0035029.jpg,2,0,0,0,2,,train
0529278_as-0035029.jpg,1,0,1,2,4,,val
0529279_as-0035029.jpg,2,0,0,1,3,,val
0529281_sc-142536.jpg,2,0,0,0,2,,test
0529282_sc-142536.jpg,1,0,2,0,3,,train
0529283_as-0033609.jpg,1,0,1,0,2,,train
0529284_as-0033609.jpg,1,0,0,0,1,,train
0529285_as-0033609.jpg,0,0,0,1,1,,train
0529286_as-0033609.jpg,0,0,1,0,1,,train
0529287_as-0033609.jpg,2,0,2,0,4,,train
0529288_as-0033609.jpg,2,0,0,0,2,,train
0529290_sc-143015.jpg,1,0,0,0,1,,val
0529291_sc-143015.jpg,1,0,0,0,1,,val
0529292_sc-143015.jpg,2,0,0,0,2,,test
0529293_as-2998008.jpg,3,1,1,0,5,,train
0529294_sc-1017200.jpg,1,0,0,0,1,,train
0529296_sc-1017200.jpg,1,0,0,0,1,,train
0529298_as-0083974.jpg,1,1,1,1,4,,train
0529299_as-0083974.jpg,1,0,0,0,1,,train
0529300_as-0083974.jpg,2,1,1,1,5,,train
0529301_as-0083974.jpg,1,0,0,0,1,,train
0529302_as-0083974.jpg,0,0,1,0,1,,val
0529303_as-0083974.jpg,0,1,1,0,2,,val
0529304_sc-228250.jpg,2,0,0,0,2,,test
0529305_sc-228250.jpg,1,0,0,0,1,,train
0529306_sc-228250.jpg,1,0,0,0,1,,train
0529307_sc-228250.jpg,2,0,0,0,2,,train
0529308_sc-228250.jpg,1,0,0,0,1,,train
0529309_as-3227509.jpg,1,0,0,0,1,,train
0529311_as-0006517.jpg,4,0,0,1,5,,train
0529312_as-0006517.jpg,1,0,0,0,1,,train
0529315_as-0054593.jpg,1,0,0,0,1,,val
0529316_as-0054593.jpg,3,2,1,1,7,,val
0529318_as-0054593.jpg,1,1,1,2,5,,test
0529320_sc-166925.jpg,5,2,0,0,7,,train
0529321_sc-166925.jpg,1,1,0,0,2,,train
0529322_sc-166925.jpg,0,1,0,0,1,,train
0529323_sc-166925.jpg,2,1,0,0,3,,train
0529324_as-0035900.jpg,2,0,1,1,4,,train
0529325_as-0035900.jpg,1,0,2,1,4,,train
0529326_as-0035900.jpg,2,0,2,1,5,,train
0529327_sc-211971.jpg,1,0,0,0,1,,val
0529328_sc-176414.jpg,2,0,2,0,4,,val
0529330_sc-176414.jpg,2,1,2,0,5,,test
0529331_sc-176414.jpg,0,0,1,0,1,,train
0529332_sc-176414.jpg,3,0,1,0,4,,train
0529333_sc-140662.jpg,1,0,0,1,2,,train
0529334_sc-140662.jpg,0,0,0,1,1,,train
0529335_sc-140662.jpg,1,0,0,1,2,,train
0529336_sc-140662.jpg,1,0,1,1,3,,train
0529338_sc-140662.jpg,1,0,0,0,1,,train
0529339_as-2922810.jpg,1,1,1,0,3,,val
0529342_as-0068309.jpg,1,1,0,1,3,,val
0529344_as-0054919.jpg,6,1,1,1,9,,test
0529345_as-0054919.jpg,3,1,2,1,7,,train
0529346_as-0054919.jpg,2,1,1,1,5,,train
0529348_sc-180231.jpg,2,0,1,1,4,,train
0529349_sc-180231.jpg,1,0,1,1,3,,train
0529350_sc-180231.jpg,3,0,1,0,4,,train
0529351_sc-180231.jpg,1,0,1,0,2,,train
0529352_sc-180231.jpg,2,0,1,0,3,,train
0529354_as-0082651.jpg,2,0,0,0,2,,val
0529355_as-0082651.jpg,1,0,0,0,1,,val
0529356_as-0082651.jpg,1,0,1,0,2,,test
0529357_as-0082651.jpg,0,0,0,1,1,,train
0529358_as-3258190.jpg,1,0,0,0,1,,train
0529359_sc-128119.jpg,9,0,0,0,9,,train
0529360_sc-128119.jpg,3,0,0,0,3,,train
0529361_sc-128119.jpg,5,0,0,0,5,,train
0529362_sc-128119.jpg,5,0,0,0,5,,train
0529363_sc-128119.jpg,1,0,1,0,2,,train
0529365_sc-128119.jpg,4,0,0,0,4,,val
0529366_sc-128119.jpg,0,1,0,0,1,,val
0529367_sc-128119.jpg,2,0,0,0,2,,test
0529368_sc-128119.jpg,2,0,0,0,2,,train
0529369_sc-128119.jpg,2,0,0,0,2,,train
0529370_sc-128119.jpg,1,0,0,0,1,,train
0529371_sc-128119.jpg,2,0,0,0,2,,train
0529372_sc-128119.jpg,3,0,0,0,3,,train
0529373_as-0000867.jpg,2,0,1,1,4,,train
0529374_sc-1041187.jpg,2,0,0,0,2,,train
0529375_sc-1041187.jpg,2,0,0,0,2,,val
0529376_sc-1005196.jpg,1,2,0,1,4,,val
0529377_sc-1005196.jpg,1,0,1,0,2,,test
0529379_sc-1005196.jpg,1,1,2,1,5,,train
0529380_sc-1005196.jpg,1,1,1,1,4,,train
0529381_sc-1005196.jpg,2,1,1,0,4,,train
0529382_sc-1005196.jpg,0,0,0,1,1,,train
0529383_sc-1005196.jpg,2,1,1,2,6,,train
0529384_sc-1005196.jpg,1,0,1,0,2,,train
0529385_sc-1005196.jpg,2,3,2,1,8,,train
0529386_sc-1005196.jpg,0,0,0,3,3,,val
0529388_as-0054116.jpg,3,0,0,0,3,,val
0529390_as-0057842.jpg,3,1,1,1,6,,test
0529391_sc-192837.jpg,2,0,0,0,2,,train
0529392_sc-192837.jpg,1,0,0,0,1,,train
0529393_sc-192837.jpg,2,0,0,0,2,,train
0529395_sc-1029164.jpg,2,0,0,0,2,,train
0529396_sc-1029164.jpg,2,0,0,0,2,,train
0529397_as-7343724.jpg,1,0,0,0,1,,train
0529399_as-2527265.jpg,1,0,0,0,1,,train
0529400_as-0081569.jpg,2,0,0,0,2,,val
0529401_as-0081569.jpg,5,0,0,0,5,,val
0529402_as-0081569.jpg,4,0,0,0,4,,test
0529403_as-0081569.jpg,4,0,0,0,4,,train
0529404_as-2873748.jpg,2,0,0,0,2,,train
0529405_sc-194647.jpg,2,0,0,1,3,,train
0529406_sc-194647.jpg,2,0,0,1,3,,train
0529407_sc-194647.jpg,3,0,0,2,5,,train
0529408_sc-194647.jpg,3,0,0,2,5,,train
0529410_sc-169403.jpg,3,0,1,1,5,,train
0529411_as-7655084.jpg,2,0,1,1,4,,val
0529412_sc-1018728.jpg,1,0,0,0,1,,val
0529414_sc-1018728.jpg,1,0,0,0,1,,test
0529415_sc-1018728.jpg,1,0,0,0,1,,train
0529416_as-3404463.jpg,2,1,1,0,4,,train
0529417_sc-103452.jpg,1,2,0,0,3,,train
0529420_as-0035223.jpg,0,1,0,0,1,,train
0529423_sc-114975.jpg,0,1,0,0,1,,train
0529424_sc-114975.jpg,0,1,1,0,2,,train
0529426_as-0030629.jpg,0,0,2,0,2,,train
0529428_sc-221026.jpg,0,1,1,0,2,,val
0529429_sc-221026.jpg,1,0,0,0,1,,val
0529430_sc-221026.jpg,2,0,2,0,4,,test
0529431_sc-221026.jpg,2,0,1,0,3,,train
0529432_sc-221026.jpg,0,1,2,0,3,,train
0529433_sc-221026.jpg,0,1,2,0,3,,train
0529434_sc-221026.jpg,0,0,2,0,2,,train
0529435_sc-221026.jpg,1,0,1,0,2,,train
0529436_sc-221026.jpg,0,1,0,0,1,,train
0529437_sc-221026.jpg,1,0,1,0,2,,train
0529438_sc-221026.jpg,2,1,0,0,3,,val
0529439_sc-221026.jpg,1,0,0,0,1,,val
0529440_sc-221026.jpg,1,0,0,0,1,,test
0529441_sc-221026.jpg,1,0,1,0,2,,train
0529442_sc-221026.jpg,1,0,0,0,1,,train
0529443_sc-221026.jpg,1,0,0,0,1,,train
0529449_as-0080617.jpg,3,3,2,0,8,,train
0529450_as-0080617.jpg,3,1,0,0,4,,train
0529452_sc-187552.jpg,2,1,0,0,3,,train
0529453_sc-187552.jpg,0,1,0,0,1,,train
0529454_sc-187552.jpg,2,1,0,0,3,,val
0529455_sc-187552.jpg,0,1,0,0,1,,val
0529456_as-3486490.jpg,0,0,1,0,1,,test
0529459_as-0001625.jpg,1,0,0,0,1,,train
0529460_as-0001625.jpg,1,0,0,0,1,,train
0529461_as-0001625.jpg,3,0,0,0,3,,train
0529462_as-0001625.jpg,4,0,0,0,4,,train
0529463_sc-1006195.jpg,1,0,0,2,3,,train
0529464_sc-1006195.jpg,1,0,0,2,3,,train
0529465_sc-1006195.jpg,1,0,0,2,3,,train
0529466_as-0070462.jpg,1,0,0,0,1,,val
0529467_as-0070462.jpg,1,0,0,0,1,,val
0529468_as-0070462.jpg,1,0,0,0,1,,test
0529470_as-0052106.jpg,1,0,0,0,1,,train
0529472_sc-178990.jpg,2,1,0,0,3,,train
0529473_as-0032658.jpg,2,1,2,1,6,,train
0529474_as-0032658.jpg,1,0,0,1,2,,train
0529475_as-0032658.jpg,2,0,0,0,2,,train
0529477_as-0032658.jpg,4,1,1,1,7,,train
0529478_as-0032658.jpg,8,0,3,1,12,,train
0529479_as-0032658.jpg,2,0,1,1,4,,val
0529480_as-0032658.jpg,3,0,0,0,3,,val
0529481_as-0032658.jpg,3,1,0,0,4,,test
0529482_as-0032658.jpg,3,0,0,0,3,,train
0529483_as-0032658.jpg,13,0,0,0,13,,train
0529484_as-0032658.jpg,14,0,1,1,16,,train
0529486_as-0032658.jpg,3,2,2,0,7,,train
0529487_as-0032658.jpg,7,1,0,2,10,,train
0529488_as-0032658.jpg,2,0,0,0,2,,train
0529489_as-0069843.jpg,2,0,1,0,3,,train
0529494_as-0020005.jpg,2,0,2,0,4,,val
0529495_as-0020005.jpg,1,0,1,0,2,,val
0529496_as-0020005.jpg,0,0,1,0,1,,test
0529497_as-0033343.jpg,1,0,0,0,1,,train
0529498_as-0033343.jpg,1,0,0,0,1,,train
0529499_as-0033343.jpg,2,0,4,1,7,,train
0529501_as-0033343.jpg,3,0,1,0,4,,train
0529502_as-0033343.jpg,1,1,1,0,3,,train
0529503_as-0046759.jpg,2,0,0,0,2,,train
0529504_as-0046759.jpg,3,0,0,0,3,,train
0529505_as-0046759.jpg,3,0,0,0,3,,val
0529506_as-7208817.jpg,1,0,0,0,1,,val
0529507_sc-198260.jpg,1,0,0,0,1,,test
0529508_sc-198260.jpg,3,0,0,1,4,,train
0529511_as-2534309.jpg,3,1,0,1,5,,train
0529514_as-0089543.jpg,0,0,2,0,2,,train
0529515_as-0089543.jpg,4,0,1,0,5,,train
0529516_as-0089543.jpg,1,3,5,1,10,,train
0529517_as-0089543.jpg,3,2,5,1,11,,train
0529518_as-0089543.jpg,5,1,6,1,13,,train
0529519_as-0089543.jpg,0,2,0,0,2,,val
0529520_as-0089543.jpg,0,2,0,0,2,,val
0529521_sc-103361.jpg,2,0,0,0,2,,test
0529522_sc-103361.jpg,3,0,0,0,3,,train
0529523_sc-103361.jpg,2,0,0,0,2,,train
0529524_as-2974151.jpg,2,0,0,0,2,,train
0529525_as-0082928.jpg,0,1,2,0,3,,train
0529526_as-0082928.jpg,0,1,2,0,3,,train
0529528_as-0082928.jpg,0,1,0,0,1,,train
0529529_as-0082928.jpg,1,1,0,0,2,,train
0529531_as-0082928.jpg,1,0,0,0,1,,val
0529532_sc-190017.jpg,1,0,0,0,1,,val
0529533_sc-190017.jpg,1,0,0,0,1,,test
0529534_sc-190017.jpg,1,0,0,0,1,,train
0529535_sc-1038059.jpg,4,0,0,0,4,,train
0529536_sc-1038059.jpg,1,0,0,0,1,,train
0529537_sc-1038059.jpg,2,0,0,0,2,,train
0529538_sc-167697.jpg,3,0,0,1,4,,train
0529539_sc-167697.jpg,3,0,0,1,4,,train
0529540_sc-167697.jpg,3,0,0,1,4,,train
0529541_sc-167697.jpg,3,0,0,1,4,,val
0529542_sc-167697.jpg,2,0,0,0,2,,val
0529543_as-7108517.jpg,3,0,0,0,3,,test
0529544_as-3265470.jpg,1,0,2,0,3,,train
0529545_as-2555036.jpg,3,0,0,0,3,,train
0529546_as-2997482.jpg,2,0,0,0,2,,train
0529547_as-3081979.jpg,1,0,1,0,2,,train
0529548_as-3127354.jpg,5,0,1,0,6,,train
0529549_as-3213605.jpg,2,2,0,0,4,,train
0529550_as-7455070.jpg,1,0,1,0,2,,train
0529551_sc-206334.jpg,5,0,0,0,5,,val
0529552_sc-206334.jpg,4,0,0,0,4,,val
0529553_sc-191484.jpg,1,2,1,0,4,,test
0529554_sc-191484.jpg,7,5,4,0,16,,train
0529555_sc-191484.jpg,3,0,0,0,3,,train
0529556_as-3280532.jpg,8,0,0,0,8,,train
0529557_sc-152812.jpg,2,0,0,0,2,,train
0529559_sc-152812.jpg,1,0,0,0,1,,train
0529560_sc-152812.jpg,1,0,0,0,1,,train
0529561_as-0018035.jpg,3,0,0,0,3,,train
0529562_as-0018035.jpg,3,0,0,0,3,,val
0529563_as-0018035.jpg,4,0,0,1,5,,val
0529564_as-0018035.jpg,4,0,0,1,5,,test
0529565_as-0018035.jpg,1,0,0,0,1,,train
0529566_as-0018035.jpg,1,0,0,1,2,,train
0529567_as-0061880.jpg,5,0,0,0,5,,train
0529568_sc-1022831.jpg,1,0,0,0,1,,train
0529569_sc-1022831.jpg,2,0,0,0,2,,train
0529570_sc-213617.jpg,1,0,0,0,1,,train
0529571_sc-1017651.jpg,3,0,0,0,3,,train
0529572_sc-1017651.jpg,0,1,0,0,1,,val
0529573_sc-1017651.jpg,3,0,0,0,3,,val
0529574_sc-1017651.jpg,1,1,0,0,2,,test
0529575_sc-1017651.jpg,0,2,0,0,2,,train
0529578_as-0028131.jpg,2,1,0,1,4,,train
0529579_as-0028131.jpg,5,2,1,1,9,,train
0529580_as-0028131.jpg,4,1,1,0,6,,train
0529581_as-0028131.jpg,1,1,0,0,2,,train
0529583_sc-114406.jpg,2,0,0,0,2,,train
0529585_sc-114406.jpg,4,0,0,0,4,,train
0529587_as-0055745.jpg,0,0,1,0,1,,val
0529588_as-0055745.jpg,1,0,1,1,3,,val
0529589_as-0055745.jpg,2,0,4,2,8,,test
0529590_as-0055745.jpg,0,0,2,4,6,,train
0529591_as-0055745.jpg,0,0,1,2,3,,train
0529592_as-0055745.jpg,2,0,0,0,2,,train
0529595_as-0094118.jpg,5,0,1,2,8,,train
0529597_as-0094118.jpg,5,0,2,2,9,,train
0529598_as-0094118.jpg,1,0,2,0,3,,train
0529599_as-0094118.jpg,0,0,1,1,2,,train
0529601_as-0094118.jpg,0,1,1,0,2,,val
0529602_as-0094118.jpg,0,1,2,0,3,,val
0529603_as-0094118.jpg,3,3,0,1,7,,test
0529604_as-3201615.jpg,3,0,1,0,4,,train
0529605_sc-1025721.jpg,7,0,1,0,8,,train
0529606_sc-1025721.jpg,1,1,0,1,3,,train
0529607_sc-230323.jpg,1,0,0,0,1,,train
0529609_sc-230323.jpg,5,1,2,0,8,,train
0529610_sc-230323.jpg,3,2,2,0,7,,train
0529611_as-2805648.jpg,2,1,0,3,6,,train
0529612_as-0019510.jpg,1,0,0,0,1,,val
0529613_as-0019510.jpg,2,0,0,0,2,,val
0529614_sc-149460.jpg,2,0,1,1,4,,test
0529615_as-2767638.jpg,3,1,0,1,5,,train
0529616_sc-175368.jpg,1,0,0,1,2,,train
0529617_sc-175368.jpg,1,0,0,1,2,,train
0529618_as-3140821.jpg,2,0,1,0,3,,train
0529619_sc-175899.jpg,1,0,1,1,3,,train
0529620_sc-1001674.jpg,2,0,1,1,4,,train
0529621_sc-1001674.jpg,2,0,1,0,3,,train
0529623_sc-1001674.jpg,3,0,1,0,4,,val
0529624_as-3343901.jpg,1,0,1,1,3,,val
0529625_sc-223061.jpg,4,0,0,0,4,,test
0529626_sc-223061.jpg,2,0,0,0,2,,train
0529627_sc-1040910.jpg,1,0,0,0,1,,train
0529628_as-9029399.jpg,1,0,0,0,1,,train
0529629_sc-103158.jpg,3,0,1,1,5,,train
0529630_sc-103158.jpg,2,0,1,0,3,,train
0529631_sc-103158.jpg,5,0,2,1,8,,train
0529632_sc-103158.jpg,4,0,1,0,5,,train
0529633_sc-103158.jpg,3,0,1,0,4,,val
0529634_sc-213233.jpg,1,0,1,0,2,,val
0529635_sc-213233.jpg,1,0,0,0,1,,test
0529636_sc-213233.jpg,1,0,0,0,1,,train
0529637_sc-213233.jpg,0,0,1,0,1,,train
0529638_sc-213233.jpg,1,0,1,0,2,,train
0529639_sc-213233.jpg,3,0,0,0,3,,train
0529640_sc-213233.jpg,1,0,0,0,1,,train
0529641_sc-213233.jpg,0,0,1,0,1,,train
0529642_as-2533803.jpg,0,1,0,0,1,,train
0529644_as-0004499.jpg,3,2,1,0,6,,val
0529645_as-0004499.jpg,2,1,0,0,3,,val
0529646_as-2512185.jpg,3,1,0,0,4,,test
0529647_as-2777007.jpg,1,0,0,0,1,,train
0529649_as-0002590.jpg,0,1,0,0,1,,train
0529650_as-0002590.jpg,0,1,0,0,1,,train
0529652_as-0063297.jpg,1,0,0,0,1,,train
0529653_as-0063297.jpg,1,0,0,0,1,,train
0529654_as-9043799.jpg,7,0,0,0,7,,train
0529656_sc-169223.jpg,2,0,0,0,2,,train
0529657_as-9017250.jpg,3,0,0,0,3,,val
0529658_as-0074727.jpg,1,0,1,0,2,,val
0529660_sc-196568.jpg,1,1,0,1,3,,test
0529661_sc-196568.jpg,2,1,1,1,5,,train
0529662_sc-196568.jpg,2,1,1,1,5,,train
0529663_as-0008612.jpg,5,1,1,1,8,,train
0529666_as-0088627.jpg,1,0,1,0,2,,train
0529667_as-0088627.jpg,1,0,1,0,2,,train
0529668_as-0088627.jpg,1,0,1,0,2,,train
0529669_as-0088627.jpg,1,0,0,0,1,,train
0529670_as-0088627.jpg,1,0,0,0,1,,val
0529671_sc-118658.jpg,0,0,1,1,2,,val
0529672_as-0048526.jpg,1,0,0,0,1,,test
0529673_as-0048526.jpg,1,0,0,0,1,,train
0529674_as-0048526.jpg,1,0,0,0,1,,train
0529675_as-0048526.jpg,2,0,0,0,2,,train
0529676_as-0048526.jpg,1,0,0,0,1,,train
0529677_sc-144393.jpg,3,0,1,1,5,,train
0529678_sc-144393.jpg,2,0,1,0,3,,train
0529679_sc-144393.jpg,4,0,1,0,5,,train
0529681_as-2767531.jpg,9,0,0,0,9,,val
0529682_as-0045465.jpg,0,1,0,1,2,,val
0529683_as-0078941.jpg,7,2,1,0,10,,test
0529685_as-0052543.jpg,3,0,0,0,3,,train
0529686_as-0052543.jpg,4,0,0,0,4,,train
0529687_as-0052543.jpg,1,0,0,0,1,,train
0529688_sc-120447.jpg,2,0,0,0,2,,train
0529693_sc-129255.jpg,4,0,1,1,6,,train
0529694_sc-129255.jpg,3,0,1,1,5,,train
0529695_sc-129255.jpg,2,0,1,1,4,,train
0529696_sc-129255.jpg,1,0,0,0,1,,val
0529697_sc-129255.jpg,1,0,1,1,3,,val
0529698_sc-129255.jpg,1,0,1,1,3,,test
0529699_sc-1039690.jpg,0,1,0,0,1,,train
0529700_sc-115865.jpg,2,0,1,1,4,,train
0529701_sc-115865.jpg,1,0,0,0,1,,train
0529702_sc-115865.jpg,1,0,1,1,3,,train
0529705_sc-224316.jpg,1,0,0,0,1,,train
0529707_as-0087463.jpg,4,2,1,0,7,,train
0529708_as-0087463.jpg,2,1,1,0,4,,train
0529709_as-0087463.jpg,5,2,1,0,8,,val
0529711_as-0087550.jpg,2,0,2,0,4,,val
0529712_as-0087550.jpg,2,0,1,0,3,,test
0529713_as-0087550.jpg,2,0,1,0,3,,train
0529714_as-0087550.jpg,2,0,0,0,2,,train
0529715_as-0060649.jpg,0,0,1,0,1,,train
0529716_as-0060649.jpg,1,1,1,2,5,,train
0529717_as-0060649.jpg,1,1,1,1,4,,train
0529718_as-0060649.jpg,0,0,1,0,1,,train
0529719_sc-196436.jpg,4,0,2,1,7,,train
0529720_sc-196436.jpg,3,0,2,0,5,,val
0529721_sc-196436.jpg,2,1,0,1,4,,val
0529722_as-3397411.jpg,1,1,0,0,2,,test
0529724_as-2729072.jpg,0,1,1,0,2,,train
0529725_sc-1037460.jpg,1,0,0,0,1,,train
0529728_as-2830018.jpg,3,0,2,0,5,,train
0529729_as-2591546.jpg,5,0,0,0,5,,train
0529731_as-0057256.jpg,10,2,1,1,14,,train
0529732_as-0057256.jpg,7,2,1,1,11,,train
0529733_as-0057256.jpg,4,2,1,0,7,,train
0529734_as-0057256.jpg,6,1,2,1,10,,val
0529735_as-0057256.jpg,2,2,1,2,7,,val
0529736_as-0057256.jpg,5,1,0,0,6,,test
0529737_as-0079943.jpg,2,1,0,1,4,,train
0529738_as-0079943.jpg,1,1,0,1,3,,train
0529741_sc-173381.jpg,2,0,1,1,4,,train
0529742_sc-173381.jpg,0,0,1,1,2,,train
0529743_sc-173381.jpg,0,0,1,1,2,,train
0529745_sc-173381.jpg,1,0,1,0,2,,train
0529746_sc-173381.jpg,1,0,1,0,2,,train
0529747_sc-145199.jpg,2,0,0,0,2,,val
0529749_sc-145199.jpg,1,0,0,0,1,,val
0529750_sc-145199.jpg,3,0,0,0,3,,test
0529751_sc-145199.jpg,2,0,0,0,2,,train
0529752_sc-113329.jpg,4,0,0,0,4,,train
0529753_sc-113329.jpg,5,0,1,0,6,,train
0529754_as-3133881.jpg,1,0,0,0,1,,train
0529755_as-3249254.jpg,3,0,0,0,3,,train
0529756_sc-1035064.jpg,1,0,0,0,1,,train
0529757_sc-1035064.jpg,3,0,0,0,3,,train
0529758_sc-1035064.jpg,3,0,1,0,4,,val
0529759_sc-1035064.jpg,0,0,1,0,1,,val
0529760_as-7567127.jpg,1,0,1,0,2,,test
0529761_sc-123880.jpg,1,0,0,1,2,,train
0529762_sc-123880.jpg,1,0,0,0,1,,train
0529763_sc-123880.jpg,1,0,0,1,2,,train
0529764_sc-123880.jpg,2,0,0,1,3,,train
0529765_as-2661000.jpg,2,0,0,0,2,,train
0529766_as-0030830.jpg,1,0,0,1,2,,train
0529767_as-0030830.jpg,2,0,0,1,3,,train
0529768_sc-130151.jpg,3,0,1,1,5,,val
0529769_sc-130151.jpg,2,1,1,1,5,,val
0529770_sc-130151.jpg,3,0,1,1,5,,test
0529771_sc-130151.jpg,5,0,1,1,7,,train
0529772_sc-115593.jpg,6,0,0,0,6,,train
0529773_sc-120688.jpg,8,0,0,0,8,,train
0529774_sc-126067.jpg,3,0,0,0,3,,train
0529775_sc-181430.jpg,1,0,0,0,1,,train
0529776_sc-181430.jpg,1,0,1,0,2,,train
0529777_sc-181430.jpg,2,0,0,0,2,,train
0529778_sc-104814.jpg,1,0,0,0,1,,val
0529779_sc-104814.jpg,1,0,0,0,1,,val
0529781_sc-215116.jpg,1,2,2,0,5,,test
0529782_sc-215116.jpg,1,2,3,0,6,,train
0529783_sc-215116.jpg,1,1,0,0,2,,train
0529784_sc-215116.jpg,1,1,1,0,3,,train
0529785_sc-215116.jpg,0,1,1,0,2,,train
0529786_sc-215116.jpg,0,1,1,0,2,,train
0529787_sc-215116.jpg,1,0,1,0,2,,train
0529788_sc-215116.jpg,1,0,1,0,2,,train
0529789_sc-224386.jpg,1,0,1,0,2,,val
0529790_sc-224386.jpg,1,0,0,0,1,,val
0529793_sc-224386.jpg,0,0,1,0,1,,test
0529794_sc-224386.jpg,3,0,1,0,4,,train
0529795_sc-224386.jpg,1,0,0,0,1,,train
0529796_sc-224386.jpg,1,0,0,0,1,,train
0529797_sc-224386.jpg,1,0,0,0,1,,train
0529798_sc-224386.jpg,1,0,0,0,1,,train
0529799_sc-224386.jpg,2,0,0,0,2,,train
0529800_sc-224386.jpg,1,1,0,0,2,,train
0529801_sc-224386.jpg,1,0,0,0,1,,val
0529802_as-0057385.jpg,2,0,1,0,3,,val
0529803_as-0057385.jpg,0,0,1,0,1,,test
0529804_as-0057385.jpg,0,0,1,0,1,,train
0529805_as-3104229.jpg,2,0,0,0,2,,train
0529811_as-0007320.jpg,1,0,0,0,1,,train
0529812_sc-188936.jpg,7,2,0,0,9,,train
0529813_sc-188936.jpg,20,2,0,0,22,,train
0529814_as-2617862.jpg,0,0,0,1,1,,train
0529816_as-3001943.jpg,5,0,0,0,5,,train
0529817_as-3001943.jpg,2,0,0,0,2,,val
0529818_as-3154743.jpg,1,0,0,0,1,,val
0529819_sc-170868.jpg,2,0,0,0,2,,test
0529820_sc-170868.jpg,1,0,0,0,1,,train
0529821_sc-129488.jpg,2,0,0,0,2,,train
0529823_sc-129488.jpg,1,0,0,0,1,,train
0529825_as-0089199.jpg,1,1,0,1,3,,train
0529826_as-0089199.jpg,1,1,0,1,3,,train
0529827_as-0089199.jpg,1,0,0,1,2,,train
0529828_as-0089199.jpg,1,1,0,0,2,,train
0529829_as-0089199.jpg,1,1,0,0,2,,val
0529831_as-0082295.jpg,1,1,0,0,2,,val
0529832_as-0082295.jpg,2,2,0,0,4,,test
0529835_sc-195802.jpg,5,0,3,1,9,,train
0529836_sc-195802.jpg,6,0,4,1,11,,train
0529837_sc-195802.jpg,5,0,1,0,6,,train
0529838_sc-195802.jpg,4,0,0,0,4,,train
0529839_sc-195802.jpg,1,0,0,0,1,,train
0529840_sc-195802.jpg,1,0,0,0,1,,train
0529844_sc-195802.jpg,1,0,1,0,2,,train
0529845_sc-195802.jpg,1,0,1,0,2,,val
0529846_sc-195802.jpg,2,0,0,0,2,,val
0529848_sc-195802.jpg,2,0,0,0,2,,test
0529849_sc-195802.jpg,2,0,0,0,2,,train
0529850_sc-195802.jpg,2,0,0,0,2,,train
0529851_sc-195802.jpg,4,0,0,0,4,,train
0529852_sc-195802.jpg,4,0,0,0,4,,train
0529853_sc-195802.jpg,5,0,0,0,5,,train
0529854_sc-195802.jpg,6,0,1,0,7,,train
0529857_sc-1040128.jpg,2,1,1,0,4,,train
0529858_sc-174590.jpg,5,0,0,1,6,,val
0529859_sc-174590.jpg,1,0,0,0,1,,val
0529860_sc-174590.jpg,1,0,0,1,2,,test
0529861_sc-174234.jpg,1,1,1,1,4,,train
0529862_sc-174234.jpg,1,1,1,1,4,,train
0529863_sc-174234.jpg,1,1,1,0,3,,train
0529866_as-3351504.jpg,3,0,2,0,5,,train
0529867_sc-225929.jpg,1,1,0,0,2,,train
0529868_sc-225929.jpg,1,1,0,0,2,,train
0529869_as-2643502.jpg,1,2,3,3,9,,train
0529870_sc-202789.jpg,3,0,0,0,3,,val
0529874_sc-1028987.jpg,2,2,3,0,7,,val
0529876_as-2665110.jpg,2,0,0,0,2,,test
0529877_sc-221422.jpg,0,0,1,0,1,,train
0529881_sc-152173.jpg,3,0,0,0,3,,train
0529882_as-3083699.jpg,1,0,0,0,1,,train
0529883_as-0036237.jpg,1,1,1,0,3,,train
0529885_as-0036237.jpg,1,0,1,0,2,,train
0529886_as-0036237.jpg,4,0,0,0,4,,train
0529888_as-3004770.jpg,1,0,1,1,3,,train
0529889_as-0032333.jpg,0,1,0,0,1,,val
0529890_as-0003601.jpg,1,0,0,0,1,,val
0529891_as-0003601.jpg,2,0,0,0,2,,test
0529895_as-0060983.jpg,1,0,0,0,1,,train
0529896_as-0060983.jpg,2,0,0,0,2,,train
0529899_as-0011201.jpg,0,1,2,0,3,,train
0529900_as-0011201.jpg,0,1,1,0,2,,train
0529901_as-0011201.jpg,0,1,0,0,1,,train
0529902_as-0070233.jpg,2,0,1,0,3,,train
0529903_as-0070284.jpg,2,0,0,0,2,,train
0529904_as-0070284.jpg,2,0,0,0,2,,val
0529908_as-0076350.jpg,1,0,0,0,1,,val
0529909_as-0076350.jpg,1,0,0,0,1,,test
0529910_as-0076350.jpg,1,0,0,0,1,,train
0529912_sc-126515.jpg,2,0,0,0,2,,train
0529913_sc-1002619.jpg,4,2,1,0,7,,train
0529914_sc-1002619.jpg,8,1,1,0,10,,train
0529917_sc-143002.jpg,2,0,0,0,2,,train
0529918_sc-143002.jpg,3,0,0,0,3,,train
0529919_sc-143002.jpg,1,0,1,1,3,,train
0529920_sc-143002.jpg,1,0,0,1,2,,val
0529921_sc-114175.jpg,2,0,0,0,2,,val
0529922_sc-114175.jpg,2,0,0,0,2,,test
0529923_sc-114175.jpg,2,0,0,0,2,,train
0529924_as-0034571.jpg,3,0,2,1,6,,train
0529926_as-0034571.jpg,1,0,0,0,1,,train
0529927_as-0034571.jpg,11,1,0,0,12,,train
0529931_as-0023568.jpg,1,0,0,1,2,,train
0529932_as-0023568.jpg,1,0,0,1,2,,train
0529933_as-0023568.jpg,1,0,0,0,1,,train
0529935_as-0074530.jpg,1,1,0,0,2,,val
0529937_as-0074530.jpg,1,1,0,0,2,,val
0529938_as-0074530.jpg,1,1,0,0,2,,test
0529940_as-0074530.jpg,0,0,1,0,1,,train
0529942_as-0074530.jpg,0,0,1,0,1,,train
0529943_as-0074530.jpg,1,1,1,0,3,,train
0529944_as-0024749.jpg,5,0,0,0,5,,train
0529945_as-0024749.jpg,3,0,1,2,6,,train
0529946_as-0024749.jpg,2,0,1,1,4,,train
0529947_as-0024749.jpg,4,0,1,1,6,,train
0529949_as-0069377.jpg,4,0,0,0,4,,val
0529950_as-0069377.jpg,1,0,0,0,1,,val
0529951_as-0069377.jpg,5,0,0,0,5,,test
0529952_as-0069377.jpg,6,0,0,0,6,,train
0529953_as-0069377.jpg,7,0,0,0,7,,train
0529954_as-0069377.jpg,7,1,0,0,8,,train
0529955_as-7061188.jpg,2,0,0,0,2,,train
0529956_sc-1034797.jpg,4,1,0,0,5,,train
0529957_sc-1034797.jpg,4,0,0,0,4,,train
0529958_sc-1034797.jpg,2,0,0,0,2,,train
0529961_sc-182720.jpg,3,0,2,0,5,,val
0529962_sc-182720.jpg,1,1,0,0,2,,val
0529963_sc-182720.jpg,1,1,0,0,2,,test
0529964_sc-182720.jpg,1,1,1,0,3,,train
0529965_sc-182720.jpg,1,0,1,1,3,,train
0529967_sc-190197.jpg,1,0,0,0,1,,train
0529968_sc-190197.jpg,1,0,1,0,2,,train
0529970_sc-190197.jpg,2,0,0,0,2,,train
0529971_sc-190197.jpg,1,0,0,0,1,,train
0529974_as-0034133.jpg,1,0,0,0,1,,train
0529975_as-0034133.jpg,1,0,0,0,1,,val
0529976_as-0034133.jpg,4,0,0,0,4,,val
0529977_as-2782985.jpg,2,1,0,2,5,,test
0529982_as-0026728.jpg,0,1,1,0,2,,train
0529983_as-0026728.jpg,0,2,2,1,5,,train
0529984_as-0026728.jpg,1,2,0,0,3,,train
0529986_sc-199159.jpg,1,0,0,1,2,,train
0529987_sc-199159.jpg,4,0,0,0,4,,train
0529989_sc-199159.jpg,1,2,0,0,3,,train
0529990_sc-199159.jpg,1,1,0,0,2,,train
0529992_sc-199159.jpg,2,0,0,0,2,,val
0529994_sc-199159.jpg,2,0,0,0,2,,val
0529995_as-7832648.jpg,1,2,1,0,4,,test
0529996_sc-114179.jpg,2,0,0,0,2,,train
0529997_sc-114179.jpg,1,0,0,0,1,,train
0529998_sc-114179.jpg,1,0,0,0,1,,train
0529999_sc-114179.jpg,1,0,0,0,1,,train
0530000_sc-114179.jpg,1,0,0,0,1,,train
0530003_as-0082301.jpg,4,1,1,2,8,,train
0530004_as-0082301.jpg,4,3,2,1,10,,train
0530005_as-0082301.jpg,3,1,2,2,8,,val
0530006_as-0082301.jpg,2,1,2,1,6,,val
0530007_as-0082301.jpg,2,1,2,1,6,,test
0530008_as-0082301.jpg,1,1,2,1,5,,train
0530009_as-0082301.jpg,4,0,0,0,4,,train
0530010_as-0082301.jpg,4,0,0,0,4,,train
0530011_as-0082301.jpg,1,0,0,0,1,,train
0530012_as-0082301.jpg,1,0,0,0,1,,train
0530013_as-3176017.jpg,1,0,0,0,1,,train
0530014_as-3311737.jpg,1,0,0,1,2,,train
0530015_as-3325884.jpg,1,0,0,0,1,,val
0530018_as-9007128.jpg,1,0,1,0,2,,val
0530019_as-7776854.jpg,0,0,0,1,1,,test
0530020_as-0022591.jpg,4,0,1,1,6,,train
0530021_as-0022591.jpg,7,0,2,1,10,,train
0530023_as-0036878.jpg,1,0,0,0,1,,train
0530024_as-0036878.jpg,1,0,0,0,1,,train
0530025_as-0036878.jpg,1,0,0,0,1,,train
0530026_as-0036878.jpg,1,0,0,0,1,,train
0530029_sc-155543.jpg,4,0,0,0,4,,train
0530030_sc-155543.jpg,5,0,0,0,5,,val
0530032_sc-155543.jpg,2,0,0,0,2,,val
0530033_sc-155543.jpg,3,0,0,0,3,,test
0530035_sc-155543.jpg,2,0,0,0,2,,train
0530036_sc-155543.jpg,1,0,0,0,1,,train
0530037_sc-227710.jpg,1,0,2,1,4,,train
0530038_sc-227710.jpg,1,0,2,1,4,,train
0530039_sc-227710.jpg,2,0,1,1,4,,train
0530040_sc-111536.jpg,4,0,0,0,4,,train
0530041_sc-111536.jpg,1,0,0,0,1,,train
0530042_sc-111536.jpg,3,0,0,0,3,,val
0530043_sc-111536.jpg,1,0,0,0,1,,val
0530044_sc-111536.jpg,2,0,0,0,2,,test
0530046_as-2994333.jpg,1,0,0,0,1,,train
0530047_as-0052924.jpg,0,1,1,0,2,,train
0530048_as-0052924.jpg,2,1,1,1,5,,train
0530049_as-0052924.jpg,0,0,1,0,1,,train
0530050_as-0052924.jpg,0,0,1,0,1,,train
0530051_as-0052924.jpg,0,0,1,0,1,,train
0530052_as-0052924.jpg,0,0,1,0,1,,train
0530053_as-0052924.jpg,1,0,0,0,1,,val
0530054_as-0052924.jpg,0,0,1,1,2,,val
0530055_as-0052924.jpg,2,1,1,0,4,,test
0530056_as-0052924.jpg,1,0,1,0,2,,train
0530059_as-0061361.jpg,2,0,0,0,2,,train
0530060_as-0061361.jpg,1,0,0,0,1,,train
0530061_as-0061361.jpg,1,0,0,0,1,,train
0530062_as-0061361.jpg,1,0,0,0,1,,train
0530063_as-0061361.jpg,2,0,0,0,2,,train
0530064_sc-183267.jpg,1,0,0,0,1,,train
0530065_sc-183267.jpg,1,0,2,0,3,,val
0530066_sc-183267.jpg,1,0,1,0,2,,val
0530068_sc-104708.jpg,1,0,0,0,1,,test
0530069_as-3066359.jpg,0,0,1,0,1,,train
0530070_sc-1004447.jpg,0,1,0,0,1,,train
0530072_sc-148845.jpg,2,2,2,0,6,,train
0530076_sc-136460.jpg,2,0,1,0,3,,train
0530077_sc-136460.jpg,3,0,1,0,4,,train
0530078_sc-136460.jpg,2,0,0,0,2,,train
0530079_sc-136460.jpg,0,0,1,0,1,,train
0530080_sc-136460.jpg,2,0,0,0,2,,val
0530082_sc-136460.jpg,3,0,0,0,3,,val
0530083_sc-225365.jpg,5,0,1,0,6,,test
0530084_sc-225365.jpg,9,0,1,0,10,,train
0530085_sc-225365.jpg,7,0,1,0,8,,train
0530086_sc-225365.jpg,3,0,1,0,4,,train
0530087_sc-225365.jpg,5,0,1,0,6,,train
0530088_sc-225365.jpg,4,0,0,0,4,,train
0530090_as-0054711.jpg,11,0,0,0,11,,train
0530091_as-0054711.jpg,7,0,0,0,7,,train
0530093_as-0039361.jpg,2,0,1,1,4,,val
0530094_as-3309901.jpg,0,1,0,0,1,,val
0530095_sc-1031046.jpg,0,0,0,3,3,,test
0530096_sc-1031046.jpg,0,0,0,2,2,,train
0530097_sc-1031046.jpg,0,0,0,1,1,,train
0530099_as-3397131.jpg,1,1,1,0,3,,train
0530102_as-0094887.jpg,15,3,1,1,20,,train
0530103_as-9000310.jpg,1,0,0,0,1,,train
0530104_sc-1005517.jpg,1,0,0,0,1,,train
0530105_sc-1005517.jpg,1,0,0,0,1,,train
0530107_sc-1035984.jpg,6,0,0,0,6,,val
0530108_sc-1035984.jpg,6,0,0,0,6,,val
0530109_sc-1035984.jpg,0,0,1,0,1,,test
0530110_sc-1035984.jpg,0,0,1,0,1,,train
0530111_sc-1025543.jpg,2,0,0,1,3,,train
0530112_sc-1025543.jpg,4,0,0,0,4,,train
0530115_sc-1026285.jpg,1,0,1,1,3,,train
0530116_sc-1026285.jpg,1,0,1,1,3,,train
0530117_sc-200408.jpg,9,0,0,0,9,,train
0530118_sc-200408.jpg,15,0,0,0,15,,train
0530119_sc-200408.jpg,18,0,0,0,18,,val
0530120_sc-200408.jpg,4,0,0,0,4,,val
0530122_sc-1039908.jpg,2,0,0,0,2,,test
0530123_sc-1039908.jpg,2,0,0,0,2,,train
0530124_sc-1039908.jpg,2,0,0,1,3,,train
0530125_sc-1021875.jpg,2,0,0,1,3,,train
0530126_sc-1021875.jpg,2,0,0,1,3,,train
0530127_sc-1021875.jpg,1,0,0,0,1,,train
0530128_sc-210817.jpg,1,0,2,1,4,,train
0530129_sc-210817.jpg,1,0,1,1,3,,train
0530130_sc-210817.jpg,1,0,1,1,3,,val
0530131_sc-210817.jpg,1,0,1,1,3,,val
0530133_sc-1037229.jpg,2,0,0,1,3,,test
0530134_sc-1037229.jpg,3,0,1,0,4,,train
0530135_sc-1037229.jpg,1,0,0,1,2,,train
0530136_sc-1037229.jpg,6,0,0,0,6,,train
0530137_sc-1037229.jpg,1,0,1,0,2,,train
0530138_sc-1037229.jpg,0,0,0,1,1,,train
0530139_sc-1037229.jpg,4,0,0,0,4,,train
0530140_sc-1037229.jpg,2,0,0,0,2,,train
0530141_sc-1037229.jpg,1,0,0,0,1,,val
0530142_sc-128098.jpg,3,1,0,0,4,,val
0530144_sc-128098.jpg,1,1,1,0,3,,test
0530148_sc-132714.jpg,2,0,1,2,5,,train
0530149_sc-132714.jpg,4,0,1,2,7,,train
0530150_sc-132714.jpg,3,0,1,1,5,,train
0530151_sc-132714.jpg,2,0,1,2,5,,train
0530152_sc-132714.jpg,5,0,0,1,6,,train
0530153_sc-132714.jpg,1,0,0,0,1,,train
0530154_as-3296487.jpg,1,0,0,0,1,,train
0530155_as-3374263.jpg,3,0,0,0,3,,val
0530156_sc-1010800.jpg,1,0,0,0,1,,val
0530157_sc-1010800.jpg,1,0,0,0,1,,test
0530158_sc-1010800.jpg,1,0,0,0,1,,train
0530160_sc-170390.jpg,1,1,0,0,2,,train
0530161_sc-170390.jpg,2,1,0,0,3,,train
0530163_as-3299378.jpg,7,0,1,0,8,,train
0530164_sc-137620.jpg,4,0,0,0,4,,train
0530165_sc-137620.jpg,1,0,0,0,1,,train
0530166_sc-137620.jpg,1,0,0,0,1,,train
0530167_sc-137620.jpg,1,0,0,0,1,,val
0530168_sc-137620.jpg,2,0,0,0,2,,val
0530169_sc-137620.jpg,3,0,0,0,3,,test
0530170_as-7225184.jpg,1,0,1,0,2,,train
0530171_as-7253789.jpg,0,0,0,1,1,,train
0530172_as-2774023.jpg,0,1,0,0,1,,train
0530173_sc-138246.jpg,1,0,0,0,1,,train
0530174_sc-138246.jpg,1,0,0,0,1,,train
0530175_sc-138246.jpg,1,0,0,0,1,,train
0530176_sc-138246.jpg,1,0,0,0,1,,train
0530177_sc-138246.jpg,1,0,0,0,1,,val
0530178_sc-138246.jpg,1,0,0,0,1,,val
0530180_as-0049020.jpg,1,0,0,0,1,,test
0530181_as-0049020.jpg,1,0,0,0,1,,train
0530182_as-0049020.jpg,2,0,1,1,4,,train
0530183_as-0049020.jpg,2,0,1,0,3,,train
0530184_as-0049020.jpg,2,0,1,0,3,,train
0530185_as-0049020.jpg,2,0,1,1,4,,train
0530186_as-0049020.jpg,2,0,1,1,4,,train
0530187_as-0049020.jpg,1,0,1,1,3,,train
0530190_sc-143806.jpg,6,2,0,0,8,,val
0530192_as-3151473.jpg,4,0,1,0,5,,val
0530193_as-3409856.jpg,1,0,0,0,1,,test
0530194_as-0036558.jpg,1,0,0,0,1,,train
0530195_as-0036558.jpg,1,1,3,0,5,,train
0530196_as-0036558.jpg,0,1,0,0,1,,train
0530198_as-0036558.jpg,1,1,1,0,3,,train
0530200_as-0049445.jpg,2,0,0,0,2,,train
0530201_as-0049445.jpg,2,0,0,0,2,,train
0530204_as-3486103.jpg,0,0,1,0,1,,train
0530205_sc-167938.jpg,1,0,0,0,1,,val
0530207_sc-167938.jpg,1,0,0,0,1,,val
0530208_sc-167938.jpg,1,0,0,0,1,,test
0530209_sc-167938.jpg,1,0,0,0,1,,train
0530211_as-0050968.jpg,1,0,0,0,1,,train
0530212_as-0050968.jpg,1,0,0,0,1,,train
0530213_as-0050968.jpg,1,0,0,0,1,,train
0530214_as-0050968.jpg,1,0,0,0,1,,train
0530218_as-0049753.jpg,3,0,0,0,3,,train
0530219_as-0049753.jpg,2,0,0,0,2,,train
0530221_sc-1003857.jpg,2,0,0,0,2,,val
0530224_as-9026415.jpg,1,0,0,0,1,,val
0530226_as-0020841.jpg,3,0,0,0,3,,test
0530227_as-0020841.jpg,4,0,1,0,5,,train
0530228_as-0020841.jpg,3,0,0,0,3,,train
0530229_as-0020841.jpg,2,0,0,0,2,,train
0530230_as-0020841.jpg,2,0,0,0,2,,train
0530231_as-0020841.jpg,2,0,0,1,3,,train
0530232_as-0020841.jpg,2,0,0,1,3,,train
0530233_as-0020841.jpg,1,0,0,0,1,,train
0530234_as-0020841.jpg,1,0,0,0,1,,val
0530235_as-0020841.jpg,3,0,0,1,4,,val
0530236_as-0020841.jpg,2,0,0,1,3,,test
0530237_as-0020841.jpg,2,0,0,0,2,,train
0530238_as-0020841.jpg,1,0,0,1,2,,train
0530241_as-3476106.jpg,1,0,0,0,1,,train
0530242_as-2908446.jpg,1,0,2,0,3,,train
0530245_sc-204871.jpg,3,0,0,0,3,,train
0530246_sc-204871.jpg,3,0,0,0,3,,train
0530247_sc-204871.jpg,2,0,0,0,2,,train
0530248_sc-204871.jpg,2,0,0,0,2,,val
0530249_sc-204871.jpg,2,0,0,0,2,,val
0530251_sc-204871.jpg,2,0,0,0,2,,test
0530253_sc-224310.jpg,1,0,1,0,2,,train
0530254_sc-224310.jpg,1,1,1,0,3,,train
0530255_sc-224310.jpg,0,1,1,0,2,,train
0530256_sc-198649.jpg,1,0,1,0,2,,train
0530257_sc-198649.jpg,1,0,1,0,2,,train
0530259_sc-198649.jpg,2,0,0,0,2,,train
0530260_as-0035824.jpg,2,0,0,0,2,,train
0530261_as-0035824.jpg,0,0,0,1,1,,val
0530262_as-0035824.jpg,0,0,0,1,1,,val
0530263_as-0035824.jpg,3,0,0,0,3,,test
0530264_as-0035824.jpg,1,0,0,0,1,,train
0530265_as-0035824.jpg,3,0,0,0,3,,train
0530269_sc-1013236.jpg,3,0,0,0,3,,train
0530270_as-2776897.jpg,3,0,0,1,4,,train
0530271_as-0085156.jpg,1,1,1,0,3,,train
0530273_as-2676521.jpg,1,0,1,0,2,,train
0530274_sc-123198.jpg,2,0,0,0,2,,train
0530275_sc-123198.jpg,3,0,0,0,3,,val
0530276_sc-123198.jpg,4,0,0,0,4,,val
0530277_as-3332822.jpg,2,0,0,0,2,,test
0530278_as-9051172.jpg,2,0,1,0,3,,train
0530279_as-3014162.jpg,2,1,1,0,4,,train
0530280_as-0058459.jpg,5,0,0,0,5,,train
0530281_sc-1019325.jpg,4,0,0,0,4,,train
0530282_sc-181824.jpg,0,1,0,0,1,,train
0530283_as-0078192.jpg,1,0,0,0,1,,train
0530284_as-0078192.jpg,3,0,0,0,3,,train
0530286_as-0078192.jpg,7,0,1,2,10,,val
0530287_as-0078192.jpg,9,0,1,1,11,,val
0530288_as-0078192.jpg,1,0,0,0,1,,test
0530289_as-0064828.jpg,1,0,0,0,1,,train
0530290_as-0064828.jpg,1,0,0,0,1,,train
0530291_as-2974898.jpg,3,0,0,0,3,,train
0530292_as-0056010.jpg,1,0,0,0,1,,train
0530293_sc-137295.jpg,0,1,0,0,1,,train
0530294_sc-137295.jpg,5,1,0,0,6,,train
0530295_sc-208382.jpg,4,0,0,0,4,,train
0530296_sc-208382.jpg,2,2,0,1,5,,val
0530297_sc-208382.jpg,2,0,0,0,2,,val
0530298_sc-208382.jpg,2,0,0,0,2,,test
0530299_sc-208382.jpg,5,0,0,0,5,,train
0530300_sc-205948.jpg,4,0,0,0,4,,train
0530302_sc-205948.jpg,3,0,0,0,3,,train
0530303_as-2967209.jpg,4,0,0,0,4,,train
0530304_as-3223199.jpg,2,0,0,0,2,,train
0530305_as-3217483.jpg,1,0,0,0,1,,train
0530306_as-7827824.jpg,1,1,0,0,2,,train
0530307_sc-120107.jpg,2,0,1,0,3,,val
0530308_sc-120107.jpg,0,0,1,0,1,,val
0530310_as-0052858.jpg,1,1,0,0,2,,test
0530311_as-0052858.jpg,1,1,0,0,2,,train
0530312_as-0052858.jpg,1,2,0,0,3,,train
0530313_as-0052858.jpg,0,3,0,0,3,,train
0530314_as-0052858.jpg,1,2,0,0,3,,train
0530315_as-0052858.jpg,0,1,0,0,1,,train
0530316_as-0052858.jpg,0,1,0,1,2,,train
0530317_as-0052858.jpg,0,1,0,1,2,,train
0530318_as-0052858.jpg,0,0,1,0,1,,val
0530319_as-0052858.jpg,0,1,1,0,2,,val
0530320_as-0052858.jpg,0,1,0,0,1,,test
0530321_as-0052858.jpg,0,1,0,1,2,,train
0530322_as-0052858.jpg,0,1,0,1,2,,train
0530323_as-0052858.jpg,0,0,1,0,1,,train
0530324_sc-1031515.jpg,5,0,0,0,5,,train
0530325_sc-1031515.jpg,4,0,0,0,4,,train
0530326_sc-1031515.jpg,3,0,0,0,3,,train
0530327_sc-1031515.jpg,3,0,0,0,3,,train
0530328_sc-1031515.jpg,4,0,0,0,4,,val
0530329_sc-1017078.jpg,5,1,1,1,8,,val
0530332_as-2730625.jpg,2,0,0,0,2,,test
0530333_sc-1019287.jpg,0,0,2,1,3,,train
0530334_sc-1019287.jpg,0,0,2,2,4,,train
0530335_sc-1019287.jpg,0,0,2,1,3,,train
0530336_sc-1019287.jpg,2,0,4,0,6,,train
0530337_sc-1019287.jpg,4,1,3,0,8,,train
0530338_sc-1019287.jpg,0,0,2,0,2,,train
0530339_as-0050324.jpg,1,0,0,0,1,,train
0530341_as-0050324.jpg,1,0,0,0,1,,val
0530342_as-0050324.jpg,2,0,0,0,2,,val
0530344_as-0050324.jpg,1,0,0,0,1,,test
0530345_as-0050324.jpg,1,0,0,0,1,,train
0530346_as-0050324.jpg,1,0,0,0,1,,train
0530347_as-0050324.jpg,1,0,0,0,1,,train
0530348_as-0050324.jpg,2,0,0,0,2,,train
0530349_as-0050324.jpg,0,1,0,0,1,,train
0530351_as-0050324.jpg,1,0,0,0,1,,train
0530352_as-0050324.jpg,1,0,0,0,1,,train
0530353_as-0050324.jpg,0,0,0,1,1,,val
0530354_sc-1020595.jpg,2,0,0,0,2,,val
0530355_sc-181124.jpg,2,0,0,2,4,,test
0530356_sc-181124.jpg,1,0,0,1,2,,train
0530357_sc-157370.jpg,1,1,0,0,2,,train
0530359_sc-157370.jpg,0,1,0,0,1,,train
0530360_sc-157370.jpg,0,3,0,1,4,,train
0530361_sc-157370.jpg,1,2,1,1,5,,train
0530362_sc-157370.jpg,1,2,1,2,6,,train
0530363_sc-157370.jpg,1,0,0,0,1,,train
0530365_as-0056650.jpg,1,0,0,0,1,,val
0530366_as-0056650.jpg,3,0,0,0,3,,val
0530367_as-0056650.jpg,1,0,0,0,1,,test
0530368_sc-222252.jpg,1,0,1,0,2,,train
0530369_sc-222252.jpg,1,0,1,0,2,,train
0530370_sc-222252.jpg,1,0,1,0,2,,train
0530371_sc-222252.jpg,1,0,1,0,2,,train
0530372_sc-224812.jpg,2,0,0,0,2,,train
0530373_sc-224812.jpg,2,0,0,0,2,,train
0530374_sc-224812.jpg,1,0,0,0,1,,train
0530376_sc-191101.jpg,4,0,0,0,4,,val
0530377_sc-191101.jpg,3,0,0,0,3,,val
0530378_sc-191101.jpg,1,0,0,0,1,,test
0530379_as-0052276.jpg,2,0,0,0,2,,train
0530382_sc-1002428.jpg,0,0,2,0,2,,train
0530383_as-0009154.jpg,3,0,0,0,3,,train
0530384_as-0009154.jpg,1,0,0,0,1,,train
0530386_sc-105847.jpg,2,2,0,0,4,,train
0530387_sc-105847.jpg,1,2,0,0,3,,train
0530388_sc-105847.jpg,0,2,0,0,2,,train
0530389_sc-105847.jpg,0,1,0,0,1,,val
0530390_as-2712522.jpg,5,0,0,0,5,,val
0530392_sc-145612.jpg,1,0,0,0,1,,test
0530393_sc-145612.jpg,1,0,0,0,1,,train
0530394_as-3113632.jpg,1,1,1,1,4,,train
0530396_as-0030450.jpg,2,0,1,0,3,,train
0530398_sc-139628.jpg,2,0,0,0,2,,train
0530400_sc-139628.jpg,2,0,0,0,2,,train
0530401_sc-139628.jpg,5,0,0,0,5,,train
0530402_as-0035805.jpg,2,0,0,0,2,,train
0530403_as-0035805.jpg,1,0,0,0,1,,val
0530404_as-2921369.jpg,1,1,0,0,2,,val
0530405_sc-107339.jpg,1,0,0,0,1,,test
0530406_as-0071399.jpg,1,1,0,0,2,,train
0530407_as-7717689.jpg,1,0,0,1,2,,train
0530409_as-0052954.jpg,1,0,1,0,2,,train
0530410_as-0052954.jpg,1,0,0,0,1,,train
0530411_as-0052954.jpg,1,0,1,0,2,,train
0530412_as-7003672.jpg,2,0,0,0,2,,train
0530413_sc-160202.jpg,2,0,0,0,2,,train
0530414_sc-160202.jpg,2,0,0,0,2,,val
0530415_as-2647524.jpg,3,0,0,0,3,,val
0530418_as-0086099.jpg,9,0,0,0,9,,test
0530419_as-0086099.jpg,5,0,0,0,5,,train
0530421_sc-119035.jpg,1,0,1,1,3,,train
0530422_sc-119035.jpg,1,0,1,1,3,,train
0530423_sc-119035.jpg,1,0,1,1,3,,train
0530424_sc-119035.jpg,1,0,0,0,1,,train
0530425_sc-119035.jpg,1,0,0,0,1,,train
0530426_as-0037166.jpg,3,0,0,0,3,,train
0530427_as-0037166.jpg,0,1,2,1,4,,val
0530428_as-0037166.jpg,1,1,0,0,2,,val
0530430_as-2542232.jpg,2,2,0,1,5,,test
0530431_as-0030506.jpg,1,0,0,0,1,,train
0530432_as-0030506.jpg,1,0,0,0,1,,train
0530433_sc-1023732.jpg,3,0,1,0,4,,train
0530434_sc-1023732.jpg,1,0,0,0,1,,train
0530435_as-0031584.jpg,1,0,2,0,3,,train
0530436_as-0031584.jpg,1,0,0,0,1,,train
0530437_as-0031584.jpg,2,0,0,0,2,,train
0530438_as-0031584.jpg,0,0,1,0,1,,val
0530439_as-0031584.jpg,0,0,1,1,2,,val
0530440_as-0031584.jpg,0,3,2,1,6,,test
0530442_as-0031584.jpg,1,0,0,0,1,,train
0530443_as-0031584.jpg,1,0,0,0,1,,train
0530447_sc-105905.jpg,2,1,0,0,3,,train
0530448_sc-105905.jpg,2,1,0,0,3,,train
0530450_as-3192288.jpg,0,0,1,0,1,,train
0530451_sc-200847.jpg,3,0,0,0,3,,train
0530452_sc-200847.jpg,1,0,0,0,1,,train
0530453_sc-200847.jpg,2,0,0,0,2,,val
0530454_sc-200847.jpg,0,0,1,0,1,,val
0530455_sc-200847.jpg,0,1,0,0,1,,test
0530457_as-0052017.jpg,3,0,2,0,5,,train
0530458_as-0052017.jpg,3,0,0,0,3,,train
0530460_as-0056066.jpg,5,0,0,0,5,,train
0530461_as-0056066.jpg,4,0,0,0,4,,train
0530462_as-0060543.jpg,1,0,1,0,2,,train
0530463_sc-137725.jpg,2,0,0,1,3,,train
0530464_sc-137725.jpg,3,1,0,1,5,,train
0530465_sc-206855.jpg,1,0,1,0,2,,val
0530466_sc-206855.jpg,1,0,1,0,2,,val
0530467_as-3004668.jpg,1,0,1,0,2,,test
0530468_as-2913070.jpg,4,0,0,1,5,,train
0530469_as-3325034.jpg,5,0,1,0,6,,train
0530470_as-7240803.jpg,5,1,2,1,9,,train
0530472_sc-183847.jpg,3,0,0,0,3,,train
0530474_sc-1038722.jpg,3,0,0,0,3,,train
0530475_sc-1038722.jpg,1,0,0,1,2,,train
0530476_sc-1038722.jpg,1,0,1,0,2,,train
0530479_sc-106121.jpg,3,0,0,0,3,,val
0530481_sc-1041693.jpg,0,0,1,1,2,,val
0530482_as-9077823.jpg,1,0,0,1,2,,test
0530483_sc-168136.jpg,2,0,1,0,3,,train
0530484_sc-168136.jpg,2,0,2,0,4,,train
0530486_as-0030266.jpg,2,0,0,0,2,,train
0530487_as-0030266.jpg,2,0,0,0,2,,train
0530488_as-0030266.jpg,3,0,0,0,3,,train
0530489_as-0030266.jpg,1,0,0,0,1,,train
0530491_sc-171762.jpg,2,1,2,1,6,,train
0530492_sc-171762.jpg,1,2,1,1,5,,val
0530494_sc-147524.jpg,1,0,1,1,3,,val
0530495_sc-147524.jpg,2,0,1,1,4,,test
0530496_sc-147524.jpg,2,0,1,1,4,,train
0530497_as-9001600.jpg,2,1,0,0,3,,train
0530498_sc-1038361.jpg,0,0,2,0,2,,train
0530499_sc-1038361.jpg,2,0,1,0,3,,train
0530502_sc-1038361.jpg,9,0,4,0,13,,train
0530505_as-0027259.jpg,2,0,0,0,2,,train
0530507_as-0096774.jpg,1,3,0,2,6,,train
0530508_as-0096774.jpg,1,3,0,2,6,,val
0530509_sc-204098.jpg,4,0,0,0,4,,val
0530510_sc-153088.jpg,1,0,0,0,1,,test
0530511_sc-192019.jpg,4,0,0,0,4,,train
0530512_sc-210361.jpg,2,1,0,0,3,,train
0530513_sc-210361.jpg,1,0,1,0,2,,train
0530514_as-2863498.jpg,4,0,0,0,4,,train
0530517_as-0027826.jpg,0,2,1,0,3,,train
0530518_as-0027826.jpg,1,0,1,1,3,,train
0530519_as-0027826.jpg,3,0,1,0,4,,train
0530521_as-0027826.jpg,2,1,1,0,4,,val
0530523_sc-1033722.jpg,3,0,0,0,3,,val
0530524_sc-1022071.jpg,1,0,1,1,3,,test
0530527_sc-1022071.jpg,1,0,2,1,4,,train
0530528_sc-1022071.jpg,1,0,0,0,1,,train
0530529_sc-1022071.jpg,2,0,0,0,2,,train
0530530_sc-1022071.jpg,2,0,0,0,2,,train
0530531_sc-1022071.jpg,1,0,1,1,3,,train
0530532_sc-1022071.jpg,2,0,0,0,2,,train
0530533_sc-1022071.jpg,1,0,1,1,3,,train
0530534_sc-1022071.jpg,1,0,0,1,2,,val
0530535_sc-1028102.jpg,5,0,0,0,5,,val
0530536_sc-1028102.jpg,2,0,0,1,3,,test
0530537_sc-165345.jpg,1,0,0,0,1,,train
0530538_sc-165345.jpg,2,0,0,0,2,,train
0530539_sc-165345.jpg,1,0,0,0,1,,train
0530540_sc-165345.jpg,2,0,0,0,2,,train
0530541_sc-165345.jpg,2,0,0,0,2,,train
0530542_sc-165345.jpg,4,0,0,0,4,,train
0530544_sc-165345.jpg,2,0,0,0,2,,train
0530545_sc-165345.jpg,2,0,0,0,2,,val
0530546_sc-165345.jpg,5,0,0,0,5,,val
0530547_sc-165345.jpg,3,0,0,0,3,,test
0530548_sc-165345.jpg,3,0,0,0,3,,train
0530551_as-2779879.jpg,1,0,2,0,3,,train
0530552_as-3246087.jpg,2,0,1,1,4,,train
0530554_as-3393756.jpg,2,0,0,1,3,,train
0530558_as-0084735.jpg,2,2,0,0,4,,train
0530559_as-0084735.jpg,3,2,0,0,5,,train
0530560_as-0084735.jpg,3,1,0,0,4,,train
0530562_sc-1017509.jpg,3,1,1,0,5,,val
0530563_as-2683237.jpg,0,0,2,0,2,,val
0530564_as-0090704.jpg,1,0,0,1,2,,test
0530565_as-0090704.jpg,2,0,0,0,2,,train
0530566_as-0030671.jpg,0,0,1,0,1,,train
0530568_sc-209187.jpg,2,0,0,0,2,,train
0530569_sc-209187.jpg,1,0,1,0,2,,train
0530570_sc-143400.jpg,2,0,1,0,3,,train
0530573_sc-143400.jpg,2,0,1,0,3,,train
0530575_as-0060962.jpg,1,0,1,0,2,,train
0530576_as-0060962.jpg,2,0,1,1,4,,val
0530577_sc-1010221.jpg,1,0,1,0,2,,val
0530578_sc-127530.jpg,1,0,0,1,2,,test
0530579_sc-127530.jpg,1,0,0,1,2,,train
0530580_sc-203179.jpg,3,0,0,0,3,,train
0530583_as-0058859.jpg,11,1,2,0,14,,train
0530584_as-0058859.jpg,6,1,2,0,9,,train
0530585_as-2904918.jpg,1,0,0,0,1,,train
0530587_sc-207512.jpg,2,0,0,0,2,,train
0530588_sc-207512.jpg,1,0,0,0,1,,train
0530589_sc-207512.jpg,0,1,0,0,1,,val
0530590_sc-1019978.jpg,1,0,0,0,1,,val
0530591_sc-1019978.jpg,1,0,0,0,1,,test
0530592_sc-1019978.jpg,1,0,0,0,1,,train
0530593_sc-1019978.jpg,1,0,0,0,1,,train
0530594_sc-1019978.jpg,1,0,0,0,1,,train
0530596_sc-1019978.jpg,2,0,0,0,2,,train
0530598_as-2819024.jpg,2,0,0,0,2,,train
0530601_as-0051325.jpg,3,1,0,1,5,,train
0530602_as-0051325.jpg,1,0,0,1,2,,train
0530606_as-0081068.jpg,1,1,0,0,2,,val
0530607_as-0081068.jpg,1,1,1,0,3,,val
0530609_sc-202537.jpg,1,0,1,0,2,,test
0530610_sc-202537.jpg,1,0,1,0,2,,train
0530611_sc-202537.jpg,1,0,0,0,1,,train
0530612_sc-202537.jpg,1,0,0,0,1,,train
0530613_sc-202537.jpg,1,0,1,1,3,,train
0530614_sc-144870.jpg,2,0,0,1,3,,train
0530615_sc-144870.jpg,2,0,0,0,2,,train
0530616_sc-144870.jpg,2,0,0,0,2,,train
0530617_sc-144870.jpg,2,0,0,0,2,,val
0530618_as-9095746.jpg,2,1,1,1,5,,val
0530619_sc-170348.jpg,1,1,0,0,2,,test
0530626_sc-136333.jpg,1,1,1,1,4,,train
0530627_sc-136333.jpg,2,0,1,1,4,,train
0530628_sc-136333.jpg,3,0,1,1,5,,train
0530629_sc-136333.jpg,1,0,1,1,3,,train
0530630_sc-136333.jpg,2,0,1,1,4,,train
0530631_as-0067571.jpg,2,0,0,0,2,,train
0530632_sc-215877.jpg,2,2,0,1,5,,train
0530633_sc-215877.jpg,4,0,0,0,4,,val
0530634_sc-215877.jpg,4,0,1,0,5,,val
0530635_sc-215877.jpg,5,0,1,1,7,,test
0530636_sc-215877.jpg,1,0,0,0,1,,train
0530637_sc-215877.jpg,1,0,0,0,1,,train
0530638_as-0056612.jpg,4,0,0,0,4,,train
0530639_as-0029690.jpg,0,0,1,0,1,,train
0530641_as-0029690.jpg,0,3,0,1,4,,train
0530642_as-0029690.jpg,0,1,0,1,2,,train
0530643_as-0029690.jpg,0,1,0,1,2,,train
0530644_sc-160586.jpg,1,0,0,0,1,,val
0530645_sc-160586.jpg,4,0,0,0,4,,val
0530646_sc-160586.jpg,1,0,0,0,1,,test
0530647_sc-160586.jpg,1,0,0,0,1,,train
0530648_sc-160586.jpg,1,0,0,0,1,,train
0530649_sc-160586.jpg,1,0,0,0,1,,train
0530650_sc-160586.jpg,3,0,0,0,3,,train
0530651_sc-160586.jpg,5,0,0,0,5,,train
0530652_sc-203962.jpg,1,0,0,0,1,,train
0530653_sc-203962.jpg,2,0,0,0,2,,train
0530654_sc-203962.jpg,2,0,0,0,2,,val
0530657_sc-217474.jpg,2,0,0,1,3,,val
0530658_as-3175772.jpg,1,0,0,0,1,,test
0530659_sc-1035199.jpg,3,0,1,2,6,,train
0530660_sc-1035199.jpg,2,1,3,1,7,,train
0530661_sc-1035199.jpg,3,1,1,2,7,,train
0530662_as-7288342.jpg,1,0,0,0,1,,train
0530663_as-0090270.jpg,0,0,1,0,1,,train
0530664_as-0090270.jpg,0,0,1,0,1,,train
0530665_as-0090270.jpg,0,0,1,0,1,,train
0530666_as-0090270.jpg,0,0,1,0,1,,val
0530667_sc-128270.jpg,2,2,0,0,4,,val
0530668_sc-128270.jpg,3,0,0,0,3,,test
0530671_sc-128270.jpg,12,2,0,0,14,,train
0530672_sc-128270.jpg,7,2,0,0,9,,train
0530673_sc-128270.jpg,1,2,0,0,3,,train
0530674_sc-128270.jpg,1,2,0,0,3,,train
0530675_as-7238186.jpg,1,1,2,0,4,,train
0530676_sc-229911.jpg,6,0,1,1,8,,train
0530677_sc-229911.jpg,3,0,1,1,5,,train
0530678_sc-229911.jpg,5,0,1,1,7,,val
0530679_sc-229911.jpg,4,0,1,1,6,,val
0530680_sc-229911.jpg,3,1,1,1,6,,test
0530681_sc-229911.jpg,8,0,1,0,9,,train
0530683_as-0021192.jpg,1,0,1,0,2,,train
0530686_as-0055719.jpg,3,0,0,0,3,,train
0530687_as-7686029.jpg,3,0,1,1,5,,train
0530688_as-0031365.jpg,1,0,0,0,1,,train
0530689_as-0031365.jpg,1,0,0,0,1,,train
0530690_as-0031365.jpg,2,1,0,0,3,,train
0530691_as-0055387.jpg,3,0,0,1,4,,val
0530694_as-0071963.jpg,1,0,1,1,3,,val
0530695_as-0071963.jpg,1,0,1,1,3,,test
0530696_as-0071963.jpg,1,0,0,1,2,,train
0530697_as-0071963.jpg,1,0,0,0,1,,train
0530701_sc-147575.jpg,3,0,0,0,3,,train
0530702_sc-147575.jpg,1,0,0,0,1,,train
0530703_sc-147575.jpg,3,1,0,0,4,,train
0530704_sc-147575.jpg,5,2,0,0,7,,train
0530705_sc-147575.jpg,1,0,0,0,1,,train
0530706_sc-147575.jpg,2,0,0,0,2,,val
0530707_sc-147575.jpg,2,0,0,0,2,,val
0530708_sc-1028636.jpg,1,0,0,0,1,,test
0530709_as-3049597.jpg,2,0,0,0,2,,train
0530710_as-0083546.jpg,1,0,0,1,2,,train
0530712_as-2757079.jpg,1,1,0,0,2,,train
0530713_as-0084169.jpg,1,0,0,0,1,,train
0530714_sc-197121.jpg,3,0,0,0,3,,train
0530715_sc-197121.jpg,1,0,0,0,1,,train
0530716_sc-1008049.jpg,2,0,0,0,2,,train
0530717_sc-1008049.jpg,5,3,1,1,10,,val
0530718_sc-1008049.jpg,10,3,2,0,15,,val
0530719_sc-174409.jpg,1,0,0,0,1,,test
0530720_sc-174409.jpg,1,0,0,0,1,,train
0530721_sc-174409.jpg,0,0,1,0,1,,train
0530722_sc-174409.jpg,0,0,1,0,1,,train
0530723_sc-174409.jpg,0,0,1,0,1,,train
0530724_as-7546155.jpg,1,2,1,0,4,,train
0530725_as-0072564.jpg,1,0,0,0,1,,train
0530726_as-0072564.jpg,1,0,0,0,1,,train
0530727_as-0072564.jpg,1,0,0,0,1,,val
0530728_as-0031421.jpg,1,1,0,0,2,,val
0530729_as-3482015.jpg,0,0,1,0,1,,test
0530731_sc-1041179.jpg,2,0,0,0,2,,train
0530732_sc-1041179.jpg,1,0,0,0,1,,train
0530734_sc-169002.jpg,3,1,1,0,5,,train
0530735_sc-140000.jpg,1,0,0,0,1,,train
0530736_sc-140000.jpg,4,0,0,1,5,,train
0530738_as-0024708.jpg,1,0,0,0,1,,train
0530740_as-0021612.jpg,3,0,2,1,6,,train
0530741_as-0021612.jpg,1,0,1,0,2,,val
0530742_as-7584509.jpg,2,2,0,0,4,,val
0530744_as-3248908.jpg,2,0,0,0,2,,test
0530745_as-3266575.jpg,2,0,0,0,2,,train
0530746_sc-152657.jpg,6,0,2,0,8,,train
0530747_sc-152657.jpg,3,0,0,0,3,,train
0530748_sc-152657.jpg,2,0,1,0,3,,train
0530749_sc-152657.jpg,1,0,1,0,2,,train
0530750_sc-152657.jpg,1,0,1,0,2,,train
0530751_sc-152657.jpg,1,0,1,0,2,,train
0530752_sc-186721.jpg,3,1,3,1,8,,val
0530753_sc-186721.jpg,4,1,3,1,9,,val
0530755_sc-186721.jpg,2,0,1,1,4,,test
0530759_as-0050648.jpg,1,0,3,1,5,,train
0530760_as-0050648.jpg,1,0,3,1,5,,train
0530761_as-0050648.jpg,2,0,2,1,5,,train
0530762_as-0050648.jpg,1,1,2,1,5,,train
0530763_as-3233728.jpg,3,0,4,1,8,,train
0530764_sc-1011978.jpg,6,3,1,0,10,,train
0530766_sc-1011978.jpg,1,2,0,0,3,,train
0530767_as-0045790.jpg,1,0,0,2,3,,val
0530768_as-0045790.jpg,2,0,0,2,4,,val
0530769_as-0045790.jpg,2,0,0,3,5,,test
0530770_as-0045790.jpg,1,0,0,1,2,,train
0530771_as-0045790.jpg,1,0,0,1,2,,train
0530772_as-0045790.jpg,1,0,0,1,2,,train
0530775_sc-151701.jpg,6,1,0,0,7,,train
0530776_sc-151701.jpg,4,1,0,0,5,,train
0530777_sc-151701.jpg,1,0,1,0,2,,train
0530778_as-9019841.jpg,1,0,0,0,1,,train
0530779_sc-230135.jpg,1,1,2,0,4,,val
0530780_sc-230135.jpg,1,2,3,1,7,,val
0530784_sc-230135.jpg,4,0,0,0,4,,test
0530785_sc-230135.jpg,1,0,0,0,1,,train
0530787_sc-230135.jpg,2,0,0,1,3,,train
0530788_sc-129995.jpg,3,1,0,0,4,,train
0530789_sc-129995.jpg,5,1,0,0,6,,train
0530790_sc-203363.jpg,1,0,1,0,2,,train
0530791_sc-203363.jpg,4,1,1,0,6,,train
0530792_sc-203363.jpg,1,1,1,0,3,,train
0530793_sc-203363.jpg,3,2,1,1,7,,val
0530794_sc-203363.jpg,0,0,1,0,1,,val
0530795_sc-203363.jpg,2,2,1,0,5,,test
0530796_sc-203363.jpg,1,0,0,0,1,,train
0530797_sc-203363.jpg,4,1,2,1,8,,train
0530799_sc-1019024.jpg,8,0,0,0,8,,train
0530800_as-0030709.jpg,4,1,2,0,7,,train
0530801_as-0030709.jpg,1,0,0,0,1,,train
0530802_as-0030709.jpg,1,0,1,0,2,,train
0530803_as-0030709.jpg,0,0,1,0,1,,train
0530804_as-0030709.jpg,0,0,1,0,1,,val
0530805_as-0030709.jpg,3,4,1,2,10,,val
0530807_as-3460596.jpg,1,0,0,0,1,,test
0530808_as-3460596.jpg,1,0,0,0,1,,train
0530809_sc-159109.jpg,0,1,3,0,4,,train
0530810_sc-159109.jpg,3,0,0,0,3,,train
0530813_as-7516137.jpg,5,0,1,0,6,,train
0530816_as-0023352.jpg,1,0,0,0,1,,train
0530817_as-0023352.jpg,1,0,0,0,1,,train
0530818_as-0023352.jpg,1,0,0,0,1,,train
0530819_sc-209492.jpg,1,0,1,0,2,,val
0530820_sc-120138.jpg,1,0,0,1,2,,val
0530821_sc-120138.jpg,2,0,0,1,3,,test
0530822_sc-120138.jpg,3,0,0,0,3,,train
0530823_sc-120138.jpg,1,0,0,0,1,,train
0530824_sc-120138.jpg,2,0,0,1,3,,train
0530825_sc-120138.jpg,1,0,0,0,1,,train
0530826_as-3329582.jpg,2,1,1,0,4,,train
0530827_sc-222361.jpg,2,0,0,0,2,,train
0530828_sc-222361.jpg,2,0,1,0,3,,train
0530829_sc-222361.jpg,1,0,1,0,2,,val
0530830_as-3023524.jpg,0,1,0,0,1,,val
0530831_sc-177709.jpg,3,0,1,1,5,,test
0530832_sc-177709.jpg,1,0,1,3,5,,train
0530833_sc-177709.jpg,1,0,1,3,5,,train
0530834_sc-177709.jpg,1,0,0,0,1,,train
0530835_sc-177709.jpg,1,0,1,2,4,,train
0530836_sc-177709.jpg,1,0,1,1,3,,train
0530837_as-3023130.jpg,1,0,1,0,2,,train
0530838_sc-1015129.jpg,1,0,1,0,2,,train
0530840_sc-1015129.jpg,3,1,1,0,5,,val
0530841_sc-1015129.jpg,9,0,2,0,11,,val
0530842_sc-1015129.jpg,1,0,0,0,1,,test
0530844_as-0005823.jpg,0,0,2,0,2,,train
0530846_sc-1039471.jpg,1,1,0,0,2,,train
0530847_sc-1039471.jpg,2,0,0,0,2,,train
0530848_sc-1039471.jpg,2,0,0,0,2,,train
0530851_sc-137358.jpg,0,0,1,0,1,,train
0530852_sc-137358.jpg,2,0,0,0,2,,train
0530853_sc-137358.jpg,1,0,0,0,1,,train
0530854_sc-137358.jpg,2,0,1,0,3,,val
0530855_sc-137358.jpg,1,0,0,0,1,,val
0530856_sc-137358.jpg,2,0,0,0,2,,test
0530857_as-0022304.jpg,2,0,0,1,3,,train
0530858_as-2576141.jpg,2,0,0,0,2,,train
0530859_sc-152798.jpg,3,0,0,0,3,,train
0530860_sc-152798.jpg,3,0,0,2,5,,train
0530861_as-2989293.jpg,0,0,2,1,3,,train
0530862_as-3385122.jpg,4,0,0,0,4,,train
0530864_sc-228626.jpg,3,0,0,0,3,,train
0530865_sc-228626.jpg,0,0,1,0,1,,val
0530867_as-0028177.jpg,2,0,2,1,5,,val
0530868_as-0028177.jpg,2,0,1,1,4,,test
0530869_as-0028177.jpg,4,0,1,1,6,,train
0530870_as-0028177.jpg,5,0,1,0,6,,train
0530872_as-0028177.jpg,2,0,1,2,5,,train
0530873_sc-156560.jpg,4,0,0,0,4,,train
0530874_as-2571467.jpg,2,0,0,0,2,,train
0530875_as-7178956.jpg,1,1,1,2,5,,train
0530876_sc-196135.jpg,2,0,0,0,2,,train
0530877_sc-196135.jpg,2,0,1,1,4,,val
0530878_sc-196135.jpg,2,1,1,1,5,,val
0530879_as-0082073.jpg,1,0,0,1,2,,test
0530881_sc-187975.jpg,3,0,0,0,3,,train
0530882_sc-187975.jpg,4,0,1,1,6,,train
0530883_sc-187975.jpg,2,0,0,0,2,,train
0530884_sc-187975.jpg,3,1,0,0,4,,train
0530885_sc-187975.jpg,1,0,0,0,1,,train
0530886_sc-187975.jpg,4,0,0,0,4,,train
0530888_sc-187975.jpg,1,0,0,0,1,,train
0530889_sc-187975.jpg,2,0,0,0,2,,val
0530890_as-0032540.jpg,1,0,0,0,1,,val
0530891_sc-1034047.jpg,1,1,2,0,4,,test
0530892_sc-1034047.jpg,1,0,1,0,2,,train
0530893_sc-1034047.jpg,1,0,1,1,3,,train
0530894_sc-129336.jpg,0,0,1,0,1,,train
0530895_sc-129336.jpg,1,0,0,0,1,,train
0530897_as-0049141.jpg,1,0,0,1,2,,train
0530898_as-0049141.jpg,1,0,0,1,2,,train
0530899_as-2689112.jpg,0,1,0,0,1,,train
0530901_as-0012738.jpg,2,0,0,0,2,,val
0530902_as-0012738.jpg,2,0,0,0,2,,val
0530904_as-0043792.jpg,0,0,1,1,2,,test
0530905_as-3303052.jpg,1,0,0,0,1,,train
0530908_sc-1019211.jpg,2,0,1,2,5,,train
0530909_as-2770954.jpg,1,0,0,1,2,,train
0530910_as-7621883.jpg,1,0,0,0,1,,train
0530911_as-7975798.jpg,5,0,0,0,5,,train
0530913_sc-124352.jpg,34,2,2,0,38,,train
0530914_sc-124352.jpg,19,1,2,0,22,,train
0530915_sc-193195.jpg,2,0,0,0,2,,val
0530916_sc-193195.jpg,3,0,1,0,4,,val
0530917_sc-193195.jpg,1,0,0,0,1,,test
0530918_sc-193195.jpg,4,0,1,0,5,,train
0530920_sc-172544.jpg,2,0,0,0,2,,train
0530921_sc-172544.jpg,0,0,0,1,1,,train
0530922_sc-172544.jpg,0,0,0,1,1,,train
0530923_sc-172544.jpg,0,0,0,1,1,,train
0530924_as-2916671.jpg,1,0,1,0,2,,train
0530925_as-3244302.jpg,0,0,1,0,1,,train
0530926_sc-175462.jpg,0,2,1,0,3,,val
0530927_sc-175462.jpg,0,2,1,0,3,,val
0530928_sc-175462.jpg,1,0,1,0,2,,test
0530929_sc-175462.jpg,0,2,1,0,3,,train
0530930_as-0012069.jpg,0,0,0,2,2,,train
0530932_sc-131364.jpg,3,0,0,0,3,,train
0530933_sc-131364.jpg,2,0,0,0,2,,train
0530934_as-2680669.jpg,0,1,0,0,1,,train
0530935_as-3167174.jpg,0,1,0,0,1,,train
0530936_as-3254965.jpg,1,0,0,0,1,,train
0530941_as-3333918.jpg,2,0,0,0,2,,val
0530942_sc-162902.jpg,1,0,0,0,1,,val
0530943_sc-162902.jpg,1,0,0,0,1,,test
0530944_sc-132835.jpg,1,0,0,0,1,,train
0530945_sc-132835.jpg,2,0,3,0,5,,train
0530946_sc-132835.jpg,3,1,1,1,6,,train
0530947_sc-132835.jpg,3,0,1,1,5,,train
0530948_sc-132835.jpg,4,0,1,0,5,,train
0530949_sc-132835.jpg,11,1,1,0,13,,train
0530951_sc-226372.jpg,1,1,0,0,2,,train
0530952_sc-226372.jpg,6,0,0,0,6,,val
0530953_sc-226372.jpg,4,0,0,0,4,,val
0530954_sc-226372.jpg,4,0,0,0,4,,test
0530955_sc-226372.jpg,3,0,1,1,5,,train
0530956_sc-226372.jpg,3,0,1,0,4,,train
0530957_sc-226372.jpg,3,0,1,0,4,,train
0530958_sc-226372.jpg,4,0,0,1,5,,train
0530959_sc-226372.jpg,3,0,0,0,3,,train
0530960_sc-226372.jpg,2,0,0,0,2,,train
0530961_sc-103767.jpg,2,0,0,1,3,,train
0530962_sc-103767.jpg,1,0,0,0,1,,val
0530965_sc-158800.jpg,2,1,0,1,4,,val
0530967_as-0082503.jpg,1,0,0,0,1,,test
0530969_as-0082503.jpg,4,0,0,0,4,,train
0530970_as-0082503.jpg,3,0,0,0,3,,train
0530971_as-0082503.jpg,2,0,0,0,2,,train
0530973_as-0082503.jpg,2,0,0,0,2,,train
0530975_as-0019334.jpg,1,0,0,0,1,,train
0530976_as-0019334.jpg,1,0,0,0,1,,train
0530977_as-0019334.jpg,1,0,0,0,1,,train
0530978_as-7591076.jpg,1,0,0,0,1,,val
0530981_as-0014018.jpg,1,0,0,0,1,,val
0530982_as-0014018.jpg,1,0,0,0,1,,test
0530983_as-0014018.jpg,1,0,0,0,1,,train
0530984_as-0014018.jpg,0,0,1,0,1,,train
0530985_as-0014018.jpg,2,0,0,0,2,,train
0530986_as-0014018.jpg,3,0,0,0,3,,train
0530988_sc-150425.jpg,1,0,0,0,1,,train
0530989_as-2571568.jpg,4,0,3,0,7,,train
0530990_as-0012188.jpg,1,0,0,0,1,,train
0530991_as-0012188.jpg,1,0,0,0,1,,val
0530992_as-0012188.jpg,1,0,0,0,1,,val
0530993_as-0012188.jpg,1,0,0,0,1,,test
0530994_as-0012188.jpg,1,0,0,0,1,,train
0530995_as-2982917.jpg,1,0,0,0,1,,train
0530997_as-2882213.jpg,1,0,0,0,1,,train
0530999_as-0003001.jpg,3,2,0,0,5,,train
0531000_as-0003001.jpg,5,1,1,1,8,,train
0531001_as-3220459.jpg,3,0,0,0,3,,train
0531002_as-0045154.jpg,1,0,0,0,1,,train
0531003_as-7012217.jpg,0,0,2,0,2,,val
0531004_as-0092247.jpg,3,0,0,0,3,,val
0531005_as-0092247.jpg,1,0,3,1,5,,test
0531006_as-0092247.jpg,1,0,2,1,4,,train
0531008_as-0092247.jpg,1,0,4,1,6,,train
0531009_as-0092247.jpg,1,0,3,1,5,,train
0531010_as-0092247.jpg,1,0,1,1,3,,train
0531011_as-0092247.jpg,1,0,0,1,2,,train
0531012_as-0092247.jpg,1,0,0,1,2,,train
0531013_as-0092247.jpg,0,0,0,1,1,,train
0531014_as-3199746.jpg,1,0,0,0,1,,val
0531016_as-2569302.jpg,0,0,1,0,1,,val
0531017_sc-203833.jpg,1,0,0,0,1,,test
0531018_sc-203833.jpg,2,0,1,0,3,,train
0531019_sc-203833.jpg,0,0,1,0,1,,train
0531020_sc-203833.jpg,1,0,0,0,1,,train
0531021_sc-203833.jpg,1,0,0,0,1,,train
0531022_sc-203833.jpg,1,0,2,0,3,,train
0531023_sc-203833.jpg,1,0,0,0,1,,train
0531024_sc-203833.jpg,1,0,0,0,1,,train
0531025_sc-203833.jpg,1,0,0,0,1,,val
0531026_sc-203833.jpg,1,0,0,0,1,,val
0531027_sc-203833.jpg,0,0,3,0,3,,test
0531028_sc-203833.jpg,1,0,0,0,1,,train
0531029_sc-203833.jpg,2,0,0,0,2,,train
0531030_as-2770539.jpg,2,0,0,0,2,,train
0531031_as-0070025.jpg,4,1,0,1,6,,train
0531032_as-0070025.jpg,3,0,0,2,5,,train
0531037_as-0022035.jpg,3,2,3,1,9,,train
0531038_as-0022035.jpg,1,1,2,1,5,,train
0531039_as-0022035.jpg,1,0,1,1,3,,val
0531040_as-0022035.jpg,0,0,1,0,1,,val
0531041_as-0022035.jpg,1,0,0,0,1,,test
0531042_as-0022035.jpg,1,0,1,0,2,,train
0531043_as-3482916.jpg,4,0,0,0,4,,train
0531045_as-0065164.jpg,1,0,0,0,1,,train
0531049_as-0097226.jpg,1,1,0,0,2,,train
0531050_as-0097226.jpg,2,1,0,0,3,,train
0531052_sc-191386.jpg,1,0,0,0,1,,train
0531053_sc-191386.jpg,1,0,0,0,1,,train
0531054_sc-191386.jpg,1,0,0,0,1,,val
0531055_sc-191386.jpg,2,0,1,0,3,,val
0531056_as-0064087.jpg,1,0,1,0,2,,test
0531060_sc-1010139.jpg,1,0,0,0,1,,train
0531061_sc-1010139.jpg,1,1,0,0,2,,train
0531062_sc-1010139.jpg,1,0,1,0,2,,train
0531064_sc-1027494.jpg,1,1,1,0,3,,train
0531065_sc-1014687.jpg,0,0,1,0,1,,train
0531068_sc-1014687.jpg,3,4,4,6,17,,train
0531069_sc-1014687.jpg,1,2,1,3,7,,train
0531070_sc-1014687.jpg,3,1,3,4,11,,val
0531071_sc-155303.jpg,7,0,0,0,7,,val
0531073_sc-155303.jpg,3,0,0,0,3,,test
0531074_sc-204993.jpg,1,0,0,0,1,,train
0531075_as-9092373.jpg,1,0,0,0,1,,train
0531077_as-0074304.jpg,2,0,1,1,4,,train
0531078_as-0074304.jpg,3,0,1,0,4,,train
0531079_as-0074304.jpg,2,0,0,0,2,,train
0531080_sc-225541.jpg,2,0,0,0,2,,train
0531081_as-9062074.jpg,1,0,0,0,1,,train
0531082_as-3110859.jpg,3,0,0,0,3,,val
0531083_sc-229094.jpg,0,4,0,0,4,,val
0531084_sc-229094.jpg,0,1,0,0,1,,test
0531085_as-0084140.jpg,1,1,1,1,4,,train
0531086_as-0084140.jpg,2,1,1,2,6,,train
0531087_as-0084140.jpg,1,0,0,0,1,,train
0531088_as-0084140.jpg,2,1,1,2,6,,train
0531089_as-0084140.jpg,1,0,0,1,2,,train
0531090_as-0084140.jpg,1,0,0,0,1,,train
0531091_as-0084140.jpg,0,1,0,1,2,,train
0531092_as-0084140.jpg,1,0,0,0,1,,val
0531100_sc-1037437.jpg,9,1,0,0,10,,val
0531101_as-0062652.jpg,1,0,0,0,1,,test
0531102_as-0062652.jpg,1,0,0,0,1,,train
0531103_as-0062652.jpg,1,0,0,0,1,,train
0531105_as-0062652.jpg,4,0,0,0,4,,train
0531106_as-0062652.jpg,5,0,0,0,5,,train
0531107_as-0062652.jpg,3,0,0,0,3,,train
0531108_as-0062652.jpg,3,0,0,0,3,,train
0531111_as-0062652.jpg,2,0,0,0,2,,train
0531112_sc-177749.jpg,1,0,1,0,2,,val
0531113_sc-177749.jpg,3,0,0,0,3,,val
0531114_as-2918277.jpg,4,0,0,0,4,,test
0531116_as-7830662.jpg,1,0,0,1,2,,train
0531119_as-0017581.jpg,7,0,0,0,7,,train
0531120_as-0017581.jpg,3,0,0,0,3,,train
0531121_as-0017581.jpg,4,0,0,0,4,,train
0531123_sc-135965.jpg,0,0,1,0,1,,train
0531124_as-7804587.jpg,2,0,1,0,3,,train
0531125_as-2530541.jpg,1,0,0,0,1,,train
0531126_as-2910559.jpg,4,0,1,0,5,,val
0531127_sc-1012112.jpg,1,0,0,0,1,,val
0531128_as-7185003.jpg,1,0,1,1,3,,test
0531129_as-0074570.jpg,7,2,1,1,11,,train
0531130_as-0074570.jpg,4,1,0,0,5,,train
0531131_as-0074570.jpg,3,1,0,0,4,,train
0531132_as-0074570.jpg,1,1,1,0,3,,train
0531133_as-0074570.jpg,4,1,1,0,6,,train
0531134_as-0074570.jpg,3,0,0,0,3,,train
0531135_as-0074570.jpg,5,0,0,0,5,,train
0531136_as-0074570.jpg,6,3,1,0,10,,val
0531137_as-0074570.jpg,3,2,0,0,5,,val
0531139_as-0074570.jpg,6,0,1,0,7,,test
0531140_as-2744610.jpg,5,0,0,0,5,,train
0531143_as-3189358.jpg,2,0,1,1,4,,train
0531145_as-0086187.jpg,6,0,0,1,7,,train
0531146_as-0096379.jpg,2,1,0,0,3,,train
0531147_as-0096379.jpg,2,2,0,0,4,,train
0531148_as-0096379.jpg,1,0,0,0,1,,train
0531149_as-0002964.jpg,7,0,0,2,9,,train
0531150_as-0002964.jpg,3,0,0,0,3,,val
0531151_as-0002964.jpg,3,0,0,0,3,,val
0531152_as-0002964.jpg,9,0,1,0,10,,test
0531153_as-0002964.jpg,7,0,0,1,8,,train
0531154_as-0002964.jpg,2,0,1,0,3,,train
0531155_sc-126153.jpg,1,0,0,0,1,,train
0531156_sc-126153.jpg,0,0,1,0,1,,train
0531157_sc-126153.jpg,0,1,0,0,1,,train
0531158_sc-126153.jpg,1,0,0,0,1,,train
0531159_as-0031788.jpg,6,0,1,0,7,,train
0531160_as-0031788.jpg,2,0,1,0,3,,val
0531161_as-0031788.jpg,2,0,0,0,2,,val
0531162_as-0031788.jpg,3,0,0,0,3,,test
0531164_as-0008787.jpg,1,1,0,0,2,,train
0531165_as-0008787.jpg,1,1,0,0,2,,train
0531166_as-0008787.jpg,0,1,0,0,1,,train
0531167_as-0008787.jpg,2,1,1,0,4,,train
0531171_as-3134940.jpg,0,0,1,0,1,,train
0531172_as-2692442.jpg,2,0,0,0,2,,train
0531173_sc-1007936.jpg,4,0,0,0,4,,train
0531174_sc-1007936.jpg,2,1,1,0,4,,val
0531176_as-0029564.jpg,1,0,1,0,2,,val
0531177_as-0029564.jpg,0,0,1,0,1,,test
0531178_as-0029564.jpg,1,0,0,0,1,,train
0531179_sc-153548.jpg,7,1,0,0,8,,train
0531180_sc-153548.jpg,0,1,0,0,1,,train
0531182_sc-130222.jpg,2,0,0,0,2,,train
0531183_as-3274561.jpg,1,0,2,1,4,,train
0531184_sc-118570.jpg,1,1,0,0,2,,train
0531185_sc-200047.jpg,3,0,0,1,4,,train
0531186_sc-200047.jpg,3,0,0,0,3,,val
0531187_sc-200047.jpg,2,0,0,0,2,,val
0531188_sc-200047.jpg,1,0,0,2,3,,test
0531189_sc-200047.jpg,1,0,0,2,3,,train
0531190_sc-200047.jpg,1,0,0,0,1,,train
0531191_sc-200047.jpg,1,0,0,0,1,,train
0531192_sc-200047.jpg,1,0,0,0,1,,train
0531193_sc-200047.jpg,1,0,0,0,1,,train
0531194_sc-200047.jpg,3,0,0,0,3,,train
0531195_as-3233397.jpg,1,0,0,0,1,,train
0531196_as-2941521.jpg,3,0,1,1,5,,val
0531200_as-0025829.jpg,2,0,1,0,3,,val
0531201_as-0025829.jpg,3,0,1,0,4,,test
0531202_as-0025829.jpg,3,0,1,0,4,,train
0531203_as-0025829.jpg,3,0,0,0,3,,train
0531204_as-0025829.jpg,5,0,0,0,5,,train
0531206_as-2685812.jpg,0,0,2,0,2,,train
0531207_as-3107294.jpg,2,1,0,0,3,,train
0531208_as-0013972.jpg,1,0,0,0,1,,train
0531209_as-0013972.jpg,1,0,0,0,1,,train
0531210_as-0013972.jpg,2,2,0,0,4,,val
0531211_as-0013972.jpg,3,1,0,0,4,,val
0531212_as-0013972.jpg,1,0,1,0,2,,test
0531213_as-0013972.jpg,2,0,0,0,2,,train
0531214_sc-183731.jpg,2,0,0,1,3,,train
0531215_sc-183731.jpg,2,0,0,1,3,,train
0531217_as-2751262.jpg,0,1,0,0,1,,train
0531218_sc-194046.jpg,1,0,0,0,1,,train
0531220_sc-194046.jpg,2,0,0,1,3,,train
0531222_as-0001147.jpg,4,0,1,2,7,,train
0531223_as-0001147.jpg,2,0,0,0,2,,val
0531224_sc-188084.jpg,3,0,0,0,3,,val
0531225_sc-188084.jpg,4,1,0,0,5,,test
0531226_sc-188084.jpg,4,0,1,0,5,,train
0531228_as-0099650.jpg,1,0,0,0,1,,train
0531229_as-0099650.jpg,1,1,0,0,2,,train
0531230_sc-221072.jpg,1,0,0,1,2,,train
0531231_sc-221072.jpg,1,0,0,0,1,,train
0531232_sc-221072.jpg,2,0,0,0,2,,train
0531233_sc-221072.jpg,2,0,0,0,2,,train
0531234_sc-221072.jpg,2,0,0,0,2,,val
0531235_sc-221072.jpg,1,0,0,0,1,,val
0531236_sc-221072.jpg,1,0,0,0,1,,test
0531237_sc-221072.jpg,1,0,0,0,1,,train
0531238_sc-221072.jpg,2,0,0,0,2,,train
0531240_sc-108327.jpg,2,0,0,1,3,,train
0531241_sc-151925.jpg,3,0,0,0,3,,train
0531243_sc-151925.jpg,2,0,0,0,2,,train
0531244_sc-151925.jpg,1,0,0,0,1,,train
0531245_sc-229343.jpg,2,1,0,0,3,,train
0531246_sc-229343.jpg,0,1,0,0,1,,val
0531247_sc-229343.jpg,1,0,0,0,1,,val
0531248_sc-229343.jpg,2,0,1,1,4,,test
0531250_sc-1036089.jpg,2,1,0,0,3,,train
0531251_sc-1036089.jpg,4,0,0,0,4,,train
0531252_sc-1036089.jpg,2,1,0,0,3,,train
0531253_sc-1036089.jpg,7,0,0,0,7,,train
0531254_sc-151066.jpg,1,0,0,0,1,,train
0531255_sc-151066.jpg,1,0,0,0,1,,train
0531256_sc-151066.jpg,2,0,0,0,2,,train
0531257_sc-151066.jpg,1,0,0,0,1,,val
0531258_sc-200567.jpg,2,0,0,0,2,,val
0531259_sc-200567.jpg,0,3,1,2,6,,test
0531260_sc-200567.jpg,1,1,0,0,2,,train
0531261_sc-200567.jpg,4,1,1,1,7,,train
0531262_sc-200567.jpg,0,0,1,0,1,,train
0531263_sc-200567.jpg,0,1,0,0,1,,train
0531264_sc-200567.jpg,2,0,0,0,2,,train
0531265_sc-200567.jpg,2,0,0,0,2,,train
0531266_sc-200567.jpg,3,0,0,0,3,,train
0531267_sc-200567.jpg,1,1,1,1,4,,val
0531268_sc-200567.jpg,7,1,2,3,13,,val
0531269_sc-200567.jpg,7,2,2,2,13,,test
0531270_sc-200567.jpg,1,3,1,2,7,,train
0531271_sc-200567.jpg,0,2,0,0,2,,train
0531272_sc-200567.jpg,1,1,0,0,2,,train
0531273_sc-200567.jpg,2,0,1,1,4,,train
0531274_sc-200567.jpg,0,1,1,2,4,,train
0531275_sc-200567.jpg,2,0,0,0,2,,train
0531280_as-0050015.jpg,3,0,1,0,4,,train
0531281_as-0050015.jpg,1,0,1,0,2,,val
0531282_as-0050015.jpg,3,0,1,0,4,,val
0531283_as-3315910.jpg,1,1,1,0,3,,test
0531284_as-2515387.jpg,3,0,0,0,3,,train
0531287_sc-137377.jpg,2,0,0,0,2,,train
0531288_sc-137377.jpg,2,0,0,0,2,,train
0531290_sc-137377.jpg,4,1,1,0,6,,train
0531291_sc-137377.jpg,0,1,2,0,3,,train
0531292_sc-137377.jpg,5,0,1,0,6,,train
0531293_as-2764911.jpg,1,0,0,0,1,,train
0531294_as-7912713.jpg,5,1,0,0,6,,val
0531295_sc-153914.jpg,3,0,1,1,5,,val
0531297_sc-187234.jpg,1,0,0,0,1,,test
0531299_sc-187234.jpg,1,0,0,0,1,,train
0531300_sc-187234.jpg,1,0,0,0,1,,train
0531301_sc-187234.jpg,1,0,0,0,1,,train
0531302_sc-187234.jpg,1,0,0,0,1,,train
0531303_sc-146549.jpg,4,0,0,0,4,,train
0531304_sc-146549.jpg,3,0,0,0,3,,train
0531306_sc-146549.jpg,5,0,0,0,5,,train
0531307_sc-146549.jpg,4,0,0,0,4,,val
0531308_as-0084018.jpg,0,0,1,0,1,,val
0531309_as-0084018.jpg,0,0,1,0,1,,test
0531310_as-0084018.jpg,1,0,1,0,2,,train
0531311_as-0001521.jpg,1,0,0,0,1,,train
0531312_as-7972161.jpg,2,2,0,0,4,,train
0531313_as-0047848.jpg,3,0,1,0,4,,train
0531314_as-0047848.jpg,2,0,1,0,3,,train
0531315_as-0047848.jpg,2,0,1,0,3,,train
0531316_as-0047848.jpg,4,0,0,0,4,,train
0531317_as-0047848.jpg,4,0,0,0,4,,val
0531318_as-0047848.jpg,1,0,1,0,2,,val
0531319_as-0047848.jpg,1,0,1,0,2,,test
0531320_as-0047848.jpg,1,0,1,0,2,,train
0531321_as-0047848.jpg,1,0,1,0,2,,train
0531322_as-0047848.jpg,1,0,1,0,2,,train
0531323_as-0047848.jpg,1,0,1,0,2,,train
0531325_as-3145985.jpg,2,0,0,0,2,,train
0531326_as-2948432.jpg,5,0,0,0,5,,train
0531327_as-2610550.jpg,1,0,0,0,1,,train
0531328_sc-1004070.jpg,5,0,0,2,7,,val
0531329_sc-1004070.jpg,2,0,0,0,2,,val
0531330_sc-1004070.jpg,7,0,0,0,7,,test
0531331_sc-104056.jpg,1,0,0,0,1,,train
0531334_as-3438797.jpg,3,3,1,0,7,,train
0531335_sc-1012427.jpg,10,0,0,1,11,,train
0531336_as-2936176.jpg,1,0,0,0,1,,train
0531337_sc-149939.jpg,1,0,0,0,1,,train
0531338_sc-149939.jpg,1,0,0,0,1,,train
0531339_sc-149939.jpg,1,0,0,0,1,,train
0531340_sc-149939.jpg,1,0,0,0,1,,val
0531343_as-0014271.jpg,1,0,0,0,1,,val
0531344_as-0014271.jpg,1,0,0,0,1,,test
0531345_as-0014271.jpg,1,0,0,0,1,,train
0531346_as-3163683.jpg,1,0,0,1,2,,train
0531351_as-0041184.jpg,1,0,3,0,4,,train
0531353_as-0041184.jpg,5,0,1,0,6,,train
0531354_as-0041184.jpg,0,0,2,0,2,,train
0531356_as-0041184.jpg,0,0,1,0,1,,train
0531357_as-0061433.jpg,1,0,0,0,1,,train
0531358_sc-1005020.jpg,3,1,0,1,5,,val
0531360_as-2809653.jpg,2,0,0,0,2,,val
0531361_sc-115847.jpg,2,1,0,1,4,,test
0531362_sc-115847.jpg,1,1,0,1,3,,train
0531363_sc-1020438.jpg,1,0,0,0,1,,train
0531364_as-2557604.jpg,1,0,0,0,1,,train
0531365_sc-1022160.jpg,2,0,0,0,2,,train
0531367_as-0015258.jpg,2,0,0,0,2,,train
0531368_as-0015258.jpg,3,0,0,0,3,,train
0531369_as-0015258.jpg,1,0,0,0,1,,train
0531370_as-0015258.jpg,3,0,0,0,3,,val
0531371_as-0015258.jpg,1,0,0,0,1,,val
0531372_as-0032212.jpg,5,1,0,0,6,,test
0531373_as-0032212.jpg,2,0,1,2,5,,train
0531374_as-0032212.jpg,7,0,0,2,9,,train
0531375_as-0032212.jpg,3,0,0,0,3,,train
0531376_as-0032212.jpg,4,0,0,0,4,,train
0531377_as-0032212.jpg,8,0,0,0,8,,train
0531379_as-0032212.jpg,4,0,2,1,7,,train
0531381_as-0001752.jpg,3,0,0,1,4,,train
0531382_sc-205704.jpg,0,1,0,0,1,,val
0531383_sc-205704.jpg,0,1,0,0,1,,val
0531384_sc-205704.jpg,0,1,0,0,1,,test
0531385_as-0044666.jpg,3,0,1,0,4,,train
0531386_as-0044666.jpg,3,0,0,0,3,,train
0531387_sc-115205.jpg,1,0,0,2,3,,train
0531388_sc-115205.jpg,3,0,0,2,5,,train
0531389_sc-115205.jpg,1,0,0,1,2,,train
0531390_sc-115205.jpg,3,0,0,2,5,,train
0531391_sc-115205.jpg,4,0,0,2,6,,train
0531392_sc-115205.jpg,7,0,0,0,7,,val
0531393_sc-115205.jpg,4,0,0,0,4,,val
0531394_sc-115205.jpg,2,0,0,0,2,,test
0531396_as-2693636.jpg,1,0,0,0,1,,train
0531399_sc-227967.jpg,2,1,0,0,3,,train
0531400_sc-227967.jpg,3,1,0,0,4,,train
0531401_sc-227967.jpg,3,1,0,0,4,,train
0531402_as-0094972.jpg,1,1,1,0,3,,train
0531403_as-0094972.jpg,1,1,1,0,3,,train
0531404_as-0094972.jpg,1,0,1,0,2,,train
0531405_as-0094972.jpg,1,0,2,0,3,,val
0531407_sc-159390.jpg,3,0,1,0,4,,val
0531408_sc-159390.jpg,11,0,0,0,11,,test
0531409_sc-159390.jpg,8,0,0,0,8,,train
0531410_sc-159390.jpg,1,1,2,0,4,,train
0531411_as-0075758.jpg,5,1,3,0,9,,train
0531412_as-0075758.jpg,1,1,2,0,4,,train
0531413_as-0075758.jpg,3,0,0,0,3,,train
0531414_sc-212465.jpg,2,0,1,0,3,,train
0531415_sc-212465.jpg,1,0,0,0,1,,train
0531416_sc-212465.jpg,1,0,0,0,1,,val
0531417_as-2687058.jpg,2,0,1,0,3,,val
0531418_sc-1002473.jpg,1,0,0,0,1,,test
0531419_sc-1002473.jpg,1,0,0,0,1,,train
0531420_as-0036932.jpg,1,0,0,0,1,,train
0531421_as-0036932.jpg,1,0,0,1,2,,train
0531422_as-0036932.jpg,1,0,0,0,1,,train
0531423_as-0088239.jpg,7,0,1,0,8,,train
0531424_as-0088239.jpg,7,0,1,0,8,,train
0531425_sc-150282.jpg,2,0,0,1,3,,train
0531426_sc-150282.jpg,3,0,0,1,4,,val
0531429_as-0086220.jpg,3,0,0,0,3,,val
0531430_as-0086220.jpg,0,0,2,0,2,,test
0531432_as-2758458.jpg,1,0,0,0,1,,train
0531433_as-2920139.jpg,1,0,0,0,1,,train
0531434_as-3042526.jpg,0,1,2,0,3,,train
0531435_sc-167611.jpg,1,0,0,1,2,,train
0531436_sc-167611.jpg,2,0,0,1,3,,train
0531437_sc-207581.jpg,2,0,0,0,2,,train
0531438_sc-1010169.jpg,1,0,0,0,1,,train
0531440_as-0074083.jpg,2,3,0,0,5,,val
0531441_as-0074083.jpg,2,2,0,0,4,,val
0531444_sc-214166.jpg,1,0,0,0,1,,test
0531445_sc-214166.jpg,1,0,0,0,1,,train
0531446_sc-214166.jpg,1,0,0,0,1,,train
0531447_sc-214166.jpg,1,0,0,0,1,,train
0531448_sc-214166.jpg,1,0,0,0,1,,train
0531449_sc-214166.jpg,1,0,0,0,1,,train
0531450_sc-214166.jpg,1,0,0,0,1,,train
0531452_sc-124978.jpg,1,0,1,0,2,,train
0531454_as-2819525.jpg,1,0,1,0,2,,val
0531455_as-0087476.jpg,6,0,0,0,6,,val
0531460_as-0083825.jpg,1,1,3,0,5,,test
0531461_as-0083825.jpg,1,2,4,0,7,,train
0531462_as-0083825.jpg,1,2,2,1,6,,train
0531463_as-0083825.jpg,2,0,1,1,4,,train
0531464_as-0083825.jpg,1,0,1,2,4,,train
0531465_as-0099764.jpg,3,0,0,0,3,,train
0531467_sc-1012188.jpg,3,2,0,0,5,,train
0531468_sc-1012188.jpg,2,0,1,0,3,,train
0531469_sc-1012188.jpg,0,1,0,0,1,,val
0531470_as-0021642.jpg,2,0,1,1,4,,val
0531473_sc-1018534.jpg,1,0,0,0,1,,test
0531474_sc-1018534.jpg,1,0,0,0,1,,train
0531475_sc-155023.jpg,1,0,0,0,1,,train
0531476_sc-155023.jpg,1,0,0,0,1,,train
0531477_sc-155023.jpg,5,0,0,0,5,,train
0531478_sc-155023.jpg,1,0,0,0,1,,train
0531479_sc-1005978.jpg,1,0,1,0,2,,train
0531480_sc-1005978.jpg,1,0,0,0,1,,train
0531482_sc-1005978.jpg,1,0,0,0,1,,val
0531483_sc-1005978.jpg,1,0,0,0,1,,val
0531484_as-7149248.jpg,0,1,3,3,7,,test
0531485_as-3310517.jpg,2,0,1,0,3,,train
0531486_as-0050310.jpg,0,0,1,0,1,,train
0531487_as-0050310.jpg,0,0,1,0,1,,train
0531489_as-0050310.jpg,1,1,1,1,4,,train
0531490_as-0050310.jpg,1,0,1,1,3,,train
0531491_as-0050310.jpg,1,0,1,1,3,,train
0531492_as-0050310.jpg,1,0,1,1,3,,train
0531494_as-0050310.jpg,1,0,3,1,5,,val
0531497_as-0050310.jpg,1,0,0,0,1,,val
0531498_as-0050310.jpg,1,0,1,1,3,,test
0531499_as-0050310.jpg,1,0,3,1,5,,train
0531500_as-0050310.jpg,1,0,1,0,2,,train
0531501_as-0050310.jpg,1,0,1,1,3,,train
0531502_as-0050310.jpg,1,0,0,0,1,,train
0531503_as-0050310.jpg,0,0,1,0,1,,train
0531504_as-0050310.jpg,1,0,0,0,1,,train
0531505_as-0050310.jpg,2,0,1,0,3,,train
0531507_sc-109763.jpg,0,0,1,0,1,,val
0531513_as-0034508.jpg,5,0,0,0,5,,val
0531514_as-0034508.jpg,3,0,0,0,3,,test
0531516_as-0034508.jpg,0,1,0,1,2,,train
0531519_as-0022610.jpg,2,0,0,0,2,,train
0531522_as-0095469.jpg,1,1,0,2,4,,train
0531523_as-0095469.jpg,0,1,0,1,2,,train
0531525_as-9056957.jpg,1,0,0,0,1,,train
0531529_as-3462391.jpg,1,1,0,0,2,,train
0531530_sc-106719.jpg,4,0,0,0,4,,train
0531531_sc-106719.jpg,2,0,0,0,2,,val
0531533_sc-106719.jpg,1,0,0,0,1,,val
0531534_sc-106719.jpg,3,0,0,0,3,,test
0531535_sc-106719.jpg,1,0,0,0,1,,train
0531536_sc-106719.jpg,1,0,1,0,2,,train
0531537_as-2807834.jpg,1,0,0,1,2,,train
0531538_as-7284114.jpg,1,0,0,0,1,,train
0531539_as-2561418.jpg,0,1,0,0,1,,train
0531540_sc-118438.jpg,2,0,0,1,3,,train
0531541_sc-118438.jpg,6,0,1,1,8,,train
0531542_sc-118438.jpg,4,0,0,1,5,,val
0531543_sc-118438.jpg,1,0,0,0,1,,val
0531544_sc-118438.jpg,2,0,0,1,3,,test
0531545_sc-118438.jpg,7,0,0,0,7,,train
0531546_sc-118438.jpg,1,0,1,0,2,,train
0531547_as-3129166.jpg,1,1,1,0,3,,train
0531549_sc-225054.jpg,5,0,0,0,5,,train
0531550_sc-225054.jpg,5,0,0,0,5,,train
0531551_as-3270133.jpg,1,0,2,0,3,,train
0531552_sc-1041255.jpg,1,0,0,0,1,,train
0531553_sc-1041255.jpg,4,0,0,0,4,,val
0531554_sc-1041255.jpg,1,0,0,0,1,,val
0531555_sc-1041255.jpg,4,0,0,0,4,,test
0531558_sc-119551.jpg,3,0,1,0,4,,train
0531559_sc-119551.jpg,2,0,0,0,2,,train
0531560_sc-1037410.jpg,1,0,0,0,1,,train
0531561_sc-1037410.jpg,1,0,0,0,1,,train
0531562_sc-1037410.jpg,1,0,0,1,2,,train
0531563_as-3464936.jpg,1,0,0,0,1,,train
0531564_as-2827139.jpg,2,0,0,0,2,,train
0531565_sc-155705.jpg,8,0,0,0,8,,val
0531566_sc-1028887.jpg,2,0,0,0,2,,val
0531567_sc-1028887.jpg,3,0,0,0,3,,test
0531568_as-0000500.jpg,1,0,0,0,1,,train
0531569_as-0000500.jpg,1,0,0,0,1,,train
0531570_as-5092463.jpg,1,0,1,0,2,,train
0531575_sc-1035542.jpg,1,0,1,0,2,,train
0531576_sc-1035542.jpg,2,0,1,1,4,,train
0531577_as-3328425.jpg,1,0,0,0,1,,train
0531578_as-0062829.jpg,5,0,0,0,5,,train
0531579_sc-176400.jpg,2,0,0,0,2,,val
0531580_sc-176400.jpg,2,0,0,0,2,,val
0531581_sc-1028981.jpg,1,0,0,0,1,,test
0531584_sc-1028981.jpg,3,0,2,0,5,,train
0531586_sc-1028981.jpg,4,0,1,0,5,,train
0531588_sc-1028981.jpg,5,0,2,0,7,,train
0531589_sc-1001065.jpg,0,0,0,1,1,,train
0531590_sc-1001065.jpg,0,0,0,1,1,,train
0531591_sc-223890.jpg,1,0,1,0,2,,train
0531592_as-0006903.jpg,0,1,0,0,1,,train
0531593_as-0006903.jpg,1,1,0,0,2,,val
0531594_as-0006903.jpg,1,2,0,0,3,,val
0531595_as-0006903.jpg,3,2,0,0,5,,test
0531596_as-0006903.jpg,0,1,0,0,1,,train
0531597_as-0044239.jpg,1,0,0,0,1,,train
0531598_as-2519107.jpg,2,0,0,0,2,,train
0531599_as-2811596.jpg,2,0,0,0,2,,train
0531600_as-0079678.jpg,1,0,1,1,3,,train
0531601_as-0079678.jpg,1,0,1,0,2,,train
0531602_sc-161638.jpg,0,1,0,0,1,,train
0531603_as-0009169.jpg,1,0,0,1,2,,val
0531604_sc-208584.jpg,0,1,0,0,1,,val
0531607_sc-183052.jpg,2,2,0,0,4,,test
0531608_sc-183052.jpg,2,1,0,0,3,,train
0531611_sc-112620.jpg,1,0,0,0,1,,train
0531612_as-0037221.jpg,1,0,1,0,2,,train
0531613_as-9011329.jpg,3,0,0,0,3,,train
0531614_as-0011647.jpg,1,0,0,0,1,,train
0531615_sc-202842.jpg,2,0,0,0,2,,train
0531616_sc-202842.jpg,4,0,0,0,4,,train
0531617_as-0024692.jpg,0,1,0,0,1,,val
0531618_as-0024692.jpg,0,1,0,0,1,,val
0531619_as-0024692.jpg,0,2,0,0,2,,test
0531620_as-0024692.jpg,1,1,1,0,3,,train
0531621_as-9041173.jpg,1,0,0,0,1,,train
0531622_as-2588949.jpg,3,0,0,0,3,,train
0531623_sc-208946.jpg,8,1,7,0,16,,train
0531624_sc-228181.jpg,0,1,0,0,1,,train
0531628_as-0083672.jpg,1,1,1,0,3,,train
0531629_as-0083672.jpg,0,2,1,0,3,,train
0531630_as-0083672.jpg,1,1,3,0,5,,val
0531631_sc-229729.jpg,4,1,0,0,5,,val
0531632_sc-229729.jpg,5,0,0,0,5,,test
0531633_as-0012060.jpg,2,0,0,0,2,,train
0531634_as-0012060.jpg,2,0,0,0,2,,train
0531635_as-0012060.jpg,2,0,0,0,2,,train
0531636_as-0012060.jpg,3,0,0,0,3,,train
0531637_sc-159277.jpg,4,0,0,0,4,,train
0531638_sc-159277.jpg,3,0,0,1,4,,train
0531639_sc-159277.jpg,2,0,0,1,3,,train
0531640_sc-159277.jpg,5,0,0,0,5,,val
0531641_sc-158767.jpg,1,0,0,0,1,,val
0531642_sc-158767.jpg,2,0,0,0,2,,test
0531643_sc-158767.jpg,1,0,0,0,1,,train
0531644_sc-158767.jpg,1,0,0,0,1,,train
0531645_sc-158767.jpg,0,0,0,1,1,,train
0531646_as-7225581.jpg,1,0,2,1,4,,train
0531647_sc-1005816.jpg,3,0,0,0,3,,train
0531648_sc-1005816.jpg,2,0,0,0,2,,train
0531649_sc-1005816.jpg,2,0,0,0,2,,train
0531650_as-0020762.jpg,1,0,1,0,2,,val
0531651_as-0020762.jpg,1,1,1,0,3,,val
0531653_sc-1001827.jpg,1,0,0,0,1,,test
0531654_sc-1001827.jpg,1,0,0,0,1,,train
0531655_sc-1001827.jpg,1,0,0,0,1,,train
0531656_as-2594915.jpg,6,1,0,1,8,,train
0531657_as-7556407.jpg,3,0,0,0,3,,train
0531658_sc-211176.jpg,2,0,0,1,3,,train
0531659_sc-211176.jpg,8,0,0,1,9,,train
0531660_as-0034813.jpg,2,0,1,0,3,,train
0531661_as-0034813.jpg,3,0,1,1,5,,val
0531662_as-0034813.jpg,8,0,1,1,10,,val
0531664_as-0034813.jpg,5,0,1,1,7,,test
0531666_as-0030785.jpg,1,0,1,0,2,,train
0531667_as-0030785.jpg,2,0,1,0,3,,train
0531668_as-0008204.jpg,3,1,0,0,4,,train
0531669_as-7909593.jpg,1,0,0,0,1,,train
0531670_as-2681493.jpg,1,0,0,0,1,,train
0531671_sc-1039279.jpg,1,0,0,0,1,,train
0531672_sc-1039279.jpg,1,0,0,0,1,,train
0531673_sc-1039279.jpg,1,0,1,1,3,,val
0531674_sc-1015154.jpg,1,0,0,1,2,,val
0531675_sc-1015154.jpg,1,0,0,1,2,,test
0531676_sc-1015154.jpg,5,0,0,2,7,,train
0531677_sc-1015154.jpg,1,0,0,2,3,,train
0531678_sc-1015154.jpg,1,0,0,1,2,,train
0531679_sc-1015154.jpg,1,0,0,2,3,,train
0531680_sc-1015154.jpg,1,0,0,1,2,,train
0531681_sc-1015154.jpg,1,0,0,1,2,,train
0531683_sc-139112.jpg,2,0,0,1,3,,train
0531687_as-0078394.jpg,1,1,1,1,4,,val
0531688_as-0078394.jpg,1,0,1,1,3,,val
0531689_as-3067422.jpg,0,1,2,2,5,,test
0531690_as-2699372.jpg,1,0,0,0,1,,train
0531691_sc-114677.jpg,0,1,0,0,1,,train
0531692_as-3478325.jpg,2,0,0,0,2,,train
0531693_sc-1005157.jpg,1,2,0,5,8,,train
0531694_sc-1005157.jpg,4,0,0,3,7,,train
0531695_sc-1005157.jpg,4,3,0,3,10,,train
0531696_sc-1005157.jpg,5,1,2,2,10,,train
0531697_as-2835242.jpg,1,0,0,0,1,,val
0531698_as-2623106.jpg,2,0,0,0,2,,val
0531699_as-9072902.jpg,3,0,0,0,3,,test
0531700_as-3295242.jpg,1,0,0,0,1,,train
0531701_as-2954746.jpg,0,2,0,0,2,,train
0531702_sc-173910.jpg,5,1,0,0,6,,train
0531703_sc-173910.jpg,2,0,0,0,2,,train
0531706_as-0092942.jpg,1,2,0,0,3,,train
0531708_as-0092942.jpg,1,0,0,0,1,,train
0531709_as-0092942.jpg,1,0,0,0,1,,train
0531710_as-3074490.jpg,1,0,1,1,3,,val
0531711_as-7769439.jpg,0,0,2,0,2,,val
0531712_as-0030418.jpg,1,0,0,0,1,,test
0531713_as-0030418.jpg,1,0,0,2,3,,train
0531714_sc-184936.jpg,1,0,1,0,2,,train
0531716_sc-184936.jpg,1,0,1,1,3,,train
0531717_sc-184936.jpg,2,0,1,1,4,,train
0531718_sc-184936.jpg,2,1,1,1,5,,train
0531719_sc-184936.jpg,3,0,1,1,5,,train
0531722_as-2874677.jpg,1,0,1,1,3,,train
0531723_sc-192222.jpg,2,0,0,0,2,,val
0531724_sc-192222.jpg,1,0,0,0,1,,val
0531725_sc-192222.jpg,1,0,0,0,1,,test
0531726_sc-192222.jpg,1,0,0,0,1,,train
0531727_sc-192222.jpg,2,0,0,0,2,,train
0531728_sc-192222.jpg,2,0,0,0,2,,train
0531731_sc-192222.jpg,3,0,0,1,4,,train
0531732_sc-192222.jpg,2,0,0,0,2,,train
0531733_sc-192222.jpg,3,0,0,1,4,,train
0531734_sc-192222.jpg,4,0,0,0,4,,train
0531735_sc-192222.jpg,1,0,0,0,1,,val
0531736_sc-192222.jpg,1,0,0,1,2,,val
0531737_sc-192222.jpg,2,0,1,0,3,,test
0531738_sc-197858.jpg,1,0,0,1,2,,train
0531739_sc-197858.jpg,4,0,1,1,6,,train
0531740_sc-197858.jpg,1,0,1,1,3,,train
0531741_sc-197858.jpg,1,0,1,1,3,,train
0531742_sc-197858.jpg,5,0,1,1,7,,train
0531743_sc-197858.jpg,3,1,0,0,4,,train
0531744_sc-197858.jpg,2,1,0,0,3,,train
0531745_sc-122098.jpg,1,0,0,0,1,,val
0531746_sc-157820.jpg,2,0,1,1,4,,val
0531748_sc-157820.jpg,2,0,1,1,4,,test
0531749_sc-157820.jpg,1,0,0,0,1,,train
0531750_sc-157820.jpg,1,0,0,1,2,,train
0531751_sc-157820.jpg,1,0,0,0,1,,train
0531752_sc-157820.jpg,1,0,0,0,1,,train
0531753_sc-157820.jpg,3,0,1,0,4,,train
0531754_sc-157820.jpg,2,0,1,0,3,,train
0531756_sc-144267.jpg,0,0,0,1,1,,train
0531757_sc-144267.jpg,5,0,0,1,6,,val
0531758_sc-144267.jpg,3,0,0,1,4,,val
0531759_sc-144267.jpg,3,0,0,1,4,,test
0531760_as-0094277.jpg,2,2,2,0,6,,train
0531761_sc-134049.jpg,1,0,0,0,1,,train
0531762_sc-134049.jpg,1,0,1,0,2,,train
0531763_sc-122430.jpg,1,0,1,0,2,,train
0531764_sc-122430.jpg,2,0,0,1,3,,train
0531765_sc-122430.jpg,3,0,0,0,3,,train
0531768_sc-194924.jpg,0,1,0,0,1,,train
0531771_sc-184784.jpg,0,1,0,0,1,,val
0531772_as-0030825.jpg,1,0,0,0,1,,val
0531773_as-0030825.jpg,1,0,0,0,1,,test
0531774_as-0030825.jpg,1,0,0,0,1,,train
0531776_sc-103852.jpg,3,0,0,0,3,,train
0531777_sc-103852.jpg,3,0,0,0,3,,train
0531778_sc-103852.jpg,2,0,0,1,3,,train
0531779_as-2577507.jpg,1,2,0,0,3,,train
0531780_as-0022644.jpg,3,0,0,0,3,,train
0531781_sc-186580.jpg,3,0,0,0,3,,train
0531783_sc-186580.jpg,3,0,1,0,4,,val
0531785_as-0075441.jpg,6,2,0,0,8,,val
0531786_as-0075441.jpg,5,2,1,0,8,,test
0531790_as-0054400.jpg,4,0,0,0,4,,train
0531791_as-0054400.jpg,1,0,0,1,2,,train
0531792_as-0083157.jpg,2,0,0,1,3,,train
0531793_as-0083157.jpg,3,1,0,0,4,,train
0531794_as-0083157.jpg,4,3,1,0,8,,train
0531795_as-0083157.jpg,2,2,1,0,5,,train
0531796_as-0083157.jpg,1,1,1,0,3,,train
0531797_as-0083157.jpg,0,0,1,0,1,,val
0531798_as-0083157.jpg,1,0,0,0,1,,val
0531799_as-0083157.jpg,2,0,0,1,3,,test
0531800_as-0083157.jpg,1,0,1,0,2,,train
0531801_as-7705619.jpg,1,0,0,0,1,,train
0531802_as-3028437.jpg,3,0,0,0,3,,train
0531807_as-0083049.jpg,2,1,3,0,6,,train
0531808_as-0083049.jpg,1,0,2,0,3,,train
0531809_as-0083049.jpg,3,0,3,0,6,,train
0531810_as-7269354.jpg,1,0,2,0,3,,train
0531813_as-0027024.jpg,1,0,0,0,1,,val
0531816_as-2502889.jpg,0,0,1,0,1,,val
0531817_sc-216117.jpg,0,1,0,0,1,,test
0531818_as-0061531.jpg,1,0,0,0,1,,train
0531819_as-0061531.jpg,1,0,0,0,1,,train
0531820_as-0061531.jpg,2,0,0,0,2,,train
0531821_as-0061531.jpg,2,0,0,0,2,,train
0531822_as-0061531.jpg,1,0,0,0,1,,train
0531823_as-0061531.jpg,2,0,0,0,2,,train
0531824_as-0061531.jpg,2,0,0,0,2,,train
0531825_as-0061531.jpg,1,0,0,0,1,,val
0531826_as-0061531.jpg,0,1,1,0,2,,val
0531827_as-2710425.jpg,2,0,0,0,2,,test
0531828_sc-114513.jpg,2,0,1,0,3,,train
0531829_sc-114513.jpg,1,0,1,0,2,,train
0531830_sc-114513.jpg,2,0,0,0,2,,train
0531831_as-2680152.jpg,0,0,1,0,1,,train
0531832_as-7069137.jpg,0,0,0,1,1,,train
0531833_sc-180985.jpg,2,0,1,0,3,,train
0531834_sc-180985.jpg,2,0,0,0,2,,train
0531835_as-0001924.jpg,4,0,0,0,4,,val
0531836_as-0001924.jpg,4,0,0,0,4,,val
0531837_as-0001924.jpg,8,0,0,0,8,,test
0531838_sc-182572.jpg,2,0,1,0,3,,train
0531839_sc-182572.jpg,4,0,0,0,4,,train
0531840_sc-182572.jpg,1,0,0,0,1,,train
0531841_sc-182572.jpg,1,0,0,0,1,,train
0531842_sc-1039682.jpg,0,0,2,0,2,,train
0531843_sc-1039682.jpg,0,0,2,0,2,,train
0531844_as-0002912.jpg,2,0,0,0,2,,train
0531845_as-0002912.jpg,2,0,0,0,2,,val
0531846_as-0002912.jpg,2,0,0,0,2,,val
0531847_sc-122558.jpg,1,1,0,0,2,,test
0531848_sc-122558.jpg,1,0,1,0,2,,train
0531849_sc-122558.jpg,1,0,0,0,1,,train
0531850_sc-122558.jpg,1,0,0,1,2,,train
0531851_sc-1033235.jpg,7,1,0,0,8,,train
0531853_sc-1033235.jpg,10,0,1,0,11,,train
0531854_as-3154712.jpg,2,0,1,0,3,,train
0531855_sc-1005899.jpg,2,0,0,0,2,,train
0531856_sc-197103.jpg,2,0,0,2,4,,val
0531857_as-7646388.jpg,1,0,1,1,3,,val
0531860_as-0091945.jpg,1,0,1,1,3,,test
0531861_as-0091945.jpg,1,0,0,0,1,,train
0531862_as-0091945.jpg,1,0,1,0,2,,train
0531863_as-0091945.jpg,1,0,0,0,1,,train
0531864_as-0091945.jpg,1,0,0,0,1,,train
0531865_as-0091945.jpg,1,0,1,1,3,,train
0531867_as-0091945.jpg,1,0,0,0,1,,train
0531868_as-0091945.jpg,1,0,0,0,1,,train
0531869_as-0091945.jpg,2,0,0,0,2,,val
0531870_as-0091945.jpg,1,0,0,0,1,,val
0531872_as-0022737.jpg,1,0,1,0,2,,test
0531873_as-0022737.jpg,1,0,1,0,2,,train
0531875_sc-227878.jpg,1,1,1,0,3,,train
0531876_as-7517794.jpg,2,0,1,0,3,,train
0531878_as-0051028.jpg,0,2,1,0,3,,train
0531881_as-0051028.jpg,0,1,0,4,5,,train
0531882_as-0050631.jpg,1,0,0,1,2,,train
0531883_as-0030795.jpg,2,0,0,0,2,,train
0531884_as-0030795.jpg,2,0,0,1,3,,val
0531887_as-0075778.jpg,1,1,0,0,2,,val
0531888_as-0075778.jpg,1,0,1,1,3,,test
0531889_as-0075778.jpg,0,0,1,0,1,,train
0531890_as-0075778.jpg,0,0,2,0,2,,train
0531891_sc-1024234.jpg,0,0,1,0,1,,train
0531893_sc-1024234.jpg,4,0,1,0,5,,train
0531894_sc-108455.jpg,0,1,2,0,3,,train
0531895_sc-108455.jpg,1,1,0,0,2,,train
0531897_sc-108455.jpg,1,0,1,0,2,,train
0531898_as-9028722.jpg,1,0,0,0,1,,val
0531899_as-3427667.jpg,4,0,2,0,6,,val
0531901_as-0046252.jpg,1,0,0,0,1,,test
0531902_as-0046252.jpg,1,0,0,0,1,,train
0531903_as-0046252.jpg,1,0,0,0,1,,train
0531904_as-0008477.jpg,1,0,0,0,1,,train
0531905_as-0008477.jpg,4,2,1,1,8,,train
0531906_as-0008477.jpg,4,2,1,0,7,,train
0531907_as-0008477.jpg,2,0,0,0,2,,train
0531908_as-0008477.jpg,2,1,1,1,5,,train
0531909_as-0008477.jpg,3,1,1,0,5,,val
0531910_as-0008477.jpg,4,2,1,1,8,,val
0531911_as-0008477.jpg,2,1,1,0,4,,test
0531912_as-0008477.jpg,2,1,1,0,4,,train
0531913_as-0008477.jpg,6,1,1,1,9,,train
0531914_as-0008477.jpg,1,0,0,1,2,,train
0531916_as-0008477.jpg,1,1,0,0,2,,train
0531917_as-0008477.jpg,1,0,0,1,2,,train
0531918_as-0008477.jpg,1,0,0,0,1,,train
0531919_as-0008477.jpg,1,0,0,1,2,,train
0531922_sc-190886.jpg,4,0,0,0,4,,val
0531923_sc-225974.jpg,4,1,1,1,7,,val
0531924_sc-225974.jpg,3,0,0,0,3,,test
0531925_as-7618876.jpg,1,0,0,0,1,,train
0531926_sc-1032482.jpg,1,0,0,0,1,,train
0531927_sc-1032482.jpg,1,0,0,0,1,,train
0531929_as-0034801.jpg,1,0,0,0,1,,train
0531930_as-0034801.jpg,0,1,0,0,1,,train
0531931_as-0034801.jpg,1,2,0,0,3,,train
0531934_sc-204652.jpg,1,0,0,0,1,,train
0531935_sc-204652.jpg,2,0,0,0,2,,val
0531936_sc-204652.jpg,1,0,0,0,1,,val
0531937_sc-204652.jpg,2,0,0,0,2,,test
0531938_sc-123504.jpg,1,0,1,1,3,,train
0531939_sc-123504.jpg,2,0,1,1,4,,train
0531940_sc-123504.jpg,2,0,1,1,4,,train
0531941_sc-123504.jpg,1,0,1,1,3,,train
0531943_sc-1018376.jpg,4,0,0,0,4,,train
0531944_sc-1018376.jpg,4,0,0,0,4,,train
0531946_as-0039852.jpg,1,0,0,0,1,,train
0531947_as-0039852.jpg,2,0,0,0,2,,val
0531948_sc-103580.jpg,1,0,0,0,1,,val
0531949_sc-103580.jpg,1,0,0,0,1,,test
0531950_sc-103580.jpg,2,0,0,0,2,,train
0531952_sc-1002430.jpg,2,1,0,0,3,,train
0531954_sc-183630.jpg,1,0,1,0,2,,train
0531955_as-3488300.jpg,2,0,0,0,2,,train
0531957_as-0046246.jpg,2,0,0,0,2,,train
0531958_as-0046246.jpg,1,0,0,0,1,,train
0531959_as-0046246.jpg,2,0,0,0,2,,train
0531960_as-0046246.jpg,1,0,0,0,1,,val
0531961_as-0046246.jpg,2,0,0,0,2,,val
0531962_as-9054680.jpg,1,0,1,0,2,,test
0531964_as-0012068.jpg,0,1,1,0,2,,train
0531966_as-0012068.jpg,1,3,0,0,4,,train
0531967_as-0012068.jpg,1,2,0,0,3,,train
0531968_as-0012068.jpg,1,1,0,0,2,,train
0531969_as-0093366.jpg,1,0,0,1,2,,train
0531970_as-0093366.jpg,1,0,0,1,2,,train
0531972_as-0064401.jpg,1,0,0,1,2,,train
0531973_as-0064401.jpg,1,0,0,1,2,,val
0531974_sc-1027101.jpg,1,0,0,0,1,,val
0531975_sc-1027101.jpg,1,0,0,0,1,,test
0531976_sc-1027101.jpg,0,0,0,1,1,,train
0531978_as-0059917.jpg,2,0,0,0,2,,train
0531981_as-0012379.jpg,1,0,0,0,1,,train
0531982_as-0012379.jpg,2,0,1,0,3,,train
0531983_as-0012379.jpg,2,0,0,0,2,,train
0531984_as-0012379.jpg,0,1,0,0,1,,train
0531987_sc-224496.jpg,1,0,0,0,1,,train
0531988_as-2799440.jpg,3,1,0,0,4,,val
0531989_sc-223185.jpg,3,0,0,0,3,,val
0531990_sc-223185.jpg,1,0,0,0,1,,test
0531991_sc-223185.jpg,1,0,1,1,3,,train
0531992_sc-223185.jpg,1,0,0,0,1,,train
0531993_sc-223185.jpg,1,0,0,1,2,,train
0531994_sc-223185.jpg,1,0,0,0,1,,train
0531995_as-0006551.jpg,2,2,1,2,7,,train
0531996_as-0006551.jpg,1,3,0,2,6,,train
0531997_sc-150956.jpg,2,0,0,0,2,,train
0531999_sc-1037282.jpg,3,0,0,0,3,,val
0532000_sc-1037282.jpg,6,0,1,5,12,,val
0532001_sc-1037282.jpg,9,0,1,5,15,,test
0532002_sc-1037282.jpg,8,0,1,0,9,,train
0532003_sc-1037282.jpg,6,0,0,1,7,,train
0532004_as-0022891.jpg,1,0,0,0,1,,train
0532007_as-3442824.jpg,2,0,0,0,2,,train
0532008_sc-177293.jpg,1,0,0,0,1,,train
0532009_sc-177293.jpg,1,0,0,0,1,,train
0532010_as-2627443.jpg,1,0,0,0,1,,train
0532012_as-0073500.jpg,1,0,0,0,1,,val
0532013_as-0073500.jpg,2,0,0,0,2,,val
0532015_sc-173412.jpg,2,0,1,0,3,,test
0532017_as-0047383.jpg,1,0,1,1,3,,train
0532018_as-0047383.jpg,1,0,1,1,3,,train
0532019_as-0047383.jpg,1,0,1,2,4,,train
0532020_as-0047383.jpg,1,0,1,1,3,,train
0532021_as-0047383.jpg,1,0,1,2,4,,train
0532022_as-0047383.jpg,1,0,1,2,4,,train
0532023_as-0047383.jpg,2,0,1,2,5,,train
0532024_as-0047383.jpg,1,0,1,2,4,,val
0532025_as-0047383.jpg,1,0,1,1,3,,val
0532026_sc-217187.jpg,4,0,1,3,8,,test
0532027_sc-217187.jpg,6,0,0,0,6,,train
0532028_sc-217187.jpg,6,0,0,0,6,,train
0532029_sc-217187.jpg,5,0,0,2,7,,train
0532030_sc-217187.jpg,4,0,0,2,6,,train
0532031_sc-217187.jpg,4,0,0,2,6,,train
0532032_sc-217187.jpg,2,0,0,1,3,,train
0532033_as-0087868.jpg,1,0,0,0,1,,train
0532034_as-0087868.jpg,3,0,0,1,4,,val
0532035_as-0087868.jpg,1,0,0,1,2,,val
0532038_as-0077580.jpg,5,1,0,0,6,,test
0532039_as-3417115.jpg,0,0,2,0,2,,train
0532040_sc-186857.jpg,4,1,2,0,7,,train
0532041_sc-186857.jpg,3,1,1,0,5,,train
0532042_sc-186857.jpg,2,3,2,0,7,,train
0532043_sc-186857.jpg,2,1,1,0,4,,train
0532044_sc-1041018.jpg,1,0,0,1,2,,train
0532045_sc-1041018.jpg,1,0,0,1,2,,train
0532046_sc-1041018.jpg,1,0,0,1,2,,val
0532047_sc-207307.jpg,3,0,2,0,5,,val
0532048_sc-207307.jpg,4,0,0,0,4,,test
0532049_sc-207307.jpg,2,0,0,0,2,,train
0532050_as-3265742.jpg,0,1,0,0,1,,train
0532051_as-2550636.jpg,1,0,0,0,1,,train
0532052_as-7006581.jpg,1,0,0,0,1,,train
0532053_sc-132818.jpg,4,1,1,1,7,,train
0532054_sc-132818.jpg,7,1,1,1,10,,train
0532055_sc-132818.jpg,3,1,0,0,4,,train
0532059_sc-1024713.jpg,1,0,1,0,2,,val
0532060_sc-1024713.jpg,1,0,1,0,2,,val
0532061_as-7540225.jpg,1,0,1,0,2,,test
0532062_as-2501943.jpg,1,0,1,0,2,,train
0532063_as-0080126.jpg,0,1,1,1,3,,train
0532064_as-0080126.jpg,0,1,3,1,5,,train
0532065_as-0080126.jpg,1,1,2,2,6,,train
0532066_as-0080126.jpg,1,1,2,1,5,,train
0532069_as-0080126.jpg,0,0,4,1,5,,train
0532070_as-0080126.jpg,1,0,2,1,4,,train
0532072_sc-1017731.jpg,3,1,0,0,4,,val
0532074_sc-161303.jpg,2,0,0,0,2,,val
0532075_sc-161303.jpg,1,0,0,0,1,,test
0532076_as-3151706.jpg,3,0,0,0,3,,train
0532077_as-3091672.jpg,1,0,0,0,1,,train
0532078_sc-207612.jpg,0,1,2,2,5,,train
0532079_sc-207612.jpg,1,2,0,0,3,,train
0532080_sc-207612.jpg,0,0,1,0,1,,train
0532081_sc-207612.jpg,0,0,1,0,1,,train
0532082_sc-207612.jpg,0,1,3,2,6,,train
0532083_as-0029958.jpg,1,1,0,0,2,,val
0532084_as-0029958.jpg,5,0,0,0,5,,val
0532085_as-0029958.jpg,1,0,0,0,1,,test
0532086_as-0029958.jpg,5,0,1,0,6,,train
0532087_as-0029958.jpg,4,0,1,0,5,,train
0532088_as-3072273.jpg,1,0,0,0,1,,train
0532089_as-7227143.jpg,2,0,1,0,3,,train
0532090_as-7988290.jpg,1,0,0,0,1,,train
0532091_as-2566285.jpg,1,0,0,1,2,,train
0532092_as-3378574.jpg,1,0,0,1,2,,train
0532093_sc-1032033.jpg,1,0,1,0,2,,val
0532094_sc-1032033.jpg,1,0,1,0,2,,val
0532098_as-0040333.jpg,1,0,1,1,3,,test
0532103_sc-167246.jpg,1,1,0,0,2,,train
0532104_sc-167246.jpg,2,1,0,0,3,,train
0532105_sc-1033677.jpg,3,0,0,0,3,,train
0532106_sc-1033677.jpg,3,0,0,1,4,,train
0532107_sc-1033677.jpg,2,0,0,1,3,,train
0532109_sc-1033677.jpg,1,0,0,0,1,,train
0532110_sc-1033677.jpg,2,0,0,0,2,,train
0532111_sc-1033677.jpg,2,0,0,0,2,,val
0532112_as-9020955.jpg,2,1,0,1,4,,val
0532113_sc-1013691.jpg,2,0,0,0,2,,test
0532114_sc-1013691.jpg,2,0,0,0,2,,train
0532116_sc-191980.jpg,2,1,1,0,4,,train
0532117_sc-191980.jpg,1,0,0,0,1,,train
0532119_sc-191980.jpg,1,1,2,0,4,,train
0532121_sc-1037572.jpg,4,0,0,0,4,,train
0532122_sc-1037572.jpg,3,0,0,0,3,,train
0532127_sc-1001023.jpg,1,0,0,0,1,,train
0532128_sc-1001023.jpg,5,0,0,1,6,,val
0532129_sc-1001023.jpg,2,0,0,0,2,,val
0532130_sc-1001023.jpg,3,0,0,0,3,,test
0532131_sc-1001023.jpg,1,0,0,0,1,,train
0532133_as-2710490.jpg,1,1,0,0,2,,train
0532134_as-7110041.jpg,1,0,0,1,2,,train
0532135_as-7288377.jpg,1,1,2,0,4,,train
0532136_as-0015714.jpg,0,0,0,1,1,,train
0532137_as-0015714.jpg,0,0,0,1,1,,train
0532138_as-0015714.jpg,1,0,1,0,2,,train
0532139_as-0015714.jpg,0,0,0,1,1,,val
0532140_as-2787800.jpg,1,0,1,0,2,,val
0532141_as-0021981.jpg,1,0,0,1,2,,test
0532142_as-0021981.jpg,3,0,1,1,5,,train
0532143_as-0021981.jpg,3,0,0,1,4,,train
0532145_sc-1004367.jpg,2,0,0,0,2,,train
0532146_sc-1004367.jpg,2,2,0,0,4,,train
0532147_sc-1004367.jpg,3,1,0,0,4,,train
0532148_sc-1004367.jpg,1,0,0,0,1,,train
0532149_sc-1004367.jpg,3,0,1,0,4,,train
0532150_as-3169340.jpg,2,0,1,2,5,,val
0532151_as-0047025.jpg,1,0,0,0,1,,val
0532152_as-0047025.jpg,1,0,0,0,1,,test
0532153_sc-170427.jpg,3,0,1,1,5,,train
0532154_sc-1008237.jpg,0,1,0,0,1,,train
0532155_sc-1008237.jpg,0,1,0,0,1,,train
0532156_sc-1008237.jpg,1,1,1,0,3,,train
0532157_sc-1008237.jpg,3,1,1,0,5,,train
0532158_sc-191216.jpg,1,0,0,1,2,,train
0532159_sc-191216.jpg,1,0,0,2,3,,train
0532160_sc-181808.jpg,5,0,0,2,7,,val
0532161_sc-181808.jpg,2,0,0,3,5,,val
0532162_sc-181808.jpg,4,0,0,2,6,,test
0532163_sc-181808.jpg,2,0,0,2,4,,train
0532164_sc-181808.jpg,2,0,0,1,3,,train
0532166_sc-150840.jpg,3,0,0,0,3,,train
0532167_sc-150840.jpg,3,0,0,0,3,,train
0532168_sc-127634.jpg,4,0,0,0,4,,train
0532169_sc-127634.jpg,3,0,0,0,3,,train
0532170_sc-131678.jpg,3,0,0,0,3,,train
0532171_sc-131678.jpg,3,0,0,0,3,,val
0532172_sc-115716.jpg,0,3,0,1,4,,val
0532173_as-2515577.jpg,5,1,0,0,6,,test
0532174_as-3250872.jpg,2,1,1,0,4,,train
0532175_as-0064795.jpg,2,0,0,0,2,,train
0532176_as-0064795.jpg,1,0,0,0,1,,train
0532178_as-0064795.jpg,2,0,0,1,3,,train
0532179_sc-1016450.jpg,3,1,2,1,7,,train
0532180_sc-1016450.jpg,1,2,0,1,4,,train
0532181_sc-1016450.jpg,0,0,2,0,2,,train
0532182_sc-1030165.jpg,0,1,0,0,1,,val
0532184_sc-1014790.jpg,1,0,1,0,2,,val
0532185_sc-1014790.jpg,1,0,0,0,1,,test
0532186_sc-1014790.jpg,1,0,1,0,2,,train
0532187_as-0088672.jpg,1,0,0,0,1,,train
0532189_as-0010038.jpg,0,0,0,1,1,,train
0532190_as-0010038.jpg,0,0,0,1,1,,train
0532191_as-0010038.jpg,0,0,0,1,1,,train
0532194_as-0010038.jpg,0,0,0,1,1,,train
0532195_sc-1016382.jpg,4,0,2,0,6,,train
0532196_sc-1016382.jpg,5,0,2,1,8,,val
0532197_as-0034712.jpg,1,1,0,0,2,,val
0532198_as-0034712.jpg,3,0,0,0,3,,test
0532199_as-0084109.jpg,1,0,0,0,1,,train
0532200_as-0084109.jpg,2,0,0,1,3,,train
0532201_as-0084109.jpg,1,0,0,1,2,,train
0532202_sc-103348.jpg,3,0,0,2,5,,train
0532206_as-0085772.jpg,0,0,1,0,1,,train
0532207_as-0030033.jpg,1,0,0,0,1,,train
0532208_as-0030033.jpg,1,0,0,0,1,,train
0532209_as-0030033.jpg,2,0,1,2,5,,val
0532210_as-0081340.jpg,1,0,2,0,3,,val
0532213_as-4777989.jpg,1,0,1,1,3,,test
0532214_as-2523242.jpg,2,0,0,0,2,,train
0532215_as-2523242.jpg,1,0,0,0,1,,train
0532216_as-3242561.jpg,1,0,0,0,1,,train
0532218_sc-179846.jpg,1,0,1,0,2,,train
0532220_sc-179846.jpg,2,1,1,0,4,,train
0532221_sc-179846.jpg,2,1,2,0,5,,train
0532222_sc-179846.jpg,2,1,2,0,5,,train
0532223_sc-179846.jpg,1,0,1,0,2,,val
0532224_sc-179846.jpg,1,1,1,0,3,,val
0532225_sc-179846.jpg,1,1,0,0,2,,test
0532226_as-0085298.jpg,1,0,1,0,2,,train
0532227_as-0085298.jpg,3,0,1,0,4,,train
0532230_as-0094665.jpg,1,0,0,0,1,,train
0532231_as-0005019.jpg,0,1,2,0,3,,train
0532232_as-0005019.jpg,0,0,1,0,1,,train
0532233_as-0005019.jpg,4,0,3,0,7,,train
0532234_as-0005019.jpg,5,0,1,0,6,,train
0532235_as-0005019.jpg,4,0,0,0,4,,val
0532236_as-0005019.jpg,4,0,1,0,5,,val
0532237_as-3085296.jpg,8,0,0,1,9,,test
0532238_sc-1007900.jpg,1,0,0,0,1,,train
0532239_sc-1007900.jpg,2,0,0,1,3,,train
0532240_sc-1007900.jpg,1,0,0,1,2,,train
0532241_sc-1007900.jpg,1,0,0,1,2,,train
0532242_as-0092772.jpg,1,0,0,0,1,,train
0532243_as-0092772.jpg,1,0,0,0,1,,train
0532244_as-0092772.jpg,1,0,0,0,1,,train
0532245_as-0092772.jpg,0,0,0,1,1,,val
0532246_as-0092772.jpg,1,0,0,0,1,,val
0532249_as-0092772.jpg,2,0,2,1,5,,test
0532250_as-0092772.jpg,2,0,2,1,5,,train
0532251_as-0092772.jpg,2,0,1,0,3,,train
0532252_as-0092772.jpg,1,0,1,0,2,,train
0532253_as-0092772.jpg,2,0,1,0,3,,train
0532254_as-0092772.jpg,1,0,1,0,2,,train
0532255_as-2718945.jpg,1,0,0,0,1,,train
0532256_sc-1007034.jpg,3,2,1,0,6,,train
0532258_as-0034154.jpg,1,0,0,0,1,,val
0532259_as-0034154.jpg,1,0,0,0,1,,val
0532260_as-0034154.jpg,0,1,1,0,2,,test
0532262_sc-178218.jpg,1,0,0,0,1,,train
0532263_sc-178218.jpg,2,1,0,0,3,,train
0532266_as-0099545.jpg,2,0,0,0,2,,train
0532267_sc-192018.jpg,1,0,0,0,1,,train
0532269_sc-135317.jpg,1,0,1,0,2,,train
0532270_sc-135317.jpg,2,1,2,1,6,,train
0532271_sc-135317.jpg,4,1,1,1,7,,train
0532272_as-3004781.jpg,3,0,0,0,3,,val
0532275_sc-124816.jpg,2,0,0,0,2,,val
0532278_sc-124816.jpg,0,0,1,0,1,,test
0532279_sc-124816.jpg,3,0,0,0,3,,train
0532281_sc-124816.jpg,2,0,1,0,3,,train
0532283_as-0064873.jpg,1,0,0,0,1,,train
0532285_as-0064873.jpg,2,0,0,0,2,,train
0532287_as-0064873.jpg,0,0,0,1,1,,train
0532289_as-0030317.jpg,2,0,0,0,2,,train
0532290_as-0030317.jpg,1,0,0,0,1,,train
0532291_as-2942870.jpg,2,1,0,0,3,,val
0532292_as-9077861.jpg,3,0,0,0,3,,val
0532295_sc-106389.jpg,1,0,0,0,1,,test
0532296_as-7807306.jpg,4,0,0,0,4,,train
0532297_sc-117187.jpg,0,1,0,0,1,,train
0532298_sc-116711.jpg,2,0,0,0,2,,train
0532299_sc-116711.jpg,5,0,1,0,6,,train
0532300_as-0017861.jpg,2,0,0,0,2,,train
0532301_as-0017861.jpg,2,0,0,0,2,,train
0532302_as-0017861.jpg,1,0,0,0,1,,train
0532303_as-2883483.jpg,1,0,0,0,1,,val
0532304_as-3341291.jpg,3,2,2,1,8,,val
0532305_sc-1021183.jpg,0,1,0,1,2,,test
0532306_sc-1021183.jpg,1,2,0,1,4,,train
0532307_sc-1007099.jpg,0,1,0,0,1,,train
0532308_sc-1007099.jpg,0,1,0,0,1,,train
0532309_as-9064945.jpg,2,0,1,2,5,,train
0532312_as-0084801.jpg,0,1,2,0,3,,train
0532313_as-0084801.jpg,2,3,5,0,10,,train
0532314_as-0084801.jpg,1,1,2,0,4,,train
0532315_as-0084801.jpg,1,0,4,0,5,,val
0532316_as-0084801.jpg,1,0,1,0,2,,val
0532317_as-2657897.jpg,1,0,0,0,1,,test
0532318_as-3172451.jpg,1,0,0,0,1,,train
0532320_sc-199567.jpg,1,1,1,1,4,,train
0532321_sc-199567.jpg,2,1,2,2,7,,train
0532322_sc-199567.jpg,3,1,2,1,7,,train
0532323_sc-199567.jpg,3,1,0,2,6,,train
0532324_sc-199567.jpg,1,1,0,1,3,,train
0532325_sc-199567.jpg,2,1,0,1,4,,train
0532326_sc-199567.jpg,3,0,1,1,5,,val
0532327_sc-199567.jpg,2,0,1,0,3,,val
0532328_sc-199567.jpg,1,0,1,0,2,,test
0532329_sc-199567.jpg,3,0,1,0,4,,train
0532330_sc-199567.jpg,1,0,1,0,2,,train
0532331_sc-199567.jpg,1,0,1,0,2,,train
0532332_sc-199567.jpg,3,0,1,0,4,,train
0532333_sc-199567.jpg,3,0,1,0,4,,train
0532334_sc-199567.jpg,1,0,0,0,1,,train
0532336_sc-199567.jpg,4,0,0,0,4,,train
0532337_sc-1028933.jpg,0,0,1,0,1,,val
0532338_sc-1028933.jpg,0,0,1,0,1,,val
0532340_as-0042277.jpg,1,0,0,0,1,,test
0532341_as-0042277.jpg,1,0,0,0,1,,train
0532343_as-0042277.jpg,1,0,0,0,1,,train
0532344_as-0042277.jpg,2,0,0,0,2,,train
0532345_as-0042277.jpg,2,0,0,0,2,,train
0532346_sc-161643.jpg,0,0,2,0,2,,train
0532347_as-7674221.jpg,8,0,1,0,9,,train
0532348_as-0014437.jpg,1,0,0,0,1,,train
0532349_as-0014437.jpg,3,0,0,0,3,,val
0532351_as-0060548.jpg,2,0,0,0,2,,val
0532353_as-0060548.jpg,2,0,1,0,3,,test
0532354_as-0060548.jpg,3,1,0,0,4,,train
0532355_as-0060548.jpg,1,0,0,0,1,,train
0532356_sc-1031664.jpg,0,0,1,1,2,,train
0532357_as-0028845.jpg,2,0,1,0,3,,train
0532358_as-0028845.jpg,0,0,1,1,2,,train
0532359_sc-128857.jpg,1,0,0,1,2,,train
0532360_sc-128857.jpg,1,0,0,1,2,,train
0532361_sc-128857.jpg,1,0,0,1,2,,val
0532364_as-0079966.jpg,3,1,4,1,9,,val
0532365_as-0079966.jpg,6,1,1,1,9,,test
0532366_as-0079966.jpg,1,0,1,0,2,,train
0532367_as-0079966.jpg,3,0,0,0,3,,train
0532369_as-0079966.jpg,1,0,0,0,1,,train
0532370_as-0001454.jpg,1,1,0,0,2,,train
0532372_as-0047381.jpg,2,1,0,3,6,,train
0532373_as-2896344.jpg,2,0,1,0,3,,train
0532374_as-0094272.jpg,0,1,1,0,2,,train
0532375_as-2893146.jpg,0,1,0,0,1,,val
0532376_as-2893146.jpg,1,0,0,0,1,,val
0532377_sc-132716.jpg,1,0,0,0,1,,test
0532378_as-3121988.jpg,2,0,0,0,2,,train
0532379_as-2960738.jpg,2,2,2,0,6,,train
0532380_as-0092696.jpg,2,0,0,0,2,,train
0532381_as-0092696.jpg,1,0,0,0,1,,train
0532382_as-0092696.jpg,2,0,0,0,2,,train
0532383_as-0092696.jpg,2,0,0,0,2,,train
0532384_as-0092696.jpg,1,0,0,0,1,,train
0532385_as-0092696.jpg,1,0,0,0,1,,val
0532386_as-0092696.jpg,1,0,0,0,1,,val
0532387_as-0092696.jpg,1,0,0,0,1,,test
0532388_as-0092696.jpg,1,0,0,0,1,,train
0532389_as-2951477.jpg,3,5,2,0,10,,train
0532391_as-3372270.jpg,1,0,0,1,2,,train
0532393_as-7175120.jpg,2,0,1,2,5,,train
0532394_sc-201344.jpg,7,0,1,2,10,,train
0532396_as-0071430.jpg,3,0,2,1,6,,train
0532397_as-0071430.jpg,2,0,1,1,4,,train
0532398_as-0071430.jpg,3,0,1,1,5,,val
0532399_as-0071430.jpg,3,0,0,0,3,,val
0532400_as-2657009.jpg,1,0,1,0,2,,test
0532401_as-3167131.jpg,2,0,0,0,2,,train
0532402_as-0001295.jpg,10,0,0,0,10,,train
0532404_sc-205969.jpg,4,0,1,1,6,,train
0532405_sc-205969.jpg,2,0,0,0,2,,train
0532406_sc-205969.jpg,5,1,0,0,6,,train
0532407_sc-205969.jpg,1,0,1,1,3,,train
0532408_sc-205969.jpg,1,0,1,1,3,,train
0532409_sc-205969.jpg,2,0,1,1,4,,val
0532411_as-2599035.jpg,1,0,0,1,2,,val
0532414_as-0085400.jpg,1,0,0,1,2,,test
0532416_as-0085400.jpg,2,0,0,0,2,,train
0532417_as-0085400.jpg,1,0,1,0,2,,train
0532419_as-0085400.jpg,1,0,0,1,2,,train
0532421_as-0083320.jpg,7,0,0,0,7,,train
0532422_sc-193627.jpg,1,0,0,0,1,,train
0532423_sc-193627.jpg,1,0,0,0,1,,train
0532424_sc-193627.jpg,1,0,1,1,3,,train
0532425_sc-193627.jpg,2,0,1,1,4,,val
0532426_sc-193627.jpg,1,0,0,0,1,,val
0532427_as-0052657.jpg,1,0,0,0,1,,test
0532428_as-0052657.jpg,3,0,0,0,3,,train
0532429_as-0052657.jpg,5,0,0,0,5,,train
0532430_sc-226413.jpg,2,0,0,0,2,,train
0532431_sc-1005935.jpg,7,3,2,1,13,,train
0532432_sc-1015581.jpg,1,0,0,0,1,,train
0532433_sc-1015581.jpg,1,0,0,0,1,,train
0532434_sc-206004.jpg,2,0,0,0,2,,train
0532435_sc-206004.jpg,3,0,0,0,3,,val
0532436_sc-206004.jpg,3,0,0,0,3,,val
0532437_sc-206004.jpg,1,0,0,0,1,,test
0532438_sc-206004.jpg,1,0,0,0,1,,train
0532439_sc-152695.jpg,0,0,1,0,1,,train
0532440_sc-152695.jpg,4,0,1,0,5,,train
0532441_sc-152695.jpg,4,0,1,0,5,,train
0532442_sc-152695.jpg,2,0,1,0,3,,train
0532444_as-0016600.jpg,3,1,0,0,4,,train
0532446_as-3274818.jpg,0,0,6,0,6,,train
0532447_as-0087263.jpg,1,0,1,0,2,,val
0532448_as-0093352.jpg,1,0,0,0,1,,val
0532449_as-0093352.jpg,1,0,0,0,1,,test
0532452_sc-222908.jpg,1,0,0,0,1,,train
0532453_sc-222908.jpg,2,0,0,0,2,,train
0532454_sc-222908.jpg,2,0,0,0,2,,train
0532455_sc-222908.jpg,1,0,0,0,1,,train
0532456_sc-196994.jpg,2,1,0,0,3,,train
0532457_sc-196994.jpg,1,0,0,0,1,,train
0532458_as-0007956.jpg,1,0,1,0,2,,train
0532459_as-0007956.jpg,1,0,0,0,1,,val
0532460_as-0007956.jpg,1,0,0,0,1,,val
0532461_as-0007956.jpg,1,0,0,0,1,,test
0532462_as-0007956.jpg,2,0,0,1,3,,train
0532463_as-0007956.jpg,1,0,0,1,2,,train
0532464_as-0007956.jpg,2,0,1,0,3,,train
0532465_as-0007956.jpg,1,0,1,0,2,,train
0532466_as-3101839.jpg,3,0,2,1,6,,train
0532467_as-0085326.jpg,0,0,1,0,1,,train
0532468_as-0085326.jpg,0,0,1,0,1,,train
0532469_as-0085326.jpg,0,0,1,0,1,,val
0532470_as-0085326.jpg,0,1,0,0,1,,val
0532471_as-0085326.jpg,0,0,1,0,1,,test
0532472_as-3143923.jpg,1,0,0,2,3,,train
0532473_sc-1031557.jpg,5,0,0,0,5,,train
0532474_sc-1031557.jpg,2,0,0,0,2,,train
0532475_sc-1031557.jpg,4,0,0,0,4,,train
0532476_sc-1031557.jpg,1,0,0,0,1,,train
0532477_sc-123666.jpg,2,1,0,0,3,,train
0532478_sc-123666.jpg,6,0,0,0,6,,train
0532479_sc-123666.jpg,2,2,0,0,4,,val
0532480_sc-123666.jpg,2,5,0,0,7,,val
0532481_sc-123666.jpg,2,1,0,0,3,,test
0532482_sc-211416.jpg,6,0,0,0,6,,train
0532483_sc-211416.jpg,5,0,0,0,5,,train
0532484_sc-211416.jpg,6,0,0,0,6,,train
0532485_sc-211416.jpg,6,0,0,0,6,,train
0532486_as-2822112.jpg,1,0,1,1,3,,train
0532487_as-2733681.jpg,2,0,0,0,2,,train
0532488_sc-226713.jpg,1,0,0,0,1,,train
0532489_sc-226713.jpg,1,0,0,0,1,,val
0532490_sc-226713.jpg,1,0,0,0,1,,val
0532491_sc-226713.jpg,2,0,0,0,2,,test
0532492_sc-226713.jpg,2,1,1,0,4,,train
0532493_sc-226713.jpg,1,1,1,0,3,,train
0532494_as-3093601.jpg,2,0,0,0,2,,train
0532495_sc-146746.jpg,1,0,0,0,1,,train
0532496_sc-146746.jpg,1,0,0,0,1,,train
0532497_as-0029597.jpg,2,0,1,0,3,,train
0532498_as-0029597.jpg,2,0,1,0,3,,train
0532500_as-0078592.jpg,0,2,0,0,2,,val
0532501_as-0078592.jpg,0,0,1,0,1,,val
0532503_as-0078592.jpg,3,1,2,0,6,,test
0532504_as-0078592.jpg,0,2,2,0,4,,train
0532505_sc-143010.jpg,1,0,0,0,1,,train
0532506_sc-143010.jpg,1,0,0,1,2,,train
0532508_sc-119547.jpg,2,0,0,0,2,,train
0532509_sc-119547.jpg,1,0,0,0,1,,train
0532510_sc-119547.jpg,2,0,0,2,4,,train
0532511_sc-119547.jpg,4,0,0,2,6,,train
0532512_sc-119547.jpg,1,0,0,0,1,,val
0532513_sc-119547.jpg,5,0,0,2,7,,val
0532514_sc-119547.jpg,4,0,0,3,7,,test
0532515_sc-119547.jpg,1,0,0,0,1,,train
0532516_sc-119547.jpg,1,0,1,0,2,,train
0532517_sc-119547.jpg,3,0,0,1,4,,train
0532518_sc-119547.jpg,1,0,0,0,1,,train
0532521_as-0097832.jpg,7,0,1,0,8,,train
0532522_as-0097832.jpg,9,0,0,0,9,,train
0532523_as-3050903.jpg,6,0,1,0,7,,train
0532524_as-7873671.jpg,2,0,0,0,2,,val
0532525_as-2583557.jpg,1,0,1,0,2,,val
0532526_sc-205351.jpg,1,0,2,0,3,,test
0532527_sc-205351.jpg,2,0,0,0,2,,train
0532528_sc-226949.jpg,1,4,4,1,10,,train
0532529_sc-226949.jpg,2,2,1,0,5,,train
0532530_sc-226949.jpg,2,2,1,0,5,,train
0532531_sc-226949.jpg,1,3,5,1,10,,train
0532532_sc-226949.jpg,2,2,2,0,6,,train
0532533_as-3454307.jpg,1,0,1,0,2,,train
0532534_sc-141406.jpg,0,1,0,0,1,,val
0532535_sc-141406.jpg,0,1,0,0,1,,val
0532537_as-0026912.jpg,2,1,1,0,4,,test
0532539_as-0026912.jpg,3,1,0,0,4,,train
0532540_as-0026912.jpg,3,0,0,0,3,,train
0532541_as-9085825.jpg,5,1,2,1,9,,train
0532542_sc-1028519.jpg,1,0,0,0,1,,train
0532543_sc-1028519.jpg,2,0,0,1,3,,train
0532544_sc-1028519.jpg,4,0,0,0,4,,train
0532545_sc-1028519.jpg,1,0,0,1,2,,train
0532546_sc-1028519.jpg,1,0,0,1,2,,val
0532547_as-0016574.jpg,8,1,1,0,10,,val
0532548_as-0016574.jpg,2,0,0,0,2,,test
0532549_as-0016574.jpg,10,0,0,0,10,,train
0532550_as-0016574.jpg,8,1,0,0,9,,train
0532551_as-0016574.jpg,1,1,1,0,3,,train
0532552_as-0016574.jpg,4,0,1,0,5,,train
0532553_as-0043647.jpg,1,3,0,0,4,,train
0532560_as-0092845.jpg,0,0,1,0,1,,train
0532562_as-0092845.jpg,0,1,1,0,2,,train
0532564_as-2862136.jpg,5,0,2,1,8,,val
0532565_as-2735132.jpg,2,0,0,0,2,,val
0532566_as-3350620.jpg,1,0,0,0,1,,test
0532568_as-0005983.jpg,6,0,3,1,10,,train
0532569_as-0005983.jpg,2,4,1,0,7,,train
0532570_as-0005983.jpg,1,0,1,0,2,,train
0532571_as-0005983.jpg,0,0,1,0,1,,train
0532572_as-0005983.jpg,1,0,1,0,2,,train
0532573_as-0005983.jpg,1,0,2,1,4,,train
0532574_sc-167017.jpg,4,0,1,3,8,,train
0532575_sc-167017.jpg,6,0,1,0,7,,val
0532576_as-0008679.jpg,0,2,1,0,3,,val
0532577_as-0008679.jpg,0,0,1,0,1,,test
0532578_as-0008679.jpg,0,0,1,0,1,,train
0532579_as-0008679.jpg,0,0,1,0,1,,train
0532580_as-0008679.jpg,0,0,1,0,1,,train
0532581_as-2524611.jpg,1,1,1,0,3,,train
0532582_sc-116109.jpg,4,0,0,0,4,,train
0532583_sc-116109.jpg,3,0,0,0,3,,train
0532584_sc-210444.jpg,1,0,0,0,1,,train
0532585_sc-210444.jpg,2,0,0,0,2,,val
0532586_sc-210444.jpg,2,0,0,0,2,,val
0532587_sc-131178.jpg,5,1,0,0,6,,test
0532588_sc-131178.jpg,4,0,0,0,4,,train
0532589_sc-131178.jpg,2,0,0,0,2,,train
0532590_sc-131178.jpg,2,0,0,0,2,,train
0532591_as-0041657.jpg,1,0,1,0,2,,train
0532594_as-0041657.jpg,6,0,1,0,7,,train
0532595_as-0041657.jpg,2,0,1,0,3,,train
0532600_as-0038977.jpg,0,1,0,0,1,,train
0532601_as-0038977.jpg,0,2,0,0,2,,val
0532602_as-7733075.jpg,0,0,2,0,2,,val
0532603_sc-194313.jpg,3,0,2,0,5,,test
0532605_as-2703297.jpg,1,0,0,0,1,,train
0532606_sc-194951.jpg,1,0,0,0,1,,train
0532607_as-0047042.jpg,3,0,1,0,4,,train
0532608_as-0047042.jpg,3,0,0,0,3,,train
0532609_as-0047042.jpg,3,0,0,0,3,,train
0532610_as-0047042.jpg,1,0,0,0,1,,train
0532611_as-0047042.jpg,3,0,0,0,3,,train
0532612_as-0047042.jpg,1,0,0,0,1,,val
0532613_as-0047042.jpg,1,1,0,0,2,,val
0532614_as-0047042.jpg,1,0,0,0,1,,test
0532615_as-0047042.jpg,1,0,0,0,1,,train
0532616_as-0047042.jpg,1,0,0,0,1,,train
0532617_as-3092307.jpg,1,0,0,0,1,,train
0532618_as-3092307.jpg,4,0,0,0,4,,train
0532619_as-2989304.jpg,0,1,1,0,2,,train
0532620_sc-176247.jpg,2,0,0,0,2,,train
0532621_sc-176247.jpg,1,0,0,0,1,,train
0532622_as-0062959.jpg,1,0,0,0,1,,val
0532623_as-0062959.jpg,5,2,1,2,10,,val
0532624_as-0062959.jpg,7,5,4,2,18,,test
0532625_as-0062959.jpg,0,1,1,0,2,,train
0532626_as-0062959.jpg,4,2,5,1,12,,train
0532627_as-0062959.jpg,0,1,2,0,3,,train
0532628_as-0062959.jpg,0,1,1,0,2,,train
0532629_as-0062959.jpg,3,1,1,1,6,,train
0532630_as-0062959.jpg,0,0,1,0,1,,train
0532631_as-0062959.jpg,2,0,2,1,5,,train
0532632_as-0062959.jpg,9,0,4,1,14,,val
0532636_as-0062959.jpg,4,0,0,1,5,,val
0532637_sc-188090.jpg,1,0,0,0,1,,test
0532638_sc-188090.jpg,1,0,0,0,1,,train
0532639_sc-188090.jpg,1,0,0,0,1,,train
0532640_sc-188090.jpg,1,0,0,1,2,,train
0532641_sc-188090.jpg,1,0,0,1,2,,train
0532642_sc-188090.jpg,2,0,0,0,2,,train
0532643_sc-188090.jpg,2,0,0,0,2,,train
0532644_as-0045164.jpg,0,0,0,1,1,,train
0532645_as-0045164.jpg,1,0,1,1,3,,val
0532646_as-0045164.jpg,0,0,0,1,1,,val
0532647_as-0045164.jpg,1,0,1,0,2,,test
0532648_as-3297003.jpg,0,1,2,2,5,,train
0532650_sc-124819.jpg,2,1,1,0,4,,train
0532651_sc-1015471.jpg,1,0,2,0,3,,train
0532652_as-3369098.jpg,2,0,0,0,2,,train
0532653_sc-154473.jpg,2,0,0,0,2,,train
0532655_sc-200624.jpg,1,2,1,1,5,,train
0532656_sc-200624.jpg,1,2,2,2,7,,train
0532657_sc-200624.jpg,1,2,1,2,6,,val
0532659_as-0078897.jpg,1,0,0,0,1,,val
0532660_as-0078897.jpg,1,0,0,1,2,,test
0532661_as-0078897.jpg,2,0,0,1,3,,train
0532662_as-0078897.jpg,4,0,0,0,4,,train
0532663_as-0078897.jpg,1,1,0,0,2,,train
0532666_sc-194470.jpg,6,0,0,0,6,,train
0532667_sc-194470.jpg,2,0,0,0,2,,train
0532668_as-9079381.jpg,0,0,4,0,4,,train
0532671_as-0052711.jpg,0,1,0,0,1,,train
0532672_as-0052711.jpg,2,1,0,0,3,,val
0532673_as-0052711.jpg,4,1,0,0,5,,val
0532674_as-0052711.jpg,1,0,0,0,1,,test
0532675_as-0021462.jpg,0,0,1,0,1,,train
0532676_as-2981725.jpg,3,0,0,0,3,,train
0532678_sc-209306.jpg,2,0,1,0,3,,train
0532679_sc-209306.jpg,0,0,1,0,1,,train
0532680_sc-209306.jpg,1,0,1,0,2,,train
0532682_as-0046253.jpg,3,1,0,0,4,,train
0532683_as-0046253.jpg,2,0,0,0,2,,train
0532684_as-0046253.jpg,3,0,1,0,4,,val
0532685_as-0046253.jpg,2,0,0,0,2,,val
0532687_sc-193656.jpg,0,1,0,0,1,,test
0532688_as-2775326.jpg,1,0,1,0,2,,train
0532691_as-3177905.jpg,0,1,0,0,1,,train
0532692_sc-159487.jpg,1,1,0,0,2,,train
0532695_sc-194136.jpg,1,1,1,0,3,,train
0532696_sc-194136.jpg,1,0,0,0,1,,train
0532697_sc-194136.jpg,2,0,0,0,2,,train
0532699_as-7366536.jpg,2,0,0,0,2,,train
0532700_sc-201537.jpg,1,0,0,1,2,,val
0532701_sc-177324.jpg,3,0,0,0,3,,val
0532702_sc-177324.jpg,2,0,0,0,2,,test
0532703_as-2927044.jpg,2,0,0,0,2,,train
0532704_as-0044800.jpg,2,0,2,1,5,,train
0532705_as-0044800.jpg,1,0,0,0,1,,train
0532706_as-0044800.jpg,1,0,2,1,4,,train
0532707_as-0044800.jpg,1,0,1,1,3,,train
0532708_as-0044800.jpg,1,0,0,0,1,,train
0532710_as-7610017.jpg,0,0,1,1,2,,train
0532711_as-0064947.jpg,0,0,0,1,1,,val
0532712_as-0064947.jpg,1,0,0,1,2,,val
0532713_as-0064947.jpg,1,0,0,0,1,,test
0532714_sc-1022740.jpg,1,2,2,0,5,,train
0532716_sc-1022740.jpg,1,1,2,0,4,,train
0532719_sc-1022740.jpg,0,1,1,0,2,,train
0532720_sc-1022740.jpg,2,2,2,0,6,,train
0532721_sc-1022740.jpg,1,1,1,0,3,,train
0532722_as-3376747.jpg,1,0,0,0,1,,train
0532723_sc-136682.jpg,2,0,0,0,2,,train
0532724_sc-136682.jpg,2,0,0,0,2,,val
0532725_as-9060796.jpg,1,3,1,0,5,,val
0532726_as-3343400.jpg,2,0,0,0,2,,test
0532727_as-0097185.jpg,6,0,1,0,7,,train
0532729_as-0097185.jpg,6,0,0,0,6,,train
0532732_as-0080310.jpg,5,0,0,2,7,,train
0532733_as-0080310.jpg,1,0,0,1,2,,train
0532734_as-0080310.jpg,1,0,0,1,2,,train
0532735_as-0080310.jpg,2,0,0,0,2,,train
0532736_as-0080310.jpg,2,1,0,1,4,,train
0532739_as-0025839.jpg,1,1,1,0,3,,val
0532741_as-0025839.jpg,2,0,1,0,3,,val
0532742_as-0025839.jpg,0,0,1,0,1,,test
0532743_as-0025839.jpg,3,0,1,0,4,,train
0532744_sc-1036130.jpg,1,1,0,0,2,,train
0532745_sc-1036130.jpg,2,1,0,0,3,,train
0532746_sc-1036130.jpg,1,1,0,0,2,,train
0532748_as-0068810.jpg,1,0,0,0,1,,train
0532749_as-0068810.jpg,3,0,0,0,3,,train
0532750_as-0068810.jpg,2,0,0,0,2,,train
0532751_as-0068810.jpg,1,0,0,0,1,,val
0532752_as-0068810.jpg,1,0,0,0,1,,val
0532753_as-0068810.jpg,7,0,0,0,7,,test
0532754_as-0068810.jpg,6,0,0,0,6,,train
0532755_as-0068810.jpg,4,0,0,0,4,,train
0532756_as-0068810.jpg,3,0,0,0,3,,train
0532758_as-0059232.jpg,2,1,0,0,3,,train
0532759_as-0059232.jpg,3,1,0,0,4,,train
0532760_sc-205280.jpg,10,0,2,1,13,,train
0532761_sc-205280.jpg,6,0,1,1,8,,train
0532762_sc-142908.jpg,1,0,0,0,1,,val
0532764_sc-142908.jpg,1,0,0,0,1,,val
0532766_as-0095292.jpg,1,0,0,0,1,,test
0532767_as-0095292.jpg,1,0,0,0,1,,train
0532768_as-0095292.jpg,2,0,0,0,2,,train
0532770_sc-124722.jpg,1,0,0,0,1,,train
0532771_as-2721852.jpg,3,0,1,0,4,,train
0532772_as-0017638.jpg,1,0,2,2,5,,train
0532775_as-0017638.jpg,3,0,1,0,4,,train
0532776_sc-119568.jpg,2,1,0,0,3,,train
0532777_sc-119568.jpg,2,1,1,0,4,,val
0532778_sc-119568.jpg,2,1,1,0,4,,val
0532779_sc-119568.jpg,1,0,0,0,1,,test
0532780_sc-119568.jpg,1,0,0,0,1,,train
0532782_as-0048565.jpg,3,0,0,0,3,,train
0532783_as-0048565.jpg,3,0,0,0,3,,train
0532784_as-0048565.jpg,2,0,0,0,2,,train
0532785_as-0048565.jpg,4,0,0,0,4,,train
0532786_as-3149370.jpg,2,2,2,1,7,,train
0532788_as-3109266.jpg,5,2,1,1,9,,train
0532789_as-7694875.jpg,3,2,4,1,10,,val
0532790_as-3046153.jpg,1,0,0,1,2,,val
0532791_as-3015310.jpg,0,0,1,0,1,,test
0532792_as-3487572.jpg,1,0,0,0,1,,train
0532793_as-0033696.jpg,2,0,0,0,2,,train
0532794_as-0033696.jpg,2,0,1,1,4,,train
0532795_as-0033696.jpg,3,0,1,2,6,,train
0532796_as-0033696.jpg,7,0,1,1,9,,train
0532797_as-2542846.jpg,1,0,1,0,2,,train
0532798_sc-1025724.jpg,1,0,0,0,1,,train
0532799_sc-1025724.jpg,2,0,0,0,2,,val
0532800_as-0089576.jpg,1,1,1,0,3,,val
0532803_sc-104263.jpg,1,0,0,0,1,,test
0532804_sc-104263.jpg,1,0,0,1,2,,train
0532805_sc-104263.jpg,1,0,0,1,2,,train
0532806_sc-104263.jpg,1,0,0,1,2,,train
0532807_sc-104263.jpg,1,0,0,0,1,,train
0532808_sc-104263.jpg,1,0,0,0,1,,train
0532809_as-3025974.jpg,4,0,1,1,6,,train
0532810_as-3284647.jpg,1,0,0,0,1,,train
0532812_as-0080201.jpg,1,0,0,1,2,,val
0532813_sc-1028916.jpg,3,0,1,0,4,,val
0532815_as-0057499.jpg,0,2,0,0,2,,test
0532816_as-0057499.jpg,0,2,0,0,2,,train
0532817_as-0057499.jpg,0,1,1,0,2,,train
0532818_as-0057499.jpg,0,1,0,0,1,,train
0532819_sc-171397.jpg,6,0,0,0,6,,train
0532820_sc-171397.jpg,5,0,0,0,5,,train
0532821_sc-120347.jpg,2,0,0,0,2,,train
0532822_sc-120347.jpg,2,0,0,0,2,,train
0532823_as-3483265.jpg,2,0,0,0,2,,val
0532825_as-0026064.jpg,2,0,0,0,2,,val
0532826_as-0026064.jpg,2,0,0,0,2,,test
0532827_as-0026064.jpg,1,0,0,0,1,,train
0532828_as-0033095.jpg,1,0,1,0,2,,train
0532829_as-0033095.jpg,1,0,1,0,2,,train
0532830_sc-197204.jpg,5,0,0,0,5,,train
0532831_sc-197204.jpg,3,0,0,0,3,,train
0532832_sc-197204.jpg,4,0,0,0,4,,train
0532834_sc-106313.jpg,4,1,2,1,8,,train
0532835_sc-106313.jpg,1,0,1,0,2,,val
0532836_sc-215135.jpg,1,0,1,0,2,,val
0532837_sc-215135.jpg,2,0,0,0,2,,test
0532838_sc-215135.jpg,1,0,1,0,2,,train
0532839_sc-201339.jpg,2,0,0,0,2,,train
0532840_sc-201339.jpg,2,0,0,0,2,,train
0532841_sc-201339.jpg,1,0,0,0,1,,train
0532842_sc-201339.jpg,1,0,0,0,1,,train
0532843_sc-112811.jpg,1,0,0,0,1,,train
0532844_sc-112811.jpg,1,0,0,0,1,,train
0532845_as-2683780.jpg,5,0,0,0,5,,val
0532846_sc-183493.jpg,1,0,0,0,1,,val
0532847_sc-183493.jpg,1,0,0,0,1,,test
0532848_sc-183493.jpg,3,0,0,0,3,,train
0532849_sc-183493.jpg,1,0,0,0,1,,train
0532850_sc-183493.jpg,2,0,0,0,2,,train
0532851_sc-183493.jpg,1,0,1,0,2,,train
0532852_sc-183493.jpg,1,0,0,0,1,,train
0532853_sc-183493.jpg,1,0,0,0,1,,train
0532855_sc-183493.jpg,2,0,0,0,2,,train
0532856_sc-142899.jpg,1,2,0,0,3,,val
0532858_sc-123673.jpg,0,1,2,0,3,,val
0532859_sc-123673.jpg,0,1,0,0,1,,test
0532863_as-0089212.jpg,0,2,1,0,3,,train
0532864_as-3273309.jpg,2,0,1,0,3,,train
0532865_as-2585190.jpg,1,0,0,0,1,,train
0532867_as-0093716.jpg,4,0,0,2,6,,train
0532869_as-2995356.jpg,2,0,2,0,4,,train
0532870_sc-1004287.jpg,0,0,0,1,1,,train
0532871_sc-1004287.jpg,0,1,1,0,2,,train
0532872_sc-1004287.jpg,0,1,0,0,1,,val
0532873_sc-1004287.jpg,0,0,1,0,1,,val
0532876_as-0019790.jpg,2,0,3,1,6,,test
0532877_as-0019790.jpg,2,0,3,1,6,,train
0532878_as-0019790.jpg,1,0,3,1,5,,train
0532879_as-0019790.jpg,2,0,1,1,4,,train
0532880_as-0019790.jpg,2,0,3,1,6,,train
0532881_as-0019790.jpg,1,0,1,1,3,,train
0532882_as-0019790.jpg,1,0,1,1,3,,train
0532883_as-0049842.jpg,1,0,0,0,1,,train
0532884_as-0049842.jpg,1,0,2,1,4,,val
0532885_as-0049842.jpg,1,0,1,1,3,,val
0532886_as-0049842.jpg,1,0,2,1,4,,test
0532887_as-7641600.jpg,4,0,1,0,5,,train
0532888_sc-171596.jpg,1,0,1,1,3,,train
0532889_sc-163812.jpg,1,0,0,0,1,,train
0532890_sc-163812.jpg,1,0,0,0,1,,train
0532891_sc-163812.jpg,1,0,0,0,1,,train
0532892_sc-1029599.jpg,2,0,1,0,3,,train
0532893_sc-1029599.jpg,0,1,1,0,2,,train
0532896_sc-162956.jpg,2,0,1,1,4,,val
0532897_sc-1001706.jpg,2,0,0,0,2,,val
0532898_sc-1001706.jpg,1,0,0,0,1,,test
0532899_as-0093255.jpg,2,1,0,0,3,,train
0532900_as-0093255.jpg,4,1,0,0,5,,train
0532901_sc-106287.jpg,4,0,0,0,4,,train
0532902_sc-106287.jpg,2,0,0,0,2,,train
0532903_sc-106287.jpg,1,0,0,0,1,,train
0532904_sc-106287.jpg,3,0,0,0,3,,train
0532905_as-9037215.jpg,2,1,0,0,3,,train
0532906_as-2611591.jpg,0,0,2,1,3,,val
0532909_sc-148408.jpg,6,0,0,1,7,,val
0532910_sc-148408.jpg,3,0,1,0,4,,test
0532911_sc-138745.jpg,2,0,0,0,2,,train
0532912_sc-138745.jpg,2,0,1,0,3,,train
0532913_sc-138745.jpg,2,0,1,0,3,,train
0532914_sc-138745.jpg,3,1,0,0,4,,train
0532918_as-2887370.jpg,2,0,0,0,2,,train
0532919_sc-217437.jpg,1,1,0,1,3,,train
0532920_as-2971639.jpg,3,0,1,1,5,,train
0532922_sc-1030341.jpg,2,0,0,0,2,,val
0532923_sc-1030341.jpg,3,0,1,0,4,,val
0532924_sc-1030341.jpg,1,0,0,0,1,,test
0532925_sc-1030341.jpg,6,0,1,0,7,,train
0532927_as-0094569.jpg,1,0,0,0,1,,train
0532928_as-0094569.jpg,1,0,0,0,1,,train
0532929_as-0094569.jpg,1,0,0,0,1,,train
0532930_sc-155453.jpg,3,0,0,0,3,,train
0532931_as-0030517.jpg,0,0,0,1,1,,train
0532932_as-0030517.jpg,0,0,0,1,1,,train
0532933_as-0030517.jpg,4,0,0,0,4,,val
0532934_as-0030517.jpg,2,0,0,0,2,,val
0532935_as-0030517.jpg,3,0,0,1,4,,test
0532936_as-0030517.jpg,1,0,0,0,1,,train
0532937_sc-162761.jpg,3,0,1,0,4,,train
0532938_sc-162761.jpg,3,0,0,0,3,,train
0532939_sc-162761.jpg,1,0,0,0,1,,train
0532940_as-9008023.jpg,2,0,1,0,3,,train
0532941_sc-181201.jpg,1,0,0,0,1,,train
0532942_as-3040766.jpg,1,0,0,0,1,,train
0532944_as-7637518.jpg,1,0,0,0,1,,val
0532945_as-2699874.jpg,5,0,0,1,6,,val
0532947_as-0066720.jpg,0,0,2,0,2,,test
0532948_sc-1012800.jpg,1,0,0,1,2,,train
0532949_sc-1012800.jpg,3,0,0,0,3,,train
0532950_sc-1012800.jpg,3,0,0,0,3,,train
0532951_sc-1012800.jpg,2,0,0,0,2,,train
0532952_sc-1012800.jpg,1,0,0,0,1,,train
0532953_sc-1012800.jpg,1,0,0,0,1,,train
0532954_sc-169976.jpg,1,0,0,0,1,,train
0532955_sc-169976.jpg,5,1,2,1,9,,val
0532956_sc-169976.jpg,2,0,1,2,5,,val
0532957_as-0029923.jpg,2,0,0,0,2,,test
0532958_as-0029923.jpg,3,0,0,0,3,,train
0532959_as-0029923.jpg,1,0,0,0,1,,train
0532960_as-0029923.jpg,1,0,0,0,1,,train
0532961_as-0029923.jpg,1,0,0,0,1,,train
0532962_sc-170763.jpg,1,0,2,0,3,,train
0532964_as-0013018.jpg,1,0,0,1,2,,train
0532966_as-0045604.jpg,1,0,0,0,1,,train
0532967_as-0045604.jpg,1,0,1,0,2,,val
0532968_as-0045604.jpg,3,0,1,0,4,,val
0532969_as-0045604.jpg,1,0,1,0,2,,test
0532970_as-0045604.jpg,1,0,0,0,1,,train
0532971_as-0045604.jpg,1,0,0,0,1,,train
0532972_as-0045604.jpg,2,0,0,0,2,,train
0532973_sc-181091.jpg,2,0,1,1,4,,train
0532974_sc-181091.jpg,12,0,1,0,13,,train
0532975_sc-181091.jpg,10,0,1,0,11,,train
0532976_sc-224518.jpg,1,0,0,0,1,,train
0532977_sc-224518.jpg,1,0,0,0,1,,val
0532978_sc-224518.jpg,1,0,0,0,1,,val
0532980_as-0057154.jpg,0,0,1,0,1,,test
0532981_as-0057154.jpg,0,0,1,0,1,,train
0532982_sc-129599.jpg,2,2,0,0,4,,train
0532983_sc-1010146.jpg,1,1,0,1,3,,train
0532984_sc-1041323.jpg,1,0,0,0,1,,train
0532985_as-7126579.jpg,2,1,3,2,8,,train
0532986_as-0036067.jpg,1,0,0,0,1,,train
0532987_as-0036067.jpg,0,0,1,0,1,,train
0532988_as-0036067.jpg,0,0,1,0,1,,val
0532990_as-0036067.jpg,1,0,0,0,1,,val
0532991_as-0036067.jpg,0,0,1,0,1,,test
0532994_sc-177269.jpg,2,0,0,0,2,,train
0532995_as-7662707.jpg,5,0,1,2,8,,train
0532996_sc-173851.jpg,13,1,1,0,15,,train
0532997_sc-173851.jpg,2,0,0,0,2,,train
0532999_sc-173851.jpg,6,0,2,1,9,,train
0533000_sc-173851.jpg,15,0,0,1,16,,train
0533001_sc-173851.jpg,3,1,0,0,4,,train
0533002_sc-173851.jpg,0,1,1,0,2,,val
0533004_as-0074543.jpg,1,0,1,0,2,,val
0533005_as-0074543.jpg,0,0,1,0,1,,test
0533006_as-0074543.jpg,0,0,1,0,1,,train
0533007_as-0074543.jpg,0,0,1,0,1,,train
0533009_sc-169571.jpg,4,0,0,1,5,,train
0533010_as-3010216.jpg,1,0,1,0,2,,train
0533012_as-7846597.jpg,2,1,0,0,3,,train
0533014_as-0048374.jpg,2,0,1,0,3,,train
0533015_as-0048374.jpg,2,0,2,0,4,,train
0533016_as-0048374.jpg,1,1,0,1,3,,val
0533017_as-0048374.jpg,1,1,1,1,4,,val
0533018_as-0048374.jpg,1,1,0,1,3,,test
0533019_as-0048374.jpg,1,0,1,0,2,,train
0533020_as-0048374.jpg,1,1,2,1,5,,train
0533021_as-0048374.jpg,1,1,1,1,4,,train
0533023_sc-114642.jpg,3,0,0,0,3,,train
0533024_sc-114642.jpg,5,0,0,0,5,,train
0533025_as-7921383.jpg,11,0,0,0,11,,train
0533027_sc-141356.jpg,0,0,1,0,1,,train
0533029_as-0019941.jpg,1,0,0,1,2,,val
0533030_as-0019941.jpg,1,0,0,1,2,,val
0533031_as-0019941.jpg,1,0,0,0,1,,test
0533032_as-0019941.jpg,1,0,0,0,1,,train
0533033_as-0019941.jpg,1,0,0,0,1,,train
0533035_as-0019941.jpg,1,0,0,0,1,,train
0533036_as-0019941.jpg,1,0,0,0,1,,train
0533038_as-0009375.jpg,4,1,2,0,7,,train
0533039_as-0009375.jpg,2,0,2,0,4,,train
0533040_as-3304436.jpg,3,0,1,1,5,,train
0533041_as-3079659.jpg,2,0,0,1,3,,val
0533042_as-2534546.jpg,1,1,1,0,3,,val
0533043_sc-1027572.jpg,4,0,0,0,4,,test
0533044_sc-1027572.jpg,2,0,0,0,2,,train
0533045_sc-1027572.jpg,2,0,1,0,3,,train
0533046_sc-1027572.jpg,1,0,0,0,1,,train
0533047_sc-1027572.jpg,4,0,0,0,4,,train
0533048_sc-1027572.jpg,1,0,1,0,2,,train
0533049_sc-1027572.jpg,3,0,0,1,4,,train
0533050_sc-136426.jpg,3,0,0,0,3,,train
0533051_sc-136426.jpg,4,0,0,0,4,,val
0533052_as-2553738.jpg,3,1,1,0,5,,val
0533053_sc-195815.jpg,1,0,0,0,1,,test
0533054_sc-195815.jpg,2,1,1,1,5,,train
0533055_sc-195815.jpg,1,0,1,1,3,,train
0533056_sc-195815.jpg,1,2,0,1,4,,train
0533057_sc-195815.jpg,1,1,0,0,2,,train
0533060_as-3109004.jpg,1,1,1,0,3,,train
0533061_as-3109004.jpg,3,0,0,0,3,,train
0533062_sc-211006.jpg,2,1,0,0,3,,train
0533063_sc-211006.jpg,1,1,0,0,2,,val
0533064_sc-211006.jpg,2,1,0,0,3,,val
0533065_as-0015178.jpg,1,0,0,0,1,,test
0533066_as-0015178.jpg,1,0,0,0,1,,train
0533068_sc-225186.jpg,3,0,1,0,4,,train
0533069_sc-225186.jpg,1,0,1,0,2,,train
0533070_sc-225795.jpg,4,0,0,0,4,,train
0533071_sc-225795.jpg,7,0,0,0,7,,train
0533072_as-2990401.jpg,1,0,0,1,2,,train
0533073_as-2804174.jpg,1,0,0,0,1,,train
0533074_sc-171555.jpg,1,3,1,1,6,,val
0533075_sc-171555.jpg,2,2,1,0,5,,val
0533077_sc-214013.jpg,2,0,1,0,3,,test
0533078_sc-214013.jpg,0,0,1,0,1,,train
0533079_sc-214013.jpg,3,0,1,0,4,,train
0533080_sc-214013.jpg,2,0,1,0,3,,train
0533081_sc-214013.jpg,2,0,1,0,3,,train
0533082_sc-214013.jpg,1,0,1,0,2,,train
0533083_sc-106772.jpg,1,1,0,0,2,,train
0533084_sc-106772.jpg,3,0,0,1,4,,train
0533085_sc-106772.jpg,1,1,0,1,3,,val
0533086_as-3081842.jpg,4,0,1,2,7,,val
0533087_as-2979436.jpg,1,0,0,0,1,,test
0533089_as-2533363.jpg,1,0,0,0,1,,train
0533090_as-3170042.jpg,5,0,0,0,5,,train
0533091_as-0071124.jpg,1,0,0,0,1,,train
0533092_as-0046258.jpg,2,3,2,0,7,,train
0533093_as-0046258.jpg,3,3,2,0,8,,train
0533094_as-0046258.jpg,5,3,1,0,9,,train
0533095_as-0046258.jpg,2,0,1,0,3,,train
0533096_as-0077390.jpg,4,0,1,0,5,,val
0533097_as-0077390.jpg,3,0,0,0,3,,val
0533098_as-7021578.jpg,2,0,0,0,2,,test
0533099_as-2590627.jpg,1,2,2,0,5,,train
0533100_sc-197169.jpg,3,1,0,0,4,,train
0533101_sc-197169.jpg,8,0,1,0,9,,train
0533102_sc-197169.jpg,1,1,0,0,2,,train
0533103_sc-197169.jpg,8,0,1,0,9,,train
0533106_as-2724253.jpg,1,1,1,0,3,,train
0533107_sc-132618.jpg,5,0,0,0,5,,train
0533108_sc-132618.jpg,0,0,2,0,2,,val
0533109_sc-132618.jpg,3,0,2,0,5,,val
0533110_sc-132618.jpg,4,1,1,1,7,,test
0533111_as-2775764.jpg,1,0,0,1,2,,train
0533112_as-3178189.jpg,1,0,0,0,1,,train
0533113_as-0054617.jpg,1,0,0,0,1,,train
0533114_as-0054617.jpg,1,0,0,0,1,,train
0533115_as-0054617.jpg,1,0,0,0,1,,train
0533116_as-0054617.jpg,1,0,0,0,1,,train
0533117_as-0044538.jpg,1,0,0,1,2,,train
0533119_as-0062496.jpg,2,0,0,0,2,,val
0533120_as-0062496.jpg,1,0,0,1,2,,val
0533121_as-0062496.jpg,0,0,1,0,1,,test
0533122_as-0062496.jpg,0,0,0,1,1,,train
0533123_as-7222111.jpg,4,0,1,0,5,,train
0533124_sc-206925.jpg,1,0,0,0,1,,train
0533126_as-0004282.jpg,3,1,1,2,7,,train
0533129_as-0004282.jpg,0,0,3,1,4,,train
0533132_sc-147113.jpg,1,0,1,1,3,,train
0533133_sc-147113.jpg,1,0,1,1,3,,train
0533134_as-7530092.jpg,2,0,0,0,2,,val
0533135_as-3196295.jpg,1,0,0,0,1,,val
0533136_sc-139434.jpg,1,1,0,0,2,,test
0533138_sc-139434.jpg,1,1,0,0,2,,train
0533139_sc-1019031.jpg,2,0,1,1,4,,train
0533140_sc-1019031.jpg,1,0,0,1,2,,train
0533141_as-7807179.jpg,1,0,1,0,2,,train
0533143_sc-160036.jpg,10,0,2,2,14,,train
0533144_sc-160036.jpg,4,1,2,0,7,,train
0533145_sc-103736.jpg,1,0,0,0,1,,train
0533146_as-3006973.jpg,2,0,0,0,2,,val
0533147_as-0029405.jpg,1,0,0,0,1,,val
0533148_as-0029405.jpg,1,0,0,0,1,,test
0533149_as-0029405.jpg,2,0,0,0,2,,train
0533150_as-0029405.jpg,2,0,0,0,2,,train
0533151_sc-223565.jpg,4,0,0,0,4,,train
0533152_sc-223565.jpg,1,0,0,0,1,,train
0533153_sc-115776.jpg,11,0,0,1,12,,train
0533154_sc-115776.jpg,6,0,0,2,8,,train
0533155_sc-205875.jpg,8,0,1,1,10,,train
0533156_as-0034141.jpg,0,1,0,1,2,,val
0533157_as-2751550.jpg,6,2,3,1,12,,val
0533158_sc-227059.jpg,2,0,2,0,4,,test
0533159_sc-227059.jpg,1,0,1,0,2,,train
0533160_sc-227059.jpg,1,1,0,0,2,,train
0533162_as-0039552.jpg,7,0,1,2,10,,train
0533163_as-0039552.jpg,8,0,0,0,8,,train
0533165_as-0039552.jpg,3,0,1,0,4,,train
0533168_as-0092643.jpg,0,1,2,0,3,,train
0533169_as-0092643.jpg,0,0,1,0,1,,train
0533170_as-0092643.jpg,0,0,1,0,1,,val
0533171_as-0092643.jpg,0,1,1,0,2,,val
0533172_as-0092643.jpg,0,0,1,0,1,,test
0533173_as-2851298.jpg,1,0,0,0,1,,train
0533175_sc-1019326.jpg,1,0,0,0,1,,train
0533177_as-3311862.jpg,2,1,0,0,3,,train
0533178_sc-216690.jpg,1,0,1,1,3,,train
0533179_sc-197845.jpg,1,1,1,0,3,,train
0533180_sc-197845.jpg,2,0,1,0,3,,train
0533182_sc-197845.jpg,0,0,1,0,1,,train
0533183_sc-1013539.jpg,2,0,0,0,2,,val
0533184_sc-1013539.jpg,1,0,0,0,1,,val
0533185_as-2911625.jpg,2,0,0,0,2,,test
0533187_as-0065097.jpg,1,1,0,0,2,,train
0533188_sc-1000207.jpg,4,0,0,0,4,,train
0533189_sc-1000207.jpg,6,0,1,0,7,,train
0533190_as-0098924.jpg,0,0,1,0,1,,train
0533191_as-0098924.jpg,1,0,0,0,1,,train
0533192_as-0098924.jpg,2,0,0,0,2,,train
0533194_sc-166053.jpg,1,0,0,0,1,,train
0533195_sc-166053.jpg,1,0,0,0,1,,val
0533197_as-0095961.jpg,7,0,0,1,8,,val
0533198_as-0095961.jpg,6,0,0,1,7,,test
0533199_as-0095961.jpg,6,0,0,1,7,,train
0533200_as-0095961.jpg,3,0,1,1,5,,train
0533201_as-0095961.jpg,2,0,0,1,3,,train
0533202_as-0095961.jpg,1,0,0,1,2,,train
0533203_as-0095961.jpg,8,0,1,0,9,,train
0533205_sc-114864.jpg,1,0,0,1,2,,train
0533206_sc-114864.jpg,1,0,0,0,1,,train
0533207_sc-114864.jpg,2,0,0,0,2,,val
0533208_sc-114864.jpg,3,0,0,0,3,,val
0533209_sc-114864.jpg,1,0,0,0,1,,test
0533210_as-9071001.jpg,1,0,1,0,2,,train
0533211_as-3305129.jpg,3,0,0,0,3,,train
0533213_as-0028366.jpg,1,0,0,0,1,,train
0533214_as-0028366.jpg,1,0,0,0,1,,train
0533215_as-0028366.jpg,2,0,0,0,2,,train
0533216_as-0028366.jpg,3,0,0,0,3,,train
0533217_sc-226186.jpg,3,0,0,0,3,,train
0533218_sc-226186.jpg,3,0,0,0,3,,val
0533219_sc-226186.jpg,2,0,0,0,2,,val
0533220_sc-226186.jpg,2,0,0,0,2,,test
0533221_sc-226186.jpg,1,0,0,0,1,,train
0533222_sc-226186.jpg,1,0,0,0,1,,train
0533223_sc-226186.jpg,1,0,0,0,1,,train
0533224_sc-226186.jpg,1,0,0,0,1,,train
0533225_sc-226186.jpg,1,0,0,0,1,,train
0533226_sc-226186.jpg,2,0,0,0,2,,train
0533227_sc-226186.jpg,1,0,0,0,1,,train
0533228_sc-226186.jpg,3,0,0,0,3,,val
0533229_sc-226186.jpg,3,0,0,0,3,,val
0533230_sc-226186.jpg,1,0,0,0,1,,test
0533231_sc-226186.jpg,1,0,0,0,1,,train
0533232_sc-226186.jpg,1,1,1,0,3,,train
0533233_sc-226186.jpg,2,1,1,0,4,,train
0533235_sc-148468.jpg,1,1,0,0,2,,train
0533237_sc-148468.jpg,2,0,0,0,2,,train
0533238_as-7217637.jpg,1,0,1,0,2,,train
0533239_sc-213064.jpg,0,1,0,0,1,,train
0533240_sc-213064.jpg,2,0,0,0,2,,val
0533241_sc-213064.jpg,3,0,0,0,3,,val
0533242_sc-213064.jpg,2,1,0,1,4,,test
0533243_as-3042530.jpg,1,1,0,0,2,,train
0533246_as-0013523.jpg,4,2,0,0,6,,train
0533247_as-0013523.jpg,8,2,0,0,10,,train
0533248_as-0013523.jpg,5,2,0,0,7,,train
0533249_as-0013523.jpg,4,2,1,0,7,,train
0533250_as-0013523.jpg,5,3,0,0,8,,train
0533251_as-0013523.jpg,5,2,1,0,8,,train
0533252_as-0013523.jpg,4,1,0,0,5,,val
0533253_as-0013523.jpg,6,1,0,0,7,,val
0533254_as-0013523.jpg,10,1,0,0,11,,test
0533255_sc-157609.jpg,1,0,0,0,1,,train
0533256_sc-157609.jpg,0,0,0,1,1,,train
0533257_sc-157609.jpg,1,0,0,0,1,,train
0533258_sc-157609.jpg,0,0,0,1,1,,train
0533261_as-0078894.jpg,2,0,0,0,2,,train
0533262_sc-170285.jpg,3,0,1,0,4,,train
0533263_sc-170285.jpg,4,0,0,0,4,,train
0533265_sc-158908.jpg,1,0,0,0,1,,val
0533266_sc-158908.jpg,2,0,0,0,2,,val
0533267_sc-1038374.jpg,1,0,1,0,2,,test
0533268_sc-1038374.jpg,0,0,1,0,1,,train
0533269_sc-1038374.jpg,2,0,1,2,5,,train
0533270_sc-1038374.jpg,1,0,1,0,2,,train
0533271_sc-1038374.jpg,0,0,0,1,1,,train
0533272_sc-1038374.jpg,2,0,0,2,4,,train
0533273_sc-1038374.jpg,0,0,0,1,1,,train
0533274_sc-1038374.jpg,1,0,1,1,3,,train
0533275_sc-1038374.jpg,1,0,1,1,3,,val
0533276_sc-1038374.jpg,1,0,0,1,2,,val
0533277_sc-1039464.jpg,1,0,0,0,1,,test
0533278_sc-213085.jpg,0,1,0,0,1,,train
0533279_sc-213085.jpg,0,1,0,0,1,,train
0533281_as-0000283.jpg,2,0,1,0,3,,train
0533282_as-7858212.jpg,0,0,2,0,2,,train
0533285_as-2757969.jpg,1,0,0,0,1,,train
0533286_as-5149467.jpg,0,0,0,1,1,,train
0533287_as-0036740.jpg,1,1,1,0,3,,train
0533288_as-0036740.jpg,1,0,0,0,1,,val
0533289_as-0013032.jpg,4,0,1,0,5,,val
0533290_as-0013032.jpg,6,0,1,0,7,,test
0533291_as-0013032.jpg,2,0,1,0,3,,train
0533293_sc-162131.jpg,2,0,0,0,2,,train
0533294_as-3217839.jpg,1,0,1,0,2,,train
0533297_as-0040423.jpg,4,0,0,0,4,,train
0533299_as-0040423.jpg,4,1,0,0,5,,train
0533300_as-0040423.jpg,4,0,1,0,5,,train
0533301_as-0040423.jpg,2,1,0,0,3,,train
0533303_sc-110260.jpg,2,0,0,0,2,,val
0533304_sc-110260.jpg,2,0,0,0,2,,val
0533305_sc-110260.jpg,0,0,1,0,1,,test
0533306_sc-110260.jpg,0,0,1,0,1,,train
0533307_sc-110260.jpg,1,0,0,0,1,,train
0533308_sc-110260.jpg,1,0,0,0,1,,train
0533309_sc-110260.jpg,1,0,0,0,1,,train
0533310_sc-110260.jpg,2,0,0,0,2,,train
0533311_sc-110260.jpg,1,0,0,0,1,,train
0533312_sc-1005452.jpg,2,1,0,0,3,,train
0533313_as-3199129.jpg,2,0,1,0,3,,val
0533314_as-0088183.jpg,1,0,1,0,2,,val
0533315_as-0088183.jpg,2,0,0,0,2,,test
0533316_as-0093213.jpg,2,0,0,0,2,,train
0533317_as-0093213.jpg,1,0,0,0,1,,train
0533320_as-0019877.jpg,1,0,1,2,4,,train
0533321_as-0019877.jpg,1,0,1,1,3,,train
0533322_as-0019877.jpg,1,1,0,0,2,,train
0533323_as-0019877.jpg,1,1,0,0,2,,train
0533325_as-0079644.jpg,1,0,0,0,1,,train
0533328_as-0079529.jpg,4,1,2,1,8,,val
0533329_as-2511634.jpg,0,0,1,0,1,,val
0533330_sc-142914.jpg,2,0,0,1,3,,test
0533332_sc-142914.jpg,0,0,0,1,1,,train
0533333_sc-142914.jpg,0,0,0,1,1,,train
0533336_sc-191949.jpg,4,1,0,0,5,,train
0533340_as-0004392.jpg,1,0,0,1,2,,train
0533341_as-0004392.jpg,2,0,1,1,4,,train
0533342_as-0004392.jpg,1,0,1,1,3,,train
0533343_as-0004392.jpg,1,0,0,0,1,,train
0533344_as-0004392.jpg,2,0,1,1,4,,val
0533345_sc-204518.jpg,3,0,0,0,3,,val
0533346_sc-204518.jpg,2,0,0,0,2,,test
0533347_as-3010476.jpg,5,0,1,0,6,,train
0533348_as-7416671.jpg,0,0,2,0,2,,train
0533349_as-0047148.jpg,2,0,1,0,3,,train
0533350_as-0047148.jpg,1,0,0,0,1,,train
0533351_as-0047148.jpg,2,0,1,0,3,,train
0533352_as-0047148.jpg,2,0,1,1,4,,train
0533353_as-0047148.jpg,2,0,0,0,2,,train
0533354_as-0047148.jpg,2,0,0,0,2,,val
0533355_as-0047148.jpg,2,0,0,1,3,,val
0533356_as-0047148.jpg,2,0,0,1,3,,test
0533357_as-0047148.jpg,1,0,0,0,1,,train
0533358_as-0047148.jpg,1,0,0,0,1,,train
0533359_as-0047148.jpg,1,0,0,0,1,,train
0533360_as-0047148.jpg,1,0,0,0,1,,train
0533361_as-0047148.jpg,1,0,0,0,1,,train
0533363_sc-1018732.jpg,1,0,2,1,4,,train
0533365_sc-1018732.jpg,1,0,0,0,1,,train
0533366_as-0025765.jpg,2,0,0,0,2,,val
0533367_as-0025765.jpg,0,0,0,2,2,,val
0533368_as-0025765.jpg,3,0,0,0,3,,test
0533369_as-0025765.jpg,2,0,0,2,4,,train
0533370_as-0025765.jpg,1,0,0,0,1,,train
0533371_as-0009431.jpg,1,0,0,0,1,,train
0533372_as-0009431.jpg,1,0,0,0,1,,train
0533373_as-0009431.jpg,1,0,0,0,1,,train
0533374_as-0009431.jpg,1,0,0,0,1,,train
0533375_as-0009431.jpg,2,0,0,0,2,,train
0533376_as-0009431.jpg,1,0,0,0,1,,val
0533377_as-0009431.jpg,1,0,0,0,1,,val
0533378_as-0009431.jpg,2,0,0,0,2,,test
0533379_as-0009431.jpg,1,0,0,1,2,,train
0533380_as-0009431.jpg,2,0,0,2,4,,train
0533381_as-0009431.jpg,1,0,0,1,2,,train
0533382_as-0009431.jpg,1,0,0,1,2,,train
0533383_as-0009431.jpg,1,0,0,1,2,,train
0533384_as-0009431.jpg,3,0,0,0,3,,train
0533385_as-0009431.jpg,4,0,0,0,4,,train
0533386_as-0009431.jpg,2,0,0,0,2,,val
0533387_as-0009431.jpg,1,0,0,0,1,,val
0533388_as-0009431.jpg,1,0,0,0,1,,test
0533389_as-0009431.jpg,1,0,0,0,1,,train
0533390_as-0009431.jpg,1,0,0,0,1,,train
0533391_as-0009431.jpg,1,0,0,0,1,,train
0533392_as-0009431.jpg,1,0,0,0,1,,train
0533393_as-0009431.jpg,1,0,0,0,1,,train
0533395_as-0009431.jpg,1,0,0,0,1,,train
0533396_as-0009431.jpg,1,0,0,0,1,,train
0533401_as-0009431.jpg,1,0,0,0,1,,val
0533402_as-0009431.jpg,1,0,0,0,1,,val
0533403_as-0009431.jpg,1,0,0,0,1,,test
0533404_as-0009431.jpg,2,0,0,0,2,,train
0533405_as-0009431.jpg,2,0,0,0,2,,train
0533406_as-0009431.jpg,1,0,0,0,1,,train
0533407_as-0009431.jpg,2,0,0,0,2,,train
0533408_as-0009431.jpg,1,0,0,0,1,,train
0533409_as-0009431.jpg,1,0,0,0,1,,train
0533410_as-0009431.jpg,1,0,0,0,1,,train
0533411_as-0009431.jpg,1,0,0,0,1,,val
0533414_as-0009431.jpg,1,0,0,0,1,,val
0533418_as-0009431.jpg,1,0,0,0,1,,test
0533419_as-0009431.jpg,2,0,0,0,2,,train
0533422_as-0009431.jpg,3,0,0,0,3,,train
0533423_as-0009431.jpg,2,0,0,0,2,,train
0533425_sc-1021550.jpg,2,0,1,0,3,,train
0533426_sc-1021550.jpg,4,0,1,1,6,,train
0533427_sc-204400.jpg,3,0,0,0,3,,train
0533428_as-3398036.jpg,1,0,1,0,2,,train
0533429_sc-113906.jpg,2,3,1,0,6,,val
0533432_sc-128675.jpg,7,3,0,0,10,,val
0533434_sc-128675.jpg,6,5,0,0,11,,test
0533435_sc-128675.jpg,12,5,0,1,18,,train
0533438_as-2897005.jpg,12,0,1,1,14,,train
0533439_as-2876815.jpg,5,0,0,0,5,,train
0533440_sc-151463.jpg,3,0,0,0,3,,train
0533441_as-0089452.jpg,1,0,0,0,1,,train
0533442_as-0089452.jpg,2,0,0,0,2,,train
0533443_as-0089452.jpg,1,0,0,0,1,,train
0533444_sc-207987.jpg,1,0,1,0,2,,val
0533445_as-2589134.jpg,1,0,1,0,2,,val
0533446_sc-208787.jpg,5,0,0,0,5,,test
0533447_sc-208787.jpg,5,0,0,3,8,,train
0533448_sc-208787.jpg,1,0,0,0,1,,train
0533449_sc-208787.jpg,5,0,0,1,6,,train
0533450_sc-208787.jpg,3,0,0,0,3,,train
0533451_sc-208787.jpg,4,0,0,0,4,,train
0533452_sc-208787.jpg,3,0,0,0,3,,train
0533453_sc-208787.jpg,6,0,0,0,6,,train
0533454_sc-208787.jpg,7,0,0,0,7,,val
0533455_as-9079744.jpg,1,0,0,0,1,,val
0533456_as-7045275.jpg,1,0,0,0,1,,test
0533457_as-3027047.jpg,1,0,1,1,3,,train
0533458_as-3027047.jpg,2,0,1,0,3,,train
0533461_as-0051966.jpg,4,0,0,1,5,,train
0533462_as-0051966.jpg,2,0,1,0,3,,train
0533463_as-0051966.jpg,1,0,0,0,1,,train
0533464_as-0051966.jpg,0,0,1,0,1,,train
0533465_as-0051966.jpg,1,1,0,0,2,,train
0533467_sc-200194.jpg,2,0,0,0,2,,val
0533468_as-0055347.jpg,1,0,0,0,1,,val
0533469_as-0055347.jpg,1,0,0,0,1,,test
0533470_as-0055347.jpg,1,0,0,0,1,,train
0533471_as-0055347.jpg,1,0,0,0,1,,train
0533473_as-7826707.jpg,0,0,0,1,1,,train
0533474_sc-103210.jpg,1,1,0,0,2,,train
0533475_sc-103210.jpg,1,2,0,0,3,,train
0533476_sc-103210.jpg,2,2,0,0,4,,train
0533477_sc-103210.jpg,2,0,0,0,2,,train
0533478_sc-122879.jpg,0,0,1,1,2,,val
0533486_sc-122879.jpg,0,0,0,1,1,,val
0533487_sc-122879.jpg,0,0,0,1,1,,test
0533488_sc-1027406.jpg,1,0,0,0,1,,train
0533490_sc-1027406.jpg,1,0,0,0,1,,train
0533491_sc-1027406.jpg,1,0,0,0,1,,train
0533492_sc-1027406.jpg,1,0,0,0,1,,train
0533494_sc-1027406.jpg,2,0,0,0,2,,train
0533496_sc-1027406.jpg,1,0,0,0,1,,train
0533497_sc-1027406.jpg,2,0,0,0,2,,train
0533498_sc-1027406.jpg,0,1,0,0,1,,val
0533499_sc-1027406.jpg,1,1,1,1,4,,val
0533500_sc-154379.jpg,1,0,0,1,2,,test
0533501_sc-154379.jpg,1,0,0,1,2,,train
0533502_sc-154379.jpg,2,0,0,1,3,,train
0533503_sc-156210.jpg,1,0,0,0,1,,train
0533504_sc-156210.jpg,3,0,0,0,3,,train
0533505_sc-156210.jpg,2,0,0,0,2,,train
0533507_as-0022894.jpg,0,1,0,0,1,,train
0533508_as-0022894.jpg,0,1,0,1,2,,train
0533509_as-3051183.jpg,2,0,0,0,2,,val
0533511_sc-213141.jpg,1,0,0,0,1,,val
0533512_sc-213141.jpg,2,0,0,1,3,,test
0533513_sc-213141.jpg,4,1,0,1,6,,train
0533514_sc-213141.jpg,1,1,0,0,2,,train
0533515_sc-213141.jpg,1,0,0,0,1,,train
0533516_sc-213141.jpg,1,0,0,0,1,,train
0533517_as-3240653.jpg,1,0,1,0,2,,train
0533518_as-3240653.jpg,3,1,2,2,8,,train
0533519_sc-223039.jpg,4,0,0,1,5,,train
0533520_sc-223039.jpg,1,0,1,1,3,,val
0533521_sc-223039.jpg,3,0,0,0,3,,val
0533522_sc-223039.jpg,3,0,0,0,3,,test
0533523_as-0084346.jpg,7,0,0,0,7,,train
0533524_as-0084346.jpg,5,0,0,0,5,,train
0533525_as-0084346.jpg,7,0,0,1,8,,train
0533526_as-0084346.jpg,9,0,0,1,10,,train
0533527_as-0084346.jpg,3,0,0,1,4,,train
0533528_as-0084346.jpg,5,0,1,1,7,,train
0533529_as-0084346.jpg,5,0,0,2,7,,train
0533530_as-0084346.jpg,9,0,2,3,14,,val
0533532_as-0028278.jpg,2,0,0,0,2,,val
0533533_as-0028278.jpg,2,0,0,0,2,,test
0533534_sc-1000635.jpg,2,0,1,0,3,,train
0533535_sc-1000635.jpg,0,0,2,0,2,,train
0533536_as-3128646.jpg,2,0,0,0,2,,train
0533539_sc-206776.jpg,1,0,0,1,2,,train
0533540_sc-206776.jpg,3,0,0,1,4,,train
0533541_sc-206776.jpg,1,0,0,0,1,,train
0533542_as-7066744.jpg,1,0,0,0,1,,train
0533543_as-0066750.jpg,1,0,0,0,1,,val
0533545_as-0023384.jpg,0,0,1,1,2,,val
0533546_as-0023384.jpg,2,0,1,0,3,,test
0533547_as-0023384.jpg,0,0,1,0,1,,train
0533548_sc-207195.jpg,3,0,0,0,3,,train
0533549_sc-207195.jpg,3,0,1,0,4,,train
0533550_sc-207195.jpg,2,0,1,1,4,,train
0533551_sc-207195.jpg,4,0,0,0,4,,train
0533552_sc-207195.jpg,1,0,0,0,1,,train
0533553_as-9015246.jpg,1,0,0,0,1,,train
0533554_sc-163355.jpg,5,0,0,1,6,,val
0533555_sc-163355.jpg,5,0,0,2,7,,val
0533556_sc-163355.jpg,2,0,0,1,3,,test
0533558_as-3461259.jpg,3,0,0,0,3,,train
0533559_as-0046824.jpg,2,0,0,0,2,,train
0533560_as-0046824.jpg,2,0,0,0,2,,train
0533561_as-0034928.jpg,2,0,0,0,2,,train
0533562_as-0034928.jpg,4,0,0,0,4,,train
0533563_as-0034928.jpg,1,0,0,0,1,,train
0533564_as-0034928.jpg,2,0,0,0,2,,train
0533565_as-0034928.jpg,4,0,0,0,4,,val
0533566_sc-196846.jpg,2,0,0,0,2,,val
0533567_as-0068319.jpg,1,0,0,0,1,,test
0533568_as-3236881.jpg,2,0,0,0,2,,train
0533570_as-0022428.jpg,1,2,0,0,3,,train
0533571_as-0022428.jpg,3,1,0,0,4,,train
0533572_sc-185043.jpg,1,0,1,0,2,,train
0533574_as-2938960.jpg,0,0,1,0,1,,train
0533575_as-3061428.jpg,5,0,1,0,6,,train
0533578_as-9020604.jpg,6,1,0,2,9,,train
0533579_as-3072067.jpg,4,0,0,0,4,,val
0533580_as-2624402.jpg,5,0,1,0,6,,val
0533583_sc-207613.jpg,2,0,0,1,3,,test
0533584_sc-207613.jpg,2,0,1,0,3,,train
0533585_as-9015801.jpg,4,1,2,3,10,,train
0533586_as-7875265.jpg,0,0,1,1,2,,train
0533587_sc-146403.jpg,1,1,1,0,3,,train
0533588_sc-146403.jpg,3,0,0,0,3,,train
0533589_sc-146403.jpg,2,0,1,0,3,,train
0533590_sc-146403.jpg,1,0,0,0,1,,train
0533591_sc-146403.jpg,3,0,0,0,3,,val
0533593_sc-119869.jpg,1,0,0,1,2,,val
0533594_sc-119869.jpg,2,0,0,1,3,,test
0533595_as-0036879.jpg,1,0,0,0,1,,train
0533596_as-0036879.jpg,1,0,0,0,1,,train
0533597_as-0036879.jpg,1,0,0,0,1,,train
0533598_as-0036879.jpg,1,0,0,0,1,,train
0533599_as-0036879.jpg,4,0,0,0,4,,train
0533600_as-0036879.jpg,3,0,0,0,3,,train
0533601_as-0036879.jpg,1,0,0,0,1,,train
0533602_as-0036879.jpg,1,0,0,0,1,,val
0533603_as-0036879.jpg,1,0,0,0,1,,val
0533608_as-0000859.jpg,1,0,0,0,1,,test
0533610_as-0048462.jpg,2,0,0,0,2,,train
0533611_as-0048462.jpg,3,0,0,0,3,,train
0533612_as-0048462.jpg,1,0,0,0,1,,train
0533613_as-0048462.jpg,2,0,0,0,2,,train
0533614_as-0048462.jpg,1,0,0,0,1,,train
0533615_as-0048462.jpg,4,0,0,0,4,,train
0533616_as-0048462.jpg,2,0,0,0,2,,train
0533617_as-3108375.jpg,1,0,0,0,1,,val
0533618_sc-1005711.jpg,2,0,0,0,2,,val
0533619_sc-1005711.jpg,2,0,0,0,2,,test
0533620_sc-1005711.jpg,1,0,0,1,2,,train
0533621_sc-1005711.jpg,3,0,1,0,4,,train
0533622_sc-1005711.jpg,1,0,0,1,2,,train
0533623_sc-1005711.jpg,1,0,0,1,2,,train
0533624_sc-1005711.jpg,1,0,0,0,1,,train
0533625_sc-1005711.jpg,1,0,0,1,2,,train
0533628_sc-1005711.jpg,1,0,0,1,2,,train
0533629_sc-1005711.jpg,1,0,0,1,2,,val
0533630_sc-1005711.jpg,1,0,0,0,1,,val
0533631_sc-1029899.jpg,1,0,0,1,2,,test
0533632_as-3117167.jpg,1,0,0,1,2,,train
0533633_as-2624289.jpg,0,0,1,0,1,,train
0533634_as-2807139.jpg,0,0,3,0,3,,train
0533635_as-2807139.jpg,1,1,2,0,4,,train
0533636_sc-1037783.jpg,0,0,0,1,1,,train
0533637_sc-1037783.jpg,1,0,1,1,3,,train
0533639_as-0073901.jpg,2,0,2,0,4,,train
0533640_as-0073901.jpg,3,0,1,0,4,,val
0533641_as-0073901.jpg,2,0,1,0,3,,val
0533642_as-0073901.jpg,0,0,1,0,1,,test
0533643_as-0031352.jpg,1,3,0,0,4,,train
0533644_as-0031352.jpg,2,1,3,3,9,,train
0533645_sc-202717.jpg,0,1,2,0,3,,train
0533646_sc-202717.jpg,0,1,1,0,2,,train
0533647_sc-127403.jpg,4,0,0,0,4,,train
0533649_sc-127403.jpg,3,0,0,0,3,,train
0533650_sc-127403.jpg,2,0,0,0,2,,train
0533651_sc-210518.jpg,2,0,0,0,2,,val
0533652_sc-210518.jpg,1,1,0,0,2,,val
0533653_as-7967536.jpg,4,0,0,0,4,,test
0533654_sc-1036317.jpg,1,0,0,0,1,,train
0533655_sc-1036317.jpg,1,0,0,0,1,,train
0533656_sc-1036317.jpg,1,0,0,0,1,,train
0533657_sc-1036317.jpg,2,0,0,0,2,,train
0533658_as-2903301.jpg,2,3,1,0,6,,train
0533659_sc-113882.jpg,2,0,0,0,2,,train
0533661_as-0039016.jpg,6,0,2,0,8,,train
0533662_as-0039016.jpg,3,0,1,0,4,,val
0533663_as-0039016.jpg,9,1,2,0,12,,val
0533664_as-0039016.jpg,7,0,2,0,9,,test
0533665_as-0039016.jpg,3,1,1,0,5,,train
0533666_as-0047564.jpg,1,0,1,0,2,,train
0533667_as-0047564.jpg,1,0,0,0,1,,train
0533668_as-0047564.jpg,1,0,1,0,2,,train
0533669_as-0047564.jpg,1,0,0,0,1,,train
0533670_as-0047564.jpg,2,0,1,0,3,,train
0533671_as-0047564.jpg,1,0,1,0,2,,train
0533672_as-0047564.jpg,0,0,1,0,1,,val
0533673_as-0047564.jpg,1,0,0,0,1,,val
0533674_as-0047564.jpg,1,1,1,0,3,,test
0533675_as-0047564.jpg,1,2,1,0,4,,train
0533676_sc-190134.jpg,2,0,1,1,4,,train
0533677_as-0034501.jpg,1,0,0,0,1,,train
0533678_as-0034501.jpg,1,0,0,1,2,,train
0533679_as-0034501.jpg,1,0,0,1,2,,train
0533680_as-0034501.jpg,2,0,2,1,5,,train
0533681_as-0034501.jpg,0,0,1,1,2,,train
0533682_as-0034501.jpg,0,0,1,1,2,,val
0533683_as-0034501.jpg,1,0,1,0,2,,val
0533685_as-0091370.jpg,2,0,1,0,3,,test
0533686_as-0091370.jpg,3,0,0,0,3,,train
0533687_as-0091370.jpg,0,0,3,0,3,,train
0533688_as-0091370.jpg,0,0,2,0,2,,train
0533689_as-0091370.jpg,0,0,1,0,1,,train
0533690_as-3119162.jpg,2,0,0,0,2,,train
0533691_sc-170488.jpg,0,2,0,0,2,,train
0533692_sc-170488.jpg,0,1,0,0,1,,train
0533693_sc-170488.jpg,1,1,0,0,2,,val
0533694_as-2917560.jpg,1,5,0,0,6,,val
0533695_sc-209726.jpg,2,0,1,1,4,,test
0533696_as-2874267.jpg,2,0,0,0,2,,train
0533698_sc-116278.jpg,1,0,2,1,4,,train
0533699_sc-116278.jpg,1,0,2,1,4,,train
0533700_sc-116278.jpg,1,0,2,1,4,,train
0533702_sc-116278.jpg,1,0,1,0,2,,train
0533703_sc-116278.jpg,1,1,1,1,4,,train
0533704_as-0091831.jpg,0,0,0,1,1,,train
0533705_as-0091831.jpg,0,3,1,0,4,,val
0533706_as-0091831.jpg,1,2,1,1,5,,val
0533707_as-0091831.jpg,0,0,0,1,1,,test
0533708_sc-200402.jpg,1,0,2,0,3,,train
0533709_sc-200402.jpg,6,0,0,0,6,,train
0533710_sc-200402.jpg,0,0,1,0,1,,train
0533711_sc-200402.jpg,0,0,1,0,1,,train
0533712_as-2696017.jpg,1,0,0,0,1,,train
0533714_sc-1023450.jpg,1,0,0,0,1,,train
0533717_sc-1023450.jpg,3,0,0,0,3,,train
0533721_sc-1023450.jpg,1,0,0,0,1,,val
0533722_sc-1023450.jpg,0,0,0,1,1,,val
0533725_sc-1023450.jpg,3,1,0,2,6,,test
0533728_sc-1023450.jpg,1,0,1,0,2,,train
0533729_as-0094237.jpg,3,0,0,0,3,,train
0533730_sc-202507.jpg,4,2,2,0,8,,train
0533731_sc-202507.jpg,2,0,0,0,2,,train
0533732_sc-202507.jpg,2,1,1,0,4,,train
0533733_sc-202507.jpg,1,2,3,2,8,,train
0533734_sc-202507.jpg,2,2,2,2,8,,train
0533735_sc-202507.jpg,3,0,0,0,3,,val
0533736_sc-202507.jpg,7,1,1,0,9,,val
0533737_sc-202507.jpg,2,0,2,0,4,,test
0533738_as-2766056.jpg,2,1,0,0,3,,train
0533740_as-3035063.jpg,0,0,1,0,1,,train
0533741_sc-1008590.jpg,4,1,0,0,5,,train
0533742_sc-1008590.jpg,3,1,1,0,5,,train
0533743_as-3304718.jpg,1,0,0,0,1,,train
0533747_as-0092781.jpg,2,2,2,0,6,,train
0533749_as-0092781.jpg,1,2,2,0,5,,train
0533750_as-0092781.jpg,3,2,2,0,7,,val
0533751_as-0092781.jpg,0,1,0,0,1,,val
0533752_as-0092781.jpg,0,1,0,0,1,,test
0533753_as-0092781.jpg,2,3,1,0,6,,train
0533754_as-0092781.jpg,5,3,1,0,9,,train
0533755_as-0092781.jpg,3,0,0,0,3,,train
0533756_as-0092781.jpg,3,2,0,0,5,,train
0533757_as-0092781.jpg,3,0,0,0,3,,train
0533760_as-0092781.jpg,1,0,0,1,2,,train
0533761_as-0092781.jpg,2,0,0,0,2,,train
0533762_as-0092781.jpg,2,2,0,0,4,,val
0533763_as-0092781.jpg,1,0,0,0,1,,val
0533764_as-0092781.jpg,1,0,0,0,1,,test
0533765_as-0092781.jpg,1,1,0,0,2,,train
0533766_as-0054013.jpg,3,1,1,0,5,,train
0533767_as-2923852.jpg,0,0,0,2,2,,train
0533768_sc-1016809.jpg,2,0,1,0,3,,train
0533770_sc-1016809.jpg,3,0,1,0,4,,train
0533773_as-0091505.jpg,0,1,0,1,2,,train
0533774_as-7483418.jpg,1,0,0,1,2,,train
0533775_as-3284290.jpg,4,0,0,0,4,,val
0533776_as-0009599.jpg,2,0,0,0,2,,val
0533777_as-0050318.jpg,1,0,0,0,1,,test
0533778_as-0050318.jpg,1,0,0,0,1,,train
0533779_as-0050318.jpg,1,0,0,0,1,,train
0533780_as-0050318.jpg,2,0,0,0,2,,train
0533781_as-0050318.jpg,1,0,0,0,1,,train
0533782_as-0050318.jpg,1,0,0,0,1,,train
0533783_as-3076967.jpg,4,0,0,0,4,,train
0533785_sc-1041266.jpg,2,0,0,0,2,,train
0533786_as-0055447.jpg,1,0,0,0,1,,val
0533787_as-0055447.jpg,1,0,0,0,1,,val
0533788_sc-1030715.jpg,3,1,1,0,5,,test
0533789_sc-1030715.jpg,1,1,0,0,2,,train
0533790_sc-1030715.jpg,2,2,1,0,5,,train
0533791_sc-1030715.jpg,2,1,1,1,5,,train
0533792_sc-1030715.jpg,1,0,0,1,2,,train
0533793_sc-1030715.jpg,1,0,0,0,1,,train
0533794_sc-1030715.jpg,1,1,0,1,3,,train
0533795_sc-1030715.jpg,1,0,0,0,1,,train
0533796_sc-1030715.jpg,2,0,1,1,4,,val
0533797_sc-1030715.jpg,2,2,0,0,4,,val
0533798_sc-1030715.jpg,2,3,1,0,6,,test
0533799_sc-1030715.jpg,2,0,0,0,2,,train
0533801_sc-1030980.jpg,2,1,0,0,3,,train
0533803_as-0013338.jpg,4,1,1,1,7,,train
0533804_as-0013338.jpg,3,1,1,1,6,,train
0533805_as-0013338.jpg,2,0,0,0,2,,train
0533806_as-0013338.jpg,4,1,1,1,7,,train
0533807_as-0013338.jpg,3,1,1,1,6,,train
0533808_as-0013338.jpg,3,1,1,1,6,,val
0533809_as-0013338.jpg,1,0,0,0,1,,val
0533810_as-0013338.jpg,3,0,1,1,5,,test
0533811_as-0013338.jpg,1,0,0,0,1,,train
0533812_as-0013338.jpg,3,0,0,1,4,,train
0533813_as-0013338.jpg,2,0,0,0,2,,train
0533814_as-3499137.jpg,3,0,0,0,3,,train
0533816_as-3400704.jpg,6,0,2,0,8,,train
0533817_sc-104960.jpg,2,0,0,0,2,,train
0533818_sc-104960.jpg,2,0,2,0,4,,train
0533819_sc-104960.jpg,0,0,1,0,1,,val
0533822_sc-1021653.jpg,1,0,0,0,1,,val
0533823_sc-1021653.jpg,1,0,0,0,1,,test
0533824_sc-1021653.jpg,1,0,0,0,1,,train
0533826_sc-157996.jpg,1,0,0,0,1,,train
0533827_sc-157996.jpg,2,0,0,0,2,,train
0533829_sc-1023202.jpg,4,1,0,0,5,,train
0533830_sc-1023202.jpg,4,1,0,1,6,,train
0533832_as-0002325.jpg,2,1,0,0,3,,train
0533833_as-0088360.jpg,0,0,1,0,1,,train
0533834_as-0088360.jpg,0,0,1,0,1,,val
0533835_as-0088360.jpg,0,1,0,0,1,,val
0533836_sc-1004954.jpg,1,0,0,0,1,,test
0533838_as-0070852.jpg,1,0,0,0,1,,train
0533839_as-0070852.jpg,1,0,0,0,1,,train
0533840_as-0070852.jpg,2,0,0,0,2,,train
0533841_sc-223537.jpg,2,0,0,0,2,,train
0533842_sc-212524.jpg,2,1,1,0,4,,train
0533844_sc-140585.jpg,3,0,0,0,3,,train
0533846_as-0077270.jpg,1,0,1,0,2,,train
0533847_as-0077270.jpg,3,0,3,0,6,,val
0533848_as-3431996.jpg,1,0,0,0,1,,val
0533849_as-9080637.jpg,1,0,0,0,1,,test
0533850_as-3019016.jpg,2,0,0,0,2,,train
0533851_sc-1034906.jpg,1,0,0,0,1,,train
0533852_sc-1034906.jpg,2,0,1,0,3,,train
0533853_sc-1034906.jpg,1,0,0,0,1,,train
0533854_sc-1034906.jpg,1,0,1,0,2,,train
0533855_sc-1034906.jpg,2,0,0,0,2,,train
0533856_as-7963647.jpg,1,0,1,0,2,,train
0533857_as-0020381.jpg,1,0,0,0,1,,val
0533858_as-0020381.jpg,1,0,0,0,1,,val
0533859_as-0020381.jpg,1,0,0,0,1,,test
0533860_as-0020381.jpg,1,0,0,0,1,,train
0533861_as-9049399.jpg,1,0,0,0,1,,train
0533862_sc-204937.jpg,2,0,0,1,3,,train
0533863_sc-204937.jpg,0,0,1,1,2,,train
0533864_sc-204937.jpg,0,0,1,1,2,,train
0533865_sc-204937.jpg,1,0,0,0,1,,train
0533866_sc-204937.jpg,0,0,0,1,1,,train
0533869_sc-109699.jpg,1,0,0,0,1,,val
0533871_as-3111472.jpg,1,0,2,1,4,,val
0533872_sc-1031250.jpg,3,0,0,0,3,,test
0533874_sc-1031250.jpg,5,0,0,0,5,,train
0533875_as-2786268.jpg,1,0,1,1,3,,train
0533876_sc-167757.jpg,5,0,0,0,5,,train
0533877_sc-1016570.jpg,1,0,2,1,4,,train
0533878_as-9004785.jpg,1,0,0,0,1,,train
0533879_sc-1023110.jpg,1,0,0,1,2,,train
0533880_sc-1023110.jpg,3,0,0,1,4,,train
0533881_sc-127287.jpg,2,0,1,0,3,,val
0533882_sc-127287.jpg,1,1,0,0,2,,val
0533883_as-2717123.jpg,1,0,0,0,1,,test
0533885_as-0049505.jpg,1,1,0,0,2,,train
0533888_as-0067616.jpg,3,0,0,0,3,,train
0533889_as-2737267.jpg,2,0,0,0,2,,train
0533890_as-3435803.jpg,2,0,0,2,4,,train
0533894_as-0067253.jpg,2,0,1,1,4,,train
0533895_as-7217138.jpg,3,0,1,0,4,,train
0533896_as-2525517.jpg,4,1,0,0,5,,train
0533897_sc-214475.jpg,4,0,0,0,4,,val
0533898_sc-214475.jpg,2,0,0,0,2,,val
0533899_sc-214475.jpg,1,0,0,0,1,,test
0533900_sc-188814.jpg,1,0,0,0,1,,train
0533901_sc-114610.jpg,1,0,1,0,2,,train
0533902_sc-114610.jpg,2,0,0,0,2,,train
0533903_sc-114610.jpg,1,0,0,0,1,,train
0533904_sc-114610.jpg,1,0,0,0,1,,train
0533905_sc-114610.jpg,0,1,4,0,5,,train
0533906_sc-114610.jpg,1,0,0,0,1,,train
0533908_as-0076648.jpg,7,1,1,0,9,,val
0533909_as-3163855.jpg,2,0,0,0,2,,val
0533910_as-7667136.jpg,1,0,1,1,3,,test
0533913_as-0021190.jpg,1,0,0,0,1,,train
0533914_as-0021190.jpg,3,0,0,0,3,,train
0533915_sc-220380.jpg,2,0,0,0,2,,train
0533916_sc-220380.jpg,1,0,0,0,1,,train
0533917_sc-220380.jpg,1,0,0,0,1,,train
0533918_sc-220380.jpg,1,0,0,0,1,,train
0533919_sc-220380.jpg,1,0,0,0,1,,train
0533920_sc-181165.jpg,6,0,0,1,7,,val
0533921_sc-181165.jpg,3,0,1,1,5,,val
0533922_sc-181165.jpg,2,0,1,1,4,,test
0533923_as-9083108.jpg,1,1,1,1,4,,train
0533926_sc-131653.jpg,3,1,0,1,5,,train
0533927_sc-131653.jpg,2,1,0,0,3,,train
0533928_sc-131653.jpg,4,4,1,0,9,,train
0533929_sc-131653.jpg,0,1,0,0,1,,train
0533931_sc-186489.jpg,1,0,0,0,1,,train
0533932_sc-208925.jpg,1,1,1,0,3,,train
0533933_sc-208925.jpg,1,1,1,0,3,,val
0533934_sc-208925.jpg,0,1,1,0,2,,val
0533935_sc-208925.jpg,0,0,1,0,1,,test
0533936_as-0003786.jpg,7,3,2,0,12,,train
0533937_as-0003786.jpg,2,1,1,0,4,,train
0533938_as-0003786.jpg,2,0,0,0,2,,train
0533939_sc-203134.jpg,3,4,1,0,8,,train
0533940_sc-203134.jpg,3,1,3,5,12,,train
0533941_sc-203134.jpg,4,1,3,5,13,,train
0533942_as-0064645.jpg,2,0,1,1,4,,train
0533943_as-0064645.jpg,3,0,1,1,5,,val
0533944_as-0064645.jpg,0,0,1,0,1,,val
0533945_as-0064645.jpg,0,0,1,0,1,,test
0533947_as-0064645.jpg,0,0,2,1,3,,train
0533950_as-3207465.jpg,1,0,2,0,3,,train
0533953_sc-111786.jpg,3,0,2,1,6,,train
0533954_as-0057349.jpg,3,0,0,0,3,,train
0533955_as-0057349.jpg,3,0,0,0,3,,train
0533957_sc-133444.jpg,1,0,0,0,1,,train
0533958_as-0005121.jpg,0,0,0,1,1,,train
0533959_as-0005121.jpg,0,0,0,1,1,,val
0533960_as-0005121.jpg,0,1,0,0,1,,val
0533961_as-0005121.jpg,0,1,0,0,1,,test
0533962_as-0005121.jpg,0,1,0,0,1,,train
0533963_sc-165499.jpg,1,1,0,0,2,,train
0533964_sc-1031376.jpg,1,0,0,0,1,,train
0533965_sc-1031376.jpg,1,0,0,0,1,,train
0533966_sc-146704.jpg,1,0,1,1,3,,train
0533967_sc-146704.jpg,1,0,1,1,3,,train
0533968_sc-146704.jpg,2,0,1,0,3,,train
0533969_sc-1022810.jpg,1,0,1,1,3,,val
0533970_sc-1022810.jpg,3,0,1,1,5,,val
0533971_sc-1022810.jpg,4,0,0,0,4,,test
0533972_sc-1022810.jpg,1,0,0,1,2,,train
0533973_sc-1022810.jpg,3,0,1,1,5,,train
0533974_as-9003859.jpg,1,1,0,0,2,,train
0533975_as-2609618.jpg,1,0,0,0,1,,train
0533976_as-2609618.jpg,6,0,1,0,7,,train
0533977_sc-116321.jpg,1,1,1,0,3,,train
0533979_sc-116321.jpg,2,1,1,0,4,,train
0533981_sc-160878.jpg,5,0,0,1,6,,val
0533982_sc-160878.jpg,5,0,0,1,6,,val
0533984_as-2656496.jpg,2,0,2,0,4,,test
0533985_sc-209448.jpg,3,0,0,0,3,,train
0533986_sc-209448.jpg,3,0,1,0,4,,train
0533987_sc-209448.jpg,3,0,1,0,4,,train
0533988_sc-209448.jpg,2,0,1,0,3,,train
0533989_sc-209448.jpg,1,0,0,0,1,,train
0533990_sc-209448.jpg,2,0,0,0,2,,train
0533992_as-0025473.jpg,1,1,0,1,3,,train
0533993_sc-1034283.jpg,5,1,0,0,6,,val
0533994_sc-1034283.jpg,5,0,0,0,5,,val
0533995_sc-1034283.jpg,7,0,0,0,7,,test
0533997_as-3358161.jpg,9,0,0,0,9,,train
0533999_sc-1025813.jpg,1,0,0,1,2,,train
0534000_sc-1025813.jpg,1,0,0,1,2,,train
0534001_as-2891266.jpg,2,0,1,0,3,,train
0534002_as-3314774.jpg,1,0,0,0,1,,train
0534004_sc-111654.jpg,2,0,0,1,3,,train
0534005_sc-111654.jpg,2,0,0,1,3,,train
0534006_sc-111654.jpg,3,0,0,1,4,,val
0534007_sc-161137.jpg,0,0,0,1,1,,val
0534008_as-2845366.jpg,1,0,1,0,2,,test
0534011_as-0045055.jpg,3,0,0,0,3,,train
0534012_sc-200685.jpg,10,1,1,0,12,,train
0534013_sc-200685.jpg,7,1,1,0,9,,train
0534014_as-7762957.jpg,3,0,1,0,4,,train
0534015_as-0039815.jpg,1,0,0,1,2,,train
0534016_as-0039815.jpg,2,0,0,1,3,,train
0534017_sc-154946.jpg,3,0,1,0,4,,train
0534018_sc-154946.jpg,3,0,1,0,4,,val
0534019_sc-154946.jpg,3,0,0,0,3,,val
0534020_as-0049334.jpg,0,0,1,0,1,,test
0534023_as-0049334.jpg,4,1,2,2,9,,train
0534024_as-0049334.jpg,2,0,1,1,4,,train
0534025_as-0049334.jpg,2,0,1,0,3,,train
0534026_as-0049334.jpg,0,0,1,0,1,,train
0534027_as-0049334.jpg,0,0,1,0,1,,train
0534028_as-0049334.jpg,0,0,1,0,1,,train
0534029_as-0049334.jpg,1,1,2,0,4,,train
0534030_as-0049334.jpg,1,0,1,0,2,,val
0534031_as-0049334.jpg,1,1,2,2,6,,val
0534032_as-0049334.jpg,1,1,1,0,3,,test
0534033_as-0049334.jpg,1,1,1,0,3,,train
0534034_as-0049334.jpg,2,1,1,1,5,,train
0534036_as-3499479.jpg,2,0,0,0,2,,train
0534037_as-3273399.jpg,3,0,1,0,4,,train
0534038_sc-126158.jpg,1,0,0,0,1,,train
0534041_sc-126158.jpg,1,0,0,0,1,,train
0534042_sc-126158.jpg,1,0,0,0,1,,train
0534043_sc-126158.jpg,1,1,1,0,3,,val
0534045_sc-1021598.jpg,3,0,0,0,3,,val
0534046_sc-1021598.jpg,1,0,0,0,1,,test
0534047_sc-1021598.jpg,3,0,0,0,3,,train
0534048_sc-214852.jpg,3,0,0,0,3,,train
0534049_sc-214852.jpg,0,0,0,1,1,,train
0534050_sc-214852.jpg,0,0,0,1,1,,train
0534051_sc-214419.jpg,2,0,1,0,3,,train
0534052_sc-214419.jpg,3,0,1,0,4,,train
0534053_as-9001590.jpg,4,1,1,0,6,,train
0534055_sc-225846.jpg,3,1,0,0,4,,val
0534056_sc-225846.jpg,3,0,0,0,3,,val
0534057_sc-225846.jpg,3,0,0,0,3,,test
0534059_as-0076412.jpg,2,0,0,0,2,,train
0534060_sc-1035254.jpg,5,0,0,1,6,,train
0534061_sc-1035254.jpg,2,0,0,1,3,,train
0534062_sc-1035254.jpg,2,0,0,1,3,,train
0534063_sc-1035254.jpg,4,0,0,0,4,,train
0534064_sc-1006804.jpg,1,0,0,0,1,,train
0534065_as-0039911.jpg,10,0,0,0,10,,train
0534066_as-0039911.jpg,7,0,0,0,7,,val
0534069_sc-230447.jpg,2,0,0,0,2,,val
0534070_sc-230447.jpg,3,0,0,0,3,,test
0534071_sc-230447.jpg,2,0,0,0,2,,train
0534074_as-0088938.jpg,6,0,1,0,7,,train
0534075_as-0088938.jpg,3,0,1,0,4,,train
0534076_as-0088938.jpg,1,0,1,0,2,,train
0534077_as-0088938.jpg,5,1,0,0,6,,train
0534078_as-3471609.jpg,1,1,0,0,2,,train
0534079_sc-171032.jpg,0,1,0,0,1,,train
0534080_sc-189661.jpg,3,0,1,0,4,,val
0534081_sc-1000448.jpg,1,0,0,1,2,,val
0534084_as-0006190.jpg,1,0,0,0,1,,test
0534085_as-0099812.jpg,1,0,0,0,1,,train
0534086_as-2962882.jpg,1,0,0,0,1,,train
0534087_as-2736343.jpg,1,0,0,1,2,,train
0534088_as-2780962.jpg,3,2,0,1,6,,train
0534089_as-0072821.jpg,1,0,0,0,1,,train
0534090_as-0072821.jpg,2,0,0,0,2,,train
0534092_sc-125914.jpg,2,0,1,0,3,,train
0534093_sc-125914.jpg,3,0,0,1,4,,val
0534094_sc-125914.jpg,1,0,0,0,1,,val
0534096_sc-125914.jpg,2,0,1,0,3,,test
0534097_sc-125914.jpg,2,0,0,2,4,,train
0534098_sc-125914.jpg,1,0,0,0,1,,train
0534099_as-7884047.jpg,0,0,1,0,1,,train
0534100_sc-186140.jpg,1,0,1,0,2,,train
0534101_sc-186140.jpg,1,0,1,0,2,,train
0534102_sc-186140.jpg,1,0,1,0,2,,train
0534103_sc-186140.jpg,1,0,1,0,2,,train
0534104_as-3152741.jpg,4,0,1,0,5,,val
0534105_sc-122602.jpg,3,0,0,0,3,,val
0534106_sc-122602.jpg,0,0,1,0,1,,test
0534107_sc-122602.jpg,0,0,1,0,1,,train
0534108_sc-122602.jpg,2,0,0,0,2,,train
0534109_sc-122602.jpg,1,0,0,0,1,,train
0534111_as-0080432.jpg,3,0,0,1,4,,train
0534112_as-0080432.jpg,1,0,0,1,2,,train
0534113_as-0080432.jpg,1,0,0,1,2,,train
0534114_as-0080432.jpg,1,0,0,1,2,,train
0534115_as-0080432.jpg,1,0,0,1,2,,val
0534116_as-0080432.jpg,3,0,1,1,5,,val
0534117_as-0080432.jpg,2,0,0,0,2,,test
0534118_as-7960102.jpg,1,0,1,0,2,,train
0534119_sc-166890.jpg,2,0,0,0,2,,train
0534122_as-0082709.jpg,3,0,1,0,4,,train
0534123_as-0082709.jpg,2,0,1,0,3,,train
0534124_as-0082709.jpg,1,0,0,0,1,,train
0534125_sc-156990.jpg,1,0,1,0,2,,train
0534126_sc-156990.jpg,1,0,1,0,2,,train
0534127_sc-156990.jpg,1,0,1,1,3,,val
0534128_sc-156990.jpg,1,0,1,1,3,,val
0534129_sc-227046.jpg,8,1,0,0,9,,test
0534130_sc-227046.jpg,1,1,0,0,2,,train
0534131_sc-227046.jpg,3,1,0,0,4,,train
0534132_sc-227046.jpg,4,1,0,0,5,,train
0534133_sc-227046.jpg,2,0,0,0,2,,train
0534134_as-3272997.jpg,1,0,0,0,1,,train
0534136_sc-159984.jpg,2,0,0,0,2,,train
0534138_sc-159984.jpg,1,0,0,0,1,,train
0534139_sc-159984.jpg,3,0,0,0,3,,val
0534140_sc-159984.jpg,4,0,0,0,4,,val
0534141_sc-159984.jpg,2,0,0,0,2,,test
0534143_sc-128163.jpg,0,0,1,0,1,,train
0534144_sc-128163.jpg,0,0,1,0,1,,train
0534145_sc-128163.jpg,4,1,1,0,6,,train
0534146_as-2602116.jpg,1,0,0,0,1,,train
0534150_as-0067620.jpg,1,1,2,1,5,,train
0534151_as-0067620.jpg,0,0,1,0,1,,train
0534152_sc-159648.jpg,1,0,0,0,1,,train
0534153_sc-159648.jpg,1,0,0,0,1,,val
0534155_sc-164076.jpg,1,2,2,0,5,,val
0534157_sc-164076.jpg,3,2,2,0,7,,test
0534159_as-2925816.jpg,2,0,0,0,2,,train
0534161_as-0089870.jpg,0,1,0,0,1,,train
0534162_as-0089870.jpg,0,1,0,0,1,,train
0534163_as-0034410.jpg,2,0,0,0,2,,train
0534164_as-0034410.jpg,2,0,0,0,2,,train
0534165_as-0034410.jpg,0,2,0,0,2,,train
0534166_as-0034410.jpg,0,1,0,0,1,,train
0534167_as-0034410.jpg,0,1,0,0,1,,val
0534168_as-0034410.jpg,1,1,0,1,3,,val
0534169_as-0034410.jpg,1,0,0,1,2,,test
0534170_as-0030326.jpg,1,0,0,1,2,,train
0534171_as-0030326.jpg,2,0,0,1,3,,train
0534173_as-2649365.jpg,3,0,0,0,3,,train
0534174_as-3071701.jpg,4,0,3,0,7,,train
0534176_as-9094739.jpg,5,1,2,1,9,,train
0534177_sc-139585.jpg,2,0,0,1,3,,train
0534178_sc-139585.jpg,2,0,0,1,3,,train
0534181_sc-196508.jpg,2,1,0,0,3,,val
0534182_sc-197847.jpg,2,0,0,0,2,,val
0534183_sc-219251.jpg,1,0,1,0,2,,test
0534184_sc-219251.jpg,2,0,1,0,3,,train
0534185_sc-143220.jpg,1,0,1,0,2,,train
0534186_sc-172376.jpg,1,1,0,0,2,,train
0534187_sc-172376.jpg,1,0,0,0,1,,train
0534189_as-2802756.jpg,1,0,0,0,1,,train
0534193_as-0086191.jpg,0,1,0,1,2,,train
0534194_as-3210911.jpg,1,1,1,0,3,,train
0534195_as-0055075.jpg,0,0,2,0,2,,val
0534196_sc-206468.jpg,1,1,0,1,3,,val
0534197_sc-1010941.jpg,0,1,0,0,1,,test
0534198_sc-1010941.jpg,0,1,0,0,1,,train
0534203_as-0050005.jpg,5,1,2,1,9,,train
0534204_as-0050005.jpg,1,2,0,0,3,,train
0534205_as-0050005.jpg,3,1,1,1,6,,train
0534206_as-0050005.jpg,1,0,2,0,3,,train
0534207_as-0050005.jpg,1,0,1,0,2,,train
0534208_as-0050005.jpg,1,2,2,0,5,,train
0534209_as-0050005.jpg,0,1,1,0,2,,val
0534210_as-0050005.jpg,1,0,0,0,1,,val
0534211_as-0050005.jpg,1,0,0,0,1,,test
0534212_as-0050005.jpg,1,0,0,0,1,,train
0534213_as-0017641.jpg,0,0,1,0,1,,train
0534214_as-0017641.jpg,1,0,0,0,1,,train
0534215_as-0017641.jpg,3,0,0,0,3,,train
0534221_sc-1036768.jpg,4,0,0,0,4,,train
0534222_sc-1036768.jpg,3,0,0,0,3,,train
0534224_sc-110373.jpg,1,0,0,0,1,,train
0534225_as-3430471.jpg,1,0,0,0,1,,val
0534226_as-0047461.jpg,3,1,0,1,5,,val
0534228_as-0047461.jpg,1,0,0,0,1,,test
0534229_as-0047461.jpg,2,0,0,0,2,,train
0534230_sc-191351.jpg,4,0,0,0,4,,train
0534231_as-3151995.jpg,1,0,0,0,1,,train
0534232_sc-124897.jpg,2,1,0,2,5,,train
0534233_sc-124897.jpg,2,1,0,2,5,,train
0534234_sc-124897.jpg,3,1,0,3,7,,train
0534235_sc-124897.jpg,3,0,0,0,3,,train
0534236_sc-124897.jpg,3,1,0,2,6,,val
0534237_sc-124897.jpg,2,1,0,2,5,,val
0534238_sc-124897.jpg,1,1,0,1,3,,test
0534239_sc-124897.jpg,1,1,0,0,2,,train
0534240_sc-213116.jpg,3,0,1,0,4,,train
0534241_sc-213116.jpg,3,0,1,0,4,,train
0534242_sc-213116.jpg,0,0,1,0,1,,train
0534246_as-0026761.jpg,1,1,2,1,5,,train
0534249_as-2783055.jpg,1,0,0,0,1,,train
0534251_as-7474193.jpg,1,0,0,0,1,,train
0534252_sc-128629.jpg,3,0,0,2,5,,val
0534253_sc-128629.jpg,1,0,0,1,2,,val
0534255_as-0059003.jpg,3,0,0,0,3,,test
0534256_sc-160550.jpg,0,1,1,0,2,,train
0534257_sc-160550.jpg,2,1,1,0,4,,train
0534258_as-0028752.jpg,1,0,0,0,1,,train
0534259_as-0028752.jpg,1,0,0,1,2,,train
0534260_as-0028752.jpg,1,0,1,0,2,,train
0534261_as-0073791.jpg,7,1,0,0,8,,train
0534262_as-0073791.jpg,1,1,1,0,3,,train
0534263_as-0073791.jpg,2,1,1,0,4,,val
0534264_as-0073791.jpg,0,1,0,0,1,,val
0534265_as-0073791.jpg,1,1,0,0,2,,test
0534268_sc-198487.jpg,1,0,0,0,1,,train
0534269_sc-198487.jpg,1,0,0,0,1,,train
0534270_sc-198487.jpg,1,0,0,0,1,,train
0534271_sc-198487.jpg,1,0,1,0,2,,train
0534273_as-3100441.jpg,1,0,0,0,1,,train
0534274_sc-126117.jpg,1,0,0,1,2,,train
0534275_sc-126117.jpg,1,0,0,1,2,,train
0534276_sc-126117.jpg,1,0,0,0,1,,val
0534277_sc-126117.jpg,1,0,0,1,2,,val
0534278_sc-126117.jpg,3,0,0,1,4,,test
0534280_sc-166878.jpg,3,0,0,2,5,,train
0534281_sc-166878.jpg,3,0,0,2,5,,train
0534282_sc-175199.jpg,2,0,2,0,4,,train
0534283_sc-175199.jpg,5,0,1,1,7,,train
0534286_sc-175199.jpg,3,0,1,0,4,,train
0534287_sc-175199.jpg,1,0,0,0,1,,train
0534289_sc-175199.jpg,1,0,1,0,2,,train
0534290_sc-175199.jpg,3,0,1,0,4,,val
0534291_sc-175199.jpg,2,0,1,1,4,,val
0534292_sc-175199.jpg,4,0,1,0,5,,test
0534293_as-2979910.jpg,1,0,0,1,2,,train
0534294_sc-170806.jpg,1,0,0,0,1,,train
0534295_as-2871034.jpg,1,0,0,0,1,,train
0534296_sc-1000822.jpg,0,0,1,0,1,,train
0534297_sc-1000822.jpg,0,1,0,1,2,,train
0534298_sc-111951.jpg,3,0,0,0,3,,train
0534299_sc-1004551.jpg,5,0,1,0,6,,train
0534300_sc-1004551.jpg,6,0,1,0,7,,val
0534301_sc-1004551.jpg,4,0,1,0,5,,val
0534303_as-7469123.jpg,0,1,3,3,7,,test
0534305_sc-1017792.jpg,0,1,0,0,1,,train
0534306_sc-201193.jpg,2,0,1,0,3,,train
0534307_sc-201193.jpg,3,0,1,0,4,,train
0534308_sc-201193.jpg,1,0,1,0,2,,train
0534309_sc-201193.jpg,3,0,1,0,4,,train
0534310_sc-201193.jpg,2,0,1,0,3,,train
0534311_sc-201193.jpg,1,0,0,0,1,,train
0534312_sc-201193.jpg,1,0,1,0,2,,val
0534314_sc-1025899.jpg,1,1,0,0,2,,val
0534315_sc-1025899.jpg,2,3,0,0,5,,test
0534316_sc-1025899.jpg,1,3,0,0,4,,train
0534318_as-0000447.jpg,1,0,0,0,1,,train
0534319_as-0000447.jpg,1,0,0,0,1,,train
0534320_as-0000447.jpg,4,0,0,1,5,,train
0534321_as-0025605.jpg,2,1,1,0,4,,train
0534322_as-0025605.jpg,5,1,2,1,9,,train
0534323_as-0025605.jpg,1,0,0,0,1,,train
0534324_sc-1040446.jpg,2,0,0,0,2,,val
0534326_as-0027492.jpg,0,1,0,0,1,,val
0534327_sc-1012285.jpg,2,0,0,0,2,,test
0534328_sc-1012285.jpg,6,0,0,0,6,,train
0534329_sc-1012285.jpg,2,0,0,1,3,,train
0534330_sc-1012285.jpg,1,0,0,0,1,,train
0534331_sc-1012285.jpg,6,0,0,0,6,,train
0534334_sc-1034865.jpg,9,0,2,5,16,,train
0534336_sc-1034865.jpg,5,0,2,3,10,,train
0534337_sc-1034865.jpg,2,0,1,1,4,,train
0534338_sc-1034865.jpg,3,0,2,4,9,,val
0534339_as-0095620.jpg,1,0,0,0,1,,val
0534341_as-3486970.jpg,3,0,0,0,3,,test
0534344_as-0024981.jpg,3,1,2,0,6,,train
0534345_as-0024981.jpg,1,1,1,1,4,,train
0534346_as-3445754.jpg,2,0,1,0,3,,train
0534351_sc-226878.jpg,2,0,1,0,3,,train
0534352_sc-226878.jpg,1,0,1,0,2,,train
0534353_sc-226878.jpg,1,0,0,0,1,,train
0534359_as-0041003.jpg,2,3,0,0,5,,train
0534360_as-0041003.jpg,1,1,0,1,3,,val
0534363_as-0023706.jpg,3,0,0,0,3,,val
0534364_as-0023706.jpg,0,0,0,1,1,,test
0534365_as-0023706.jpg,1,0,1,1,3,,train
0534366_as-0023706.jpg,1,0,0,0,1,,train
0534367_as-0023706.jpg,1,0,0,0,1,,train
0534368_as-3324918.jpg,1,0,1,0,2,,train
0534369_as-3198190.jpg,2,0,1,0,3,,train
0534370_sc-178572.jpg,4,3,2,2,11,,train
0534371_sc-178572.jpg,3,1,1,2,7,,train
0534372_sc-178572.jpg,2,2,1,2,7,,val
0534373_sc-1040045.jpg,1,0,0,0,1,,val
0534375_sc-1040045.jpg,3,0,1,0,4,,test
0534376_as-2513842.jpg,2,0,0,0,2,,train
0534377_as-7252522.jpg,2,3,4,2,11,,train
0534378_as-2853103.jpg,2,1,1,0,4,,train
0534379_as-2853103.jpg,1,0,0,0,1,,train
0534380_as-2514615.jpg,0,0,0,1,1,,train
0534381_sc-177660.jpg,1,0,1,0,2,,train
0534382_sc-177660.jpg,2,0,0,0,2,,train
0534383_sc-177660.jpg,0,0,1,0,1,,val
0534384_sc-177660.jpg,3,0,1,1,5,,val
0534385_sc-177660.jpg,2,0,0,0,2,,test
0534386_sc-177660.jpg,4,0,0,0,4,,train
0534387_sc-177660.jpg,2,0,0,0,2,,train
0534388_sc-177660.jpg,2,0,0,0,2,,train
0534389_as-0096543.jpg,5,0,0,0,5,,train
0534390_as-0096543.jpg,1,0,0,0,1,,train
0534393_as-0086471.jpg,1,1,0,0,2,,train
0534394_as-0086471.jpg,1,0,1,0,2,,train
0534395_as-0086471.jpg,0,3,0,0,3,,val
0534398_as-3357645.jpg,2,0,1,0,3,,val
0534400_as-0033245.jpg,0,1,0,0,1,,test
0534403_as-2819227.jpg,1,0,0,0,1,,train
0534404_as-3142957.jpg,0,0,1,0,1,,train
0534405_as-2652199.jpg,3,1,1,1,6,,train
0534406_as-3025921.jpg,3,0,0,0,3,,train
0534407_as-0020861.jpg,1,0,0,0,1,,train
0534408_as-0020861.jpg,1,0,0,0,1,,train
0534409_as-0020861.jpg,1,0,0,0,1,,train
0534410_as-2636128.jpg,2,0,0,0,2,,val
0534411_sc-109975.jpg,1,0,0,0,1,,val
0534412_sc-109975.jpg,1,0,0,0,1,,test
0534413_sc-109975.jpg,1,0,0,0,1,,train
0534414_sc-109975.jpg,1,0,0,0,1,,train
0534415_sc-198756.jpg,1,0,1,0,2,,train
0534416_sc-198756.jpg,2,0,0,0,2,,train
0534417_sc-198756.jpg,1,0,1,0,2,,train
0534418_sc-221302.jpg,2,1,1,0,4,,train
0534420_sc-107732.jpg,0,1,0,0,1,,train
0534421_as-0023359.jpg,2,0,0,0,2,,val
0534422_as-0023359.jpg,1,0,0,0,1,,val
0534423_as-3403087.jpg,1,0,1,0,2,,test
0534424_sc-112985.jpg,3,0,0,0,3,,train
0534426_as-0075374.jpg,1,0,0,0,1,,train
0534429_as-0075374.jpg,1,0,0,0,1,,train
0534430_as-0075374.jpg,1,0,0,0,1,,train
0534431_sc-203085.jpg,6,0,1,0,7,,train
0534432_sc-203085.jpg,1,0,0,0,1,,train
0534433_sc-203085.jpg,6,0,1,1,8,,train
0534437_as-9054555.jpg,3,1,0,0,4,,val
0534438_as-0057209.jpg,1,0,0,0,1,,val
0534439_as-2786552.jpg,1,0,1,0,2,,test
0534440_as-0004223.jpg,7,0,0,1,8,,train
0534441_as-0004223.jpg,3,0,0,0,3,,train
0534442_as-0004223.jpg,2,0,1,2,5,,train
0534443_as-0004223.jpg,1,0,0,2,3,,train
0534444_as-0004223.jpg,3,0,0,1,4,,train
0534445_sc-1014643.jpg,3,0,2,1,6,,train
0534448_as-0078513.jpg,1,0,0,0,1,,train
0534449_as-0078513.jpg,2,0,0,0,2,,val
0534450_as-3284167.jpg,2,1,1,0,4,,val
0534451_as-7722400.jpg,3,0,1,0,4,,test
0534452_sc-217243.jpg,1,0,1,0,2,,train
0534453_sc-217243.jpg,1,0,1,1,3,,train
0534454_sc-217243.jpg,1,0,1,0,2,,train
0534455_sc-217243.jpg,1,0,0,0,1,,train
0534456_sc-217243.jpg,1,0,0,0,1,,train
0534457_sc-217243.jpg,1,0,1,0,2,,train
0534458_sc-217243.jpg,4,0,0,0,4,,train
0534459_sc-217243.jpg,1,0,0,0,1,,val
0534461_sc-218848.jpg,1,0,1,0,2,,val
0534462_sc-198341.jpg,2,0,0,0,2,,test
0534463_sc-198341.jpg,6,0,0,0,6,,train
0534469_sc-183851.jpg,1,0,0,1,2,,train
0534470_sc-183851.jpg,1,0,0,1,2,,train
0534471_sc-183851.jpg,2,0,0,0,2,,train
0534472_sc-183851.jpg,3,0,0,1,4,,train
0534473_sc-183851.jpg,3,0,0,1,4,,train
0534475_sc-177475.jpg,2,0,1,0,3,,train
0534477_as-0039701.jpg,3,1,0,0,4,,val
0534478_as-0039701.jpg,8,0,1,0,9,,val
0534480_as-0039701.jpg,7,1,0,0,8,,test
0534481_as-2838323.jpg,1,0,0,0,1,,train
0534482_as-7087808.jpg,0,0,1,0,1,,train
0534483_as-0089912.jpg,2,0,0,1,3,,train
0534484_as-0094206.jpg,4,1,0,0,5,,train
0534485_as-0094206.jpg,4,1,0,0,5,,train
0534486_as-0094206.jpg,3,0,1,0,4,,train
0534488_as-0094206.jpg,2,0,1,0,3,,train
0534490_as-0100029.jpg,3,0,0,1,4,,val
0534491_sc-213686.jpg,1,0,1,1,3,,val
0534492_sc-213686.jpg,1,0,1,1,3,,test
0534493_sc-213686.jpg,1,0,1,1,3,,train
0534494_sc-213686.jpg,0,0,1,1,2,,train
0534495_sc-213686.jpg,1,0,0,0,1,,train
0534496_sc-213686.jpg,1,0,0,0,1,,train
0534497_sc-193809.jpg,6,0,0,0,6,,train
0534498_sc-193809.jpg,7,0,0,0,7,,train
0534499_sc-193809.jpg,1,0,0,0,1,,train
0534500_as-0017590.jpg,4,0,0,0,4,,val
0534501_as-0080653.jpg,1,2,0,0,3,,val
0534502_as-0080653.jpg,1,2,0,0,3,,test
0534504_as-0080653.jpg,7,0,0,0,7,,train
0534505_as-0080653.jpg,4,0,0,0,4,,train
0534506_as-0080653.jpg,4,0,0,0,4,,train
0534507_as-0080653.jpg,1,0,0,0,1,,train
0534510_as-0057521.jpg,0,1,0,0,1,,train
0534511_as-2628524.jpg,2,0,0,1,3,,train
0534512_sc-148250.jpg,1,0,1,0,2,,train
0534513_sc-148250.jpg,3,0,0,1,4,,val
0534514_sc-148250.jpg,1,0,1,0,2,,val
0534515_sc-148250.jpg,1,0,0,0,1,,test
0534517_sc-1033489.jpg,3,1,1,0,5,,train
0534522_as-0059786.jpg,4,1,2,0,7,,train
0534524_as-0059786.jpg,3,0,0,0,3,,train
0534525_as-0059786.jpg,3,0,0,0,3,,train
0534526_as-0059786.jpg,2,0,0,0,2,,train
0534527_as-0059786.jpg,4,0,0,0,4,,train
0534528_as-0059786.jpg,3,0,2,0,5,,train
0534530_sc-1026954.jpg,0,0,0,1,1,,val
0534531_sc-1026954.jpg,0,0,0,1,1,,val
0534532_as-7576769.jpg,0,1,0,0,1,,test
0534533_as-0019799.jpg,2,0,0,0,2,,train
0534534_as-0019799.jpg,2,0,0,0,2,,train
0534535_as-0019799.jpg,1,0,1,0,2,,train
0534536_as-0019799.jpg,1,0,1,0,2,,train
0534537_as-0019799.jpg,1,0,1,0,2,,train
0534539_as-0019799.jpg,1,0,0,0,1,,train
0534540_as-0019799.jpg,2,0,0,0,2,,train
0534541_as-0036802.jpg,1,0,0,1,2,,val
0534542_as-0036802.jpg,1,0,0,0,1,,val
0534543_as-0036802.jpg,1,0,0,0,1,,test
0534544_as-0036802.jpg,3,0,0,1,4,,train
0534545_as-0036802.jpg,5,0,1,0,6,,train
0534547_as-0036802.jpg,5,0,1,0,6,,train
0534548_sc-1028824.jpg,1,3,1,0,5,,train
0534549_sc-1028824.jpg,2,1,1,0,4,,train
0534551_as-3259243.jpg,3,0,1,0,4,,train
0534553_as-3381352.jpg,2,1,0,0,3,,train
0534554_sc-1039162.jpg,1,0,1,1,3,,val
0534557_sc-1039162.jpg,2,0,1,1,4,,val
0534558_sc-153334.jpg,1,0,0,0,1,,test
0534560_sc-153334.jpg,0,2,1,0,3,,train
0534561_sc-198140.jpg,1,0,1,1,3,,train
0534562_sc-198140.jpg,0,0,0,1,1,,train
0534563_sc-198140.jpg,1,0,0,1,2,,train
0534565_sc-179294.jpg,3,0,1,0,4,,train
0534566_sc-179294.jpg,5,0,0,0,5,,train
0534567_sc-179294.jpg,1,0,1,0,2,,train
0534568_sc-1031946.jpg,3,0,0,1,4,,val
0534569_sc-1031946.jpg,3,0,0,1,4,,val
0534570_sc-1031946.jpg,2,0,1,0,3,,test
0534571_as-2584060.jpg,2,0,1,0,3,,train
0534572_sc-188759.jpg,1,0,0,0,1,,train
0534573_sc-188759.jpg,1,0,0,0,1,,train
0534574_sc-188759.jpg,1,0,0,0,1,,train
0534575_sc-188759.jpg,1,0,0,1,2,,train
0534576_sc-188759.jpg,1,0,0,0,1,,train
0534577_sc-188759.jpg,1,0,0,0,1,,train
0534578_sc-188759.jpg,1,0,0,0,1,,val
0534579_sc-188759.jpg,1,0,0,0,1,,val
0534580_sc-188759.jpg,1,0,0,0,1,,test
0534581_sc-188759.jpg,1,0,0,0,1,,train
0534582_as-2698716.jpg,1,1,0,0,2,,train
0534587_as-0040427.jpg,2,1,2,0,5,,train
0534588_as-0040427.jpg,2,1,2,0,5,,train
0534589_as-0040427.jpg,1,1,2,0,4,,train
0534590_as-0040427.jpg,0,0,1,0,1,,train
0534591_as-0040427.jpg,0,0,1,0,1,,train
0534592_as-0040427.jpg,1,1,2,0,4,,val
0534595_sc-1003396.jpg,0,1,1,1,3,,val
0534596_sc-1003396.jpg,2,1,1,1,5,,test
0534597_sc-1003396.jpg,1,3,0,0,4,,train
0534599_sc-1003396.jpg,1,2,1,0,4,,train
0534600_sc-1003396.jpg,0,1,1,0,2,,train
0534603_as-0021365.jpg,2,0,0,0,2,,train
0534605_as-0021365.jpg,1,0,0,0,1,,train
0534607_as-0021365.jpg,5,0,0,0,5,,train
0534608_as-0045335.jpg,5,0,1,1,7,,train
0534609_as-0045335.jpg,3,0,0,1,4,,val
0534610_as-0045335.jpg,2,0,0,1,3,,val
0534611_as-0045335.jpg,3,0,1,0,4,,test
0534612_as-0045335.jpg,1,2,0,0,3,,train
0534613_as-0045335.jpg,1,1,0,0,2,,train
0534614_as-0045335.jpg,1,0,1,0,2,,train
0534615_sc-165699.jpg,3,0,1,1,5,,train
0534616_sc-165699.jpg,1,0,1,1,3,,train
0534617_sc-165699.jpg,1,0,1,1,3,,train
0534618_sc-165699.jpg,3,0,1,1,5,,train
0534619_as-2904818.jpg,3,1,1,1,6,,val
0534620_as-3088800.jpg,2,0,0,0,2,,val
0534621_as-2898825.jpg,3,5,0,0,8,,test
0534623_sc-130344.jpg,2,0,0,1,3,,train
0534625_sc-130344.jpg,2,0,0,0,2,,train
0534626_sc-130344.jpg,3,0,0,1,4,,train
0534627_sc-130344.jpg,3,0,0,0,3,,train
0534628_as-3356511.jpg,3,0,1,0,4,,train
0534629_sc-192909.jpg,1,0,0,1,2,,train
0534630_sc-192909.jpg,1,0,0,0,1,,train
0534631_sc-192909.jpg,1,0,0,0,1,,val
0534632_sc-192909.jpg,1,0,0,0,1,,val
0534633_sc-192909.jpg,1,0,0,0,1,,test
0534634_sc-192909.jpg,1,0,0,1,2,,train
0534635_sc-192909.jpg,1,0,0,1,2,,train
0534636_sc-192909.jpg,4,0,0,0,4,,train
0534637_sc-192909.jpg,5,0,0,0,5,,train
0534638_sc-192909.jpg,2,0,0,0,2,,train
0534639_as-2512438.jpg,1,0,0,0,1,,train
0534640_as-5045389.jpg,4,1,0,0,5,,train
0534641_as-0009556.jpg,5,0,1,1,7,,val
0534642_as-0009556.jpg,7,0,0,1,8,,val
0534643_as-0009556.jpg,4,0,0,0,4,,test
0534644_as-0009556.jpg,7,0,0,0,7,,train
0534645_as-2866878.jpg,2,0,1,2,5,,train
0534646_as-0033998.jpg,1,3,1,0,5,,train
0534647_as-0033998.jpg,1,1,1,0,3,,train
0534648_as-0033998.jpg,1,1,1,1,4,,train
0534650_as-0033998.jpg,1,2,1,0,4,,train
0534652_sc-187760.jpg,1,0,0,1,2,,train
0534653_sc-187760.jpg,1,0,0,0,1,,val
0534654_sc-187760.jpg,1,0,1,0,2,,val
0534655_sc-187760.jpg,0,0,1,0,1,,test
0534656_sc-187760.jpg,1,0,0,0,1,,train
0534658_sc-187760.jpg,0,0,1,0,1,,train
0534659_sc-187760.jpg,1,0,1,0,2,,train
0534660_sc-187760.jpg,1,0,0,0,1,,train
0534662_sc-187760.jpg,1,0,0,0,1,,train
0534663_sc-187760.jpg,1,0,1,0,2,,train
0534664_sc-187760.jpg,1,0,0,0,1,,train
0534665_sc-187760.jpg,1,0,1,0,2,,val
0534667_sc-187760.jpg,1,1,0,0,2,,val
0534668_sc-187760.jpg,1,0,1,0,2,,test
0534669_sc-187760.jpg,1,0,0,0,1,,train
0534670_sc-174379.jpg,4,0,0,0,4,,train
0534672_sc-221470.jpg,8,0,0,0,8,,train
0534673_sc-221470.jpg,1,0,1,0,2,,train
0534674_as-3272853.jpg,2,0,0,0,2,,train
0534675_sc-157953.jpg,2,0,0,0,2,,train
0534678_sc-157953.jpg,2,0,0,0,2,,train
0534679_sc-157953.jpg,2,0,0,0,2,,val
0534681_sc-157953.jpg,2,0,0,0,2,,val
0534684_sc-1026135.jpg,2,0,1,1,4,,test
0534685_sc-1026135.jpg,3,0,1,1,5,,train
0534686_sc-161187.jpg,4,0,1,0,5,,train
0534687_sc-161187.jpg,0,0,1,0,1,,train
0534689_sc-161187.jpg,6,0,1,0,7,,train
0534691_sc-161187.jpg,9,0,1,0,10,,train
0534693_sc-132015.jpg,8,0,1,2,11,,train
0534694_sc-132015.jpg,4,0,0,1,5,,train
0534695_sc-132015.jpg,2,0,1,0,3,,val
0534697_as-0013087.jpg,3,0,0,0,3,,val
0534698_as-0013087.jpg,2,0,0,0,2,,test
0534699_as-0013087.jpg,1,0,0,1,2,,train
0534700_as-0013087.jpg,1,0,0,1,2,,train
0534701_sc-182556.jpg,1,0,0,0,1,,train
0534702_sc-1025217.jpg,2,0,0,0,2,,train
0534703_sc-1025217.jpg,2,0,0,0,2,,train
0534704_as-0028416.jpg,1,1,2,0,4,,train
0534705_as-0028416.jpg,0,0,1,0,1,,train
0534706_as-0028416.jpg,3,0,0,0,3,,val
0534707_as-0028416.jpg,2,0,0,0,2,,val
0534708_as-2868252.jpg,1,0,1,0,2,,test
0534709_as-2868252.jpg,0,1,2,0,3,,train
0534711_as-0006038.jpg,2,1,0,1,4,,train
0534717_sc-118078.jpg,3,0,0,0,3,,train
0534718_sc-118078.jpg,1,0,0,0,1,,train
0534719_as-7444359.jpg,1,1,2,1,5,,train
0534720_as-3270063.jpg,1,0,0,0,1,,train
0534721_as-3185415.jpg,0,1,2,1,4,,train
0534722_as-9015217.jpg,2,1,0,0,3,,val
0534725_as-0078453.jpg,8,0,0,2,10,,val
0534729_as-0047580.jpg,2,0,1,0,3,,test
0534730_as-0047580.jpg,1,0,1,0,2,,train
0534731_as-0047580.jpg,2,0,1,0,3,,train
0534732_as-0047580.jpg,2,0,1,0,3,,train
0534733_as-0047580.jpg,2,0,1,0,3,,train
0534734_as-0047580.jpg,1,0,0,0,1,,train
0534735_as-0047580.jpg,2,0,1,0,3,,train
0534736_as-0047580.jpg,1,0,0,0,1,,train
0534737_sc-1025957.jpg,1,0,0,2,3,,val
0534738_sc-1025957.jpg,1,0,0,2,3,,val
0534739_sc-1025957.jpg,1,0,0,2,3,,test
0534740_sc-1025957.jpg,1,0,0,2,3,,train
0534741_sc-1025957.jpg,1,0,0,0,1,,train
0534742_sc-1025957.jpg,1,0,0,0,1,,train
0534743_as-3392875.jpg,1,0,0,0,1,,train
0534744_sc-201201.jpg,2,0,0,0,2,,train
0534745_sc-201201.jpg,0,0,0,1,1,,train
0534746_sc-201201.jpg,1,0,0,1,2,,train
0534747_sc-201201.jpg,2,0,0,1,3,,val
0534748_sc-201201.jpg,2,0,0,1,3,,val
0534750_sc-153078.jpg,2,0,0,1,3,,test
0534751_sc-153078.jpg,1,0,2,0,3,,train
0534752_sc-212338.jpg,1,0,1,1,3,,train
0534753_sc-212338.jpg,4,0,1,2,7,,train
0534754_sc-212338.jpg,2,0,0,1,3,,train
0534755_sc-212338.jpg,3,0,1,1,5,,train
0534756_sc-212338.jpg,3,0,0,1,4,,train
0534757_sc-212338.jpg,2,0,0,0,2,,train
0534760_sc-166125.jpg,1,0,0,0,1,,val
0534761_sc-166125.jpg,1,0,0,0,1,,val
0534762_sc-212037.jpg,1,0,0,0,1,,test
0534763_sc-212037.jpg,1,0,0,0,1,,train
0534764_sc-180578.jpg,2,0,0,0,2,,train
0534765_sc-180578.jpg,1,0,0,0,1,,train
0534766_sc-180578.jpg,1,0,0,0,1,,train
0534767_sc-180578.jpg,1,0,0,0,1,,train
0534768_sc-180578.jpg,1,0,0,0,1,,train
0534769_sc-180578.jpg,1,0,0,0,1,,train
0534770_sc-180578.jpg,1,0,0,0,1,,val
0534771_sc-180578.jpg,1,0,0,0,1,,val
0534774_as-0071290.jpg,2,0,0,0,2,,test
0534775_as-0071290.jpg,2,0,0,0,2,,train
0534776_as-0071290.jpg,2,0,0,0,2,,train
0534777_as-0071290.jpg,1,0,0,0,1,,train
0534778_as-0071290.jpg,2,0,0,0,2,,train
0534780_sc-196382.jpg,1,1,0,0,2,,train
0534781_sc-196382.jpg,1,1,0,1,3,,train
0534782_sc-196382.jpg,1,0,0,0,1,,train
0534783_sc-196382.jpg,1,0,0,0,1,,val
0534784_sc-196382.jpg,1,0,0,0,1,,val
0534785_sc-140044.jpg,0,0,1,0,1,,test
0534788_as-0068729.jpg,1,0,0,0,1,,train
0534789_as-0068729.jpg,1,0,0,0,1,,train
0534791_as-0068729.jpg,2,0,0,0,2,,train
0534792_as-3371717.jpg,1,0,1,0,2,,train
0534793_as-0023750.jpg,2,1,0,0,3,,train
0534794_as-7926899.jpg,2,0,0,0,2,,train
0534795_sc-1002190.jpg,1,1,1,0,3,,train
0534796_sc-1002190.jpg,0,1,1,0,2,,val
0534797_sc-1002190.jpg,0,1,1,0,2,,val
0534798_sc-1002190.jpg,0,1,1,0,2,,test
0534801_sc-162720.jpg,2,0,1,0,3,,train
0534802_sc-162720.jpg,2,0,0,0,2,,train
0534803_sc-162720.jpg,1,0,0,0,1,,train
0534804_as-0075772.jpg,1,0,0,0,1,,train
0534805_as-3289908.jpg,0,0,1,0,1,,train
0534806_as-2602987.jpg,2,0,0,0,2,,train
0534807_sc-123619.jpg,2,0,0,1,3,,train
0534808_sc-123619.jpg,1,0,0,1,2,,val
0534809_sc-123619.jpg,1,0,0,0,1,,val
0534810_sc-123619.jpg,2,0,0,0,2,,test
0534811_as-7384455.jpg,0,0,2,0,2,,train
0534812_sc-193915.jpg,3,0,0,0,3,,train
0534813_sc-205209.jpg,1,0,1,0,2,,train
0534814_sc-205209.jpg,1,0,1,0,2,,train
0534815_sc-205209.jpg,2,0,1,0,3,,train
0534819_sc-154990.jpg,1,0,1,1,3,,train
0534820_sc-154990.jpg,1,0,1,1,3,,train
0534823_as-0041504.jpg,0,0,5,3,8,,val
0534824_as-0041504.jpg,0,1,4,2,7,,val
0534826_as-0041504.jpg,0,1,0,0,1,,test
0534827_as-0041504.jpg,1,0,1,0,2,,train
0534828_as-0041504.jpg,1,0,1,0,2,,train
0534829_as-0041504.jpg,4,0,1,0,5,,train
0534834_as-0041504.jpg,0,1,1,0,2,,train
0534835_as-0041504.jpg,1,1,1,1,4,,train
0534836_sc-1037741.jpg,1,0,0,0,1,,train
0534837_as-2613177.jpg,1,2,2,0,5,,train
0534840_sc-136771.jpg,6,0,0,0,6,,val
0534841_sc-136771.jpg,7,0,0,0,7,,val
0534842_sc-136771.jpg,7,1,0,0,8,,test
0534843_sc-136771.jpg,2,1,0,0,3,,train
0534844_as-7716488.jpg,3,0,1,0,4,,train
0534845_as-2729428.jpg,7,0,1,0,8,,train
0534846_sc-1037508.jpg,1,0,0,1,2,,train
0534847_sc-1037508.jpg,1,0,0,1,2,,train
0534849_as-0070996.jpg,1,0,0,0,1,,train
0534850_as-0070996.jpg,1,0,0,0,1,,train
0534851_as-0070996.jpg,1,0,0,0,1,,val
0534852_as-2750004.jpg,1,0,0,0,1,,val
0534853_sc-115305.jpg,2,0,0,0,2,,test
0534856_as-0018088.jpg,1,1,1,0,3,,train
0534857_as-0018088.jpg,1,0,1,0,2,,train
0534858_as-0018088.jpg,2,1,1,0,4,,train
0534861_as-0038451.jpg,2,0,0,0,2,,train
0534862_as-0038451.jpg,2,0,0,0,2,,train
0534863_as-0038451.jpg,1,0,0,0,1,,train
0534864_as-0038451.jpg,1,0,0,0,1,,train
0534865_as-0038451.jpg,1,0,0,0,1,,val
0534866_as-7263428.jpg,2,0,0,0,2,,val
0534867_as-0061551.jpg,1,0,0,0,1,,test
0534868_as-0061551.jpg,5,0,1,0,6,,train
0534869_as-0061551.jpg,6,0,0,0,6,,train
0534870_as-0061551.jpg,3,0,0,0,3,,train
0534871_as-0061551.jpg,2,0,0,0,2,,train
0534872_as-0061551.jpg,1,0,1,0,2,,train
0534873_as-0061551.jpg,2,0,0,0,2,,train
0534874_as-0061551.jpg,2,0,0,0,2,,train
0534875_as-0046262.jpg,2,0,0,0,2,,val
0534877_as-0046262.jpg,3,0,0,0,3,,val
0534878_as-0046262.jpg,4,0,0,0,4,,test
0534879_as-0046262.jpg,1,0,0,0,1,,train
0534880_as-0046262.jpg,2,0,0,0,2,,train
0534881_as-0046262.jpg,3,0,0,0,3,,train
0534882_as-0046262.jpg,1,0,0,0,1,,train
0534883_as-0046262.jpg,2,0,0,0,2,,train
0534884_as-0046262.jpg,2,0,0,0,2,,train
0534885_as-7065793.jpg,2,0,0,0,2,,train
0534886_sc-134094.jpg,2,0,0,0,2,,val
0534887_sc-134094.jpg,0,0,1,0,1,,val
0534889_sc-134094.jpg,2,0,0,0,2,,test
0534890_sc-134094.jpg,1,0,0,0,1,,train
0534891_as-0077637.jpg,6,0,0,0,6,,train
0534892_as-0077637.jpg,1,0,0,0,1,,train
0534894_as-7747865.jpg,1,1,0,0,2,,train
0534895_as-0022374.jpg,2,0,0,0,2,,train
0534896_as-0022374.jpg,4,0,0,0,4,,train
0534899_sc-120983.jpg,1,1,0,0,2,,train
0534900_sc-199928.jpg,3,1,0,0,4,,val
0534901_as-0029869.jpg,0,1,0,0,1,,val
0534902_as-0029869.jpg,0,1,0,0,1,,test
0534903_as-0029869.jpg,0,2,0,0,2,,train
0534905_sc-193156.jpg,2,0,0,0,2,,train
0534906_sc-193156.jpg,2,1,0,0,3,,train
0534907_sc-193156.jpg,1,0,0,0,1,,train
0534908_as-0082568.jpg,1,0,0,0,1,,train
0534909_as-2829186.jpg,2,0,1,1,4,,train
0534911_sc-185158.jpg,2,0,0,0,2,,train
0534912_sc-185158.jpg,2,0,0,0,2,,val
0534913_as-2560872.jpg,1,0,0,0,1,,val
0534914_as-0071505.jpg,1,0,0,0,1,,test
0534915_as-0071505.jpg,1,0,0,0,1,,train
0534916_as-0075519.jpg,3,1,3,1,8,,train
0534918_as-0075519.jpg,1,1,0,0,2,,train
0534919_as-0075519.jpg,0,1,0,0,1,,train
0534920_as-0075519.jpg,6,0,0,0,6,,train
0534922_sc-143270.jpg,1,0,0,0,1,,train
0534923_sc-143270.jpg,1,0,0,0,1,,train
0534924_sc-143270.jpg,1,0,0,0,1,,val
0534925_sc-143270.jpg,1,0,0,0,1,,val
0534926_sc-143270.jpg,1,0,0,0,1,,test
0534927_sc-143270.jpg,1,0,0,0,1,,train
0534928_sc-143270.jpg,1,0,0,0,1,,train
0534929_sc-143270.jpg,1,0,0,0,1,,train
0534930_sc-143270.jpg,1,0,0,0,1,,train
0534932_sc-205599.jpg,3,0,0,0,3,,train
0534933_sc-205599.jpg,2,0,0,0,2,,train
0534934_sc-205599.jpg,1,0,0,0,1,,train
0534935_sc-205599.jpg,1,0,0,0,1,,val
0534936_sc-205599.jpg,1,0,0,0,1,,val
0534937_sc-205599.jpg,2,0,0,0,2,,test
0534939_as-0078628.jpg,7,0,0,0,7,,train
0534940_as-0078628.jpg,1,2,0,1,4,,train
0534941_as-0049325.jpg,2,0,0,0,2,,train
0534942_as-0049325.jpg,2,0,0,0,2,,train
0534943_as-0049325.jpg,1,0,0,0,1,,train
0534944_as-0049325.jpg,3,0,0,0,3,,train
0534945_as-0049325.jpg,4,0,0,0,4,,train
0534946_as-0049325.jpg,4,0,0,0,4,,val
0534947_as-0049325.jpg,4,0,0,0,4,,val
0534948_as-0049325.jpg,4,0,0,0,4,,test
0534949_as-0049325.jpg,4,0,0,0,4,,train
0534950_sc-123435.jpg,1,1,0,1,3,,train
0534951_sc-123435.jpg,1,1,0,1,3,,train
0534952_sc-123435.jpg,1,1,0,1,3,,train
0534953_sc-123435.jpg,1,1,0,1,3,,train
0534954_as-2929283.jpg,1,0,1,0,2,,train
0534955_sc-159394.jpg,4,0,0,0,4,,train
0534956_sc-217938.jpg,1,0,0,0,1,,val
0534957_sc-217938.jpg,0,0,2,1,3,,val
0534958_sc-217938.jpg,0,0,1,0,1,,test
0534959_sc-192588.jpg,4,0,0,0,4,,train
0534960_sc-192588.jpg,1,0,0,1,2,,train
0534961_sc-192588.jpg,4,0,1,0,5,,train
0534962_sc-192588.jpg,4,0,0,0,4,,train
0534963_sc-192588.jpg,1,0,0,0,1,,train
0534964_sc-192588.jpg,3,0,0,1,4,,train
0534965_as-3030983.jpg,4,0,1,0,5,,train
0534966_sc-1035908.jpg,0,0,1,0,1,,val
0534967_as-2916110.jpg,1,0,0,0,1,,val
0534968_sc-1032812.jpg,2,1,1,0,4,,test
0534969_sc-1032812.jpg,1,1,0,0,2,,train
0534970_sc-1032812.jpg,1,1,1,0,3,,train
0534971_as-3160761.jpg,9,0,0,0,9,,train
0534973_as-0070965.jpg,1,0,0,0,1,,train
0534974_as-0070965.jpg,1,1,0,0,2,,train
0534975_as-0070965.jpg,4,0,0,0,4,,train
0534976_as-0070965.jpg,2,0,0,0,2,,train
0534977_as-0070965.jpg,1,0,0,0,1,,val
0534978_as-0070965.jpg,2,0,0,0,2,,val
0534979_as-0070965.jpg,3,0,0,0,3,,test
0534980_as-0070965.jpg,1,0,0,0,1,,train
0534981_sc-130125.jpg,2,0,0,0,2,,train
0534982_sc-130125.jpg,1,0,0,0,1,,train
0534983_as-3146098.jpg,1,0,0,0,1,,train
0534984_as-2793922.jpg,0,0,1,0,1,,train
0534988_sc-190444.jpg,3,0,0,0,3,,train
0534989_sc-144790.jpg,2,0,1,0,3,,train
0534990_sc-144790.jpg,3,0,0,0,3,,val
0534991_sc-144790.jpg,1,0,0,0,1,,val
0534992_sc-219124.jpg,2,0,0,0,2,,test
0534995_sc-229593.jpg,1,2,1,0,4,,train
0534996_sc-229593.jpg,1,2,1,0,4,,train
0534997_sc-229593.jpg,1,2,0,0,3,,train
0534998_sc-229593.jpg,1,2,1,0,4,,train
0534999_as-3303234.jpg,1,0,0,0,1,,train
0535001_sc-1033703.jpg,1,0,0,0,1,,train
0535002_sc-1033703.jpg,2,0,1,1,4,,train
0535003_sc-1033703.jpg,2,0,1,1,4,,val
0535004_sc-1033703.jpg,1,0,0,0,1,,val
0535005_sc-1033703.jpg,1,0,0,1,2,,test
0535006_sc-1033703.jpg,1,0,0,0,1,,train
0535007_as-7152611.jpg,0,0,2,0,2,,train
0535008_sc-109692.jpg,2,1,0,0,3,,train
0535013_as-2663381.jpg,3,0,0,0,3,,train
0535014_as-3162417.jpg,5,0,1,1,7,,train
0535015_as-3360531.jpg,1,0,0,0,1,,train
0535021_as-0057032.jpg,1,0,0,0,1,,train
0535022_as-0057032.jpg,1,0,0,0,1,,val
0535024_sc-1028943.jpg,4,0,2,1,7,,val
0535025_sc-1028943.jpg,2,0,1,1,4,,test
0535026_sc-1028943.jpg,4,0,1,1,6,,train
0535029_sc-1003062.jpg,2,0,1,1,4,,train
0535030_sc-1003062.jpg,2,0,1,0,3,,train
0535033_sc-1003062.jpg,3,0,0,0,3,,train
0535034_sc-1003062.jpg,5,0,1,1,7,,train
0535035_as-3278645.jpg,2,1,0,1,4,,train
0535041_sc-106565.jpg,8,0,1,0,9,,train
0535042_sc-106565.jpg,0,0,1,0,1,,val
0535046_as-0042198.jpg,2,0,1,1,4,,val
0535047_as-0042198.jpg,2,0,1,1,4,,test
0535050_as-0077106.jpg,1,1,1,0,3,,train
0535051_as-0077106.jpg,1,0,0,0,1,,train
0535052_as-0077106.jpg,3,0,0,0,3,,train
0535053_as-0077106.jpg,1,0,0,1,2,,train
0535054_as-0077106.jpg,2,1,0,0,3,,train
0535055_as-0077106.jpg,7,0,0,1,8,,train
0535056_as-2949348.jpg,1,0,0,0,1,,train
0535057_sc-1023822.jpg,1,0,0,0,1,,val
0535058_sc-1023822.jpg,3,0,0,0,3,,val
0535060_sc-213210.jpg,2,1,0,0,3,,test
0535061_sc-213210.jpg,1,1,0,0,2,,train
0535062_sc-213210.jpg,1,0,0,0,1,,train
0535063_sc-213210.jpg,1,0,0,0,1,,train
0535066_as-0032567.jpg,2,0,1,0,3,,train
0535067_as-0032567.jpg,1,0,0,0,1,,train
0535068_as-0032567.jpg,1,0,0,0,1,,train
0535069_as-0032567.jpg,1,0,0,0,1,,train
0535070_as-3117607.jpg,0,0,1,0,1,,val
0535071_sc-221600.jpg,1,0,1,1,3,,val
0535072_sc-221600.jpg,2,0,1,0,3,,test
0535073_sc-221600.jpg,3,0,1,0,4,,train
0535074_sc-221600.jpg,4,0,0,1,5,,train
0535075_sc-221600.jpg,3,0,0,0,3,,train
0535076_sc-221600.jpg,1,0,1,1,3,,train
0535077_sc-221600.jpg,2,0,0,1,3,,train
0535078_as-0059724.jpg,1,0,0,0,1,,train
0535079_as-0059724.jpg,1,0,0,1,2,,train
0535080_as-0056520.jpg,5,0,0,0,5,,val
0535081_as-0056520.jpg,4,0,0,0,4,,val
0535082_as-0056520.jpg,1,0,0,0,1,,test
0535083_as-0056520.jpg,3,0,0,0,3,,train
0535084_sc-158917.jpg,3,0,0,0,3,,train
0535085_sc-167252.jpg,1,0,1,0,2,,train
0535086_sc-167252.jpg,1,0,1,0,2,,train
0535087_sc-218697.jpg,1,1,1,0,3,,train
0535088_sc-218697.jpg,0,0,1,0,1,,train
0535089_sc-218697.jpg,0,0,1,0,1,,train
0535090_as-0086839.jpg,2,0,0,0,2,,val
0535091_as-0038031.jpg,1,1,0,0,2,,val
0535092_as-0038031.jpg,0,1,0,0,1,,test
0535093_as-0038031.jpg,2,0,0,0,2,,train
0535095_as-7828275.jpg,1,0,0,2,3,,train
0535098_sc-1014774.jpg,2,0,1,0,3,,train
0535099_sc-1014774.jpg,4,0,1,1,6,,train
0535101_sc-1014774.jpg,1,0,0,0,1,,train
0535102_sc-1014774.jpg,5,1,3,1,10,,train
0535103_sc-1014774.jpg,5,1,3,1,10,,train
0535104_sc-1014774.jpg,5,1,3,1,10,,val
0535105_sc-1014774.jpg,1,1,1,1,4,,val
0535106_sc-158069.jpg,1,0,0,0,1,,test
0535107_sc-150372.jpg,10,1,0,0,11,,train
0535108_sc-150372.jpg,8,1,0,0,9,,train
0535109_as-2664416.jpg,0,1,2,0,3,,train
0535110_as-0034814.jpg,4,0,1,1,6,,train
0535111_as-0034814.jpg,0,0,1,1,2,,train
0535112_as-0034814.jpg,0,0,1,1,2,,train
0535113_as-3029347.jpg,8,2,3,1,14,,train
0535114_sc-221153.jpg,3,0,0,0,3,,val
0535115_sc-1008759.jpg,5,0,0,0,5,,val
0535116_sc-1008759.jpg,2,0,0,1,3,,test
0535118_as-0036423.jpg,1,0,1,0,2,,train
0535119_as-0036423.jpg,1,1,0,0,2,,train
0535120_as-0036423.jpg,1,1,0,0,2,,train
0535121_as-0036423.jpg,0,1,2,0,3,,train
0535122_as-0036423.jpg,3,1,1,2,7,,train
0535123_sc-203196.jpg,5,0,0,0,5,,train
0535124_sc-203196.jpg,3,0,0,0,3,,train
0535125_sc-203196.jpg,3,0,0,0,3,,val
0535126_sc-203196.jpg,1,0,0,0,1,,val
0535127_as-2602179.jpg,1,0,0,0,1,,test
0535128_as-0074683.jpg,1,0,1,1,3,,train
0535129_as-0074683.jpg,1,0,1,0,2,,train
0535130_as-0074683.jpg,0,0,1,0,1,,train
0535131_as-0074683.jpg,1,0,0,0,1,,train
0535132_as-0074683.jpg,1,0,0,1,2,,train
0535133_sc-115048.jpg,1,1,0,1,3,,train
0535134_as-0071400.jpg,2,2,0,1,5,,train
0535135_as-0071400.jpg,2,2,0,1,5,,val
0535136_as-0071400.jpg,2,2,0,0,4,,val
0535137_as-0071400.jpg,1,1,0,0,2,,test
0535138_as-0071400.jpg,1,1,0,0,2,,train
0535139_as-0071400.jpg,1,1,0,0,2,,train
0535140_as-0071400.jpg,2,2,0,0,4,,train
0535142_sc-226251.jpg,2,1,1,0,4,,train
0535143_sc-226251.jpg,2,2,1,0,5,,train
0535144_sc-226251.jpg,1,3,1,0,5,,train
0535145_sc-226251.jpg,3,1,0,0,4,,train
0535146_as-3048228.jpg,2,1,1,0,4,,val
0535151_as-2919784.jpg,4,0,1,0,5,,val
0535152_as-0058379.jpg,2,0,1,0,3,,test
0535153_as-0058379.jpg,3,0,1,0,4,,train
0535154_as-7583162.jpg,1,0,1,0,2,,train
0535155_as-7669096.jpg,3,1,0,0,4,,train
0535157_as-2751719.jpg,1,0,0,0,1,,train
0535158_as-3165185.jpg,3,1,0,1,5,,train
0535159_sc-164584.jpg,1,0,1,0,2,,train
0535160_sc-164584.jpg,1,0,0,0,1,,train
0535161_sc-164584.jpg,1,0,0,0,1,,val
0535162_as-7063031.jpg,0,0,2,0,2,,val
0535164_as-0008713.jpg,1,1,3,1,6,,test
0535165_sc-1031494.jpg,2,1,0,0,3,,train
0535166_sc-1031494.jpg,0,1,0,0,1,,train
0535167_sc-1031494.jpg,4,2,2,1,9,,train
0535168_sc-1031494.jpg,1,2,0,1,4,,train
0535169_sc-1031494.jpg,0,2,0,0,2,,train
0535170_sc-1031494.jpg,3,3,0,0,6,,train
0535171_as-0030803.jpg,1,0,1,0,2,,train
0535172_as-0030803.jpg,4,2,0,1,7,,val
0535175_sc-1031981.jpg,3,0,0,1,4,,val
0535176_sc-1031981.jpg,3,0,0,0,3,,test
0535177_sc-184949.jpg,3,0,1,1,5,,train
0535178_sc-184949.jpg,4,0,1,1,6,,train
0535179_sc-184949.jpg,3,0,1,1,5,,train
0535180_sc-184949.jpg,5,0,1,1,7,,train
0535181_sc-151105.jpg,1,0,0,1,2,,train
0535182_sc-151105.jpg,2,0,0,1,3,,train
0535183_sc-151105.jpg,2,0,0,1,3,,train
0535186_as-0096893.jpg,1,1,1,0,3,,val
0535188_sc-138594.jpg,2,0,1,1,4,,val
0535189_as-2690220.jpg,1,0,1,0,2,,test
0535192_as-0021887.jpg,1,0,0,0,1,,train
0535193_as-0021887.jpg,0,1,0,0,1,,train
0535194_as-0021887.jpg,0,0,1,0,1,,train
0535195_as-0021887.jpg,1,0,0,0,1,,train
0535196_as-0021887.jpg,1,0,0,0,1,,train
0535197_as-0021887.jpg,1,0,0,0,1,,train
0535198_as-0021887.jpg,2,0,0,0,2,,train
0535199_as-0021887.jpg,1,0,0,0,1,,val
0535200_as-0021887.jpg,1,0,0,0,1,,val
0535201_as-0021887.jpg,2,0,0,0,2,,test
0535202_as-0021887.jpg,0,0,1,0,1,,train
0535203_as-0031626.jpg,3,0,1,1,5,,train
0535204_as-0031626.jpg,1,0,1,1,3,,train
0535206_sc-122463.jpg,3,0,0,1,4,,train
0535209_sc-122463.jpg,2,0,0,1,3,,train
0535210_as-2552291.jpg,6,0,0,0,6,,train
0535211_as-2519636.jpg,1,0,0,0,1,,train
0535214_sc-1038583.jpg,3,0,0,1,4,,val
0535215_sc-1038583.jpg,3,0,0,1,4,,val
0535216_as-7563923.jpg,1,0,1,2,4,,test
0535217_as-0047000.jpg,2,0,0,0,2,,train
0535218_as-0047000.jpg,5,0,2,0,7,,train
0535219_as-0047000.jpg,1,0,1,0,2,,train
0535220_as-0047000.jpg,1,0,2,0,3,,train
0535221_as-0047000.jpg,1,0,1,0,2,,train
0535222_as-0047000.jpg,1,1,1,0,3,,train
0535223_as-0047000.jpg,2,1,2,0,5,,train
0535224_as-0047000.jpg,1,0,0,0,1,,val
0535225_as-0047000.jpg,4,0,1,0,5,,val
0535226_as-0047000.jpg,1,1,1,0,3,,test
0535227_as-0047000.jpg,3,0,0,0,3,,train
0535228_as-0047000.jpg,3,0,2,0,5,,train
0535229_as-0047000.jpg,2,0,1,0,3,,train
0535230_as-0047000.jpg,1,0,1,0,2,,train
0535231_as-0047000.jpg,2,0,1,0,3,,train
0535232_as-0047000.jpg,1,0,0,0,1,,train
0535233_as-0035947.jpg,1,0,0,0,1,,train
0535234_as-0035947.jpg,1,0,0,0,1,,val
0535235_as-0035947.jpg,1,1,0,1,3,,val
0535236_as-0035947.jpg,4,0,1,1,6,,test
0535237_as-0035947.jpg,3,0,0,0,3,,train
0535238_sc-110008.jpg,4,0,1,0,5,,train
0535239_sc-110008.jpg,3,0,0,0,3,,train
0535240_sc-110008.jpg,1,0,1,1,3,,train
0535241_sc-209490.jpg,1,0,0,0,1,,train
0535243_sc-209490.jpg,1,0,0,0,1,,train
0535244_sc-209490.jpg,4,0,0,0,4,,train
0535245_sc-114191.jpg,2,0,0,0,2,,val
0535246_sc-114191.jpg,2,0,0,0,2,,val
0535248_sc-103749.jpg,3,2,2,0,7,,test
0535250_sc-103749.jpg,1,0,0,0,1,,train
0535251_as-9073156.jpg,1,0,1,0,2,,train
0535252_sc-155166.jpg,6,3,0,0,9,,train
0535253_sc-155166.jpg,2,0,0,0,2,,train
0535255_as-0069141.jpg,4,1,0,0,5,,train
0535256_as-0069141.jpg,0,1,0,1,2,,train
0535258_sc-148437.jpg,1,0,1,0,2,,train
0535259_sc-148437.jpg,1,0,0,1,2,,val
0535260_sc-148437.jpg,1,0,0,1,2,,val
0535263_sc-221801.jpg,0,1,0,0,1,,test
0535264_sc-221801.jpg,2,0,0,0,2,,train
0535265_sc-221801.jpg,2,0,0,0,2,,train
0535266_sc-221801.jpg,1,0,0,0,1,,train
0535267_sc-221801.jpg,1,0,0,0,1,,train
0535269_as-0090473.jpg,3,1,0,0,4,,train
0535270_as-0090473.jpg,2,1,0,0,3,,train
0535271_as-0090473.jpg,1,0,0,0,1,,train
0535272_as-0090473.jpg,1,0,0,0,1,,val
0535273_as-0090473.jpg,1,0,0,0,1,,val
0535274_as-0090473.jpg,1,0,2,0,3,,test
0535275_as-0090473.jpg,1,0,0,0,1,,train
0535277_sc-129751.jpg,5,0,2,0,7,,train
0535278_as-2593962.jpg,1,3,1,0,5,,train
0535279_as-0031871.jpg,1,1,1,0,3,,train
0535280_as-0031871.jpg,1,0,0,0,1,,train
0535281_as-0031871.jpg,0,3,0,0,3,,train
0535282_as-0031871.jpg,1,0,0,0,1,,train
0535283_as-0031871.jpg,2,1,0,0,3,,val
0535285_as-0031871.jpg,2,1,1,0,4,,val
0535286_as-2694352.jpg,4,0,0,0,4,,test
0535288_as-2631532.jpg,4,0,0,0,4,,train
0535289_sc-109707.jpg,17,1,1,1,20,,train
0535290_sc-109707.jpg,14,1,1,1,17,,train
0535291_sc-109707.jpg,7,2,1,1,11,,train
0535292_sc-109707.jpg,0,1,0,1,2,,train
0535293_sc-225882.jpg,0,0,1,0,1,,train
0535294_as-7731411.jpg,3,0,1,1,5,,train
0535295_as-2980509.jpg,2,0,0,0,2,,val
0535296_as-0010600.jpg,1,0,1,1,3,,val
0535297_as-0010600.jpg,0,1,0,0,1,,test
0535298_as-0010600.jpg,0,2,0,0,2,,train
0535299_sc-128104.jpg,1,0,1,0,2,,train
0535300_sc-128104.jpg,3,0,1,0,4,,train
0535302_sc-1001237.jpg,3,0,0,0,3,,train
0535303_sc-1001237.jpg,3,0,0,0,3,,train
0535304_sc-1001237.jpg,1,0,1,0,2,,train
0535305_sc-1001237.jpg,1,0,1,1,3,,train
0535307_sc-1001237.jpg,2,0,2,0,4,,val
0535308_sc-1001237.jpg,3,0,0,0,3,,val
0535311_as-0085455.jpg,0,1,0,0,1,,test
0535312_as-0085455.jpg,0,1,0,0,1,,train
0535313_as-0085455.jpg,0,1,0,0,1,,train
0535316_as-2663351.jpg,2,0,2,1,5,,train
0535318_as-0020947.jpg,3,0,1,1,5,,train
0535319_as-0020947.jpg,2,0,0,0,2,,train
0535321_as-0020947.jpg,2,1,0,0,3,,train
0535322_as-3118918.jpg,1,0,0,2,3,,train
0535323_sc-1000923.jpg,3,0,0,0,3,,val
0535324_sc-1000923.jpg,6,0,0,0,6,,val
0535325_sc-1000923.jpg,4,0,0,0,4,,test
0535326_as-3435250.jpg,1,0,1,1,3,,train
0535327_as-0019432.jpg,1,0,0,1,2,,train
0535328_as-0019432.jpg,2,1,0,1,4,,train
0535329_as-0019432.jpg,1,1,0,0,2,,train
0535330_as-0019432.jpg,2,2,0,0,4,,train
0535332_sc-1041728.jpg,1,0,0,0,1,,train
0535333_sc-1041728.jpg,1,0,0,0,1,,train
0535334_sc-1041728.jpg,2,0,0,0,2,,val
0535337_as-0020869.jpg,1,0,1,0,2,,val
0535338_as-0020869.jpg,3,0,0,0,3,,test
0535339_sc-1001407.jpg,2,0,1,1,4,,train
0535340_sc-1001407.jpg,3,0,1,1,5,,train
0535341_sc-1001407.jpg,1,0,0,0,1,,train
0535342_sc-1001407.jpg,1,0,0,0,1,,train
0535344_as-7115225.jpg,1,0,0,0,1,,train
0535345_sc-211786.jpg,3,0,0,0,3,,train
0535346_sc-211786.jpg,2,0,0,0,2,,train
0535347_sc-211786.jpg,4,0,0,0,4,,val
0535348_as-3186372.jpg,2,0,0,0,2,,val
0535349_as-0033806.jpg,2,0,0,0,2,,test
0535350_as-0033806.jpg,1,0,0,0,1,,train
0535353_as-0027563.jpg,2,0,0,0,2,,train
0535354_as-9046093.jpg,2,0,1,0,3,,train
0535355_as-0005071.jpg,1,0,0,0,1,,train
0535356_sc-168683.jpg,2,0,0,0,2,,train
0535357_sc-168683.jpg,2,0,0,1,3,,train
0535358_sc-168683.jpg,1,0,0,1,2,,train
0535359_sc-168683.jpg,1,0,1,0,2,,val
0535360_sc-168683.jpg,1,0,0,0,1,,val
0535361_sc-168683.jpg,1,0,1,0,2,,test
0535362_sc-211511.jpg,0,1,0,0,1,,train
0535364_as-0059886.jpg,0,0,1,1,2,,train
0535365_as-0059886.jpg,1,0,0,1,2,,train
0535366_as-7855469.jpg,1,0,1,1,3,,train
0535368_as-0084762.jpg,1,0,1,0,2,,train
0535369_as-0084762.jpg,3,0,2,0,5,,train
0535370_as-0084762.jpg,3,0,1,0,4,,train
0535371_as-0084762.jpg,0,0,1,0,1,,val
0535372_as-0084762.jpg,1,0,1,0,2,,val
0535373_as-0084762.jpg,0,0,1,0,1,,test
0535374_as-0041433.jpg,1,1,1,1,4,,train
0535375_as-0041433.jpg,1,1,1,1,4,,train
0535376_as-0041433.jpg,1,0,1,1,3,,train
0535377_as-0041433.jpg,2,1,1,1,5,,train
0535378_as-0041433.jpg,1,1,1,1,4,,train
0535379_as-2940240.jpg,3,0,1,1,5,,train
0535380_as-9004211.jpg,8,0,0,0,8,,train
0535381_as-7401312.jpg,1,0,2,0,3,,val
0535383_as-0039293.jpg,3,0,0,0,3,,val
0535384_as-0039293.jpg,1,0,0,0,1,,test
0535385_as-0039293.jpg,1,0,0,0,1,,train
0535386_as-0039293.jpg,1,0,0,0,1,,train
0535387_as-0039293.jpg,1,0,0,0,1,,train
0535388_sc-116894.jpg,2,0,0,0,2,,train
0535389_sc-116894.jpg,4,0,0,0,4,,train
0535390_as-2922348.jpg,0,2,1,0,3,,train
0535391_sc-225558.jpg,9,0,1,0,10,,train
0535392_sc-225558.jpg,4,0,1,0,5,,val
0535393_as-9069554.jpg,1,0,0,0,1,,val
0535395_as-0008135.jpg,3,0,0,0,3,,test
0535396_as-3032205.jpg,3,0,0,0,3,,train
0535398_as-0082364.jpg,0,0,0,1,1,,train
0535399_as-0082364.jpg,0,0,0,2,2,,train
0535401_as-7878630.jpg,0,0,0,1,1,,train
0535402_as-3070959.jpg,1,0,1,1,3,,train
0535403_as-0033577.jpg,0,2,0,0,2,,train
0535404_as-0033577.jpg,0,2,0,0,2,,train
0535405_as-0033577.jpg,0,1,0,0,1,,val
0535406_sc-203327.jpg,1,0,0,0,1,,val
0535407_sc-203327.jpg,2,0,0,0,2,,test
0535408_sc-203327.jpg,2,0,0,0,2,,train
0535411_as-0015266.jpg,2,1,1,0,4,,train
0535413_as-0015266.jpg,1,0,0,0,1,,train
0535414_as-0015266.jpg,1,0,0,0,1,,train
0535415_as-0015266.jpg,1,0,0,0,1,,train
0535417_sc-176883.jpg,1,1,0,0,2,,train
0535418_sc-176883.jpg,2,1,0,0,3,,train
0535419_sc-175172.jpg,4,0,0,0,4,,val
0535422_sc-177051.jpg,1,2,0,0,3,,val
0535423_sc-177051.jpg,3,1,0,0,4,,test
0535424_sc-128656.jpg,2,0,0,1,3,,train
0535425_as-0017050.jpg,2,0,0,0,2,,train
0535426_as-0017050.jpg,2,0,0,0,2,,train
0535427_as-0017050.jpg,2,0,0,0,2,,train
0535428_as-0017050.jpg,2,0,0,0,2,,train
0535429_as-0017050.jpg,3,0,0,0,3,,train
0535430_as-0048623.jpg,0,0,1,1,2,,train
0535431_as-0048623.jpg,0,0,1,1,2,,val
0535432_as-0048623.jpg,0,0,1,1,2,,val
0535433_as-0048623.jpg,0,0,1,0,1,,test
0535434_as-0048623.jpg,0,0,1,0,1,,train
0535435_as-0048623.jpg,0,0,1,1,2,,train
0535436_sc-1021846.jpg,6,0,0,0,6,,train
0535438_as-0075733.jpg,6,0,1,0,7,,train
0535439_as-0075733.jpg,1,0,0,0,1,,train
0535441_sc-206068.jpg,1,0,0,0,1,,train
0535442_sc-206068.jpg,1,0,0,0,1,,train
0535443_sc-206068.jpg,14,0,1,0,15,,val
0535444_sc-169365.jpg,4,0,0,0,4,,val
0535445_sc-169365.jpg,2,0,0,0,2,,test
0535446_as-2761979.jpg,1,0,0,0,1,,train
0535447_sc-1019470.jpg,1,0,3,0,4,,train
0535448_sc-1019470.jpg,1,0,0,0,1,,train
0535449_as-0099354.jpg,4,0,0,0,4,,train
0535450_as-0099354.jpg,4,0,1,0,5,,train
0535451_sc-209628.jpg,6,0,0,2,8,,train
0535452_sc-209628.jpg,1,0,0,0,1,,train
0535453_sc-209628.jpg,4,0,0,2,6,,val
0535455_sc-1039669.jpg,1,0,1,0,2,,val
0535456_sc-1039669.jpg,1,0,1,0,2,,test
0535462_sc-117632.jpg,1,0,0,0,1,,train
0535463_sc-117632.jpg,1,0,0,0,1,,train
0535464_sc-117632.jpg,1,0,0,0,1,,train
0535465_sc-1002714.jpg,1,0,1,1,3,,train
0535466_sc-1002714.jpg,1,0,1,1,3,,train
0535469_as-0088204.jpg,0,0,2,0,2,,train
0535472_as-0088204.jpg,0,0,2,2,4,,train
0535473_sc-181073.jpg,1,0,0,0,1,,val
0535475_as-0022817.jpg,0,1,0,0,1,,val
0535476_sc-1006787.jpg,3,0,0,0,3,,test
0535477_sc-212822.jpg,1,0,0,0,1,,train
0535478_sc-212822.jpg,1,0,0,0,1,,train
0535479_sc-212822.jpg,0,0,1,1,2,,train
0535480_sc-212822.jpg,1,0,1,0,2,,train
0535481_sc-212822.jpg,3,0,0,0,3,,train
0535482_sc-212822.jpg,3,0,0,0,3,,train
0535483_sc-212822.jpg,1,0,0,0,1,,train
0535484_sc-212822.jpg,1,0,0,0,1,,val
0535485_sc-212822.jpg,1,0,0,0,1,,val
0535486_sc-212822.jpg,2,0,1,1,4,,test
0535487_sc-1026712.jpg,1,0,0,0,1,,train
0535488_sc-1026712.jpg,2,0,0,0,2,,train
0535489_sc-1026712.jpg,2,0,0,0,2,,train
0535490_as-0035832.jpg,0,0,1,0,1,,train
0535491_as-0035832.jpg,0,0,1,0,1,,train
0535492_sc-196296.jpg,2,0,0,0,2,,train
0535493_sc-196296.jpg,3,0,0,0,3,,train
0535494_sc-196296.jpg,2,0,0,0,2,,val
0535495_sc-123774.jpg,2,0,0,0,2,,val
0535496_sc-123774.jpg,3,0,0,0,3,,test
0535497_sc-123774.jpg,1,0,0,0,1,,train
0535498_sc-123774.jpg,2,0,0,0,2,,train
0535501_as-0043308.jpg,0,0,1,0,1,,train
0535502_as-0043308.jpg,1,0,1,0,2,,train
0535503_as-0043308.jpg,1,1,1,0,3,,train
0535504_as-0043308.jpg,0,1,0,0,1,,train
0535505_as-0058619.jpg,1,0,1,0,2,,train
0535508_as-0058619.jpg,1,0,0,0,1,,val
0535510_sc-105022.jpg,1,1,0,0,2,,val
0535512_sc-167370.jpg,6,0,0,0,6,,test
0535513_sc-167370.jpg,2,0,0,0,2,,train
0535514_sc-167370.jpg,3,0,0,0,3,,train
0535515_sc-167370.jpg,5,0,0,0,5,,train
0535516_sc-167370.jpg,7,0,0,0,7,,train
0535519_as-2649360.jpg,4,1,0,1,6,,train
0535522_sc-174127.jpg,0,0,1,0,1,,train
0535523_sc-174127.jpg,1,0,0,1,2,,train
0535524_sc-174127.jpg,1,0,1,0,2,,val
0535525_sc-174127.jpg,1,0,1,0,2,,val
0535527_as-0015223.jpg,2,0,0,0,2,,test
0535528_as-0015223.jpg,1,0,0,0,1,,train
0535529_as-0015223.jpg,2,0,0,0,2,,train
0535530_sc-129734.jpg,1,0,0,2,3,,train
0535532_sc-1037195.jpg,21,0,3,2,26,,train
0535533_sc-1037195.jpg,17,0,4,2,23,,train
0535534_sc-1037195.jpg,1,0,1,1,3,,train
0535540_sc-1037195.jpg,13,1,1,1,16,,train
0535542_as-0022045.jpg,1,0,0,0,1,,val
0535543_as-0022045.jpg,4,2,0,1,7,,val
0535544_as-0022045.jpg,10,2,0,0,12,,test
0535545_as-0022045.jpg,5,1,0,0,6,,train
0535546_as-0022045.jpg,5,3,1,1,10,,train
0535547_as-0022045.jpg,1,0,1,0,2,,train
0535548_sc-156320.jpg,5,0,0,1,6,,train
0535549_as-0022097.jpg,1,0,0,1,2,,train
0535550_as-0022097.jpg,1,0,0,1,2,,train
0535551_as-0022097.jpg,1,0,0,1,2,,train
0535552_as-0022097.jpg,1,0,0,0,1,,val
0535553_as-0022097.jpg,1,0,0,1,2,,val
0535554_as-7516036.jpg,6,0,1,0,7,,test
0535555_sc-1031677.jpg,3,1,2,1,7,,train
0535556_sc-1031677.jpg,4,2,2,1,9,,train
0535557_sc-1031677.jpg,3,1,1,0,5,,train
0535558_sc-1031677.jpg,3,1,1,1,6,,train
0535561_as-0076601.jpg,2,1,0,0,3,,train
0535563_as-0059086.jpg,3,0,0,1,4,,train
0535564_as-0059086.jpg,2,0,1,0,3,,train
0535565_as-0059086.jpg,2,0,0,1,3,,val
0535566_as-0059086.jpg,1,0,0,1,2,,val
0535567_as-0059086.jpg,1,0,0,1,2,,test
0535570_sc-159730.jpg,0,1,0,0,1,,train
0535572_sc-157037.jpg,4,0,0,0,4,,train
0535573_sc-157037.jpg,5,0,1,0,6,,train
0535577_sc-157037.jpg,1,0,0,0,1,,train
0535578_sc-157037.jpg,4,0,0,0,4,,train
0535580_as-0063909.jpg,0,0,1,0,1,,train
0535581_as-0063909.jpg,0,0,1,0,1,,train
0535582_as-0063909.jpg,0,0,1,1,2,,val
0535583_as-0063909.jpg,0,0,1,0,1,,val
0535584_as-0063909.jpg,0,0,1,0,1,,test
0535585_as-0063909.jpg,1,2,2,1,6,,train
0535586_as-0063909.jpg,0,1,1,0,2,,train
0535587_as-0063909.jpg,0,1,1,1,3,,train
0535588_as-0063909.jpg,0,1,1,1,3,,train
0535589_as-0033306.jpg,3,1,0,0,4,,train
0535590_as-0033306.jpg,2,2,0,0,4,,train
0535591_as-0033306.jpg,1,0,0,0,1,,train
0535592_sc-121552.jpg,2,3,1,1,7,,val
0535594_sc-121552.jpg,0,0,2,1,3,,val
0535596_as-0069643.jpg,1,0,0,0,1,,test
0535599_as-0057643.jpg,1,0,0,0,1,,train
0535600_as-0057643.jpg,1,0,1,1,3,,train
0535601_as-0057643.jpg,1,0,0,0,1,,train
0535602_as-0057643.jpg,0,0,0,1,1,,train
0535606_sc-222341.jpg,2,0,0,0,2,,train
0535607_sc-222341.jpg,3,0,0,0,3,,train
0535608_sc-178114.jpg,6,0,0,0,6,,train
0535609_sc-178114.jpg,6,0,0,0,6,,val
0535610_sc-178114.jpg,1,0,0,0,1,,val
0535611_sc-178114.jpg,2,0,0,1,3,,test
0535612_sc-178114.jpg,5,0,0,1,6,,train
0535613_sc-178114.jpg,2,0,1,0,3,,train
0535614_as-7589661.jpg,2,0,1,0,3,,train
0535615_as-0026870.jpg,2,0,0,0,2,,train
0535616_as-0026870.jpg,1,0,0,0,1,,train
0535617_as-0053343.jpg,1,0,0,0,1,,train
0535618_as-0053343.jpg,1,0,0,0,1,,train
0535620_as-0053343.jpg,1,0,2,0,3,,val
0535621_as-0053343.jpg,2,0,0,0,2,,val
0535622_as-3037430.jpg,2,0,2,0,4,,test
0535623_as-3467544.jpg,5,0,0,0,5,,train
0535624_sc-209867.jpg,1,0,0,0,1,,train
0535625_sc-209867.jpg,2,0,0,0,2,,train
0535626_sc-209867.jpg,3,0,1,1,5,,train
0535627_sc-209867.jpg,2,0,1,1,4,,train
0535628_sc-209867.jpg,3,0,1,1,5,,train
0535629_sc-209867.jpg,4,0,1,0,5,,train
0535630_sc-209867.jpg,1,0,0,0,1,,val
0535631_sc-209867.jpg,2,0,0,0,2,,val
0535632_sc-150463.jpg,1,0,0,0,1,,test
0535633_sc-150463.jpg,1,0,0,0,1,,train
0535634_sc-150463.jpg,1,0,0,0,1,,train
0535635_sc-150463.jpg,1,0,0,0,1,,train
0535636_sc-150463.jpg,1,0,0,0,1,,train
0535637_as-0089082.jpg,1,0,0,0,1,,train
0535638_as-0089082.jpg,1,0,0,0,1,,train
0535639_as-0089082.jpg,3,0,0,0,3,,train
0535640_as-0089082.jpg,1,0,0,0,1,,val
0535641_as-0089082.jpg,2,0,0,0,2,,val
0535642_as-0089082.jpg,2,0,0,0,2,,test
0535643_as-0089082.jpg,2,1,0,0,3,,train
0535644_as-0089082.jpg,2,1,0,0,3,,train
0535645_sc-1013568.jpg,2,0,0,0,2,,train
0535646_sc-1013568.jpg,2,0,0,0,2,,train
0535647_sc-1013568.jpg,2,0,0,0,2,,train
0535648_as-3336204.jpg,0,1,1,1,3,,train
0535650_sc-108232.jpg,2,0,0,0,2,,train
0535651_sc-1006374.jpg,1,0,0,0,1,,val
0535652_sc-1006374.jpg,1,0,1,1,3,,val
0535653_sc-1006374.jpg,1,0,1,0,2,,test
0535656_sc-1006374.jpg,2,0,0,0,2,,train
0535657_sc-1006374.jpg,2,0,0,1,3,,train
0535658_as-7540063.jpg,3,1,3,1,8,,train
0535659_as-0010664.jpg,6,1,0,0,7,,train
0535660_as-0010664.jpg,4,1,0,0,5,,train
0535661_as-0010664.jpg,4,1,0,0,5,,train
0535662_as-0010664.jpg,1,0,0,0,1,,train
0535664_as-0021747.jpg,1,0,0,0,1,,val
0535665_as-0021747.jpg,2,0,1,1,4,,val
0535666_as-0021747.jpg,3,0,1,1,5,,test
0535667_as-0021747.jpg,5,0,0,0,5,,train
0535668_as-0021747.jpg,2,0,0,0,2,,train
0535669_as-0021747.jpg,1,0,0,0,1,,train
0535670_as-0021747.jpg,1,0,0,0,1,,train
0535672_sc-122586.jpg,3,0,1,0,4,,train
0535675_sc-122586.jpg,2,0,1,0,3,,train
0535679_as-0013345.jpg,1,0,0,0,1,,train
0535680_as-0013345.jpg,1,0,0,0,1,,val
0535681_as-0013345.jpg,1,0,0,0,1,,val
0535682_as-0013345.jpg,1,0,0,0,1,,test
0535683_as-0013345.jpg,1,0,0,0,1,,train
0535684_as-0082957.jpg,1,1,0,0,2,,train
0535686_sc-1041177.jpg,6,0,0,3,9,,train
0535689_as-0061238.jpg,4,0,0,1,5,,train
0535691_as-0078952.jpg,8,7,3,2,20,,train
0535695_as-0059882.jpg,2,3,1,1,7,,train
0535696_as-0059882.jpg,1,0,0,0,1,,train
0535698_sc-107600.jpg,1,1,1,0,3,,val
0535699_as-0035310.jpg,1,0,0,0,1,,val
0535700_as-0035310.jpg,2,0,1,0,3,,test
0535701_as-0035310.jpg,1,0,1,0,2,,train
0535702_as-0035310.jpg,3,0,1,0,4,,train
0535703_sc-137188.jpg,0,0,1,0,1,,train
0535704_sc-1038246.jpg,1,0,0,0,1,,train
0535705_sc-1038246.jpg,2,0,0,0,2,,train
0535706_sc-1038246.jpg,1,0,1,1,3,,train
0535707_sc-1038246.jpg,0,0,1,0,1,,train
0535708_sc-1040907.jpg,1,0,0,0,1,,val
0535711_sc-157716.jpg,1,0,0,1,2,,val
0535712_sc-157716.jpg,1,0,0,1,2,,test
0535713_as-0043124.jpg,2,1,1,0,4,,train
0535714_as-0043124.jpg,2,0,1,0,3,,train
0535715_as-3028362.jpg,4,0,1,1,6,,train
0535716_as-2888790.jpg,5,2,1,0,8,,train
0535717_as-3169260.jpg,1,0,0,0,1,,train
0535720_as-0021852.jpg,1,0,2,0,3,,train
0535721_sc-136152.jpg,2,0,0,0,2,,train
0535723_sc-1033890.jpg,1,0,0,0,1,,val
0535724_as-3421452.jpg,1,0,0,0,1,,val
0535725_sc-128837.jpg,1,0,0,0,1,,test
0535726_sc-128837.jpg,1,0,0,0,1,,train
0535727_sc-128837.jpg,1,1,0,0,2,,train
0535728_sc-128837.jpg,2,0,0,0,2,,train
0535729_as-0055565.jpg,1,1,0,0,2,,train
0535730_as-0055565.jpg,1,2,0,0,3,,train
0535731_as-3216950.jpg,0,0,0,1,1,,train
0535732_sc-103138.jpg,3,0,0,0,3,,train
0535733_sc-103138.jpg,1,0,1,1,3,,val
0535734_sc-103138.jpg,1,0,1,1,3,,val
0535735_sc-103138.jpg,2,0,0,0,2,,test
0535738_sc-103138.jpg,2,0,0,1,3,,train
0535739_sc-1010925.jpg,1,0,1,0,2,,train
0535740_sc-1004989.jpg,2,0,0,1,3,,train
0535741_sc-1004989.jpg,2,0,0,1,3,,train
0535743_as-0002855.jpg,1,0,1,2,4,,train
0535744_sc-1029792.jpg,2,1,1,1,5,,train
0535745_sc-1029792.jpg,0,1,0,0,1,,train
0535746_sc-1029792.jpg,2,0,0,0,2,,val
0535747_sc-1029792.jpg,2,0,0,0,2,,val
0535748_sc-1029792.jpg,3,0,1,0,4,,test
0535749_sc-1029792.jpg,6,0,0,0,6,,train
0535751_sc-196991.jpg,2,0,0,0,2,,train
0535752_sc-196991.jpg,1,0,0,0,1,,train
0535753_sc-196991.jpg,2,0,0,0,2,,train
0535754_as-2713879.jpg,2,0,0,0,2,,train
0535757_sc-175103.jpg,2,0,0,2,4,,train
0535758_sc-175103.jpg,4,1,0,0,5,,train
0535759_sc-175103.jpg,6,1,0,0,7,,val
0535760_sc-175103.jpg,5,1,0,0,6,,val
0535761_sc-175103.jpg,2,0,0,1,3,,test
0535762_sc-175103.jpg,3,0,0,0,3,,train
0535763_sc-175103.jpg,1,0,0,0,1,,train
0535764_sc-146224.jpg,2,0,0,1,3,,train
0535765_sc-146224.jpg,3,0,0,2,5,,train
0535766_sc-146224.jpg,1,0,0,1,2,,train
0535767_as-0036293.jpg,1,0,0,0,1,,train
0535768_as-0036293.jpg,1,0,0,0,1,,train
0535769_as-0036293.jpg,1,0,0,0,1,,val
0535770_as-0036293.jpg,2,0,0,0,2,,val
0535771_as-0036293.jpg,2,0,0,0,2,,test
0535772_as-0036293.jpg,2,0,0,0,2,,train
0535774_as-0005470.jpg,0,0,0,1,1,,train
0535775_sc-143266.jpg,1,2,0,0,3,,train
0535776_sc-143266.jpg,4,0,1,0,5,,train
0535777_sc-143266.jpg,2,0,1,0,3,,train
0535779_sc-143266.jpg,3,2,0,0,5,,train
0535780_as-2597538.jpg,1,1,0,0,2,,train
0535781_as-2743617.jpg,2,0,0,0,2,,val
0535787_sc-176530.jpg,2,1,0,0,3,,val
0535788_sc-200686.jpg,1,0,0,0,1,,test
0535789_sc-200686.jpg,2,0,0,0,2,,train
0535790_sc-200686.jpg,3,0,0,0,3,,train
0535791_sc-200686.jpg,1,0,0,0,1,,train
0535792_sc-151267.jpg,5,1,1,1,8,,train
0535793_sc-221333.jpg,1,0,0,0,1,,train
0535794_sc-221333.jpg,1,0,0,0,1,,train
0535795_sc-221333.jpg,3,0,0,0,3,,train
0535796_sc-221333.jpg,3,0,0,0,3,,val
0535797_sc-221333.jpg,4,0,0,0,4,,val
0535798_sc-221333.jpg,4,0,0,0,4,,test
0535799_sc-157136.jpg,1,0,0,0,1,,train
0535801_sc-157136.jpg,1,0,0,0,1,,train
0535803_sc-157136.jpg,4,0,0,0,4,,train
0535804_sc-112988.jpg,1,0,0,0,1,,train
0535805_sc-112988.jpg,1,0,0,0,1,,train
0535806_sc-158864.jpg,5,0,4,0,9,,train
0535807_sc-158864.jpg,3,0,1,0,4,,train
0535808_as-0058593.jpg,3,0,2,2,7,,val
0535809_as-0058593.jpg,1,0,0,0,1,,val
0535810_as-3164623.jpg,2,0,0,0,2,,test
0535813_as-0087309.jpg,3,0,0,0,3,,train
0535814_as-0087309.jpg,4,0,0,0,4,,train
0535815_as-0030089.jpg,1,0,0,0,1,,train
0535816_as-0030089.jpg,3,0,0,0,3,,train
0535817_sc-112145.jpg,4,0,0,2,6,,train
0535818_sc-112145.jpg,2,0,0,1,3,,train
0535821_as-0078977.jpg,4,2,2,1,9,,train
0535822_as-0078977.jpg,2,1,1,1,5,,val
0535823_as-0078977.jpg,1,1,2,1,5,,val
0535824_as-0078977.jpg,2,1,1,1,5,,test
0535825_sc-1035401.jpg,1,1,0,0,2,,train
0535826_sc-1035401.jpg,6,1,1,0,8,,train
0535827_sc-1035401.jpg,1,0,0,0,1,,train
0535828_sc-1035401.jpg,1,0,0,0,1,,train
0535831_sc-1035401.jpg,3,0,1,0,4,,train
0535832_sc-1035401.jpg,1,0,0,0,1,,train
0535835_sc-154929.jpg,2,0,1,1,4,,train
0535836_sc-154929.jpg,4,0,1,0,5,,val
0535837_sc-154929.jpg,3,0,1,0,4,,val
0535838_sc-131332.jpg,1,0,2,1,4,,test
0535840_sc-131332.jpg,1,1,1,1,4,,train
0535841_sc-131332.jpg,1,0,1,1,3,,train
0535842_sc-147785.jpg,5,3,1,0,9,,train
0535843_sc-147785.jpg,1,1,1,0,3,,train
0535844_sc-147785.jpg,1,0,2,0,3,,train
0535845_sc-131308.jpg,2,0,1,0,3,,train
0535846_sc-131308.jpg,2,1,0,0,3,,train
0535848_sc-131308.jpg,1,0,1,0,2,,val
0535851_as-0027843.jpg,6,0,0,0,6,,val
0535852_as-0027843.jpg,4,0,0,0,4,,test
0535853_as-0027843.jpg,10,0,0,1,11,,train
0535856_sc-1028331.jpg,1,0,1,0,2,,train
0535857_sc-1028331.jpg,0,1,3,1,5,,train
0535860_as-0073461.jpg,3,1,1,1,6,,train
0535861_as-0073461.jpg,0,1,1,1,3,,train
0535864_as-0076123.jpg,5,0,0,0,5,,train
0535865_as-0076123.jpg,0,0,1,0,1,,train
0535866_as-0076123.jpg,5,0,0,0,5,,val
0535867_as-0076123.jpg,1,0,0,0,1,,val
0535868_as-0076123.jpg,5,0,0,0,5,,test
0535869_as-0076123.jpg,3,0,1,0,4,,train
0535870_as-0076216.jpg,5,5,0,0,10,,train
0535871_as-0076216.jpg,1,0,1,0,2,,train
0535872_as-0076216.jpg,0,0,1,0,1,,train
0535873_sc-212493.jpg,1,0,0,0,1,,train
0535874_sc-212493.jpg,2,0,0,0,2,,train
0535875_as-3290372.jpg,1,1,0,0,2,,train
0535876_as-7333849.jpg,0,1,0,0,1,,val
0535878_as-0082645.jpg,1,0,0,0,1,,val
0535879_as-0082645.jpg,3,0,0,0,3,,test
0535880_as-0082645.jpg,2,0,0,0,2,,train
0535881_as-0082645.jpg,1,0,0,0,1,,train
0535882_as-0082645.jpg,3,0,0,0,3,,train
0535883_as-0082645.jpg,2,0,0,0,2,,train
0535884_as-0082645.jpg,4,0,0,0,4,,train
0535886_as-0050386.jpg,1,0,0,0,1,,train
0535887_as-0050386.jpg,1,0,0,0,1,,train
0535888_as-0050386.jpg,1,0,0,0,1,,val
0535889_as-0050386.jpg,3,0,0,0,3,,val
0535890_as-0050386.jpg,2,0,0,0,2,,test
0535891_as-0067205.jpg,1,0,0,0,1,,train
0535892_as-0067205.jpg,5,0,0,0,5,,train
0535893_sc-204151.jpg,3,0,0,0,3,,train
0535894_sc-204151.jpg,2,0,0,0,2,,train
0535895_sc-204151.jpg,1,0,0,0,1,,train
0535896_sc-204151.jpg,1,0,0,0,1,,train
0535897_sc-1009708.jpg,1,0,0,0,1,,train
0535899_as-0049125.jpg,2,0,0,0,2,,val
0535900_as-0049125.jpg,1,0,0,0,1,,val
0535901_sc-156075.jpg,1,0,0,0,1,,test
0535903_as-0026964.jpg,1,2,3,4,10,,train
0535904_as-0026964.jpg,0,1,1,2,4,,train
0535905_sc-151174.jpg,1,0,0,0,1,,train
0535907_as-7145876.jpg,4,0,0,0,4,,train
0535908_as-3052937.jpg,3,0,0,0,3,,train
0535909_sc-133182.jpg,1,0,0,0,1,,train
0535911_sc-133182.jpg,2,0,0,0,2,,train
0535912_sc-133182.jpg,1,0,0,1,2,,val
0535914_as-0097690.jpg,1,0,0,0,1,,val
0535915_as-0097690.jpg,1,0,0,0,1,,test
0535916_as-3238840.jpg,3,0,0,0,3,,train
0535919_sc-186986.jpg,1,0,0,0,1,,train
0535922_sc-1037474.jpg,1,1,1,0,3,,train
0535923_sc-1037474.jpg,1,1,1,0,3,,train
0535925_as-0028230.jpg,3,0,0,0,3,,train
0535926_as-0028230.jpg,1,0,0,0,1,,train
0535927_as-0032523.jpg,2,1,1,0,4,,train
0535928_as-0032523.jpg,3,0,0,0,3,,val
0535929_as-0032523.jpg,1,0,0,0,1,,val
0535930_as-0032523.jpg,2,0,0,0,2,,test
0535931_as-0032523.jpg,2,0,0,0,2,,train
0535933_sc-125916.jpg,1,0,0,0,1,,train
0535934_sc-1027909.jpg,1,0,1,0,2,,train
0535935_sc-1027909.jpg,2,0,1,0,3,,train
0535936_sc-1027909.jpg,1,0,1,1,3,,train
0535937_as-0052577.jpg,1,0,0,0,1,,train
0535938_as-0052577.jpg,3,0,1,0,4,,train
0535939_as-0052577.jpg,1,0,1,0,2,,val
0535940_as-0052577.jpg,2,0,1,0,3,,val
0535942_as-0052577.jpg,1,0,0,0,1,,test
0535943_as-0052577.jpg,3,0,0,0,3,,train
0535944_as-0052577.jpg,1,0,0,0,1,,train
0535945_as-3286300.jpg,2,0,0,0,2,,train
0535946_as-3293928.jpg,1,1,1,1,4,,train
0535949_sc-157453.jpg,0,2,0,1,3,,train
0535950_sc-157453.jpg,1,2,0,1,4,,train
0535952_sc-157453.jpg,2,1,0,0,3,,train
0535953_sc-157453.jpg,3,1,0,0,4,,val
0535954_sc-157453.jpg,1,0,0,0,1,,val
0535955_sc-157453.jpg,1,0,1,0,2,,test
0535956_sc-157453.jpg,3,0,1,0,4,,train
0535957_sc-157453.jpg,1,0,1,0,2,,train
0535958_sc-194183.jpg,2,1,1,0,4,,train
0535959_sc-194183.jpg,1,1,1,0,3,,train
0535960_sc-194183.jpg,1,1,1,0,3,,train
0535961_sc-194183.jpg,1,1,0,0,2,,train
0535962_sc-190067.jpg,0,1,0,0,1,,train
0535963_as-0040875.jpg,1,1,0,1,3,,val
0535964_as-0040875.jpg,2,1,0,1,4,,val
0535965_as-0040875.jpg,1,0,0,0,1,,test
0535967_sc-137758.jpg,2,1,0,0,3,,train
0535968_sc-137758.jpg,0,1,0,0,1,,train
0535969_sc-1024912.jpg,1,0,1,1,3,,train
0535970_sc-1024912.jpg,2,0,0,0,2,,train
0535971_sc-1024912.jpg,1,0,0,1,2,,train
0535972_sc-200121.jpg,2,0,0,0,2,,train
0535973_sc-200121.jpg,1,0,1,0,2,,train
0535974_sc-1011686.jpg,0,1,0,0,1,,val
0535976_sc-123451.jpg,3,2,0,0,5,,val
0535977_sc-123451.jpg,3,1,3,1,8,,test
0535978_sc-123451.jpg,2,1,1,1,5,,train
0535979_sc-123451.jpg,2,1,1,0,4,,train
0535980_sc-123451.jpg,2,0,0,1,3,,train
0535981_sc-123451.jpg,0,0,1,1,2,,train
0535983_sc-123451.jpg,3,0,1,0,4,,train
0535984_sc-123451.jpg,1,1,0,0,2,,train
0535985_sc-123451.jpg,0,0,2,0,2,,train
0535987_as-2584920.jpg,2,2,0,0,4,,val
0535988_sc-153707.jpg,5,0,1,0,6,,val
0535989_sc-153707.jpg,3,1,1,3,8,,test
0535990_sc-153707.jpg,1,0,0,0,1,,train
0535991_sc-153707.jpg,4,1,1,2,8,,train
0535992_sc-1009525.jpg,2,0,0,0,2,,train
0535993_sc-1009525.jpg,2,0,0,0,2,,train
0535995_as-3375751.jpg,1,1,1,1,4,,train
0535996_as-5174969.jpg,0,0,2,1,3,,train
0535998_sc-1007152.jpg,1,0,0,0,1,,train
0536000_sc-127845.jpg,2,0,0,0,2,,val
0536001_as-0029479.jpg,6,0,0,0,6,,val
0536005_as-0042728.jpg,0,0,1,0,1,,test
0536006_as-0042728.jpg,2,1,1,1,5,,train
0536007_as-0042728.jpg,1,0,2,1,4,,train
0536008_as-0093938.jpg,1,0,0,0,1,,train
0536009_as-0093938.jpg,1,0,0,0,1,,train
0536010_sc-228948.jpg,3,0,0,0,3,,train
0536011_sc-228948.jpg,2,0,0,0,2,,train
0536015_as-0014261.jpg,2,1,1,1,5,,train
0536016_as-0014261.jpg,0,1,0,0,1,,val
0536018_as-0014261.jpg,1,0,0,0,1,,val
0536019_as-0014261.jpg,1,0,0,0,1,,test
0536020_as-0050285.jpg,1,0,0,0,1,,train
0536021_as-0050285.jpg,1,0,0,0,1,,train
0536022_as-0037509.jpg,1,0,0,0,1,,train
0536023_sc-179359.jpg,1,0,0,1,2,,train
0536024_sc-179359.jpg,1,0,0,1,2,,train
0536025_sc-179359.jpg,1,0,0,0,1,,train
0536026_sc-179359.jpg,1,0,0,0,1,,train
0536028_sc-179359.jpg,1,0,0,0,1,,val
0536029_sc-179359.jpg,1,0,0,0,1,,val
0536030_sc-179359.jpg,1,0,0,0,1,,test
0536031_sc-1026737.jpg,1,0,0,0,1,,train
0536032_sc-1026737.jpg,1,0,0,0,1,,train
0536033_as-2911654.jpg,0,0,1,0,1,,train
0536034_as-0009273.jpg,1,0,1,0,2,,train
0536035_as-0009273.jpg,1,0,0,1,2,,train
0536037_as-0009273.jpg,1,0,1,1,3,,train
0536039_as-7762825.jpg,0,1,0,0,1,,train
0536040_sc-154430.jpg,5,1,0,0,6,,val
0536041_as-3222880.jpg,6,0,0,0,6,,val
0536043_as-2711276.jpg,1,0,1,0,2,,test
0536044_sc-220299.jpg,5,0,0,0,5,,train
0536045_sc-220299.jpg,6,0,0,0,6,,train
0536046_sc-220299.jpg,3,0,0,0,3,,train
0536047_sc-220299.jpg,3,0,0,1,4,,train
0536048_sc-186779.jpg,0,0,1,1,2,,train
0536049_sc-186779.jpg,0,0,1,0,1,,train
0536050_sc-186779.jpg,0,0,1,0,1,,train
0536051_sc-186779.jpg,0,0,1,0,1,,val
0536052_sc-186779.jpg,1,0,1,0,2,,val
0536053_sc-191944.jpg,1,0,0,0,1,,test
0536054_as-2745144.jpg,1,0,2,1,4,,train
0536055_as-2539962.jpg,1,0,0,0,1,,train
0536056_as-0066392.jpg,3,0,0,0,3,,train
0536057_as-3264474.jpg,2,0,0,0,2,,train
0536058_as-3140327.jpg,1,0,0,0,1,,train
0536061_as-0036365.jpg,1,0,0,0,1,,train
0536062_as-0036365.jpg,1,0,1,0,2,,train
0536063_as-0036365.jpg,1,0,1,0,2,,val
0536064_sc-208338.jpg,1,0,0,0,1,,val
0536065_sc-158236.jpg,1,0,0,0,1,,test
0536066_as-9079818.jpg,4,1,1,1,7,,train
0536068_sc-160269.jpg,5,0,0,0,5,,train
0536069_as-0034095.jpg,2,0,1,0,3,,train
0536070_as-0034095.jpg,4,1,1,1,7,,train
0536072_as-0034095.jpg,2,0,0,0,2,,train
0536073_as-0034095.jpg,0,1,0,1,2,,train
0536074_as-0034095.jpg,1,0,0,0,1,,train
0536076_as-0034095.jpg,1,1,1,1,4,,val
0536077_as-0034095.jpg,3,0,0,0,3,,val
0536078_as-0034095.jpg,1,0,1,1,3,,test
0536080_sc-169618.jpg,1,0,0,0,1,,train
0536081_sc-169618.jpg,3,0,1,0,4,,train
0536082_sc-169618.jpg,2,0,1,0,3,,train
0536083_sc-169618.jpg,2,0,1,0,3,,train
0536084_as-2801775.jpg,1,0,0,0,1,,train
0536085_sc-157330.jpg,3,2,0,0,5,,train
0536086_sc-186181.jpg,1,0,0,1,2,,train
0536089_sc-1022601.jpg,1,1,0,0,2,,val
0536090_as-2694549.jpg,2,0,0,0,2,,val
0536091_sc-189576.jpg,2,0,0,0,2,,test
0536092_sc-189576.jpg,0,0,1,0,1,,train
0536094_sc-189576.jpg,1,0,3,0,4,,train
0536095_sc-189576.jpg,0,0,1,0,1,,train
0536096_sc-189576.jpg,1,0,1,0,2,,train
0536097_as-7848728.jpg,2,0,0,0,2,,train
0536098_sc-218034.jpg,2,0,2,2,6,,train
0536102_as-0017227.jpg,2,0,0,1,3,,train
0536103_as-0017227.jpg,2,0,0,1,3,,val
0536104_as-0017227.jpg,1,0,0,1,2,,val
0536106_as-3449829.jpg,0,0,0,2,2,,test
0536109_as-0045695.jpg,0,1,0,0,1,,train
0536110_as-0045695.jpg,0,1,1,0,2,,train
0536111_as-0045695.jpg,1,0,0,0,1,,train
0536114_sc-1037302.jpg,5,0,0,1,6,,train
0536118_as-0064142.jpg,1,0,0,1,2,,train
0536120_as-0064142.jpg,2,0,0,1,3,,train
0536121_sc-1005901.jpg,1,0,0,0,1,,train
0536122_as-0047590.jpg,0,0,1,0,1,,val
0536123_as-0047590.jpg,0,0,1,0,1,,val
0536124_as-0047590.jpg,1,0,0,0,1,,test
0536125_as-0047590.jpg,1,0,0,0,1,,train
0536126_as-0047590.jpg,0,1,1,1,3,,train
0536127_as-0047590.jpg,1,0,0,0,1,,train
0536128_as-0047590.jpg,1,0,0,0,1,,train
0536129_as-0047590.jpg,0,0,0,1,1,,train
0536130_as-0047590.jpg,1,0,0,0,1,,train
0536131_as-0047590.jpg,1,0,0,0,1,,train
0536132_as-0047590.jpg,1,0,1,0,2,,val
0536133_as-0047590.jpg,1,0,1,0,2,,val
0536134_as-0047590.jpg,1,0,1,0,2,,test
0536135_as-0047590.jpg,1,0,1,0,2,,train
0536136_as-0047590.jpg,3,0,1,0,4,,train
0536137_as-0047590.jpg,0,0,1,0,1,,train
0536140_as-3235321.jpg,5,0,0,0,5,,train
0536142_sc-111794.jpg,3,2,0,0,5,,train
0536150_as-0017468.jpg,4,0,1,0,5,,train
0536151_as-0017468.jpg,1,0,0,0,1,,train
0536152_as-0017468.jpg,0,1,0,0,1,,val
0536153_sc-222343.jpg,1,0,0,1,2,,val
0536154_sc-222343.jpg,2,0,0,1,3,,test
0536155_sc-222343.jpg,1,0,0,1,2,,train
0536156_sc-222343.jpg,2,0,0,1,3,,train
0536157_sc-1006513.jpg,2,0,1,0,3,,train
0536158_sc-1006513.jpg,2,0,1,0,3,,train
0536159_as-2808048.jpg,4,2,1,0,7,,train
0536160_as-0001971.jpg,3,2,2,1,8,,train
0536162_sc-193255.jpg,4,1,2,0,7,,train
0536163_sc-193255.jpg,2,1,2,0,5,,val
0536165_as-0048143.jpg,0,1,1,1,3,,val
0536166_as-0048143.jpg,0,1,1,1,3,,test
0536167_as-0048143.jpg,0,1,1,1,3,,train
0536168_as-0048143.jpg,2,1,1,1,5,,train
0536169_as-0048143.jpg,0,2,1,1,4,,train
0536170_as-0048143.jpg,0,1,1,0,2,,train
0536171_sc-1023455.jpg,3,0,0,0,3,,train
0536172_sc-1023455.jpg,3,0,0,0,3,,train
0536174_sc-209102.jpg,1,0,2,0,3,,train
0536175_sc-209102.jpg,2,0,1,0,3,,val
0536176_sc-209102.jpg,2,0,1,0,3,,val
0536177_sc-209102.jpg,1,0,0,0,1,,test
0536178_sc-209102.jpg,1,0,0,0,1,,train
0536179_sc-209102.jpg,2,0,0,0,2,,train
0536182_as-0002082.jpg,6,0,1,0,7,,train
0536183_sc-214812.jpg,1,0,0,1,2,,train
0536184_sc-1030562.jpg,1,0,1,0,2,,train
0536185_as-2647553.jpg,1,0,0,0,1,,train
0536186_sc-133727.jpg,2,0,0,0,2,,train
0536187_sc-133727.jpg,1,0,0,0,1,,val
0536188_sc-1012249.jpg,1,0,1,1,3,,val
0536189_sc-1012249.jpg,2,0,1,1,4,,test
0536190_sc-1012249.jpg,1,0,1,1,3,,train
0536191_as-2812999.jpg,3,0,0,0,3,,train
0536192_as-2966150.jpg,1,0,0,0,1,,train
0536194_as-0076033.jpg,1,0,1,0,2,,train
0536195_as-0076033.jpg,2,0,2,0,4,,train
0536196_as-2985213.jpg,3,0,0,0,3,,train
0536197_sc-199169.jpg,4,1,3,1,9,,train
0536198_sc-199169.jpg,1,1,2,1,5,,val
0536199_sc-199169.jpg,2,0,2,1,5,,val
0536200_sc-199169.jpg,2,1,2,1,6,,test
0536201_sc-199169.jpg,1,1,1,0,3,,train
0536202_sc-199169.jpg,2,0,0,1,3,,train
0536203_sc-199169.jpg,3,0,0,1,4,,train
0536204_sc-199169.jpg,2,0,0,1,3,,train
0536205_as-0087330.jpg,5,0,0,0,5,,train
0536206_as-0087330.jpg,5,0,0,0,5,,train
0536207_sc-169287.jpg,1,0,0,0,1,,train
0536208_sc-169287.jpg,1,0,0,0,1,,val
0536209_as-7998296.jpg,1,1,1,1,4,,val
0536210_sc-175728.jpg,0,1,0,0,1,,test
0536211_sc-175728.jpg,1,0,0,0,1,,train
0536212_sc-175728.jpg,4,0,0,0,4,,train
0536213_sc-175728.jpg,2,0,0,0,2,,train
0536214_sc-202363.jpg,2,0,0,0,2,,train
0536215_sc-229290.jpg,3,0,0,1,4,,train
0536216_sc-229290.jpg,3,0,0,0,3,,train
0536217_sc-229290.jpg,2,0,0,0,2,,train
0536218_sc-229290.jpg,5,0,1,0,6,,val
0536219_sc-229290.jpg,2,0,0,0,2,,val
0536221_as-2649310.jpg,1,1,0,0,2,,test
0536222_sc-105271.jpg,3,0,0,0,3,,train
0536224_sc-216728.jpg,1,1,2,0,4,,train
0536225_sc-216728.jpg,0,1,1,0,2,,train
0536226_sc-216728.jpg,1,1,1,0,3,,train
0536227_sc-216728.jpg,1,0,1,0,2,,train
0536228_sc-216728.jpg,2,0,0,1,3,,train
0536229_sc-216728.jpg,2,0,1,1,4,,train
0536230_sc-216728.jpg,2,0,0,0,2,,val
0536231_sc-186567.jpg,1,0,1,1,3,,val
0536232_sc-186567.jpg,1,0,1,1,3,,test
0536234_as-0031041.jpg,1,0,0,0,1,,train
0536235_as-7781584.jpg,1,0,0,0,1,,train
0536236_sc-218144.jpg,12,2,3,0,17,,train
0536237_sc-218144.jpg,9,0,1,0,10,,train
0536238_sc-218144.jpg,11,1,2,0,14,,train
0536239_sc-218144.jpg,8,0,0,0,8,,train
0536240_sc-218144.jpg,6,0,0,0,6,,train
0536241_sc-218144.jpg,5,0,0,0,5,,val
0536242_sc-149076.jpg,3,0,0,0,3,,val
0536243_sc-149076.jpg,2,0,0,0,2,,test
0536244_sc-135908.jpg,3,0,0,0,3,,train
0536246_as-0069554.jpg,2,0,0,0,2,,train
0536247_sc-1019828.jpg,7,0,1,1,9,,train
0536249_sc-1019828.jpg,6,0,1,1,8,,train
0536251_sc-202937.jpg,1,0,1,1,3,,train
0536252_sc-202937.jpg,1,0,1,1,3,,train
0536253_sc-202937.jpg,1,0,1,1,3,,train
0536255_sc-155315.jpg,2,0,0,0,2,,val
0536256_sc-155315.jpg,2,0,0,0,2,,val
0536257_as-2529783.jpg,1,0,0,1,2,,test
0536261_as-0077649.jpg,1,0,1,0,2,,train
0536262_as-0077649.jpg,0,0,1,0,1,,train
0536263_sc-154561.jpg,2,0,0,0,2,,train
0536264_sc-1037646.jpg,1,0,1,0,2,,train
0536265_sc-1037646.jpg,1,0,1,0,2,,train
0536266_sc-1037646.jpg,1,0,1,0,2,,train
0536267_as-2502689.jpg,1,1,0,0,2,,train
0536269_as-0010463.jpg,3,0,1,1,5,,val
0536272_as-0010463.jpg,3,0,0,0,3,,val
0536273_as-0010463.jpg,3,1,0,1,5,,test
0536274_as-0010463.jpg,4,1,0,1,6,,train
0536275_as-0010463.jpg,6,0,0,0,6,,train
0536277_sc-177163.jpg,0,1,0,0,1,,train
0536279_sc-177163.jpg,0,1,1,0,2,,train
0536281_sc-1004148.jpg,1,0,0,0,1,,train
0536282_sc-1004148.jpg,1,0,0,0,1,,train
0536283_sc-182362.jpg,1,0,0,0,1,,train
0536284_sc-182362.jpg,2,1,0,0,3,,val
0536285_sc-182362.jpg,2,1,0,1,4,,val
0536286_sc-182362.jpg,1,0,0,0,1,,test
0536287_sc-182362.jpg,1,0,0,0,1,,train
0536288_sc-182362.jpg,1,0,0,0,1,,train
0536289_sc-182362.jpg,4,1,0,1,6,,train
0536290_sc-182362.jpg,1,1,0,0,2,,train
0536291_sc-182362.jpg,3,1,0,0,4,,train
0536292_sc-182362.jpg,2,1,0,0,3,,train
0536293_sc-182362.jpg,3,1,0,2,6,,train
0536294_as-3393215.jpg,2,0,0,0,2,,val
0536295_sc-1023030.jpg,4,0,1,1,6,,val
0536296_sc-1023030.jpg,2,0,0,1,3,,test
0536297_as-3222303.jpg,1,0,0,0,1,,train
0536302_as-0041722.jpg,1,0,0,1,2,,train
0536303_as-0041722.jpg,1,0,0,0,1,,train
0536304_as-0041722.jpg,1,0,0,0,1,,train
0536305_as-0041722.jpg,2,0,0,0,2,,train
0536306_as-0041722.jpg,1,0,0,0,1,,train
0536308_sc-183560.jpg,0,1,1,0,2,,train
0536309_as-3473336.jpg,4,0,0,0,4,,val
0536310_as-3473744.jpg,1,0,0,0,1,,val
0536311_as-0088003.jpg,1,0,1,1,3,,test
0536312_as-0088003.jpg,1,0,1,0,2,,train
0536313_as-0088003.jpg,1,0,1,0,2,,train
0536314_sc-221259.jpg,3,0,0,0,3,,train
0536315_sc-221259.jpg,3,0,0,0,3,,train
0536316_as-0094298.jpg,3,0,0,0,3,,train
0536317_as-0094298.jpg,2,0,0,0,2,,train
0536318_as-0094298.jpg,1,0,0,0,1,,train
0536319_as-0094298.jpg,3,0,0,0,3,,val
0536320_as-0094298.jpg,5,0,0,0,5,,val
0536321_as-0094298.jpg,3,0,0,0,3,,test
0536322_as-0094298.jpg,3,0,0,0,3,,train
0536324_as-0047988.jpg,1,0,0,0,1,,train
0536325_as-0047988.jpg,1,0,0,0,1,,train
0536326_as-0047988.jpg,3,0,0,0,3,,train
0536327_as-0047988.jpg,2,0,0,0,2,,train
0536328_as-0047988.jpg,4,0,0,0,4,,train
0536329_sc-200603.jpg,1,0,0,0,1,,train
0536330_sc-200603.jpg,1,0,0,0,1,,val
0536332_as-7451977.jpg,2,0,0,0,2,,val
0536333_as-3355297.jpg,2,0,1,2,5,,test
0536335_sc-131275.jpg,3,2,0,0,5,,train
0536336_sc-131275.jpg,0,1,0,1,2,,train
0536337_sc-131275.jpg,1,2,0,1,4,,train
0536338_as-2811732.jpg,2,0,1,0,3,,train
0536339_sc-186886.jpg,1,0,0,0,1,,train
0536340_sc-186886.jpg,1,0,0,0,1,,train
0536341_sc-186886.jpg,1,0,0,0,1,,train
0536342_sc-186886.jpg,2,0,0,2,4,,val
0536343_sc-186886.jpg,2,0,0,1,3,,val
0536344_as-3127247.jpg,1,0,0,0,1,,test
0536346_sc-144498.jpg,2,0,1,0,3,,train
0536347_as-7503683.jpg,1,0,0,0,1,,train
0536348_as-5597254.jpg,1,0,0,0,1,,train
0536349_sc-1025654.jpg,2,0,0,0,2,,train
0536350_sc-1025654.jpg,1,0,1,0,2,,train
0536351_sc-1025654.jpg,1,0,1,0,2,,train
0536352_sc-1025654.jpg,2,0,0,0,2,,train
0536354_as-3180843.jpg,1,0,1,0,2,,val
0536357_as-0076871.jpg,1,2,0,0,3,,val
0536358_as-0076871.jpg,0,1,0,0,1,,test
0536359_sc-225748.jpg,10,0,1,1,12,,train
0536360_sc-225748.jpg,4,0,1,2,7,,train
0536361_sc-225748.jpg,8,0,1,1,10,,train
0536362_sc-225748.jpg,1,0,1,0,2,,train
0536364_as-3366493.jpg,4,1,0,2,7,,train
0536365_as-7007450.jpg,0,0,0,2,2,,train
0536367_sc-1011172.jpg,6,2,1,0,9,,train
0536368_sc-204815.jpg,1,0,0,2,3,,val
0536369_sc-204815.jpg,1,0,0,1,2,,val
0536370_sc-204815.jpg,1,0,1,0,2,,test
0536371_sc-204815.jpg,1,0,1,3,5,,train
0536372_sc-204815.jpg,1,0,1,2,4,,train
0536373_sc-204815.jpg,1,0,0,0,1,,train
0536375_sc-104422.jpg,1,0,0,1,2,,train
0536376_sc-104422.jpg,2,0,0,1,3,,train
0536377_sc-104422.jpg,1,0,0,1,2,,train
0536378_sc-131094.jpg,11,0,0,0,11,,train
0536379_sc-169130.jpg,4,0,0,0,4,,val
0536381_as-0088820.jpg,1,0,0,1,2,,val
0536382_as-0088820.jpg,1,0,0,1,2,,test
0536383_as-0088820.jpg,2,0,0,1,3,,train
0536384_as-0088820.jpg,2,0,0,1,3,,train
0536385_as-0088820.jpg,1,0,0,0,1,,train
0536386_as-0088820.jpg,1,0,0,0,1,,train
0536387_as-0088820.jpg,1,0,1,1,3,,train
0536388_as-7683641.jpg,4,0,1,0,5,,train
0536389_sc-152998.jpg,4,0,0,0,4,,train
0536390_sc-152998.jpg,3,0,1,0,4,,val
0536391_sc-191384.jpg,1,0,1,0,2,,val
0536392_sc-191384.jpg,1,0,0,0,1,,test
0536393_sc-191384.jpg,1,0,0,0,1,,train
0536394_sc-191384.jpg,1,0,0,0,1,,train
0536395_sc-191384.jpg,1,0,0,0,1,,train
0536396_sc-191384.jpg,1,0,0,0,1,,train
0536397_sc-191384.jpg,1,1,1,0,3,,train
0536398_sc-191384.jpg,2,0,0,0,2,,train
0536399_sc-191384.jpg,1,0,0,0,1,,train
0536400_sc-191384.jpg,1,0,0,0,1,,val
0536401_as-7389381.jpg,0,1,0,1,2,,val
0536402_as-0044346.jpg,1,1,0,0,2,,test
0536403_sc-230214.jpg,3,0,2,0,5,,train
0536404_sc-230214.jpg,9,0,0,0,9,,train
0536405_sc-230214.jpg,2,0,1,1,4,,train
0536406_sc-230214.jpg,1,0,3,0,4,,train
0536407_sc-230214.jpg,4,0,0,0,4,,train
0536408_sc-230214.jpg,8,0,0,0,8,,train
0536409_sc-137046.jpg,1,0,0,0,1,,train
0536410_sc-137046.jpg,1,0,0,0,1,,val
0536411_sc-137046.jpg,1,0,0,0,1,,val
0536412_sc-137046.jpg,1,0,0,0,1,,test
0536414_sc-137046.jpg,1,1,0,0,2,,train
0536415_sc-137046.jpg,1,0,0,0,1,,train
0536417_sc-137046.jpg,1,0,0,0,1,,train
0536418_sc-137046.jpg,1,0,0,0,1,,train
0536419_sc-137046.jpg,1,0,0,0,1,,train
0536421_sc-183980.jpg,0,2,0,0,2,,train
0536422_as-3040898.jpg,3,1,0,1,5,,train
0536423_as-0040099.jpg,2,0,2,0,4,,val
0536424_as-0040099.jpg,0,0,1,0,1,,val
0536425_as-0040099.jpg,0,0,2,0,2,,test
0536426_as-0040099.jpg,0,0,1,0,1,,train
0536428_as-7651333.jpg,1,0,0,0,1,,train
0536429_as-7651333.jpg,2,0,0,0,2,,train
0536430_sc-1023574.jpg,3,0,1,1,5,,train
0536431_sc-227236.jpg,1,0,1,0,2,,train
0536432_sc-227236.jpg,1,1,0,0,2,,train
0536433_as-2768464.jpg,1,1,0,1,3,,train
0536435_as-0076095.jpg,1,0,1,1,3,,val
0536436_as-0076095.jpg,1,0,1,1,3,,val
0536437_as-0076095.jpg,0,1,0,0,1,,test
0536438_as-2539507.jpg,7,1,1,0,9,,train
0536439_sc-227567.jpg,1,1,1,0,3,,train
0536440_as-3079384.jpg,0,0,1,0,1,,train
0536441_sc-218539.jpg,3,0,0,0,3,,train
0536442_as-7351665.jpg,2,0,0,0,2,,train
0536443_as-2541249.jpg,0,0,1,0,1,,train
0536444_as-9074980.jpg,1,0,0,0,1,,train
0536445_sc-179531.jpg,1,0,0,0,1,,val
0536446_sc-179531.jpg,2,0,0,0,2,,val
0536447_sc-179531.jpg,1,0,0,0,1,,test
0536448_sc-179531.jpg,1,0,0,0,1,,train
0536449_sc-179531.jpg,1,0,0,0,1,,train
0536450_sc-179531.jpg,1,0,0,0,1,,train
0536451_sc-179531.jpg,1,0,0,0,1,,train
0536453_as-7495193.jpg,1,0,1,1,3,,train
0536454_as-3365998.jpg,2,0,0,0,2,,train
0536456_sc-1002771.jpg,1,0,0,0,1,,train
0536457_sc-1002771.jpg,1,0,0,0,1,,val
0536458_sc-1002771.jpg,2,0,1,0,3,,val
0536459_sc-1029232.jpg,2,0,1,0,3,,test
0536461_as-0057650.jpg,0,0,1,0,1,,train
0536462_as-0057650.jpg,0,1,1,0,2,,train
0536463_as-3028661.jpg,2,1,1,1,5,,train
0536464_sc-160755.jpg,3,0,0,3,6,,train
0536465_sc-160755.jpg,1,0,0,4,5,,train
0536466_as-7528197.jpg,1,1,1,0,3,,train
0536468_sc-148587.jpg,1,1,0,1,3,,train
0536469_sc-148587.jpg,1,0,0,0,1,,val
0536470_as-0097585.jpg,1,0,0,1,2,,val
0536471_as-0097585.jpg,1,0,0,1,2,,test
0536472_as-0097585.jpg,1,0,0,1,2,,train
0536473_as-0097585.jpg,1,0,0,1,2,,train
0536474_as-0097585.jpg,1,0,0,1,2,,train
0536475_as-0097585.jpg,1,0,0,1,2,,train
0536476_as-0097585.jpg,1,0,1,0,2,,train
0536477_as-0097585.jpg,2,0,1,0,3,,train
0536478_as-0097585.jpg,1,0,0,0,1,,train
0536479_sc-198314.jpg,5,0,1,0,6,,val
0536480_sc-198314.jpg,4,0,1,0,5,,val
0536483_sc-198314.jpg,9,0,0,1,10,,test
0536484_sc-198314.jpg,7,0,0,1,8,,train
0536485_sc-198314.jpg,7,0,0,0,7,,train
0536487_sc-1032533.jpg,1,0,2,0,3,,train
0536488_sc-1032533.jpg,1,0,1,1,3,,train
0536490_sc-1032533.jpg,1,0,0,0,1,,train
0536491_as-9052253.jpg,1,0,0,0,1,,train
0536492_as-3390260.jpg,1,0,0,0,1,,train
0536494_as-0017837.jpg,0,0,1,1,2,,val
0536495_as-0017837.jpg,0,0,1,1,2,,val
0536496_as-0017837.jpg,2,0,1,1,4,,test
0536497_as-0017837.jpg,3,0,1,1,5,,train
0536498_as-0017837.jpg,2,0,1,1,4,,train
0536499_as-0017837.jpg,4,0,1,1,6,,train
0536500_as-0017837.jpg,0,0,1,1,2,,train
0536502_as-0049638.jpg,1,0,0,0,1,,train
0536505_as-0049638.jpg,1,0,1,1,3,,train
0536507_as-0049638.jpg,1,0,0,0,1,,train
0536508_as-0049638.jpg,1,0,1,0,2,,val
0536509_as-0049638.jpg,2,0,1,1,4,,val
0536511_as-0004966.jpg,2,1,1,1,5,,test
0536512_as-0004966.jpg,1,1,1,1,4,,train
0536513_as-0004966.jpg,2,1,0,1,4,,train
0536514_as-0004966.jpg,2,1,0,0,3,,train
0536516_as-0044749.jpg,2,0,0,1,3,,train
0536517_as-0044749.jpg,1,0,0,0,1,,train
0536518_as-0044749.jpg,1,2,1,1,5,,train
0536519_as-0044749.jpg,4,1,1,1,7,,train
0536520_as-0043401.jpg,8,0,1,3,12,,val
0536521_as-0043401.jpg,10,0,0,0,10,,val
0536522_as-0043401.jpg,7,0,1,3,11,,test
0536523_as-3074963.jpg,1,0,0,0,1,,train
0536524_as-0060661.jpg,0,0,1,0,1,,train
0536529_as-0045730.jpg,1,1,1,1,4,,train
0536530_as-0045730.jpg,3,1,1,0,5,,train
0536532_as-0063470.jpg,1,0,1,1,3,,train
0536533_as-0063470.jpg,1,0,0,0,1,,train
0536534_as-0063470.jpg,2,0,0,0,2,,train
0536535_as-9024884.jpg,1,0,0,0,1,,val
0536536_sc-194531.jpg,3,1,1,2,7,,val
0536537_sc-194531.jpg,4,0,1,2,7,,test
0536538_sc-194531.jpg,2,0,0,0,2,,train
0536539_sc-194531.jpg,3,0,0,0,3,,train
0536540_sc-194531.jpg,3,0,1,0,4,,train
0536541_sc-194531.jpg,4,1,1,2,8,,train
0536542_sc-194531.jpg,1,1,1,1,4,,train
0536543_sc-194531.jpg,5,1,1,3,10,,train
0536544_as-2716193.jpg,1,1,0,0,2,,train
0536545_sc-1030948.jpg,0,0,1,0,1,,val
0536547_as-3296881.jpg,2,0,0,0,2,,val
0536549_as-2635350.jpg,1,2,1,1,5,,test
0536551_sc-220602.jpg,3,1,0,0,4,,train
0536553_sc-220602.jpg,2,1,0,0,3,,train
0536554_sc-220602.jpg,3,1,0,0,4,,train
0536556_as-9055081.jpg,4,0,0,0,4,,train
0536557_as-3309562.jpg,5,0,1,0,6,,train
0536559_as-0024736.jpg,1,0,0,0,1,,train
0536560_as-0024736.jpg,2,0,0,0,2,,train
0536561_as-0024736.jpg,2,2,1,0,5,,val
0536562_as-0024736.jpg,3,0,1,0,4,,val
0536563_as-0024736.jpg,2,0,1,0,3,,test
0536564_sc-1010629.jpg,4,1,0,0,5,,train
0536568_as-0091898.jpg,1,0,1,0,2,,train
0536571_as-0078733.jpg,1,0,0,0,1,,train
0536575_as-0078733.jpg,2,1,2,0,5,,train
0536576_as-0078733.jpg,2,0,0,0,2,,train
0536577_as-0078733.jpg,1,1,0,0,2,,train
0536581_as-0063419.jpg,1,0,0,0,1,,train
0536583_as-0063419.jpg,2,0,0,0,2,,val
0536585_as-0063419.jpg,1,0,0,1,2,,val
0536587_as-0063419.jpg,1,0,0,0,1,,test
0536591_as-0023173.jpg,0,0,1,1,2,,train
0536592_as-0023173.jpg,0,0,1,1,2,,train
0536593_as-0023173.jpg,3,0,0,0,3,,train
0536595_as-9007869.jpg,3,0,0,0,3,,train
0536596_as-9007869.jpg,9,1,0,0,10,,train
0536597_sc-183226.jpg,5,0,0,0,5,,train
0536598_sc-183226.jpg,1,0,0,0,1,,train
0536599_sc-183226.jpg,1,0,0,0,1,,val
0536600_sc-183226.jpg,1,0,0,0,1,,val
0536601_sc-183226.jpg,1,0,0,0,1,,test
0536602_sc-183226.jpg,2,0,0,1,3,,train
0536605_as-2826707.jpg,1,0,0,0,1,,train
0536606_sc-214861.jpg,1,0,0,0,1,,train
0536607_sc-214861.jpg,2,0,0,0,2,,train
0536608_sc-214861.jpg,1,0,0,0,1,,train
0536609_sc-214861.jpg,4,0,0,0,4,,train
0536610_sc-214861.jpg,1,0,0,0,1,,train
0536611_as-9098293.jpg,2,1,2,0,5,,val
0536612_sc-1005158.jpg,2,0,0,0,2,,val
0536613_sc-1005158.jpg,2,0,0,0,2,,test
0536614_as-3134346.jpg,1,0,0,0,1,,train
0536615_sc-202802.jpg,1,0,0,0,1,,train
0536616_sc-147917.jpg,1,0,1,0,2,,train
0536617_sc-147917.jpg,1,1,1,1,4,,train
0536618_sc-147917.jpg,2,1,1,1,5,,train
0536619_sc-147917.jpg,2,0,1,0,3,,train
0536620_sc-147917.jpg,1,0,0,0,1,,train
0536621_as-9015993.jpg,1,0,1,0,2,,val
0536622_sc-160808.jpg,0,1,0,0,1,,val
0536623_sc-160808.jpg,0,1,0,0,1,,test
0536624_sc-160808.jpg,0,1,0,0,1,,train
0536625_sc-160808.jpg,1,0,0,0,1,,train
0536626_sc-160808.jpg,1,0,0,0,1,,train
0536627_sc-160808.jpg,1,0,0,0,1,,train
0536630_as-7691943.jpg,2,1,1,1,5,,train
0536632_sc-123213.jpg,1,1,1,1,4,,train
0536634_as-2989969.jpg,1,0,0,0,1,,train
0536635_sc-168014.jpg,2,0,1,1,4,,val
0536636_sc-168014.jpg,4,0,0,1,5,,val
0536638_sc-176313.jpg,4,0,0,0,4,,test
0536639_sc-176313.jpg,4,0,0,0,4,,train
0536640_sc-210257.jpg,1,0,0,0,1,,train
0536641_as-3199209.jpg,0,0,0,1,1,,train
0536643_sc-146197.jpg,2,0,0,0,2,,train
0536644_sc-146197.jpg,2,0,0,0,2,,train
0536646_as-0002161.jpg,2,0,0,0,2,,train
0536648_sc-134197.jpg,1,0,1,0,2,,train
0536649_sc-134197.jpg,1,0,0,0,1,,val
0536651_sc-134197.jpg,2,1,0,0,3,,val
0536652_sc-134197.jpg,2,2,1,1,6,,test
0536653_sc-134197.jpg,1,0,1,0,2,,train
0536657_sc-166729.jpg,1,0,0,0,1,,train
0536658_sc-166729.jpg,3,0,0,0,3,,train
0536659_sc-166729.jpg,3,0,0,0,3,,train
0536660_sc-166729.jpg,3,0,0,0,3,,train
0536661_sc-166729.jpg,2,0,0,0,2,,train
0536662_sc-166729.jpg,2,0,0,0,2,,train
0536663_sc-166729.jpg,1,0,0,0,1,,val
0536664_sc-166729.jpg,2,0,0,0,2,,val
0536665_sc-166729.jpg,2,0,0,1,3,,test
0536666_sc-166729.jpg,2,0,0,1,3,,train
0536667_sc-166729.jpg,5,0,1,1,7,,train
0536668_sc-166729.jpg,2,0,1,1,4,,train
0536669_sc-166729.jpg,4,0,0,2,6,,train
0536672_sc-125352.jpg,1,0,0,0,1,,train
0536673_sc-125352.jpg,1,0,0,0,1,,train
0536674_as-2935398.jpg,1,0,0,0,1,,train
0536675_as-3482079.jpg,3,0,0,0,3,,val
0536676_sc-144353.jpg,4,2,2,0,8,,val
0536677_sc-144353.jpg,0,2,1,0,3,,test
0536680_sc-144353.jpg,1,2,1,0,4,,train
0536683_as-0049237.jpg,0,0,1,0,1,,train
0536684_as-0049237.jpg,1,1,0,0,2,,train
0536685_as-0049237.jpg,2,1,0,0,3,,train
0536686_as-0049237.jpg,3,1,0,0,4,,train
0536688_as-0027676.jpg,2,0,0,0,2,,train
0536689_as-0027676.jpg,3,0,0,0,3,,train
0536693_as-0020235.jpg,0,0,2,0,2,,val
0536694_as-0020235.jpg,0,0,1,0,1,,val
0536696_as-0020235.jpg,1,0,1,0,2,,test
0536697_as-0020235.jpg,1,0,1,0,2,,train
0536698_sc-183866.jpg,4,0,0,0,4,,train
0536699_as-3188206.jpg,1,0,0,0,1,,train
0536700_sc-1039914.jpg,2,1,0,0,3,,train
0536702_as-2882915.jpg,2,0,0,0,2,,train
0536706_as-7467012.jpg,2,0,0,0,2,,train
0536708_sc-171262.jpg,2,0,1,0,3,,train
0536709_as-7627019.jpg,1,0,0,1,2,,val
0536710_sc-139587.jpg,0,0,1,0,1,,val
0536711_sc-139587.jpg,0,0,1,0,1,,test
0536712_sc-139587.jpg,0,0,1,0,1,,train
0536713_sc-139587.jpg,0,0,1,0,1,,train
0536714_as-2922976.jpg,1,0,1,0,2,,train
0536718_as-0006847.jpg,6,0,3,2,11,,train
0536719_sc-136685.jpg,1,0,0,1,2,,train
0536721_sc-136685.jpg,1,0,0,1,2,,train
0536722_sc-136685.jpg,1,0,0,1,2,,train
0536725_as-0058688.jpg,3,0,0,0,3,,val
0536727_as-0082415.jpg,1,0,0,0,1,,val
0536729_as-0082415.jpg,4,0,0,0,4,,test
0536730_as-0082415.jpg,2,0,0,0,2,,train
0536731_as-0082415.jpg,1,0,0,0,1,,train
0536732_as-0082415.jpg,1,0,0,0,1,,train
0536733_as-0050655.jpg,2,0,0,0,2,,train
0536734_as-0050655.jpg,3,0,0,0,3,,train
0536735_as-7558208.jpg,1,0,2,1,4,,train
0536736_sc-1027623.jpg,7,0,0,2,9,,train
0536737_sc-1027623.jpg,7,0,0,2,9,,val
0536738_sc-1027623.jpg,7,0,1,1,9,,val
0536739_sc-1027623.jpg,7,0,0,2,9,,test
0536740_as-0061837.jpg,0,0,2,1,3,,train
0536741_as-0061837.jpg,0,0,2,0,2,,train
0536743_as-0061837.jpg,2,1,2,1,6,,train
0536747_as-0061837.jpg,0,1,1,0,2,,train
0536748_sc-115953.jpg,3,2,0,0,5,,train
0536750_as-0060252.jpg,1,1,1,0,3,,train
0536751_as-0060252.jpg,1,0,1,0,2,,train
0536752_as-9053508.jpg,2,2,1,0,5,,val
0536753_sc-138087.jpg,0,0,1,0,1,,val
0536754_as-3021155.jpg,3,0,1,0,4,,test
0536756_as-0031307.jpg,5,0,0,0,5,,train
0536757_as-0031307.jpg,3,0,1,0,4,,train
0536758_as-0031307.jpg,4,0,0,0,4,,train
0536759_sc-197412.jpg,1,0,0,0,1,,train
0536760_sc-1023165.jpg,5,1,0,1,7,,train
0536761_sc-1023165.jpg,1,2,1,0,4,,train
0536763_sc-129576.jpg,2,1,0,0,3,,train
0536765_as-0044179.jpg,2,2,1,1,6,,val
0536767_as-0044179.jpg,1,1,0,0,2,,val
0536768_as-0044179.jpg,2,1,0,0,3,,test
0536769_as-0044179.jpg,1,0,1,0,2,,train
0536770_as-0044179.jpg,0,0,1,0,1,,train
0536771_sc-1017189.jpg,3,0,1,0,4,,train
0536772_sc-1017189.jpg,4,0,1,0,5,,train
0536773_sc-1036562.jpg,2,1,0,0,3,,train
0536774_sc-1036562.jpg,0,1,0,0,1,,train
0536775_sc-1036562.jpg,1,0,0,0,1,,train
0536776_sc-1036562.jpg,1,0,0,0,1,,val
0536777_sc-132602.jpg,1,0,0,0,1,,val
0536778_sc-132602.jpg,3,0,0,0,3,,test
0536780_as-2627110.jpg,1,3,1,0,5,,train
0536781_as-7129361.jpg,1,0,0,0,1,,train
0536783_as-0010563.jpg,1,1,0,1,3,,train
0536786_as-0010563.jpg,1,0,0,1,2,,train
0536789_as-0088406.jpg,0,0,1,0,1,,train
0536790_as-0088406.jpg,0,0,1,0,1,,train
0536791_as-0088406.jpg,0,0,1,0,1,,train
0536792_as-0088406.jpg,0,0,1,0,1,,val
0536793_as-0088406.jpg,5,0,1,0,6,,val
0536794_as-0088406.jpg,0,0,1,0,1,,test
0536795_as-0088406.jpg,0,0,1,0,1,,train
0536796_as-0088406.jpg,10,2,1,2,15,,train
0536797_sc-1001593.jpg,1,0,0,0,1,,train
0536800_as-3198728.jpg,0,0,1,0,1,,train
0536801_sc-211507.jpg,0,1,0,0,1,,train
0536802_as-2697932.jpg,1,0,1,0,2,,train
0536805_as-3199873.jpg,0,0,0,1,1,,train
0536807_as-0073066.jpg,1,0,0,0,1,,val
0536808_as-0073066.jpg,0,0,0,1,1,,val
0536809_as-0073066.jpg,3,0,0,0,3,,test
0536810_as-0073066.jpg,3,0,0,0,3,,train
0536813_sc-132183.jpg,4,0,0,1,5,,train
0536815_as-2612595.jpg,2,0,0,0,2,,train
0536819_as-0026146.jpg,0,1,2,1,4,,train
0536820_as-0026146.jpg,2,2,2,1,7,,train
0536822_as-0026146.jpg,2,0,0,1,3,,train
0536823_as-0026146.jpg,2,0,1,1,4,,train
0536824_as-0026146.jpg,3,0,1,1,5,,val
0536825_as-0026146.jpg,2,0,0,1,3,,val
0536826_as-0026146.jpg,1,0,0,0,1,,test
0536827_as-0026146.jpg,2,0,1,1,4,,train
0536828_sc-223298.jpg,0,0,0,2,2,,train
0536829_sc-223298.jpg,0,0,0,1,1,,train
0536830_sc-223298.jpg,1,0,0,1,2,,train
0536831_sc-1004152.jpg,3,1,1,1,6,,train
0536832_sc-1004152.jpg,1,0,0,1,2,,train
0536835_sc-1004152.jpg,0,0,1,0,1,,train
0536836_as-3484458.jpg,1,0,1,0,2,,val
0536837_as-9069490.jpg,1,1,1,1,4,,val
0536838_sc-137225.jpg,0,0,1,1,2,,test
0536839_sc-137225.jpg,0,0,1,0,1,,train
0536841_sc-184416.jpg,1,1,1,1,4,,train
0536842_sc-184416.jpg,1,0,1,1,3,,train
0536843_as-7614455.jpg,2,0,0,0,2,,train
0536844_as-3222592.jpg,4,0,0,0,4,,train
0536845_as-3227010.jpg,1,0,0,0,1,,train
0536846_as-3012093.jpg,1,0,0,0,1,,train
0536848_sc-167172.jpg,2,1,0,1,4,,val
0536849_sc-167172.jpg,5,0,0,0,5,,val
0536850_sc-167172.jpg,3,1,0,0,4,,test
0536851_sc-167172.jpg,6,0,0,0,6,,train
0536852_as-2745941.jpg,1,0,0,0,1,,train
0536853_as-2717346.jpg,1,0,0,0,1,,train
0536854_as-3011621.jpg,0,1,1,1,3,,train
0536858_as-3225809.jpg,2,0,1,0,3,,train
0536861_as-0066804.jpg,0,0,0,1,1,,train
0536863_sc-121378.jpg,3,0,0,1,4,,train
0536864_sc-121378.jpg,3,0,1,0,4,,val
0536865_sc-121378.jpg,2,0,1,0,3,,val
0536866_sc-121378.jpg,2,0,0,1,3,,test
0536867_sc-121378.jpg,7,0,0,1,8,,train
0536868_sc-121378.jpg,4,0,1,0,5,,train
0536869_sc-121378.jpg,2,0,1,0,3,,train
0536870_sc-121378.jpg,2,0,1,0,3,,train
0536871_sc-1023424.jpg,8,0,0,0,8,,train
0536872_sc-1023424.jpg,7,0,0,0,7,,train
0536873_sc-1023424.jpg,3,1,0,0,4,,train
0536874_sc-1036793.jpg,3,0,1,0,4,,val
0536875_sc-1036793.jpg,2,0,0,0,2,,val
0536876_sc-1036793.jpg,2,0,1,0,3,,test
0536877_sc-1036793.jpg,1,0,1,0,2,,train
0536879_sc-1015201.jpg,1,0,2,0,3,,train
0536881_as-0083380.jpg,0,2,0,0,2,,train
0536882_as-0083380.jpg,0,1,0,0,1,,train
0536883_as-0083380.jpg,1,1,0,0,2,,train
0536885_sc-1034414.jpg,3,0,0,0,3,,train
0536886_sc-1035057.jpg,2,0,0,1,3,,train
0536887_sc-1035057.jpg,3,0,0,1,4,,val
0536888_sc-139929.jpg,0,1,1,2,4,,val
0536889_sc-139929.jpg,3,0,1,2,6,,test
0536890_sc-139929.jpg,3,0,1,0,4,,train
0536891_as-0052557.jpg,3,0,1,2,6,,train
0536892_as-0052557.jpg,3,0,1,2,6,,train
0536893_as-3380633.jpg,1,0,0,0,1,,train
0536894_as-5475225.jpg,1,0,0,0,1,,train
0536896_as-0001005.jpg,1,0,1,2,4,,train
0536897_as-0002047.jpg,1,0,0,0,1,,train
0536898_as-0002047.jpg,2,0,0,1,3,,val
0536900_sc-200066.jpg,2,1,2,0,5,,val
0536902_as-0025990.jpg,1,0,0,0,1,,test
0536903_sc-188179.jpg,4,0,0,1,5,,train
0536904_sc-188179.jpg,3,0,0,1,4,,train
0536905_sc-188179.jpg,3,0,0,2,5,,train
0536906_as-2818294.jpg,3,2,1,0,6,,train
0536907_as-7029871.jpg,1,0,1,0,2,,train
0536908_sc-121725.jpg,1,1,0,0,2,,train
0536909_sc-121725.jpg,3,1,0,0,4,,train
0536910_sc-121725.jpg,4,1,0,0,5,,val
0536911_sc-121725.jpg,2,1,0,0,3,,val
0536912_sc-186304.jpg,1,0,0,0,1,,test
0536913_sc-186304.jpg,1,0,0,0,1,,train
0536914_sc-119899.jpg,5,0,1,1,7,,train
0536915_sc-119899.jpg,5,0,0,1,6,,train
0536916_sc-119899.jpg,2,0,0,1,3,,train
0536917_sc-119899.jpg,5,0,0,1,6,,train
0536919_sc-203276.jpg,3,0,0,0,3,,train
0536920_sc-220646.jpg,0,0,1,0,1,,train
0536921_sc-220646.jpg,4,0,0,0,4,,val
0536922_sc-220646.jpg,1,1,1,0,3,,val
0536923_sc-210034.jpg,0,1,1,0,2,,test
0536924_sc-210034.jpg,0,0,1,0,1,,train
0536925_sc-210034.jpg,1,0,1,1,3,,train
0536926_sc-201774.jpg,2,0,0,0,2,,train
0536927_sc-201774.jpg,1,0,0,0,1,,train
0536928_sc-201774.jpg,1,0,0,0,1,,train
0536929_sc-201774.jpg,1,0,0,0,1,,train
0536930_sc-201774.jpg,1,0,0,0,1,,train
0536931_sc-201774.jpg,2,0,0,0,2,,val
0536932_sc-201774.jpg,2,0,0,0,2,,val
0536933_sc-201774.jpg,3,0,0,0,3,,test
0536934_sc-201774.jpg,2,0,0,0,2,,train
0536935_as-9002364.jpg,4,1,0,0,5,,train
0536936_as-0062158.jpg,3,0,0,0,3,,train
0536937_sc-118047.jpg,1,0,0,1,2,,train
0536938_sc-118047.jpg,2,0,0,1,3,,train
0536939_sc-118047.jpg,6,0,0,2,8,,train
0536940_sc-118047.jpg,5,0,0,1,6,,train
0536941_sc-118047.jpg,5,0,0,1,6,,val
0536943_sc-192187.jpg,1,0,1,0,2,,val
0536944_sc-192187.jpg,1,0,0,0,1,,test
0536945_as-3014947.jpg,2,0,0,0,2,,train
0536947_sc-170750.jpg,1,0,1,0,2,,train
0536948_sc-128928.jpg,3,0,0,0,3,,train
0536950_as-0068601.jpg,1,0,1,1,3,,train
0536951_as-0068601.jpg,1,0,0,0,1,,train
0536952_as-0068601.jpg,1,0,0,0,1,,train
0536953_as-0068601.jpg,1,0,1,2,4,,train
0536955_sc-114847.jpg,0,0,1,1,2,,val
0536956_sc-173361.jpg,1,0,0,1,2,,val
0536957_sc-173361.jpg,2,0,0,1,3,,test
0536958_as-2553709.jpg,1,0,0,1,2,,train
0536959_as-0045111.jpg,2,0,0,0,2,,train
0536960_as-3314069.jpg,5,0,0,0,5,,train
0536961_as-0007718.jpg,2,0,0,0,2,,train
0536962_as-0007718.jpg,2,0,0,0,2,,train
0536963_as-0007718.jpg,1,0,0,0,1,,train
0536964_sc-198465.jpg,2,0,1,0,3,,train
0536965_sc-198465.jpg,2,0,1,0,3,,val
0536966_sc-198465.jpg,1,0,1,0,2,,val
0536967_sc-198465.jpg,1,0,1,0,2,,test
0536968_sc-198465.jpg,0,0,1,0,1,,train
0536970_as-0051094.jpg,2,0,1,1,4,,train
0536972_as-0051094.jpg,2,0,1,1,4,,train
0536975_sc-206344.jpg,1,1,3,1,6,,train
0536976_sc-206344.jpg,1,1,3,0,5,,train
0536977_sc-206344.jpg,1,1,2,0,4,,train
0536978_sc-206344.jpg,1,1,3,0,5,,train
0536982_sc-107657.jpg,1,0,1,0,2,,val
0536983_sc-107657.jpg,1,0,1,0,2,,val
0536984_sc-210601.jpg,2,0,0,0,2,,test
0536985_sc-210601.jpg,1,0,0,0,1,,train
0536986_sc-210601.jpg,1,0,1,0,2,,train
0536987_sc-197314.jpg,1,0,0,0,1,,train
0536988_sc-1008919.jpg,5,0,2,1,8,,train
0536989_sc-1008919.jpg,5,0,2,0,7,,train
0536990_sc-1008919.jpg,1,2,1,1,5,,train
0536992_sc-1008919.jpg,2,1,1,0,4,,train
0536993_sc-1008919.jpg,4,1,1,1,7,,val
0536994_as-0052092.jpg,0,2,1,1,4,,val
0536995_as-0052092.jpg,1,1,0,2,4,,test
0536996_as-0052092.jpg,0,1,0,0,1,,train
0536997_as-0052092.jpg,0,1,2,1,4,,train
0536998_as-0052092.jpg,1,0,0,0,1,,train
0536999_as-2758818.jpg,2,0,0,0,2,,train
0537000_sc-1035001.jpg,8,0,0,0,8,,train
0537001_sc-1035001.jpg,4,0,0,1,5,,train
0537002_sc-1035001.jpg,2,0,0,1,3,,train
0537004_sc-1035001.jpg,0,1,1,0,2,,val
0537005_sc-1035001.jpg,3,0,0,1,4,,val
0537006_as-3478784.jpg,1,1,1,1,4,,test
0537007_sc-113908.jpg,1,0,0,0,1,,train
0537008_sc-113908.jpg,1,0,0,0,1,,train
0537009_sc-170262.jpg,3,0,1,0,4,,train
0537010_sc-170262.jpg,6,0,2,0,8,,train
0537012_as-0063664.jpg,2,0,0,0,2,,train
0537013_as-0063664.jpg,1,0,1,0,2,,train
0537015_as-0063664.jpg,7,2,0,0,9,,train
0537017_as-0063664.jpg,10,2,2,0,14,,val
0537018_as-0063664.jpg,7,2,1,0,10,,val
0537020_as-0063664.jpg,1,0,0,0,1,,test
0537022_sc-1015470.jpg,4,1,0,0,5,,train
0537024_sc-1015470.jpg,7,1,0,0,8,,train
0537025_sc-1015470.jpg,3,1,1,0,5,,train
0537026_sc-1015470.jpg,1,3,0,0,4,,train
0537027_sc-163873.jpg,1,0,1,1,3,,train
0537029_sc-163873.jpg,1,0,1,1,3,,train
0537030_sc-163873.jpg,1,0,0,0,1,,train
0537031_sc-163873.jpg,1,0,0,0,1,,val
0537032_sc-163873.jpg,1,0,0,0,1,,val
0537034_sc-215050.jpg,1,0,0,0,1,,test
0537035_sc-215050.jpg,1,0,0,0,1,,train
0537036_sc-215050.jpg,1,0,0,0,1,,train
0537038_as-7694076.jpg,1,0,0,0,1,,train
0537039_sc-222619.jpg,2,0,0,0,2,,train
0537040_sc-222619.jpg,2,0,0,0,2,,train
0537041_sc-222619.jpg,2,0,0,0,2,,train
0537042_sc-222619.jpg,1,0,1,0,2,,train
0537043_sc-222619.jpg,0,0,0,1,1,,val
0537044_sc-222619.jpg,0,0,1,1,2,,val
0537045_sc-222619.jpg,0,0,1,1,2,,test
0537046_sc-222619.jpg,1,0,1,1,3,,train
0537047_sc-222619.jpg,1,0,0,1,2,,train
0537048_sc-214764.jpg,2,0,0,0,2,,train
0537049_sc-214764.jpg,3,0,0,0,3,,train
0537050_sc-214764.jpg,2,0,0,0,2,,train
0537051_sc-214764.jpg,2,0,0,0,2,,train
0537052_sc-214764.jpg,1,0,0,0,1,,train
0537053_as-0052901.jpg,2,0,0,0,2,,val
0537054_sc-182034.jpg,4,0,2,1,7,,val
0537055_sc-182034.jpg,3,0,1,1,5,,test
0537056_sc-182034.jpg,5,0,2,1,8,,train
0537057_as-3183833.jpg,1,0,0,1,2,,train
0537060_sc-186315.jpg,1,1,0,1,3,,train
0537061_sc-186315.jpg,1,0,1,0,2,,train
0537062_as-3270018.jpg,2,0,0,0,2,,train
0537063_sc-134036.jpg,2,0,1,0,3,,train
0537065_sc-134036.jpg,1,0,0,0,1,,train
0537066_sc-134036.jpg,3,0,0,0,3,,val
0537067_sc-134036.jpg,4,0,1,0,5,,val
0537068_sc-134036.jpg,5,0,1,0,6,,test
0537069_sc-134036.jpg,3,0,1,0,4,,train
0537070_sc-134036.jpg,5,0,0,0,5,,train
0537071_sc-134036.jpg,3,0,0,0,3,,train
0537074_as-7952272.jpg,2,0,0,0,2,,train
0537075_as-2593183.jpg,1,0,0,0,1,,train
0537077_sc-1041137.jpg,3,0,1,0,4,,train
0537079_sc-1041137.jpg,2,0,1,0,3,,train
0537080_sc-1041137.jpg,2,0,0,0,2,,val
0537081_as-0083697.jpg,0,0,0,1,1,,val
0537082_as-0083697.jpg,0,0,0,1,1,,test
0537083_sc-1041418.jpg,3,0,0,0,3,,train
0537084_sc-1041418.jpg,5,0,0,0,5,,train
0537085_sc-1041418.jpg,3,0,0,0,3,,train
0537086_sc-1016870.jpg,1,1,1,0,3,,train
0537087_sc-1016870.jpg,1,1,1,0,3,,train
0537088_sc-1016870.jpg,2,0,0,0,2,,train
0537089_sc-216445.jpg,3,0,0,0,3,,train
0537090_sc-216445.jpg,3,0,0,0,3,,val
0537091_sc-216445.jpg,6,0,0,0,6,,val
0537092_as-0030278.jpg,3,4,0,0,7,,test
0537093_as-0030278.jpg,3,5,1,0,9,,train
0537094_as-0030278.jpg,1,6,5,0,12,,train
0537096_sc-177731.jpg,1,1,0,0,2,,train
0537098_as-7824278.jpg,2,0,0,0,2,,train
0537100_sc-1001856.jpg,1,0,0,0,1,,train
0537102_as-0094204.jpg,1,0,0,0,1,,train
0537103_as-0094204.jpg,1,0,0,0,1,,train
0537104_as-0094204.jpg,1,1,0,0,2,,val
0537105_sc-202003.jpg,9,0,0,0,9,,val
0537106_sc-202003.jpg,1,0,1,0,2,,test
0537107_sc-202003.jpg,3,0,1,0,4,,train
0537108_sc-202003.jpg,3,1,2,0,6,,train
0537109_sc-202003.jpg,1,1,0,0,2,,train
0537111_as-0040552.jpg,3,0,1,1,5,,train
0537112_as-0040552.jpg,3,0,1,1,5,,train
0537113_as-0040552.jpg,1,0,1,1,3,,train
0537114_as-0040552.jpg,1,1,0,0,2,,train
0537115_as-0040552.jpg,1,0,1,1,3,,val
0537117_as-2878624.jpg,1,0,0,0,1,,val
0537118_as-3044865.jpg,4,0,0,0,4,,test
0537119_as-3288944.jpg,0,2,0,2,4,,train
0537122_as-0070151.jpg,0,0,3,1,4,,train
0537123_sc-146991.jpg,4,0,2,2,8,,train
0537126_sc-146991.jpg,0,1,1,0,2,,train
0537127_sc-202108.jpg,0,0,1,0,1,,train
0537128_as-7490172.jpg,0,3,0,0,3,,train
0537129_as-3208279.jpg,3,1,1,1,6,,train
0537131_as-0012490.jpg,2,0,0,0,2,,val
0537132_as-0012490.jpg,2,0,0,0,2,,val
0537133_as-0012490.jpg,3,0,0,0,3,,test
0537135_as-3146085.jpg,0,0,1,0,1,,train
0537136_as-7115999.jpg,1,0,0,0,1,,train
0537138_as-0042883.jpg,1,1,1,0,3,,train
0537139_as-0034250.jpg,1,1,0,0,2,,train
0537140_as-0034250.jpg,2,1,1,0,4,,train
0537143_as-0002591.jpg,4,0,0,0,4,,train
0537145_as-3490731.jpg,1,0,0,0,1,,train
0537146_as-2846730.jpg,0,0,0,1,1,,val
0537147_sc-205560.jpg,3,0,0,0,3,,val
0537148_sc-205560.jpg,0,0,0,1,1,,test
0537149_sc-105682.jpg,1,0,0,0,1,,train
0537151_as-0013727.jpg,1,1,0,0,2,,train
0537152_as-0013727.jpg,1,0,0,0,1,,train
0537153_as-0013727.jpg,1,0,0,0,1,,train
0537154_as-0013727.jpg,2,0,0,0,2,,train
0537155_as-0013727.jpg,1,0,0,0,1,,train
0537157_sc-145342.jpg,0,1,2,0,3,,train
0537159_sc-145342.jpg,1,1,1,0,3,,val
0537160_sc-145342.jpg,0,0,1,0,1,,val
0537161_sc-145342.jpg,1,0,0,0,1,,test
0537162_sc-145342.jpg,1,0,0,1,2,,train
0537163_sc-145342.jpg,0,0,0,1,1,,train
0537164_sc-1038233.jpg,2,0,0,0,2,,train
0537166_sc-140543.jpg,2,1,1,0,4,,train
0537171_sc-140543.jpg,5,1,1,0,7,,train
0537174_sc-140543.jpg,4,1,1,0,6,,train
0537175_sc-140543.jpg,3,1,1,0,5,,train
0537176_as-0012020.jpg,1,0,0,1,2,,val
0537177_as-0012020.jpg,1,0,0,1,2,,val
0537178_sc-189452.jpg,2,0,0,0,2,,test
0537179_as-3121365.jpg,2,1,0,2,5,,train
0537180_as-3321906.jpg,4,1,1,1,7,,train
0537181_sc-171659.jpg,2,1,0,1,4,,train
0537183_sc-171659.jpg,2,0,0,0,2,,train
0537184_sc-171659.jpg,2,1,0,2,5,,train
0537185_sc-197219.jpg,1,1,1,0,3,,train
0537186_sc-197219.jpg,2,0,0,0,2,,train
0537188_sc-209685.jpg,2,0,0,0,2,,val
0537189_sc-146404.jpg,0,1,2,0,3,,val
0537190_as-9013364.jpg,1,0,0,0,1,,test
0537191_sc-107044.jpg,0,1,0,0,1,,train
0537192_sc-120251.jpg,2,0,0,0,2,,train
0537194_sc-120251.jpg,6,0,0,0,6,,train
0537196_sc-1040016.jpg,1,0,0,1,2,,train
0537197_sc-137733.jpg,1,0,0,1,2,,train
0537198_sc-137733.jpg,1,0,0,1,2,,train
0537199_sc-137733.jpg,2,0,0,1,3,,train
0537200_sc-137733.jpg,1,0,0,1,2,,val
0537201_as-0015550.jpg,0,0,1,0,1,,val
0537202_as-0015550.jpg,2,0,1,0,3,,test
0537203_as-0015550.jpg,1,0,1,0,2,,train
0537205_as-0015550.jpg,1,1,0,0,2,,train
0537206_as-0015550.jpg,0,1,0,0,1,,train
0537208_sc-103968.jpg,10,2,0,0,12,,train
0537211_sc-211448.jpg,3,1,0,0,4,,train
0537212_sc-211448.jpg,1,1,1,0,3,,train
0537213_sc-211448.jpg,1,0,0,0,1,,train
0537214_as-2624248.jpg,2,0,0,0,2,,val
0537216_as-0031069.jpg,2,0,0,0,2,,val
0537217_sc-229759.jpg,0,1,0,0,1,,test
0537219_sc-1015276.jpg,4,0,2,0,6,,train
0537220_sc-1015276.jpg,5,0,2,0,7,,train
0537222_sc-167269.jpg,2,0,1,0,3,,train
0537223_sc-167269.jpg,2,0,1,0,3,,train
0537224_as-3495229.jpg,4,0,0,0,4,,train
0537227_as-0019555.jpg,2,0,0,1,3,,train
0537228_as-0019555.jpg,4,0,0,2,6,,train
0537229_as-0019555.jpg,5,0,0,2,7,,val
0537230_as-0019555.jpg,2,0,0,1,3,,val
0537233_sc-223633.jpg,1,0,0,0,1,,test
0537234_sc-223633.jpg,3,0,0,0,3,,train
0537235_as-0040409.jpg,1,1,0,0,2,,train
0537236_as-0040409.jpg,2,3,0,0,5,,train
0537237_as-0040409.jpg,5,1,0,0,6,,train
0537238_as-0040409.jpg,4,0,0,1,5,,train
0537239_as-0040409.jpg,1,0,0,1,2,,train
0537241_sc-133318.jpg,2,2,2,0,6,,train
0537242_as-2639419.jpg,2,0,2,0,4,,val
0537243_sc-211004.jpg,2,0,1,0,3,,val
0537244_sc-1034293.jpg,2,1,2,0,5,,test
0537245_sc-1034293.jpg,2,1,2,0,5,,train
0537246_sc-1034293.jpg,0,0,1,1,2,,train
0537248_as-0081845.jpg,1,0,0,0,1,,train
0537249_as-0081845.jpg,1,0,0,0,1,,train
0537252_as-0009668.jpg,0,0,1,1,2,,train
0537253_as-0009668.jpg,1,0,0,0,1,,train
0537254_as-0009668.jpg,2,0,0,0,2,,train
0537256_sc-228924.jpg,2,0,0,0,2,,val
0537257_sc-228924.jpg,4,0,0,0,4,,val
0537259_as-0005190.jpg,1,0,2,0,3,,test
0537260_as-0005190.jpg,2,0,1,0,3,,train
0537261_as-0005190.jpg,2,0,1,0,3,,train
0537262_as-0005190.jpg,2,0,1,0,3,,train
0537263_as-0005190.jpg,1,0,1,0,2,,train
0537264_sc-190290.jpg,3,0,2,0,5,,train
0537265_as-3045802.jpg,1,0,0,1,2,,train
0537266_sc-201051.jpg,0,1,1,0,2,,train
0537267_sc-201051.jpg,1,1,5,1,8,,val
0537268_sc-201051.jpg,2,0,1,1,4,,val
0537269_sc-201051.jpg,0,0,2,0,2,,test
0537270_sc-201051.jpg,1,1,2,0,4,,train
0537271_sc-201051.jpg,2,0,3,1,6,,train
0537272_sc-225672.jpg,1,1,1,0,3,,train
0537275_sc-151115.jpg,1,0,0,0,1,,train
0537277_sc-151115.jpg,1,0,0,0,1,,train
0537278_as-2941886.jpg,1,0,0,0,1,,train
0537280_sc-190362.jpg,4,2,0,1,7,,train
0537281_sc-190362.jpg,3,0,0,0,3,,val
0537284_as-3056826.jpg,1,0,0,0,1,,val
0537285_as-7574585.jpg,4,3,0,2,9,,test
0537286_sc-147106.jpg,0,0,1,2,3,,train
0537287_sc-147106.jpg,0,0,1,2,3,,train
0537289_sc-213899.jpg,4,0,1,3,8,,train
0537291_sc-213899.jpg,6,0,0,0,6,,train
0537292_sc-1032358.jpg,2,3,0,0,5,,train
0537294_as-0004750.jpg,1,2,0,1,4,,train
0537295_as-0004750.jpg,1,0,0,0,1,,train
0537296_as-0004750.jpg,3,0,0,0,3,,val
0537299_as-0014050.jpg,3,2,0,3,8,,val
0537300_as-0014050.jpg,0,1,0,1,2,,test
0537301_as-0014050.jpg,0,0,0,1,1,,train
0537302_as-0014050.jpg,0,1,0,1,2,,train
0537303_as-0014050.jpg,0,1,0,0,1,,train
0537304_as-0014050.jpg,0,0,1,0,1,,train
0537305_as-0014050.jpg,0,0,1,0,1,,train
0537306_as-0014050.jpg,0,0,1,0,1,,train
0537307_as-0014050.jpg,0,0,2,0,2,,train
0537308_as-0014050.jpg,0,0,1,0,1,,val
0537310_as-2653015.jpg,1,0,1,1,3,,val
0537311_as-3204452.jpg,1,1,0,1,3,,test
0537313_as-0028656.jpg,2,0,0,0,2,,train
0537314_as-0028656.jpg,2,0,0,0,2,,train
0537315_as-0028656.jpg,0,0,0,2,2,,train
0537318_as-0028656.jpg,2,0,0,0,2,,train
0537319_as-0028656.jpg,2,0,0,0,2,,train
0537321_sc-195161.jpg,1,0,1,0,2,,train
0537323_sc-195161.jpg,2,0,1,0,3,,train
0537324_as-0065422.jpg,2,0,0,0,2,,val
0537325_as-0065422.jpg,2,0,0,0,2,,val
0537326_sc-1038529.jpg,1,0,0,1,2,,test
0537327_sc-1038529.jpg,4,2,2,0,8,,train
0537328_sc-1038529.jpg,2,0,0,1,3,,train
0537331_sc-188809.jpg,1,0,1,1,3,,train
0537332_sc-188809.jpg,1,0,1,1,3,,train
0537333_sc-188809.jpg,1,0,1,1,3,,train
0537334_sc-188809.jpg,3,0,1,1,5,,train
0537335_as-7492636.jpg,1,0,1,0,2,,train
0537336_as-0095304.jpg,1,0,0,1,2,,val
0537337_as-0095304.jpg,1,0,0,1,2,,val
0537338_as-0095304.jpg,1,0,0,1,2,,test
0537339_as-2844998.jpg,0,0,1,0,1,,train
0537340_as-2645646.jpg,0,1,0,0,1,,train
0537341_as-2909123.jpg,1,0,0,0,1,,train
0537342_as-2726465.jpg,1,1,1,0,3,,train
0537343_as-0098432.jpg,1,0,0,0,1,,train
0537344_as-3455008.jpg,3,1,1,1,6,,train
0537345_as-3455008.jpg,1,0,0,1,2,,train
0537347_sc-1032646.jpg,1,0,0,0,1,,val
0537348_sc-1032646.jpg,1,1,1,0,3,,val
0537349_sc-1032646.jpg,1,1,0,0,2,,test
0537350_as-3132618.jpg,1,0,0,0,1,,train
0537351_as-2844503.jpg,1,0,0,0,1,,train
0537352_sc-197343.jpg,1,0,0,0,1,,train
0537353_sc-197343.jpg,1,1,0,0,2,,train
0537357_sc-146999.jpg,1,0,0,0,1,,train
0537358_sc-146999.jpg,1,0,1,0,2,,train
0537359_sc-146999.jpg,1,0,1,0,2,,train
0537360_sc-146999.jpg,1,0,0,1,2,,val
0537361_sc-146999.jpg,1,0,0,1,2,,val
0537362_sc-146999.jpg,0,0,0,1,1,,test
0537363_sc-146999.jpg,0,0,0,1,1,,train
0537364_sc-146999.jpg,2,0,0,2,4,,train
0537365_sc-146999.jpg,1,0,0,2,3,,train
0537366_sc-146999.jpg,4,2,1,1,8,,train
0537367_sc-177994.jpg,2,0,0,0,2,,train
0537368_sc-198128.jpg,1,0,0,0,1,,train
0537369_sc-198128.jpg,1,0,0,1,2,,train
0537370_as-0009573.jpg,1,0,0,0,1,,val
0537371_as-0009573.jpg,4,1,3,0,8,,val
0537373_as-0007842.jpg,1,1,0,0,2,,test
0537374_as-0007842.jpg,1,1,0,0,2,,train
0537375_as-0007842.jpg,2,1,1,0,4,,train
0537376_as-0007842.jpg,0,1,1,0,2,,train
0537377_as-0007842.jpg,0,1,0,0,1,,train
0537381_sc-178157.jpg,6,0,0,3,9,,train
0537382_sc-176087.jpg,1,0,1,0,2,,train
0537383_sc-176087.jpg,2,0,1,0,3,,train
0537384_sc-176087.jpg,1,0,1,0,2,,val
0537385_sc-176087.jpg,2,0,0,0,2,,val
0537386_sc-176087.jpg,1,0,1,0,2,,test
0537387_sc-176087.jpg,1,0,0,0,1,,train
0537389_sc-210695.jpg,1,0,0,0,1,,train
0537390_sc-210695.jpg,2,0,0,0,2,,train
0537391_sc-210695.jpg,7,0,0,0,7,,train
0537392_sc-210695.jpg,2,0,0,0,2,,train
0537393_sc-210695.jpg,6,0,1,1,8,,train
0537394_sc-165005.jpg,4,0,1,1,6,,train
0537396_sc-165005.jpg,2,0,1,1,4,,val
0537397_sc-165005.jpg,2,0,1,1,4,,val
0537398_sc-165005.jpg,2,0,1,1,4,,test
0537399_sc-165005.jpg,1,0,1,1,3,,train
0537400_sc-198411.jpg,0,0,1,1,2,,train
0537401_as-3490133.jpg,1,0,0,0,1,,train
0537402_sc-1015770.jpg,0,0,0,1,1,,train
0537403_sc-1015770.jpg,1,0,0,1,2,,train
0537404_sc-1015770.jpg,1,1,0,0,2,,train
0537405_sc-1015770.jpg,1,0,0,0,1,,train
0537406_sc-1015770.jpg,0,1,2,0,3,,val
0537408_as-2804256.jpg,1,1,1,1,4,,val
0537409_as-3124776.jpg,1,0,0,1,2,,test
0537413_as-0009413.jpg,0,1,2,0,3,,train
0537415_as-0009413.jpg,1,0,0,0,1,,train
0537416_as-0009413.jpg,1,0,0,0,1,,train
0537418_sc-191724.jpg,0,0,1,0,1,,train
0537419_sc-191724.jpg,2,0,1,0,3,,train
0537420_sc-191724.jpg,1,0,0,0,1,,train
0537422_as-0066239.jpg,3,0,0,1,4,,train
0537423_as-0037799.jpg,1,0,0,0,1,,val
0537424_as-0037799.jpg,1,0,0,0,1,,val
0537425_as-3498387.jpg,1,0,0,0,1,,test
0537426_as-0099434.jpg,1,0,2,0,3,,train
0537428_as-0099434.jpg,4,0,1,0,5,,train
0537430_as-0026535.jpg,3,0,3,0,6,,train
0537431_as-0026535.jpg,1,0,3,0,4,,train
0537432_as-0026535.jpg,0,0,4,0,4,,train
0537434_as-0026535.jpg,1,0,1,1,3,,train
0537435_as-0026535.jpg,1,0,1,0,2,,train
0537437_as-0048804.jpg,1,0,0,0,1,,val
0537438_as-0048804.jpg,1,1,0,0,2,,val
0537439_sc-222327.jpg,1,0,1,0,2,,test
0537440_sc-222327.jpg,2,0,1,0,3,,train
0537442_sc-175038.jpg,2,0,0,1,3,,train
0537443_sc-175038.jpg,3,0,1,1,5,,train
0537444_sc-175038.jpg,2,0,0,1,3,,train
0537445_sc-175038.jpg,2,0,0,0,2,,train
0537446_sc-175038.jpg,2,0,0,0,2,,train
0537447_sc-175038.jpg,2,0,0,0,2,,train
0537448_sc-175038.jpg,1,0,0,0,1,,val
0537449_sc-175038.jpg,2,0,0,0,2,,val
0537450_sc-175038.jpg,1,0,0,0,1,,test
0537451_as-0000311.jpg,1,0,1,0,2,,train
0537452_as-0000311.jpg,2,0,0,0,2,,train
0537453_as-0000311.jpg,1,0,0,0,1,,train
0537454_as-0000311.jpg,2,0,0,0,2,,train
0537455_as-0000311.jpg,3,0,0,0,3,,train
0537456_sc-1034923.jpg,2,0,1,0,3,,train
0537457_sc-1034923.jpg,3,0,0,0,3,,train
0537458_sc-1034923.jpg,2,0,0,0,2,,val
0537459_sc-1034923.jpg,3,0,0,0,3,,val
0537460_sc-1034923.jpg,4,0,0,0,4,,test
0537461_sc-1034923.jpg,3,0,0,0,3,,train
0537462_as-3324611.jpg,1,0,0,0,1,,train
0537463_as-2807395.jpg,2,0,1,0,3,,train
0537464_as-9049429.jpg,1,0,0,0,1,,train
0537465_sc-1000170.jpg,3,0,0,0,3,,train
0537467_sc-1016919.jpg,1,0,0,0,1,,train
0537468_sc-1016919.jpg,2,0,0,0,2,,train
0537469_sc-124588.jpg,2,0,0,0,2,,val
0537470_sc-209547.jpg,1,0,0,0,1,,val
0537471_sc-209547.jpg,1,0,0,0,1,,test
0537474_as-0059249.jpg,1,2,2,0,5,,train
0537476_as-0059249.jpg,1,1,1,0,3,,train
0537477_sc-1027380.jpg,3,1,1,0,5,,train
0537478_sc-1027380.jpg,4,0,1,0,5,,train
0537479_sc-1027380.jpg,2,1,1,0,4,,train
0537480_sc-1027380.jpg,1,1,1,0,3,,train
0537481_sc-1027380.jpg,2,0,0,0,2,,train
0537482_sc-1027380.jpg,0,0,1,0,1,,val
0537483_as-2590910.jpg,3,0,0,0,3,,val
0537484_as-0062997.jpg,1,1,1,0,3,,test
0537485_as-9064139.jpg,2,0,0,0,2,,train
0537486_sc-1034079.jpg,3,0,1,0,4,,train
0537487_sc-1034079.jpg,2,0,0,0,2,,train
0537489_as-2673054.jpg,1,0,1,0,2,,train
0537491_sc-220831.jpg,3,1,3,0,7,,train
0537492_sc-220831.jpg,0,0,1,1,2,,train
0537493_sc-220831.jpg,2,0,1,0,3,,train
0537494_sc-220831.jpg,5,1,1,1,8,,val
0537496_as-2804491.jpg,2,0,1,0,3,,val
0537497_sc-212542.jpg,0,0,1,0,1,,test
0537498_sc-1012969.jpg,1,0,0,2,3,,train
0537499_sc-1012969.jpg,1,0,1,1,3,,train
0537500_sc-1012969.jpg,1,0,1,1,3,,train
0537501_sc-1012969.jpg,1,0,0,3,4,,train
0537505_as-0027470.jpg,2,0,0,0,2,,train
0537510_as-0019542.jpg,3,0,0,0,3,,train
0537512_as-0091168.jpg,0,0,1,0,1,,train
0537515_as-0050719.jpg,3,0,0,1,4,,val
0537516_as-0050719.jpg,1,0,0,1,2,,val
0537517_as-7802590.jpg,1,0,1,1,3,,test
0537518_as-3470621.jpg,2,0,1,0,3,,train
0537520_as-7581253.jpg,3,1,1,0,5,,train
0537521_sc-214061.jpg,0,1,0,0,1,,train
0537523_as-3033559.jpg,2,0,0,0,2,,train
0537524_as-3244279.jpg,5,1,2,1,9,,train
0537527_as-0067063.jpg,1,0,0,0,1,,train
0537528_as-0067063.jpg,3,0,0,0,3,,train
0537529_as-0067063.jpg,2,0,1,1,4,,val
0537532_as-0038595.jpg,0,1,2,0,3,,val
0537533_as-0038595.jpg,0,2,2,0,4,,test
0537534_as-0038595.jpg,1,1,4,1,7,,train
0537535_as-0038595.jpg,1,0,2,0,3,,train
0537536_as-0038595.jpg,0,0,1,1,2,,train
0537540_as-0038595.jpg,0,0,1,0,1,,train
0537541_as-0038595.jpg,0,0,3,0,3,,train
0537542_as-0038595.jpg,0,0,2,0,2,,train
0537546_as-0038595.jpg,0,0,1,0,1,,train
0537547_sc-108863.jpg,5,1,0,0,6,,val
0537548_sc-108863.jpg,7,1,0,0,8,,val
0537549_sc-108863.jpg,4,1,0,0,5,,test
0537550_sc-108863.jpg,1,2,0,0,3,,train
0537552_sc-108863.jpg,2,1,0,0,3,,train
0537553_sc-108863.jpg,5,0,0,0,5,,train
0537555_as-0042262.jpg,2,0,0,0,2,,train
0537556_as-0042262.jpg,5,0,0,0,5,,train
0537557_as-0025552.jpg,1,1,0,0,2,,train
0537558_as-0025552.jpg,1,1,0,0,2,,train
0537559_as-0025552.jpg,2,1,0,0,3,,val
0537560_as-0025552.jpg,1,0,0,0,1,,val
0537561_as-0025552.jpg,1,0,0,0,1,,test
0537562_as-0003830.jpg,1,0,0,0,1,,train
0537563_as-0003830.jpg,1,0,0,0,1,,train
0537564_as-2649748.jpg,1,0,0,0,1,,train
0537565_as-3269817.jpg,5,0,0,1,6,,train
0537566_sc-1014445.jpg,2,0,0,0,2,,train
0537567_sc-1014445.jpg,2,0,0,0,2,,train
0537568_sc-1014445.jpg,3,0,0,0,3,,train
0537569_sc-1014445.jpg,2,0,0,0,2,,val
0537570_sc-1014445.jpg,2,0,1,0,3,,val
0537572_sc-1036764.jpg,2,0,0,0,2,,test
0537573_sc-1036764.jpg,2,0,0,0,2,,train
0537574_as-0004303.jpg,2,0,1,0,3,,train
0537575_as-0004303.jpg,0,0,1,0,1,,train
0537576_sc-202791.jpg,1,0,0,0,1,,train
0537577_sc-202791.jpg,2,0,0,0,2,,train
0537578_as-0012514.jpg,1,0,0,0,1,,train
0537579_as-0012514.jpg,2,0,0,0,2,,train
0537580_as-0012514.jpg,1,0,0,2,3,,val
0537581_as-3287378.jpg,1,0,0,0,1,,val
0537584_as-0082874.jpg,0,0,1,0,1,,test
0537586_as-0019537.jpg,1,0,1,0,2,,train
0537587_as-0028189.jpg,3,0,0,0,3,,train
0537588_as-0028189.jpg,3,0,0,0,3,,train
0537590_as-0028189.jpg,1,0,0,0,1,,train
0537591_as-0028189.jpg,4,0,1,0,5,,train
0537592_as-0028189.jpg,1,0,0,0,1,,train
0537593_as-0028189.jpg,1,0,0,0,1,,train
0537594_sc-151089.jpg,4,0,0,0,4,,val
0537595_sc-151089.jpg,7,0,0,0,7,,val
0537596_sc-151089.jpg,4,2,2,1,9,,test
0537598_sc-151089.jpg,14,2,1,0,17,,train
0537600_sc-151089.jpg,1,3,0,0,4,,train
0537601_sc-151089.jpg,1,2,0,0,3,,train
0537602_as-3030863.jpg,3,0,0,0,3,,train
0537603_as-7379897.jpg,2,0,0,0,2,,train
0537604_as-3079470.jpg,3,0,1,2,6,,train
0537605_as-0098148.jpg,1,0,1,0,2,,train
0537606_as-0098148.jpg,2,0,1,0,3,,val
0537607_as-0098148.jpg,2,0,1,0,3,,val
0537608_as-0098148.jpg,2,0,0,0,2,,test
0537609_as-0098148.jpg,1,0,1,0,2,,train
0537611_sc-183021.jpg,7,0,0,0,7,,train
0537612_as-2575001.jpg,1,0,1,0,2,,train
0537615_as-0072114.jpg,2,0,0,0,2,,train
0537616_as-0072114.jpg,2,0,0,1,3,,train
0537617_as-0072114.jpg,2,0,0,0,2,,train
0537619_as-0072114.jpg,2,2,0,0,4,,train
0537621_as-2962080.jpg,2,0,0,0,2,,val
0537622_as-0033458.jpg,2,1,2,0,5,,val
0537626_sc-1014731.jpg,2,0,0,0,2,,test
0537627_sc-1014731.jpg,3,1,1,0,5,,train
0537628_sc-227105.jpg,2,0,0,0,2,,train
0537629_sc-227105.jpg,1,0,0,0,1,,train
0537630_sc-227105.jpg,1,0,0,0,1,,train
0537631_sc-227105.jpg,1,0,0,0,1,,train
0537632_as-0095824.jpg,1,0,2,0,3,,train
0537633_as-0095824.jpg,1,0,0,0,1,,train
0537634_sc-179097.jpg,3,0,0,2,5,,val
0537635_as-3043376.jpg,1,0,0,0,1,,val
0537636_sc-154019.jpg,2,0,0,0,2,,test
0537638_sc-154019.jpg,3,0,1,0,4,,train
0537639_sc-154019.jpg,1,0,0,0,1,,train
0537641_sc-154019.jpg,1,0,0,0,1,,train
0537642_sc-154019.jpg,2,0,1,0,3,,train
0537643_as-3108851.jpg,1,0,0,0,1,,train
0537644_as-4944729.jpg,1,1,0,0,2,,train
0537645_sc-208554.jpg,0,0,0,1,1,,train
0537646_sc-200144.jpg,4,2,0,0,6,,val
0537647_sc-200144.jpg,10,4,0,0,14,,val
0537648_sc-200144.jpg,8,4,0,1,13,,test
0537650_as-0033559.jpg,2,0,0,0,2,,train
0537651_as-2853185.jpg,2,0,0,0,2,,train
0537652_as-2695681.jpg,1,0,0,0,1,,train
0537653_sc-1015422.jpg,3,0,1,0,4,,train
0537654_sc-1015422.jpg,4,1,0,0,5,,train
0537655_sc-1015422.jpg,10,0,1,1,12,,train
0537656_sc-1015422.jpg,5,0,1,0,6,,train
0537657_sc-1015422.jpg,2,1,2,0,5,,val
0537660_sc-104545.jpg,1,0,0,0,1,,val
0537661_sc-104545.jpg,1,1,0,1,3,,test
0537662_as-0035462.jpg,2,1,0,0,3,,train
0537663_as-0035462.jpg,2,3,0,0,5,,train
0537664_as-0035462.jpg,4,0,0,0,4,,train
0537665_as-0035462.jpg,1,0,0,0,1,,train
0537666_as-0035462.jpg,5,0,0,0,5,,train
0537668_sc-206475.jpg,3,0,0,3,6,,train
0537669_sc-206475.jpg,2,1,0,2,5,,train
0537670_sc-206475.jpg,3,0,0,2,5,,val
0537671_as-7925575.jpg,3,0,2,1,6,,val
0537672_as-2833462.jpg,2,0,0,0,2,,test
0537674_sc-1034417.jpg,2,0,0,0,2,,train
0537675_as-0024206.jpg,1,0,0,1,2,,train
0537676_as-0024206.jpg,1,0,0,1,2,,train
0537677_as-0024206.jpg,1,0,0,0,1,,train
0537678_as-0024206.jpg,1,0,0,0,1,,train
0537679_as-0024206.jpg,1,0,0,0,1,,train
0537680_as-0024206.jpg,1,0,0,0,1,,train
0537682_as-9087399.jpg,1,0,0,0,1,,val
0537683_as-0002565.jpg,8,0,1,0,9,,val
0537684_as-0002565.jpg,5,1,0,0,6,,test
0537685_as-0002565.jpg,8,0,0,0,8,,train
0537686_as-0002565.jpg,1,0,0,0,1,,train
0537687_sc-211137.jpg,1,0,0,1,2,,train
0537688_sc-211137.jpg,2,0,0,1,3,,train
0537689_sc-211137.jpg,1,0,0,0,1,,train
0537690_sc-211137.jpg,1,0,0,1,2,,train
0537692_sc-212585.jpg,2,0,0,0,2,,train
0537693_sc-212585.jpg,2,0,0,0,2,,val
0537694_sc-212585.jpg,1,0,0,0,1,,val
0537695_as-0000981.jpg,1,0,0,0,1,,test
0537696_as-0000981.jpg,2,0,0,0,2,,train
0537697_sc-1029359.jpg,1,0,0,0,1,,train
0537698_sc-1029359.jpg,2,0,1,0,3,,train
0537699_sc-1029359.jpg,1,0,0,0,1,,train
0537700_sc-1029359.jpg,1,0,0,0,1,,train
0537703_as-0064059.jpg,3,0,0,1,4,,train
0537705_as-3446301.jpg,2,0,0,1,3,,train
0537706_as-3018896.jpg,6,0,0,0,6,,val
0537707_as-3006087.jpg,4,1,0,0,5,,val
0537708_sc-184887.jpg,1,0,0,1,2,,test
0537709_sc-184887.jpg,1,0,1,0,2,,train
0537710_sc-184887.jpg,3,0,0,0,3,,train
0537711_sc-184887.jpg,1,0,0,0,1,,train
0537712_sc-184887.jpg,3,0,0,0,3,,train
0537713_sc-184887.jpg,1,0,0,0,1,,train
0537714_sc-184887.jpg,4,0,0,1,5,,train
0537716_sc-150926.jpg,4,1,0,0,5,,train
0537717_sc-150926.jpg,6,1,0,0,7,,val
0537718_sc-150926.jpg,5,1,0,0,6,,val
0537719_as-0044304.jpg,3,0,0,0,3,,test
0537720_as-7362734.jpg,1,0,0,0,1,,train
0537722_as-0079989.jpg,1,0,0,0,1,,train
0537725_as-0079989.jpg,2,0,1,1,4,,train
0537727_as-0079989.jpg,3,0,1,0,4,,train
0537728_as-0031503.jpg,1,0,0,0,1,,train
0537729_as-0031503.jpg,1,0,0,0,1,,train
0537730_as-0031503.jpg,1,0,0,0,1,,train
0537731_as-0031503.jpg,1,0,0,0,1,,val
0537732_sc-1024055.jpg,3,0,0,0,3,,val
0537733_sc-1041766.jpg,6,0,0,1,7,,test
0537736_as-0054599.jpg,1,0,1,0,2,,train
0537738_as-0017915.jpg,0,0,1,1,2,,train
0537739_as-0017915.jpg,1,0,1,0,2,,train
0537740_sc-216303.jpg,7,0,0,0,7,,train
0537741_sc-216303.jpg,5,0,0,1,6,,train
0537742_sc-216303.jpg,6,0,0,0,6,,train
0537743_sc-216303.jpg,5,0,0,0,5,,train
0537744_sc-216303.jpg,2,0,0,1,3,,val
0537745_sc-216303.jpg,2,0,0,1,3,,val
0537746_sc-1015891.jpg,1,0,0,0,1,,test
0537747_sc-1015891.jpg,6,0,1,0,7,,train
0537749_sc-225278.jpg,3,1,2,1,7,,train
0537750_sc-166824.jpg,4,0,0,1,5,,train
0537751_sc-166824.jpg,6,0,0,1,7,,train
0537753_as-3003013.jpg,2,0,0,1,3,,train
0537754_sc-1031436.jpg,3,0,0,0,3,,train
0537755_sc-1031436.jpg,2,1,0,0,3,,train
0537756_sc-1031436.jpg,0,0,2,1,3,,val
0537757_as-7108722.jpg,1,0,1,0,2,,val
0537758_sc-1005184.jpg,1,0,0,0,1,,test
0537759_sc-1005184.jpg,1,0,1,0,2,,train
0537760_sc-1005184.jpg,4,0,0,0,4,,train
0537761_sc-1005184.jpg,4,0,0,0,4,,train
0537762_as-2785434.jpg,1,0,0,0,1,,train
0537764_as-0006109.jpg,0,1,0,0,1,,train
0537765_as-0006109.jpg,1,0,0,0,1,,train
0537767_as-0006109.jpg,1,0,0,0,1,,train
0537768_as-3279185.jpg,1,0,0,1,2,,val
0537769_as-2629456.jpg,0,0,0,1,1,,val
0537772_sc-1015461.jpg,1,2,0,0,3,,test
0537773_sc-1015461.jpg,2,0,0,0,2,,train
0537774_as-2876798.jpg,5,0,0,0,5,,train
0537776_as-0003908.jpg,1,0,0,0,1,,train
0537777_as-0003908.jpg,1,0,0,1,2,,train
0537778_as-0003908.jpg,1,0,0,0,1,,train
0537779_sc-210088.jpg,7,1,0,0,8,,train
0537780_sc-210088.jpg,10,1,0,0,11,,train
0537781_as-0016001.jpg,1,0,1,0,2,,val
0537782_as-0016001.jpg,2,1,0,0,3,,val
0537783_as-0016001.jpg,1,1,0,0,2,,test
0537784_as-0016001.jpg,1,0,0,0,1,,train
0537786_as-0025763.jpg,2,0,0,0,2,,train
0537787_as-0025763.jpg,1,1,0,0,2,,train
0537788_as-0025763.jpg,0,1,0,0,1,,train
0537790_sc-165923.jpg,1,0,1,1,3,,train
0537791_sc-165923.jpg,1,0,0,0,1,,train
0537793_as-0061443.jpg,1,0,0,0,1,,train
0537794_as-0061443.jpg,2,0,0,0,2,,val
0537795_as-0061443.jpg,1,0,0,1,2,,val
0537797_sc-1014093.jpg,1,0,0,0,1,,test
0537799_as-0018590.jpg,0,0,1,0,1,,train
0537800_as-0018590.jpg,1,0,1,0,2,,train
0537801_as-0018590.jpg,1,0,1,0,2,,train
0537802_as-0039371.jpg,1,0,0,0,1,,train
0537803_as-0039371.jpg,2,0,0,0,2,,train
0537804_as-0039371.jpg,1,0,0,0,1,,train
0537805_sc-1005575.jpg,0,0,1,0,1,,train
0537806_sc-1005575.jpg,0,0,1,0,1,,val
0537807_as-0003977.jpg,3,0,0,0,3,,val
0537808_as-0003977.jpg,1,0,0,0,1,,test
0537809_sc-141238.jpg,0,0,1,0,1,,train
0537810_sc-1005916.jpg,3,0,1,0,4,,train
0537811_sc-1011022.jpg,2,0,0,0,2,,train
0537812_sc-1011022.jpg,2,0,0,0,2,,train
0537815_as-2842894.jpg,1,0,0,0,1,,train
0537816_sc-215658.jpg,6,1,0,0,7,,train
0537817_sc-215658.jpg,2,0,0,0,2,,train
0537818_sc-215658.jpg,2,0,0,0,2,,val
0537819_sc-215658.jpg,2,0,0,0,2,,val
0537820_sc-215658.jpg,4,1,2,1,8,,test
0537821_sc-215658.jpg,5,1,2,1,9,,train
0537822_sc-215658.jpg,3,1,2,1,7,,train
0537823_sc-215658.jpg,2,1,2,1,6,,train
0537825_as-0075859.jpg,1,0,1,0,2,,train
0537826_as-0075859.jpg,2,0,1,0,3,,train
0537827_as-0075859.jpg,2,0,1,0,3,,train
0537828_as-3070948.jpg,3,2,1,0,6,,train
0537829_as-3070948.jpg,1,2,1,1,5,,val
0537831_sc-1005587.jpg,4,0,4,1,9,,val
0537832_sc-208831.jpg,2,0,0,1,3,,test
0537833_sc-208831.jpg,2,0,0,1,3,,train
0537834_sc-208831.jpg,1,0,0,1,2,,train
0537835_sc-208831.jpg,1,0,0,1,2,,train
0537836_sc-208831.jpg,1,0,0,0,1,,train
0537837_sc-216167.jpg,2,0,0,0,2,,train
0537838_sc-216167.jpg,2,0,0,0,2,,train
0537839_as-7648479.jpg,1,1,1,0,3,,train
0537840_sc-162773.jpg,1,0,0,0,1,,val
0537842_as-0064228.jpg,1,0,0,0,1,,val
0537843_as-0064228.jpg,4,0,0,0,4,,test
0537844_as-0064228.jpg,1,0,0,0,1,,train
0537845_as-0064228.jpg,1,0,0,0,1,,train
0537846_as-0064228.jpg,4,0,0,0,4,,train
0537847_as-0064228.jpg,2,0,0,0,2,,train
0537848_as-0064228.jpg,3,0,0,0,3,,train
0537849_as-0064228.jpg,4,0,0,0,4,,train
0537850_as-0064228.jpg,3,1,0,0,4,,train
0537851_as-0064228.jpg,2,0,0,0,2,,val
0537852_as-0064228.jpg,4,1,0,0,5,,val
0537853_as-0064228.jpg,1,1,0,0,2,,test
0537854_as-0064228.jpg,0,1,0,0,1,,train
0537855_as-0064228.jpg,1,0,0,0,1,,train
0537856_as-0064228.jpg,0,1,0,0,1,,train
0537857_as-0064228.jpg,4,0,0,0,4,,train
0537858_as-0064228.jpg,4,0,0,0,4,,train
0537859_as-0064228.jpg,6,0,0,0,6,,train
0537860_as-0064228.jpg,9,0,0,0,9,,train
0537861_as-0064228.jpg,3,0,1,0,4,,val
0537862_as-0064228.jpg,7,0,0,0,7,,val
0537863_as-0006013.jpg,1,1,0,0,2,,test
0537865_as-3121539.jpg,1,0,2,0,3,,train
0537867_as-3485937.jpg,3,0,2,0,5,,train
0537868_sc-154886.jpg,7,0,0,1,8,,train
0537869_sc-154886.jpg,6,0,0,1,7,,train
0537870_as-3340281.jpg,1,0,1,0,2,,train
0537871_as-2561811.jpg,1,1,0,0,2,,train
0537872_as-2561811.jpg,6,0,0,0,6,,train
0537873_as-0017889.jpg,0,0,1,1,2,,val
0537879_as-0017889.jpg,0,0,2,1,3,,val
0537881_as-0017889.jpg,0,0,1,0,1,,test
0537883_as-3143359.jpg,2,0,2,0,4,,train
0537884_sc-220266.jpg,1,1,1,0,3,,train
0537885_sc-220266.jpg,1,0,1,0,2,,train
0537886_sc-220266.jpg,1,1,0,1,3,,train
0537887_as-3002170.jpg,1,0,0,0,1,,train
0537888_as-0064967.jpg,13,0,2,0,15,,train
0537889_as-0064967.jpg,10,0,1,0,11,,train
0537891_as-0033518.jpg,1,0,0,0,1,,val
0537892_as-0033518.jpg,1,0,0,0,1,,val
0537894_sc-229669.jpg,6,2,0,0,8,,test
0537895_sc-229669.jpg,6,2,1,1,10,,train
0537896_sc-229669.jpg,6,3,1,0,10,,train
0537897_as-3429977.jpg,2,0,0,0,2,,train
0537898_sc-175239.jpg,4,0,0,0,4,,train
0537899_as-2901374.jpg,0,0,1,0,1,,train
0537900_sc-104562.jpg,0,0,0,1,1,,train
0537901_as-3204133.jpg,1,0,0,0,1,,train
0537902_as-2689878.jpg,3,0,1,1,5,,val
0537903_as-0012110.jpg,1,0,0,0,1,,val
0537904_as-0012110.jpg,2,0,0,0,2,,test
0537905_as-0012110.jpg,2,0,0,0,2,,train
0537906_as-0030340.jpg,2,0,1,0,3,,train
0537907_as-0030340.jpg,1,0,0,0,1,,train
0537908_as-0030340.jpg,1,0,0,0,1,,train
0537909_as-0030340.jpg,2,0,1,1,4,,train
0537910_as-3478146.jpg,1,1,0,0,2,,train
0537913_sc-119646.jpg,1,0,0,0,1,,train
0537914_sc-119646.jpg,0,1,0,0,1,,val
0537915_sc-119646.jpg,1,1,0,0,2,,val
0537916_as-2987665.jpg,2,0,0,0,2,,test
0537917_sc-187917.jpg,2,0,1,1,4,,train
0537919_sc-187917.jpg,3,0,1,1,5,,train
0537920_as-2630633.jpg,1,0,0,1,2,,train
0537921_as-9006261.jpg,2,0,0,0,2,,train
0537923_as-0076507.jpg,1,0,1,0,2,,train
0537924_as-0076507.jpg,1,0,1,0,2,,train
0537925_sc-134247.jpg,1,0,0,0,1,,train
0537926_sc-134247.jpg,3,0,0,0,3,,val
0537928_sc-134247.jpg,4,0,0,1,5,,val
0537929_sc-134247.jpg,1,0,0,1,2,,test
0537930_sc-134247.jpg,2,0,0,0,2,,train
0537931_sc-204989.jpg,5,1,2,0,8,,train
0537932_sc-204989.jpg,1,1,1,0,3,,train
0537933_sc-204989.jpg,1,0,1,0,2,,train
0537934_as-3108277.jpg,1,0,1,1,3,,train
0537935_as-7924167.jpg,2,0,2,0,4,,train
0537938_sc-137348.jpg,3,0,2,1,6,,train
0537940_as-0001198.jpg,1,0,1,1,3,,val
0537941_as-0001198.jpg,1,0,0,0,1,,val
0537942_as-0066990.jpg,0,1,0,0,1,,test
0537943_as-0066990.jpg,0,1,1,0,2,,train
0537945_as-0066990.jpg,1,1,1,0,3,,train
0537947_sc-214229.jpg,2,0,0,1,3,,train
0537948_sc-214229.jpg,3,0,0,0,3,,train
0537949_sc-214229.jpg,3,0,0,1,4,,train
0537950_sc-214229.jpg,3,0,0,1,4,,train
0537951_sc-214229.jpg,2,0,0,1,3,,train
0537952_as-3301819.jpg,1,1,1,0,3,,val
0537954_as-0070643.jpg,9,0,0,0,9,,val
0537955_as-0070643.jpg,2,0,2,0,4,,test
0537956_as-0070643.jpg,1,0,1,1,3,,train
0537957_as-0070643.jpg,4,0,1,1,6,,train
0537958_as-0070643.jpg,1,0,0,0,1,,train
0537959_as-0070643.jpg,13,0,0,0,13,,train
0537960_as-0013146.jpg,2,1,0,0,3,,train
0537961_as-0013146.jpg,3,1,3,0,7,,train
0537962_as-2882270.jpg,1,0,0,0,1,,train
0537967_as-0050492.jpg,5,0,0,0,5,,val
0537968_as-0050492.jpg,3,0,1,0,4,,val
0537969_as-0050492.jpg,2,0,1,0,3,,test
0537970_as-0050492.jpg,4,0,1,0,5,,train
0537971_as-0050492.jpg,3,0,0,0,3,,train
0537972_as-0050492.jpg,2,0,0,0,2,,train
0537973_as-0050492.jpg,1,0,0,0,1,,train
0537974_as-0050492.jpg,1,0,0,0,1,,train
0537975_as-0050492.jpg,1,0,0,0,1,,train
0537976_as-0050492.jpg,2,0,0,0,2,,train
0537977_as-0050492.jpg,1,0,0,0,1,,val
0537978_as-0050492.jpg,1,0,0,0,1,,val
0537979_as-0050492.jpg,2,0,0,4,6,,test
0537980_as-0050492.jpg,2,0,0,2,4,,train
0537981_as-0050492.jpg,5,0,0,1,6,,train
0537982_as-0050492.jpg,2,0,0,0,2,,train
0537984_as-0050492.jpg,3,0,1,1,5,,train
0537985_as-0050492.jpg,6,0,1,1,8,,train
0537986_as-0050492.jpg,3,0,1,0,4,,train
0537987_as-0050492.jpg,5,0,1,0,6,,train
0537988_as-0050492.jpg,3,0,0,2,5,,val
0537989_as-0050492.jpg,1,0,0,1,2,,val
0537991_as-3071405.jpg,4,0,1,0,5,,test
0537992_sc-225308.jpg,0,0,2,0,2,,train
0537993_sc-225308.jpg,1,0,1,0,2,,train
0537994_sc-225308.jpg,1,0,1,0,2,,train
0537995_sc-225308.jpg,2,1,1,1,5,,train
0537996_sc-225308.jpg,2,1,1,1,5,,train
0537997_sc-225308.jpg,2,0,0,0,2,,train
0537998_sc-225308.jpg,2,0,0,0,2,,train
0537999_sc-225308.jpg,1,0,0,0,1,,val
0538000_sc-225308.jpg,2,0,0,0,2,,val
0538001_sc-225308.jpg,1,0,0,0,1,,test
0538002_sc-225308.jpg,1,0,0,0,1,,train
0538003_sc-225308.jpg,2,0,0,0,2,,train
0538005_as-0022373.jpg,0,1,1,1,3,,train
0538006_as-0022373.jpg,0,1,1,1,3,,train
0538007_as-0022373.jpg,0,0,2,0,2,,train
0538008_as-0022373.jpg,0,0,1,0,1,,train
0538009_as-0022373.jpg,0,0,1,0,1,,train
0538010_sc-219855.jpg,1,0,0,0,1,,val
0538011_sc-219855.jpg,3,0,1,1,5,,val
0538012_sc-219855.jpg,3,0,1,1,5,,test
0538013_sc-219855.jpg,2,0,0,0,2,,train
0538014_sc-219855.jpg,1,0,0,0,1,,train
0538015_sc-219855.jpg,1,0,0,0,1,,train
0538017_sc-227403.jpg,1,0,0,1,2,,train
0538018_sc-227403.jpg,1,0,0,1,2,,train
0538020_as-0037660.jpg,1,0,0,0,1,,train
0538021_sc-207717.jpg,1,0,0,0,1,,train
0538022_sc-207717.jpg,1,0,0,0,1,,val
0538023_sc-207717.jpg,1,0,0,0,1,,val
0538024_sc-217303.jpg,1,0,0,0,1,,test
0538025_sc-217303.jpg,9,0,0,0,9,,train
0538026_sc-217303.jpg,3,1,0,0,4,,train
0538027_sc-217303.jpg,4,1,0,0,5,,train
0538028_sc-217303.jpg,0,0,3,0,3,,train
0538029_as-0070553.jpg,3,1,0,0,4,,train
0538030_as-0070553.jpg,2,1,1,0,4,,train
0538031_as-0070553.jpg,2,2,1,0,5,,train
0538032_as-0070553.jpg,3,1,1,0,5,,val
0538033_as-0070553.jpg,3,1,0,0,4,,val
0538034_as-7559434.jpg,0,0,2,0,2,,test
0538035_as-3065096.jpg,3,0,0,0,3,,train
0538036_as-2615356.jpg,4,0,0,0,4,,train
0538037_as-2961599.jpg,4,0,0,0,4,,train
0538040_sc-204532.jpg,2,0,0,0,2,,train
0538041_sc-204532.jpg,3,0,0,0,3,,train
0538042_sc-204532.jpg,3,0,0,0,3,,train
0538043_sc-204532.jpg,2,0,0,0,2,,train
0538044_sc-204532.jpg,1,0,0,1,2,,val
0538045_sc-204532.jpg,2,0,0,0,2,,val
0538046_sc-115124.jpg,2,0,0,0,2,,test
0538047_sc-115124.jpg,6,0,0,2,8,,train
0538048_sc-115124.jpg,5,0,0,0,5,,train
0538049_sc-115124.jpg,6,0,0,0,6,,train
0538050_sc-115124.jpg,6,0,0,0,6,,train
0538051_sc-115124.jpg,3,0,0,0,3,,train
0538052_as-7035448.jpg,1,0,0,0,1,,train
0538056_sc-181358.jpg,5,0,0,0,5,,train
0538057_sc-181358.jpg,3,1,2,0,6,,val
0538059_sc-181358.jpg,2,2,1,0,5,,val
0538060_sc-181358.jpg,3,1,0,0,4,,test
0538061_sc-181358.jpg,1,2,1,0,4,,train
0538062_as-7215402.jpg,0,0,0,1,1,,train
0538063_sc-1022546.jpg,1,0,0,1,2,,train
0538066_as-0020584.jpg,2,3,1,1,7,,train
0538069_as-0092204.jpg,2,0,0,0,2,,train
0538070_as-0092204.jpg,1,0,0,0,1,,train
0538071_as-0092204.jpg,6,0,1,0,7,,train
0538074_as-0092204.jpg,4,0,0,1,5,,val
0538075_as-0092204.jpg,3,0,1,1,5,,val
0538076_as-0092204.jpg,3,0,1,1,5,,test
0538077_as-0092204.jpg,3,0,1,1,5,,train
0538078_as-0092204.jpg,2,0,1,1,4,,train
0538079_as-0092204.jpg,6,0,1,1,8,,train
0538081_as-0092204.jpg,6,0,1,0,7,,train
0538082_as-0092204.jpg,4,0,1,0,5,,train
0538083_as-0092204.jpg,4,0,1,1,6,,train
0538084_as-0092204.jpg,1,0,1,0,2,,train
0538085_as-0092204.jpg,8,0,0,0,8,,val
0538087_sc-219376.jpg,1,0,0,0,1,,val
0538088_sc-219376.jpg,1,0,0,0,1,,test
0538090_as-0078822.jpg,0,0,0,1,1,,train
0538091_as-0078822.jpg,3,0,1,1,5,,train
0538092_as-0078822.jpg,2,1,1,1,5,,train
0538093_sc-116515.jpg,2,0,1,0,3,,train
0538095_as-7815442.jpg,1,0,0,1,2,,train
0538096_as-2567621.jpg,1,0,0,0,1,,train
0538097_sc-149499.jpg,3,0,0,2,5,,train
0538099_as-0017185.jpg,1,0,1,0,2,,val
0538104_sc-229307.jpg,1,0,0,0,1,,val
0538105_as-0094778.jpg,4,0,1,1,6,,test
0538106_as-0094778.jpg,1,0,0,1,2,,train
0538107_as-0094778.jpg,1,0,0,1,2,,train
0538108_as-0094778.jpg,5,0,0,1,6,,train
0538109_as-0094778.jpg,2,0,0,2,4,,train
0538110_as-0094778.jpg,1,0,0,0,1,,train
0538111_as-0094778.jpg,3,0,0,0,3,,train
0538113_sc-151846.jpg,1,0,0,1,2,,train
0538114_sc-151846.jpg,1,0,0,1,2,,val
0538116_as-3236130.jpg,5,0,0,2,7,,val
0538117_sc-128547.jpg,5,0,0,0,5,,test
0538118_sc-128547.jpg,7,0,0,0,7,,train
0538121_as-0046187.jpg,5,0,0,3,8,,train
0538122_as-0046187.jpg,4,0,0,2,6,,train
0538123_as-0046187.jpg,2,0,0,0,2,,train
0538124_as-0046187.jpg,2,0,0,0,2,,train
0538125_as-0046592.jpg,3,0,0,1,4,,train
0538126_as-0046592.jpg,1,0,1,0,2,,train
0538127_as-0046592.jpg,1,0,1,0,2,,val
0538128_as-0046592.jpg,2,0,1,0,3,,val
0538129_as-0046592.jpg,2,0,1,0,3,,test
0538130_as-0046592.jpg,3,0,1,0,4,,train
0538131_as-0000889.jpg,1,0,0,1,2,,train
0538135_sc-111758.jpg,0,0,0,1,1,,train
0538136_sc-111758.jpg,0,0,0,1,1,,train
0538137_sc-111758.jpg,0,0,0,1,1,,train
0538139_as-2518397.jpg,1,0,0,1,2,,train
0538140_sc-209369.jpg,2,0,0,0,2,,train
0538141_sc-209369.jpg,4,0,0,0,4,,val
0538142_sc-209369.jpg,3,0,0,0,3,,val
0538143_as-3296126.jpg,4,0,0,0,4,,test
0538145_sc-155767.jpg,2,0,0,0,2,,train
0538146_sc-155767.jpg,2,1,0,0,3,,train
0538149_sc-155767.jpg,3,0,0,0,3,,train
0538150_sc-155767.jpg,2,0,0,0,2,,train
0538151_sc-155767.jpg,1,0,0,0,1,,train
0538152_sc-155767.jpg,1,0,0,0,1,,train
0538153_sc-155767.jpg,2,2,0,0,4,,train
0538154_sc-155767.jpg,2,2,0,0,4,,val
0538156_as-0069217.jpg,0,0,1,0,1,,val
0538158_as-0069217.jpg,0,0,1,0,1,,test
0538160_sc-1000095.jpg,4,1,0,0,5,,train
0538161_sc-1000095.jpg,7,1,0,0,8,,train
0538162_sc-112817.jpg,1,0,0,0,1,,train
0538163_sc-112817.jpg,2,0,0,0,2,,train
0538164_sc-112817.jpg,2,0,0,0,2,,train
0538165_sc-112817.jpg,1,0,0,0,1,,train
0538166_as-0081141.jpg,1,0,0,0,1,,train
0538167_as-0029399.jpg,0,0,1,0,1,,val
0538168_as-0029399.jpg,6,0,0,0,6,,val
0538169_as-0029399.jpg,3,0,0,0,3,,test
0538170_sc-155374.jpg,0,0,1,0,1,,train
0538171_sc-155374.jpg,0,0,1,0,1,,train
0538172_sc-219322.jpg,1,1,0,1,3,,train
0538173_sc-219322.jpg,2,0,0,0,2,,train
0538174_sc-204983.jpg,3,0,0,0,3,,train
0538175_sc-204983.jpg,2,0,0,0,2,,train
0538176_sc-204983.jpg,4,0,0,0,4,,train
0538177_sc-204983.jpg,3,0,0,0,3,,val
0538179_as-7477060.jpg,2,0,0,0,2,,val
0538189_as-0087307.jpg,2,0,0,0,2,,test
0538190_as-0087307.jpg,4,0,0,0,4,,train
0538191_sc-207261.jpg,0,0,1,0,1,,train
0538192_sc-207261.jpg,1,0,0,0,1,,train
0538193_sc-207261.jpg,0,0,1,0,1,,train
0538194_as-0007302.jpg,1,0,0,0,1,,train
0538195_as-0007302.jpg,1,1,0,1,3,,train
0538196_as-0007302.jpg,1,0,0,1,2,,train
0538197_as-0007302.jpg,1,1,0,1,3,,val
0538198_as-0007302.jpg,1,0,0,1,2,,val
0538199_as-2550617.jpg,1,0,1,0,2,,test
0538200_as-2622974.jpg,6,0,1,0,7,,train
0538201_sc-210612.jpg,0,0,1,0,1,,train
0538202_sc-210612.jpg,2,0,0,0,2,,train
0538203_sc-210612.jpg,2,0,0,0,2,,train
0538204_sc-210612.jpg,2,0,0,0,2,,train
0538205_as-0054608.jpg,1,0,0,0,1,,train
0538206_as-3340402.jpg,1,1,0,1,3,,train
0538208_as-7676939.jpg,4,0,1,0,5,,val
0538209_as-2761221.jpg,1,0,0,0,1,,val
0538210_sc-218044.jpg,4,0,0,0,4,,test
0538211_sc-218044.jpg,4,0,0,0,4,,train
0538212_sc-218044.jpg,1,0,0,0,1,,train
0538213_sc-181364.jpg,1,0,0,0,1,,train
0538214_sc-181364.jpg,2,0,1,1,4,,train
0538215_sc-181364.jpg,2,0,1,1,4,,train
0538216_sc-181364.jpg,1,0,1,1,3,,train
0538219_as-0083971.jpg,2,0,0,1,3,,train
0538220_as-0083971.jpg,2,0,0,2,4,,val
0538221_as-0083971.jpg,0,0,1,1,2,,val
0538222_as-0083971.jpg,0,0,2,1,3,,test
0538224_as-0083971.jpg,0,0,4,0,4,,train
0538225_as-0083971.jpg,0,0,2,0,2,,train
0538226_as-0083971.jpg,1,1,0,0,2,,train
0538227_as-2801097.jpg,1,1,0,0,2,,train
0538228_sc-203886.jpg,7,0,2,0,9,,train
0538229_sc-203886.jpg,1,0,2,0,3,,train
0538230_sc-203886.jpg,4,0,1,0,5,,train
0538231_sc-222060.jpg,3,0,0,0,3,,val
0538232_sc-222060.jpg,3,0,0,0,3,,val
0538233_sc-222060.jpg,3,0,0,0,3,,test
0538234_sc-222060.jpg,2,0,0,0,2,,train
0538235_sc-222060.jpg,2,0,0,0,2,,train
0538237_sc-198641.jpg,1,3,0,0,4,,train
0538238_sc-122882.jpg,5,1,0,0,6,,train
0538239_sc-1040266.jpg,1,0,1,0,2,,train
0538240_sc-1040266.jpg,1,0,0,0,1,,train
0538241_sc-1040266.jpg,3,0,0,0,3,,train
0538242_sc-1040266.jpg,3,0,0,0,3,,val
0538243_sc-1040266.jpg,3,0,0,0,3,,val
0538244_sc-111345.jpg,2,0,0,0,2,,test
0538245_as-2571163.jpg,1,0,0,0,1,,train
0538246_sc-165917.jpg,2,0,0,0,2,,train
0538247_sc-165917.jpg,2,0,2,0,4,,train
0538248_sc-1036560.jpg,5,1,2,1,9,,train
0538249_sc-1036560.jpg,7,1,2,0,10,,train
0538250_sc-1036560.jpg,1,0,1,1,3,,train
0538251_sc-135672.jpg,1,0,0,0,1,,train
0538252_as-7396036.jpg,1,0,0,0,1,,val
0538254_as-0098698.jpg,2,0,1,1,4,,val
0538255_as-0098698.jpg,2,0,0,0,2,,test
0538256_as-2667974.jpg,0,1,0,0,1,,train
0538257_as-0009297.jpg,2,0,0,0,2,,train
0538258_sc-159858.jpg,2,0,0,0,2,,train
0538260_sc-159858.jpg,3,0,0,0,3,,train
0538261_sc-159858.jpg,1,0,1,0,2,,train
0538262_sc-159858.jpg,4,0,0,0,4,,train
0538263_sc-159858.jpg,1,0,0,0,1,,train
0538264_sc-159858.jpg,5,0,0,0,5,,val
0538265_sc-217197.jpg,1,0,0,0,1,,val
0538266_sc-217197.jpg,3,0,0,0,3,,test
0538267_sc-217197.jpg,1,0,0,0,1,,train
0538268_sc-217197.jpg,1,0,0,0,1,,train
0538269_as-9025804.jpg,4,0,0,0,4,,train
0538270_sc-134296.jpg,0,1,0,0,1,,train
0538272_sc-134296.jpg,1,1,1,0,3,,train
0538274_sc-134296.jpg,0,1,1,0,2,,train
0538275_sc-134296.jpg,1,1,1,0,3,,train
0538276_sc-199744.jpg,2,0,0,1,3,,val
0538277_sc-180633.jpg,0,0,0,1,1,,val
0538279_as-2938853.jpg,1,0,0,0,1,,test
0538280_as-7994402.jpg,2,0,0,0,2,,train
0538281_as-9033294.jpg,4,0,0,0,4,,train
0538286_as-0072531.jpg,3,1,0,0,4,,train
0538288_as-0072531.jpg,4,1,1,1,7,,train
0538289_as-0072531.jpg,3,0,1,1,5,,train
0538290_as-0072531.jpg,1,1,0,0,2,,train
0538291_as-0072531.jpg,0,0,1,0,1,,train
0538292_as-0072531.jpg,0,0,1,0,1,,val
0538293_as-0072531.jpg,3,0,0,0,3,,val
0538294_as-0072531.jpg,2,0,0,0,2,,test
0538295_as-2565778.jpg,2,0,2,1,5,,train
0538296_as-0080691.jpg,1,0,0,0,1,,train
0538297_as-0080691.jpg,1,0,0,0,1,,train
0538298_as-0079408.jpg,2,0,0,0,2,,train
0538299_as-0079408.jpg,2,0,0,0,2,,train
0538300_as-0079408.jpg,1,0,0,0,1,,train
0538301_as-0079408.jpg,2,1,0,0,3,,train
0538302_as-0079408.jpg,1,0,0,0,1,,val
0538303_as-0079408.jpg,1,0,0,0,1,,val
0538306_as-0080026.jpg,1,0,1,1,3,,test
0538307_as-0080026.jpg,1,0,0,0,1,,train
0538308_as-0080026.jpg,1,0,0,0,1,,train
0538309_as-0024289.jpg,2,0,0,0,2,,train
0538310_as-2807289.jpg,1,0,1,1,3,,train
0538311_as-7201600.jpg,1,0,0,0,1,,train
0538312_sc-1013207.jpg,2,1,0,1,4,,train
0538313_sc-1013207.jpg,1,1,0,1,3,,train
0538314_as-2659885.jpg,4,0,0,0,4,,val
0538318_as-0002316.jpg,1,1,2,0,4,,val
0538319_as-3418288.jpg,4,0,0,0,4,,test
0538320_sc-186656.jpg,5,0,1,1,7,,train
0538321_sc-186656.jpg,1,0,0,0,1,,train
0538322_sc-186656.jpg,1,0,0,0,1,,train
0538323_as-2778628.jpg,2,0,0,1,3,,train
0538324_as-2706198.jpg,0,1,0,0,1,,train
0538325_sc-214663.jpg,1,0,0,0,1,,train
0538326_sc-214663.jpg,1,0,0,0,1,,train
0538327_as-0081131.jpg,3,0,0,0,3,,val
0538328_as-0081131.jpg,1,0,0,0,1,,val
0538329_sc-208626.jpg,3,0,1,0,4,,test
0538330_sc-208626.jpg,1,0,0,0,1,,train
0538331_sc-208626.jpg,3,0,1,0,4,,train
0538332_sc-208626.jpg,1,0,0,0,1,,train
0538335_as-0076458.jpg,6,0,0,0,6,,train
0538338_sc-230167.jpg,0,2,2,1,5,,train
0538339_sc-230167.jpg,0,2,1,1,4,,train
0538340_sc-230167.jpg,1,2,2,0,5,,train
0538341_sc-230167.jpg,0,2,2,1,5,,val
0538342_sc-209724.jpg,7,0,1,0,8,,val
0538343_sc-209724.jpg,2,0,0,0,2,,test
0538344_sc-209724.jpg,3,0,0,0,3,,train
0538348_as-0060445.jpg,0,0,1,0,1,,train
0538349_as-0060445.jpg,1,0,0,0,1,,train
0538350_as-0060445.jpg,0,1,0,0,1,,train
0538351_as-0060445.jpg,2,0,0,0,2,,train
0538352_as-0060445.jpg,0,0,0,1,1,,train
0538355_as-0060445.jpg,7,0,0,0,7,,train
0538356_as-0060445.jpg,0,1,0,0,1,,val
0538357_as-0060445.jpg,1,0,0,0,1,,val
0538358_as-0060445.jpg,0,2,0,0,2,,test
0538359_as-0060445.jpg,0,0,0,1,1,,train
0538360_as-0060445.jpg,3,0,0,0,3,,train
0538364_as-0040269.jpg,2,0,0,0,2,,train
0538365_as-0040269.jpg,2,0,0,0,2,,train
0538366_as-0040269.jpg,1,0,1,0,2,,train
0538367_as-0040269.jpg,1,0,1,0,2,,train
0538368_as-0040269.jpg,2,0,3,0,5,,train
0538369_as-0040269.jpg,1,0,1,1,3,,val
0538370_as-0040269.jpg,2,0,0,0,2,,val
0538375_as-0082298.jpg,0,0,1,1,2,,test
0538376_as-0082298.jpg,0,0,1,1,2,,train
0538377_as-0082298.jpg,0,0,1,1,2,,train
0538378_as-0082298.jpg,0,0,1,1,2,,train
0538379_as-0051625.jpg,1,0,1,0,2,,train
0538380_as-0051625.jpg,1,0,1,0,2,,train
0538381_as-0051625.jpg,1,0,0,0,1,,train
0538382_as-0051625.jpg,1,0,0,0,1,,train
0538383_as-0051625.jpg,1,0,1,0,2,,val
0538384_as-0051625.jpg,1,0,1,0,2,,val
0538387_sc-1018683.jpg,2,0,1,0,3,,test
0538389_sc-127914.jpg,1,0,1,0,2,,train
0538390_as-0013182.jpg,1,0,0,0,1,,train
0538391_as-0013182.jpg,1,0,0,0,1,,train
0538392_as-0013182.jpg,1,0,0,0,1,,train
0538393_as-3137527.jpg,1,0,1,0,2,,train
0538394_as-2709892.jpg,1,1,0,0,2,,train
0538395_as-3494071.jpg,0,0,1,0,1,,train
0538397_sc-1008524.jpg,0,1,0,1,2,,val
0538398_sc-1008524.jpg,0,1,0,1,2,,val
0538399_sc-1008524.jpg,0,1,1,1,3,,test
0538400_as-0035879.jpg,6,1,1,0,8,,train
0538401_as-0035879.jpg,2,1,1,0,4,,train
0538402_sc-175105.jpg,4,2,2,0,8,,train
0538403_sc-175105.jpg,0,0,1,0,1,,train
0538404_sc-175105.jpg,3,0,1,0,4,,train
0538407_sc-175105.jpg,2,1,1,0,4,,train
0538408_sc-175105.jpg,6,2,1,0,9,,train
0538409_as-2912956.jpg,1,1,0,0,2,,val
0538410_as-0056937.jpg,1,0,0,0,1,,val
0538411_as-0056937.jpg,1,0,0,0,1,,test
0538412_as-0056937.jpg,2,0,0,0,2,,train
0538413_as-0056937.jpg,1,0,0,0,1,,train
0538414_as-0056937.jpg,2,0,0,0,2,,train
0538415_as-0056937.jpg,2,0,0,0,2,,train
0538416_as-0056937.jpg,4,0,0,0,4,,train
0538417_as-0056937.jpg,2,0,0,0,2,,train
0538418_as-0056937.jpg,1,0,0,0,1,,train
0538419_as-0056937.jpg,1,1,0,0,2,,val
0538420_as-0056937.jpg,1,1,0,0,2,,val
0538421_as-0056937.jpg,1,1,0,0,2,,test
0538423_as-3047558.jpg,2,0,0,0,2,,train
0538425_as-0021124.jpg,1,0,1,0,2,,train
0538427_as-0021124.jpg,1,0,0,0,1,,train
0538428_as-0021124.jpg,1,0,1,0,2,,train
0538429_sc-194960.jpg,3,0,2,0,5,,train
0538430_sc-194960.jpg,1,0,0,1,2,,train
0538431_sc-194960.jpg,1,0,0,2,3,,train
0538432_sc-194960.jpg,1,0,0,1,2,,val
0538433_sc-194960.jpg,1,0,0,1,2,,val
0538435_sc-194960.jpg,2,0,0,0,2,,test
0538436_sc-194960.jpg,0,0,1,0,1,,train
0538437_sc-194960.jpg,1,0,0,0,1,,train
0538438_sc-194960.jpg,1,0,0,0,1,,train
0538439_sc-194960.jpg,1,0,1,0,2,,train
0538442_sc-194960.jpg,1,0,0,1,2,,train
0538443_sc-194960.jpg,1,0,0,1,2,,train
0538444_as-0038562.jpg,1,0,0,0,1,,train
0538445_as-0038562.jpg,5,0,0,0,5,,val
0538446_as-9048425.jpg,1,0,0,0,1,,val
0538447_sc-176415.jpg,1,0,1,0,2,,test
0538448_sc-176415.jpg,2,0,1,0,3,,train
0538450_sc-118962.jpg,1,0,0,0,1,,train
0538452_sc-118962.jpg,1,0,0,0,1,,train
0538453_as-0006661.jpg,1,0,2,0,3,,train
0538454_as-7713848.jpg,4,0,0,1,5,,train
0538455_as-7289324.jpg,1,1,1,0,3,,train
0538456_sc-114374.jpg,2,0,2,1,5,,train
0538457_sc-114374.jpg,3,0,0,0,3,,val
0538462_as-0015465.jpg,3,0,1,0,4,,val
0538463_as-0015465.jpg,1,0,0,0,1,,test
0538464_as-0015465.jpg,2,0,0,0,2,,train
0538465_as-0015465.jpg,2,0,0,0,2,,train
0538469_sc-194064.jpg,1,1,2,0,4,,train
0538470_sc-194064.jpg,1,1,1,0,3,,train
0538471_sc-194064.jpg,1,1,1,0,3,,train
0538472_sc-194064.jpg,2,0,1,1,4,,train
0538473_sc-194064.jpg,1,0,1,1,3,,train
0538474_sc-194064.jpg,2,1,0,1,4,,val
0538475_as-0097778.jpg,0,0,1,1,2,,val
0538476_as-0097778.jpg,0,0,1,1,2,,test
0538477_as-0097778.jpg,0,1,0,0,1,,train
0538478_as-3137355.jpg,0,0,2,1,3,,train
0538480_sc-110244.jpg,2,6,2,0,10,,train
0538482_sc-110244.jpg,2,6,6,1,15,,train
0538484_as-0004769.jpg,1,0,0,0,1,,train
0538485_as-0004769.jpg,1,0,0,0,1,,train
0538486_as-0004769.jpg,1,0,0,0,1,,train
0538487_as-0086256.jpg,0,0,0,2,2,,val
0538488_as-0086256.jpg,0,0,1,2,3,,val
0538489_as-0086256.jpg,0,0,0,1,1,,test
0538490_as-0086256.jpg,1,0,1,0,2,,train
0538491_as-0086256.jpg,0,0,1,0,1,,train
0538492_as-0086256.jpg,0,0,0,1,1,,train
0538494_as-0081787.jpg,2,0,0,0,2,,train
0538496_sc-1019315.jpg,6,0,1,1,8,,train
0538498_sc-1019315.jpg,1,0,0,0,1,,train
0538500_as-0074461.jpg,0,0,1,1,2,,train
0538501_sc-1026972.jpg,1,0,0,0,1,,val
0538502_as-0090967.jpg,1,1,2,2,6,,val
0538503_as-0090967.jpg,1,1,1,1,4,,test
0538504_as-0090967.jpg,2,1,1,1,5,,train
0538505_as-0090967.jpg,1,0,1,1,3,,train
0538506_as-0090967.jpg,0,0,1,0,1,,train
0538507_sc-205011.jpg,4,0,2,1,7,,train
0538508_sc-205011.jpg,3,2,1,1,7,,train
0538509_sc-205011.jpg,3,1,1,2,7,,train
0538510_sc-205011.jpg,1,0,0,0,1,,train
0538511_sc-205011.jpg,0,0,0,1,1,,val
0538512_sc-205011.jpg,0,0,0,1,1,,val
0538513_sc-205011.jpg,2,0,0,0,2,,test
0538514_sc-205011.jpg,3,0,0,0,3,,train
0538515_sc-205011.jpg,1,0,1,1,3,,train
0538516_sc-205011.jpg,2,0,2,1,5,,train
0538517_sc-205011.jpg,2,1,1,2,6,,train
0538518_sc-205011.jpg,3,1,0,1,5,,train
0538519_as-0015832.jpg,0,0,1,1,2,,train
0538520_as-0015832.jpg,2,0,1,1,4,,train
0538521_as-0015832.jpg,1,1,1,0,3,,val
0538522_as-0015832.jpg,0,0,2,0,2,,val
0538523_as-3127216.jpg,4,0,1,1,6,,test
0538524_as-3049932.jpg,4,0,0,0,4,,train
0538525_sc-222994.jpg,4,0,1,0,5,,train
0538526_sc-222994.jpg,5,0,0,0,5,,train
0538527_sc-222994.jpg,1,0,1,0,2,,train
0538528_sc-126811.jpg,1,1,1,0,3,,train
0538529_sc-170480.jpg,2,1,0,0,3,,train
0538531_sc-115918.jpg,2,0,0,0,2,,train
0538532_sc-115918.jpg,3,1,0,0,4,,val
0538533_sc-115918.jpg,0,2,0,0,2,,val
0538534_sc-115918.jpg,0,1,0,0,1,,test
0538535_sc-115918.jpg,0,1,0,0,1,,train
0538536_sc-115918.jpg,3,0,0,0,3,,train
0538537_sc-115918.jpg,3,0,0,0,3,,train
0538541_as-0020036.jpg,4,1,0,0,5,,train
0538543_as-0020036.jpg,5,0,0,0,5,,train
0538544_as-0020036.jpg,1,1,1,2,5,,train
0538545_as-0020036.jpg,1,1,1,1,4,,train
0538546_as-0020036.jpg,0,0,0,1,1,,val
0538549_as-0020036.jpg,0,1,0,1,2,,val
0538550_sc-197429.jpg,7,0,0,0,7,,test
0538551_sc-197429.jpg,4,0,0,0,4,,train
0538552_sc-197429.jpg,1,1,0,0,2,,train
0538553_sc-197429.jpg,2,0,0,0,2,,train
0538554_sc-197429.jpg,1,0,0,0,1,,train
0538558_sc-226568.jpg,1,0,1,0,2,,train
0538559_sc-226568.jpg,1,0,0,0,1,,train
0538560_sc-226568.jpg,3,0,0,0,3,,train
0538561_sc-226568.jpg,1,0,0,0,1,,val
0538562_sc-226568.jpg,2,0,0,0,2,,val
0538563_sc-226568.jpg,3,0,1,0,4,,test
0538564_sc-226568.jpg,1,0,0,0,1,,train
0538565_as-0012342.jpg,2,0,0,0,2,,train
0538566_as-0012342.jpg,2,0,0,0,2,,train
0538567_as-0012342.jpg,1,0,0,0,1,,train
0538568_as-0012342.jpg,2,0,0,0,2,,train
0538570_as-0035330.jpg,1,0,0,0,1,,train
0538571_as-0035330.jpg,1,0,0,0,1,,train
0538572_as-0035330.jpg,1,0,0,0,1,,val
0538573_sc-105942.jpg,5,2,0,0,7,,val
0538574_as-0002344.jpg,1,2,1,0,4,,test
0538575_as-3047561.jpg,0,0,1,0,1,,train
0538576_sc-1003120.jpg,2,1,1,2,6,,train
0538578_sc-1012312.jpg,2,1,0,1,4,,train
0538579_sc-1012312.jpg,2,0,1,0,3,,train
0538581_sc-108352.jpg,1,1,0,0,2,,train
0538582_as-0084883.jpg,1,0,1,0,2,,train
0538583_as-0084883.jpg,0,0,1,0,1,,train
0538584_as-0084883.jpg,2,0,1,0,3,,val
0538585_as-0084883.jpg,2,0,1,0,3,,val
0538586_as-0084883.jpg,1,0,2,0,3,,test
0538587_as-0084883.jpg,2,1,0,0,3,,train
0538588_as-0084883.jpg,2,0,0,0,2,,train
0538589_as-0084883.jpg,2,0,1,0,3,,train
0538590_sc-217565.jpg,5,0,1,0,6,,train
0538591_sc-217565.jpg,3,0,1,0,4,,train
0538592_sc-165582.jpg,2,4,1,0,7,,train
0538593_sc-165582.jpg,2,0,1,0,3,,train
0538594_as-0066558.jpg,0,0,0,1,1,,val
0538595_as-3470716.jpg,3,0,0,0,3,,val
0538596_sc-140105.jpg,1,1,0,0,2,,test
0538597_as-3444627.jpg,3,0,0,0,3,,train
0538598_sc-204539.jpg,4,0,1,0,5,,train
0538599_as-3180169.jpg,2,1,2,1,6,,train
0538600_as-0036448.jpg,2,0,0,0,2,,train
0538601_as-0036448.jpg,1,0,0,0,1,,train
0538602_sc-104256.jpg,2,0,0,0,2,,train
0538603_sc-104256.jpg,2,0,0,0,2,,train
0538604_sc-104256.jpg,1,0,0,0,1,,val
0538605_sc-104256.jpg,2,0,0,0,2,,val
0538606_as-0051933.jpg,1,0,0,0,1,,test
0538607_sc-116891.jpg,3,0,0,0,3,,train
0538608_sc-116891.jpg,3,0,1,0,4,,train
0538609_as-2819089.jpg,1,0,0,0,1,,train
0538610_sc-217343.jpg,0,1,0,0,1,,train
0538611_as-3335736.jpg,4,0,1,1,6,,train
0538612_as-2711791.jpg,1,0,0,0,1,,train
0538614_as-3262813.jpg,4,0,1,1,6,,train
0538619_as-0017138.jpg,2,2,1,2,7,,val
0538620_as-0017138.jpg,1,2,1,1,5,,val
0538621_sc-1029007.jpg,3,0,0,0,3,,test
0538623_sc-122552.jpg,2,0,1,0,3,,train
0538624_sc-122552.jpg,2,0,1,0,3,,train
0538626_as-0067393.jpg,1,0,0,0,1,,train
0538627_as-0044397.jpg,2,0,1,2,5,,train
0538628_as-0044397.jpg,1,0,0,0,1,,train
0538632_as-3226257.jpg,1,0,0,0,1,,train
0538633_as-3105679.jpg,1,1,1,1,4,,train
0538634_as-7877122.jpg,1,0,0,0,1,,val
0538635_as-0035859.jpg,1,0,0,0,1,,val
0538636_as-0035859.jpg,0,1,0,0,1,,test
0538637_as-0035859.jpg,0,1,0,0,1,,train
0538639_sc-1014616.jpg,3,0,0,0,3,,train
0538640_sc-1014616.jpg,4,0,0,0,4,,train
0538642_sc-125907.jpg,3,1,0,0,4,,train
0538643_sc-125907.jpg,4,0,0,0,4,,train
0538645_sc-125907.jpg,1,0,0,0,1,,train
0538647_sc-195096.jpg,5,0,0,1,6,,train
0538648_sc-194409.jpg,3,0,0,0,3,,val
0538649_sc-194409.jpg,5,0,0,1,6,,val
0538650_sc-194263.jpg,0,0,0,1,1,,test
0538651_sc-194263.jpg,2,0,0,1,3,,train
0538655_sc-204650.jpg,1,1,0,0,2,,train
0538656_sc-204650.jpg,3,1,0,0,4,,train
0538657_sc-204650.jpg,1,1,1,1,4,,train
0538658_sc-1025847.jpg,2,0,0,0,2,,train
0538659_sc-1025847.jpg,5,0,1,0,6,,train
0538660_as-2848296.jpg,5,0,1,2,8,,train
0538662_as-2656481.jpg,2,0,0,0,2,,val
0538663_as-0007826.jpg,1,0,0,0,1,,val
0538665_sc-1026985.jpg,3,0,0,0,3,,test
0538666_as-0056521.jpg,1,0,0,0,1,,train
0538667_as-0056521.jpg,1,0,0,0,1,,train
0538668_as-0056521.jpg,1,0,0,0,1,,train
0538669_as-2647689.jpg,1,0,1,0,2,,train
0538670_as-0007662.jpg,2,0,1,0,3,,train
0538671_as-0007662.jpg,1,0,0,0,1,,train
0538673_sc-135771.jpg,1,1,0,0,2,,train
0538674_sc-184141.jpg,2,0,0,0,2,,val
0538675_sc-184141.jpg,4,0,0,0,4,,val
0538676_as-0057199.jpg,2,0,0,1,3,,test
0538677_as-0057199.jpg,1,0,0,1,2,,train
0538678_as-0057199.jpg,1,0,0,1,2,,train
0538679_as-0045109.jpg,1,0,0,0,1,,train
0538680_as-0045109.jpg,0,0,1,0,1,,train
0538681_as-0045109.jpg,1,1,1,1,4,,train
0538683_as-0053242.jpg,1,0,0,0,1,,train
0538685_as-0053242.jpg,2,0,0,0,2,,train
0538686_as-0053242.jpg,2,0,0,0,2,,val
0538687_as-0053242.jpg,2,0,0,0,2,,val
0538688_as-0053242.jpg,1,0,0,0,1,,test
0538691_as-0073292.jpg,1,1,0,2,4,,train
0538692_as-0073292.jpg,0,1,0,0,1,,train
0538693_as-0073292.jpg,1,1,0,1,3,,train
0538694_as-0073292.jpg,4,2,0,2,8,,train
0538695_as-0073292.jpg,2,1,0,1,4,,train
0538696_as-3466156.jpg,5,0,0,0,5,,train
0538697_as-2981503.jpg,1,0,0,0,1,,train
0538698_as-2981503.jpg,2,0,0,2,4,,val
0538699_as-2538220.jpg,4,0,0,0,4,,val
0538702_sc-200069.jpg,2,0,0,0,2,,test
0538703_sc-200069.jpg,6,0,0,0,6,,train
0538704_sc-200069.jpg,4,0,0,0,4,,train
0538705_sc-200069.jpg,2,0,0,0,2,,train
0538706_sc-200069.jpg,1,0,0,0,1,,train
0538707_sc-200069.jpg,4,0,0,0,4,,train
0538708_sc-200069.jpg,1,0,0,0,1,,train
0538709_sc-200069.jpg,3,0,0,0,3,,train
0538710_sc-200069.jpg,2,0,0,0,2,,val
0538711_sc-200069.jpg,1,0,0,0,1,,val
0538712_sc-200069.jpg,2,0,0,0,2,,test
0538713_sc-200069.jpg,1,1,0,0,2,,train
0538714_sc-202627.jpg,10,0,0,1,11,,train
0538715_sc-110208.jpg,1,0,1,1,3,,train
0538717_as-3255705.jpg,2,0,0,0,2,,train
0538718_as-2563634.jpg,1,0,1,1,3,,train
0538719_as-0003371.jpg,2,1,0,0,3,,train
0538722_as-0035624.jpg,2,0,1,0,3,,train
0538724_sc-1033992.jpg,3,0,1,0,4,,val
0538726_sc-1033992.jpg,1,0,0,0,1,,val
0538729_sc-184375.jpg,0,1,0,0,1,,test
0538730_sc-1035652.jpg,1,0,0,0,1,,train
0538732_sc-1035652.jpg,3,0,0,0,3,,train
0538733_sc-1035652.jpg,1,0,0,0,1,,train
0538734_sc-1035652.jpg,2,0,1,1,4,,train
0538735_sc-1035652.jpg,3,0,1,1,5,,train
0538737_as-0018466.jpg,2,1,1,2,6,,train
0538739_as-0018466.jpg,1,0,2,1,4,,train
0538740_as-0018466.jpg,0,2,2,2,6,,val
0538743_as-0051775.jpg,3,0,1,1,5,,val
0538744_as-0051775.jpg,3,0,1,1,5,,test
0538745_as-0051775.jpg,1,0,1,1,3,,train
0538746_as-0051775.jpg,2,0,1,1,4,,train
0538747_as-0051775.jpg,2,0,0,0,2,,train
0538748_as-2675644.jpg,0,0,1,0,1,,train
0538749_sc-1018947.jpg,2,1,0,0,3,,train
0538750_sc-1018947.jpg,2,0,1,0,3,,train
0538751_sc-135650.jpg,0,1,0,0,1,,train
0538753_as-0012178.jpg,2,0,0,0,2,,val
0538754_as-0012178.jpg,2,0,0,0,2,,val
0538755_as-0012178.jpg,2,0,0,0,2,,test
0538756_sc-185429.jpg,1,0,0,0,1,,train
0538757_sc-185429.jpg,1,0,0,0,1,,train
0538759_sc-185429.jpg,1,0,0,0,1,,train
0538761_sc-185429.jpg,1,2,0,0,3,,train
0538762_sc-188296.jpg,3,0,0,0,3,,train
0538763_as-0049080.jpg,3,0,0,0,3,,train
0538764_as-0049080.jpg,1,0,0,0,1,,train
0538765_as-0049080.jpg,1,0,0,0,1,,val
0538766_as-0049080.jpg,1,0,0,0,1,,val
0538767_as-0049080.jpg,1,0,0,0,1,,test
0538768_as-0049080.jpg,2,0,0,0,2,,train
0538769_as-0049080.jpg,1,0,0,0,1,,train
0538770_as-0049080.jpg,2,0,0,0,2,,train
0538772_as-0045626.jpg,1,0,0,0,1,,train
0538773_as-0045626.jpg,1,0,0,0,1,,train
0538774_as-0045626.jpg,2,0,0,0,2,,train
0538775_as-0045626.jpg,3,0,1,0,4,,train
0538776_as-0045626.jpg,2,0,1,0,3,,val
0538777_as-0045626.jpg,1,0,0,0,1,,val
0538778_as-0045626.jpg,4,0,0,0,4,,test
0538779_as-0045626.jpg,3,0,0,1,4,,train
0538780_as-0045626.jpg,1,0,0,1,2,,train
0538781_as-0045626.jpg,3,0,1,0,4,,train
0538782_as-0045626.jpg,2,0,1,1,4,,train
0538783_as-0045626.jpg,1,1,0,0,2,,train
0538784_as-0045626.jpg,1,0,0,0,1,,train
0538785_as-0045626.jpg,6,0,0,0,6,,train
0538786_as-0045626.jpg,4,0,0,0,4,,val
0538787_as-0045626.jpg,1,0,0,0,1,,val
0538788_as-0045626.jpg,1,0,0,2,3,,test
0538790_as-0018765.jpg,1,0,1,1,3,,train
0538791_as-0018765.jpg,2,0,0,0,2,,train
0538792_as-0018765.jpg,2,0,0,0,2,,train
0538793_as-0018765.jpg,2,0,0,0,2,,train
0538794_as-0018765.jpg,2,0,0,0,2,,train
0538795_as-0018765.jpg,2,0,0,0,2,,train
0538798_as-0018765.jpg,1,0,1,0,2,,train
0538799_as-0018765.jpg,2,0,0,1,3,,val
0538800_as-9034392.jpg,0,1,0,0,1,,val
0538801_as-0030336.jpg,1,0,1,1,3,,test
0538802_as-0030336.jpg,1,0,1,1,3,,train
0538803_as-0030336.jpg,1,0,1,0,2,,train
0538804_as-0030336.jpg,2,0,1,3,6,,train
0538805_as-0030336.jpg,1,0,0,1,2,,train
0538806_sc-1023177.jpg,4,0,0,1,5,,train
0538807_sc-1023177.jpg,4,0,0,1,5,,train
0538808_sc-1023177.jpg,5,0,0,1,6,,train
0538809_sc-1023177.jpg,2,0,0,0,2,,val
0538811_as-0022287.jpg,15,0,2,0,17,,val
0538812_as-0022287.jpg,6,0,1,0,7,,test
0538813_as-0022287.jpg,6,0,1,0,7,,train
0538814_sc-168347.jpg,2,0,0,0,2,,train
0538815_sc-168347.jpg,1,0,0,0,1,,train
0538816_sc-168347.jpg,1,0,0,0,1,,train
0538817_sc-168347.jpg,1,0,0,0,1,,train
0538818_sc-168347.jpg,1,0,0,0,1,,train
0538820_sc-134364.jpg,1,0,0,2,3,,train
0538822_sc-134364.jpg,1,0,0,1,2,,val
0538823_sc-134364.jpg,1,0,0,2,3,,val
0538824_as-2549714.jpg,4,1,0,0,5,,test
0538825_as-0096303.jpg,3,0,0,0,3,,train
0538826_as-0096303.jpg,2,0,1,1,4,,train
0538828_sc-124425.jpg,4,0,1,0,5,,train
0538831_sc-124425.jpg,7,0,0,0,7,,train
0538832_sc-124425.jpg,4,0,1,0,5,,train
0538833_sc-124425.jpg,4,0,1,0,5,,train
0538834_sc-124425.jpg,1,0,0,0,1,,train
0538835_sc-124425.jpg,6,0,0,0,6,,val
0538836_as-2764492.jpg,5,0,0,0,5,,val
0538837_as-9025756.jpg,3,0,0,0,3,,test
0538838_sc-180024.jpg,1,0,0,0,1,,train
0538839_sc-126037.jpg,1,0,0,0,1,,train
0538840_as-0016288.jpg,0,0,0,1,1,,train
0538841_as-0098450.jpg,1,0,0,0,1,,train
0538843_as-0052396.jpg,0,0,0,1,1,,train
0538844_as-0052396.jpg,4,0,0,0,4,,train
0538845_as-0052396.jpg,7,0,0,0,7,,train
0538846_as-0052396.jpg,1,0,0,0,1,,val
0538847_as-0030114.jpg,1,0,0,0,1,,val
0538848_as-0030114.jpg,1,0,0,0,1,,test
0538849_as-0030114.jpg,1,0,0,0,1,,train
0538850_as-0030114.jpg,2,2,0,0,4,,train
0538851_as-0030114.jpg,1,2,0,0,3,,train
0538853_as-0018296.jpg,1,0,0,0,1,,train
0538854_as-0018296.jpg,2,0,0,0,2,,train
0538855_as-0018296.jpg,4,0,0,0,4,,train
0538858_sc-192433.jpg,5,0,1,0,6,,train
0538859_as-2831736.jpg,1,0,0,1,2,,val
0538860_sc-1017047.jpg,1,0,0,0,1,,val
0538863_sc-1017047.jpg,0,0,1,0,1,,test
0538864_sc-1017047.jpg,5,0,1,0,6,,train
0538865_sc-1017047.jpg,1,0,0,0,1,,train
0538866_sc-1017047.jpg,5,0,1,0,6,,train
0538867_sc-1017047.jpg,2,0,0,0,2,,train
0538869_sc-209885.jpg,1,0,0,0,1,,train
0538870_sc-209885.jpg,1,0,0,0,1,,train
0538871_sc-209885.jpg,1,0,0,0,1,,train
0538877_as-0016895.jpg,1,1,2,0,4,,val
0538878_as-0016895.jpg,2,2,3,1,8,,val
0538879_as-0016895.jpg,1,1,2,3,7,,test
0538880_as-0016895.jpg,2,1,3,1,7,,train
0538882_as-0016895.jpg,0,2,2,1,5,,train
0538883_as-0016895.jpg,2,0,1,0,3,,train
0538884_as-0016895.jpg,0,1,1,1,3,,train
0538886_as-0016895.jpg,1,0,0,0,1,,train
0538887_as-0016895.jpg,1,0,0,0,1,,train
0538889_as-0021350.jpg,6,0,0,0,6,,train
0538890_as-0021350.jpg,0,0,1,0,1,,val
0538891_as-0021350.jpg,0,0,1,0,1,,val
0538892_sc-194068.jpg,3,0,1,1,5,,test
0538893_sc-194068.jpg,1,0,0,1,2,,train
0538894_sc-194068.jpg,2,2,0,1,5,,train
0538895_sc-194068.jpg,2,1,1,1,5,,train
0538896_sc-194068.jpg,1,1,1,1,4,,train
0538897_as-0031959.jpg,1,0,0,0,1,,train
0538898_as-0031959.jpg,1,0,0,0,1,,train
0538899_as-0031959.jpg,2,0,0,1,3,,train
0538901_sc-132081.jpg,2,0,0,0,2,,val
0538902_sc-128532.jpg,1,0,1,0,2,,val
0538903_sc-128532.jpg,1,0,1,0,2,,test
0538904_sc-1027967.jpg,2,0,0,0,2,,train
0538907_sc-1027967.jpg,6,0,0,0,6,,train
0538909_as-0070181.jpg,3,0,0,0,3,,train
0538910_as-0070181.jpg,1,0,0,0,1,,train
0538911_as-0070181.jpg,1,0,0,0,1,,train
0538912_as-0070181.jpg,1,0,0,0,1,,train
0538913_as-3316000.jpg,4,1,1,1,7,,train
0538916_as-0054542.jpg,4,0,1,0,5,,val
0538917_as-0054542.jpg,4,1,2,0,7,,val
0538918_as-0054542.jpg,2,1,2,1,6,,test
0538923_as-0064936.jpg,2,0,0,0,2,,train
0538924_as-0064936.jpg,2,0,0,0,2,,train
0538925_sc-128277.jpg,6,0,0,0,6,,train
0538926_sc-128277.jpg,4,0,0,0,4,,train
0538927_as-0080884.jpg,1,0,1,0,2,,train
0538928_as-0080884.jpg,1,0,0,0,1,,train
0538929_as-0080884.jpg,1,0,0,1,2,,train
0538930_as-0080884.jpg,1,0,0,1,2,,val
0538931_sc-221254.jpg,1,0,0,0,1,,val
0538932_sc-221254.jpg,1,0,0,1,2,,test
0538933_sc-221254.jpg,2,0,2,0,4,,train
0538934_sc-106611.jpg,3,0,2,1,6,,train
0538935_sc-106611.jpg,1,0,1,1,3,,train
0538936_sc-106611.jpg,3,0,0,2,5,,train
0538937_sc-106611.jpg,3,0,1,1,5,,train
0538938_sc-106611.jpg,3,0,0,2,5,,train
0538939_sc-106611.jpg,2,0,0,2,4,,train
0538940_sc-106611.jpg,3,0,0,1,4,,val
0538941_sc-106611.jpg,1,0,1,1,3,,val
0538942_sc-106611.jpg,4,0,0,1,5,,test
0538945_as-0009733.jpg,4,0,0,0,4,,train
0538946_as-0009733.jpg,2,1,1,0,4,,train
0538947_as-0009733.jpg,4,0,1,0,5,,train
0538948_as-0009733.jpg,4,0,0,0,4,,train
0538949_as-0009733.jpg,1,1,1,0,3,,train
0538950_as-0009733.jpg,1,1,1,0,3,,train
0538952_as-0009733.jpg,1,0,0,0,1,,train
0538954_as-2965718.jpg,0,0,1,0,1,,val
0538955_as-2537275.jpg,2,0,0,1,3,,val
0538956_sc-115220.jpg,2,0,1,0,3,,test
0538957_as-7523303.jpg,1,0,0,0,1,,train
0538958_as-7986372.jpg,1,0,0,2,3,,train
0538959_as-0034101.jpg,1,0,1,0,2,,train
0538960_as-0034101.jpg,2,1,2,0,5,,train
0538961_as-0034101.jpg,2,1,1,0,4,,train
0538962_as-0034101.jpg,6,5,0,0,11,,train
0538964_as-0034101.jpg,4,2,1,0,7,,train
0538966_as-0034101.jpg,1,1,0,1,3,,val
0538967_as-0034101.jpg,0,0,1,0,1,,val
0538968_as-0034101.jpg,2,0,0,1,3,,test
0538970_as-3394290.jpg,0,1,1,0,2,,train
0538972_sc-200006.jpg,1,0,0,0,1,,train
0538973_sc-200006.jpg,1,1,0,0,2,,train
0538974_sc-200006.jpg,1,0,0,0,1,,train
0538975_as-0003711.jpg,0,1,0,0,1,,train
0538976_sc-217547.jpg,5,1,0,1,7,,train
0538977_sc-217547.jpg,3,1,2,2,8,,train
0538978_sc-217547.jpg,3,1,1,2,7,,val
0538979_sc-217547.jpg,3,2,1,0,6,,val
0538980_sc-217547.jpg,2,1,1,0,4,,test
0538981_sc-217547.jpg,2,1,1,0,4,,train
0538982_sc-217547.jpg,1,0,1,0,2,,train
0538983_sc-201114.jpg,2,0,1,4,7,,train
0538984_as-3083640.jpg,0,1,0,0,1,,train
0538986_sc-123382.jpg,2,0,0,0,2,,train
0538987_sc-123382.jpg,3,0,0,0,3,,train
0538988_sc-123382.jpg,2,0,0,0,2,,train
0538989_sc-218077.jpg,7,0,0,0,7,,val
0538990_sc-218077.jpg,4,0,0,0,4,,val
0538991_sc-218077.jpg,3,0,0,0,3,,test
0538992_sc-218077.jpg,3,0,0,0,3,,train
0538993_sc-218077.jpg,1,0,0,0,1,,train
0538994_sc-218077.jpg,2,0,0,0,2,,train
0538995_sc-218077.jpg,3,0,0,0,3,,train
0538996_sc-141342.jpg,1,0,0,0,1,,train
0538998_sc-186323.jpg,2,2,2,2,8,,train
0538999_sc-186323.jpg,3,1,1,2,7,,train
0539000_sc-186323.jpg,2,1,1,0,4,,val
0539003_sc-1018925.jpg,1,0,0,1,2,,val
0539004_sc-1018925.jpg,1,0,0,0,1,,test
0539005_sc-1018925.jpg,1,0,0,1,2,,train
0539006_as-2733447.jpg,3,1,1,0,5,,train
0539007_sc-164660.jpg,0,0,0,1,1,,train
0539008_sc-164660.jpg,0,0,0,1,1,,train
0539010_as-0062370.jpg,0,0,1,0,1,,train
0539011_as-0062370.jpg,0,0,1,0,1,,train
0539012_as-0062370.jpg,1,0,0,0,1,,train
0539013_as-0062370.jpg,0,0,1,0,1,,val
0539014_as-0033962.jpg,1,1,1,1,4,,val
0539015_as-0033962.jpg,1,1,1,1,4,,test
0539016_as-0033962.jpg,1,1,0,1,3,,train
0539018_sc-1029021.jpg,0,0,1,0,1,,train
0539019_sc-1029021.jpg,3,0,0,0,3,,train
0539021_sc-170620.jpg,1,0,0,2,3,,train
0539022_sc-170620.jpg,0,0,0,2,2,,train
0539023_sc-170620.jpg,1,0,0,2,3,,train
0539024_as-0024527.jpg,0,0,1,0,1,,train
0539026_as-0024527.jpg,1,0,2,1,4,,val
0539027_as-0024527.jpg,3,0,0,0,3,,val
0539028_sc-1036195.jpg,2,0,1,0,3,,test
0539029_sc-1036195.jpg,2,0,1,0,3,,train
0539030_as-3136921.jpg,2,1,1,0,4,,train
0539031_as-7974944.jpg,2,0,0,0,2,,train
0539032_as-2994163.jpg,2,0,0,0,2,,train
0539033_sc-138207.jpg,1,0,0,0,1,,train
0539034_as-3216794.jpg,1,0,1,1,3,,train
0539035_as-9002083.jpg,1,0,0,0,1,,train
0539036_as-9002083.jpg,1,1,0,1,3,,val
0539037_as-2992902.jpg,3,0,1,0,4,,val
0539038_sc-116551.jpg,1,0,0,0,1,,test
0539039_sc-192102.jpg,1,0,0,0,1,,train
0539040_sc-192102.jpg,2,0,0,0,2,,train
0539041_sc-192102.jpg,1,0,0,0,1,,train
0539042_sc-192102.jpg,1,0,0,0,1,,train
0539043_sc-1037958.jpg,0,0,1,0,1,,train
0539044_sc-1037958.jpg,1,0,1,0,2,,train
0539045_sc-1037958.jpg,1,0,1,0,2,,train
0539046_sc-1037958.jpg,0,1,1,0,2,,val
0539047_sc-1037958.jpg,1,0,0,0,1,,val
0539049_sc-1001733.jpg,2,1,1,1,5,,test
0539050_sc-1001733.jpg,1,1,1,0,3,,train
0539051_sc-1001733.jpg,1,1,1,0,3,,train
0539053_as-0091665.jpg,2,0,1,1,4,,train
0539054_as-0091665.jpg,3,0,1,0,4,,train
0539055_as-0091665.jpg,2,0,0,1,3,,train
0539056_as-0091665.jpg,6,0,0,1,7,,train
0539057_as-0091665.jpg,4,0,0,0,4,,train
0539058_as-0091665.jpg,1,0,1,0,2,,val
0539059_as-0091665.jpg,2,0,1,1,4,,val
0539060_as-0091665.jpg,2,0,0,1,3,,test
0539061_as-0091665.jpg,1,0,0,0,1,,train
0539064_as-7468974.jpg,1,0,0,0,1,,train
0539065_as-0047326.jpg,1,0,1,0,2,,train
0539066_as-0047326.jpg,0,0,1,0,1,,train
0539067_as-0047326.jpg,1,0,0,0,1,,train
0539068_as-0047326.jpg,1,0,0,0,1,,train
0539069_as-0025039.jpg,1,0,0,0,1,,train
0539070_as-0025039.jpg,3,1,0,0,4,,val
0539071_sc-210377.jpg,1,0,0,2,3,,val
0539072_sc-210377.jpg,1,0,0,2,3,,test
0539073_sc-210377.jpg,1,0,0,1,2,,train
0539074_sc-210377.jpg,1,0,0,1,2,,train
0539075_sc-210377.jpg,1,0,0,1,2,,train
0539076_as-3240551.jpg,5,0,0,0,5,,train
0539078_as-0048599.jpg,0,1,1,1,3,,train
0539079_as-0048599.jpg,0,0,1,0,1,,train
0539081_as-0048599.jpg,1,1,1,1,4,,train
0539083_as-0048599.jpg,0,1,1,1,3,,val
0539084_as-0048599.jpg,1,1,1,1,4,,val
0539085_as-0048599.jpg,0,0,1,1,2,,test
0539086_as-0048599.jpg,1,0,2,1,4,,train
0539087_as-0048599.jpg,1,0,0,0,1,,train
0539088_as-0048599.jpg,0,1,0,0,1,,train
0539089_as-0048599.jpg,0,0,1,0,1,,train
0539090_as-0048599.jpg,0,1,1,2,4,,train
0539092_as-3098850.jpg,1,0,1,1,3,,train
0539093_as-2521534.jpg,2,2,1,3,8,,train
0539095_as-0029320.jpg,1,1,0,0,2,,val
0539098_as-0029320.jpg,0,1,3,2,6,,val
0539099_as-2995049.jpg,1,0,0,0,1,,test
0539101_as-2816041.jpg,1,0,1,0,2,,train
0539102_as-7575585.jpg,3,0,0,1,4,,train
0539104_sc-154467.jpg,7,0,0,2,9,,train
0539105_sc-154467.jpg,3,1,0,1,5,,train
0539107_sc-152470.jpg,12,1,2,0,15,,train
0539109_sc-152470.jpg,9,1,2,0,12,,train
0539110_sc-152470.jpg,6,1,1,0,8,,train
0539111_sc-167888.jpg,1,0,0,0,1,,val
0539112_sc-167888.jpg,2,0,1,1,4,,val
0539113_sc-167888.jpg,2,1,0,1,4,,test
0539114_sc-167888.jpg,2,1,0,0,3,,train
0539115_sc-167888.jpg,2,0,0,1,3,,train
0539116_sc-167888.jpg,1,1,0,1,3,,train
0539117_sc-167888.jpg,1,1,0,0,2,,train
0539118_as-4787213.jpg,1,1,1,0,3,,train
0539121_as-0041511.jpg,3,0,1,1,5,,train
0539122_as-0041511.jpg,3,0,0,0,3,,train
0539123_as-0041511.jpg,2,1,0,0,3,,val
0539126_sc-1040193.jpg,1,0,0,0,1,,val
0539127_sc-1040193.jpg,1,0,0,0,1,,test
0539128_sc-1036655.jpg,1,0,1,0,2,,train
0539129_sc-1036655.jpg,1,0,1,0,2,,train
0539130_sc-1025129.jpg,1,0,1,1,3,,train
0539132_sc-1025129.jpg,2,0,0,0,2,,train
0539133_as-0001492.jpg,1,0,0,0,1,,train
0539134_as-0001492.jpg,1,0,2,1,4,,train
0539135_as-0001492.jpg,1,0,2,1,4,,train
0539136_as-0001492.jpg,1,0,0,0,1,,val
0539139_sc-181145.jpg,5,0,1,0,6,,val
0539140_sc-181145.jpg,1,0,1,0,2,,test
0539141_sc-181145.jpg,1,0,1,0,2,,train
0539143_sc-181145.jpg,4,0,0,0,4,,train
0539145_as-7151937.jpg,0,1,2,2,5,,train
0539146_sc-124404.jpg,1,0,0,0,1,,train
0539147_sc-124404.jpg,1,0,0,0,1,,train
0539148_sc-124404.jpg,1,0,0,0,1,,train
0539149_sc-124404.jpg,1,0,0,0,1,,train
0539150_sc-124404.jpg,1,0,0,0,1,,val
0539153_sc-181986.jpg,2,1,1,0,4,,val
0539155_sc-1028975.jpg,2,0,0,0,2,,test
0539157_as-0030014.jpg,1,0,1,1,3,,train
0539158_as-0030014.jpg,2,0,1,0,3,,train
0539159_as-0030014.jpg,2,0,1,1,4,,train
0539160_as-0030014.jpg,1,0,0,0,1,,train
0539161_as-0030014.jpg,2,0,0,0,2,,train
0539162_as-0030014.jpg,2,0,0,0,2,,train
0539163_as-0030014.jpg,3,0,0,0,3,,train
0539164_as-0030014.jpg,4,0,1,1,6,,val
0539165_as-0054261.jpg,3,0,0,0,3,,val
0539166_as-0054261.jpg,1,0,0,0,1,,test
0539167_as-0054261.jpg,1,0,0,0,1,,train
0539168_as-0054261.jpg,1,0,0,0,1,,train
0539170_as-0083902.jpg,0,0,1,0,1,,train
0539171_as-0083902.jpg,3,0,1,1,5,,train
0539172_as-0083902.jpg,1,0,1,1,3,,train
0539173_as-0083902.jpg,1,0,1,0,2,,train
0539174_as-2961120.jpg,1,0,1,0,2,,train
0539175_as-2961120.jpg,1,0,1,0,2,,val
0539176_sc-194316.jpg,1,1,0,1,3,,val
0539177_sc-194316.jpg,4,1,0,1,6,,test
0539178_sc-194316.jpg,3,1,0,1,5,,train
0539179_sc-194316.jpg,12,1,0,0,13,,train
0539180_sc-194316.jpg,5,1,0,1,7,,train
0539181_sc-194316.jpg,6,0,0,1,7,,train
0539183_sc-194316.jpg,2,0,0,0,2,,train
0539184_sc-194316.jpg,4,1,0,1,6,,train
0539187_sc-208096.jpg,1,0,1,0,2,,train
0539188_sc-208096.jpg,1,0,0,0,1,,val
0539189_sc-1032484.jpg,1,1,0,0,2,,val
0539190_sc-1032484.jpg,1,1,0,0,2,,test
0539192_as-3246106.jpg,1,0,0,1,2,,train
0539194_as-0031346.jpg,4,0,0,1,5,,train
0539195_as-0031346.jpg,2,0,1,1,4,,train
0539196_as-0031346.jpg,1,0,1,0,2,,train
0539197_as-2629240.jpg,1,0,0,0,1,,train
0539199_sc-224501.jpg,2,0,1,1,4,,train
0539200_sc-224501.jpg,2,0,2,1,5,,train
0539201_sc-224501.jpg,2,0,2,1,5,,val
0539202_sc-224501.jpg,1,0,2,2,5,,val
0539203_sc-214358.jpg,12,0,0,0,12,,test
0539204_sc-214358.jpg,8,0,0,0,8,,train
0539205_as-2822044.jpg,0,0,1,0,1,,train
0539206_as-0091103.jpg,0,0,1,2,3,,train
0539207_as-0091103.jpg,0,0,1,2,3,,train
0539208_sc-130435.jpg,1,0,0,0,1,,train
0539210_sc-130435.jpg,1,0,0,0,1,,train
0539212_sc-130435.jpg,1,0,0,0,1,,train
0539213_as-0054726.jpg,2,0,1,1,4,,val
0539214_as-0054726.jpg,2,0,0,0,2,,val
0539215_sc-171305.jpg,2,4,1,0,7,,test
0539217_sc-171305.jpg,2,1,1,0,4,,train
0539218_sc-171305.jpg,1,2,0,0,3,,train
0539219_as-2827131.jpg,0,0,1,0,1,,train
0539220_sc-225724.jpg,4,0,0,2,6,,train
0539221_sc-225724.jpg,4,0,0,2,6,,train
0539222_sc-225724.jpg,2,0,0,0,2,,train
0539223_sc-225724.jpg,2,0,0,0,2,,train
0539224_sc-225724.jpg,3,0,0,2,5,,val
0539225_sc-225724.jpg,2,0,0,0,2,,val
0539226_sc-225724.jpg,2,0,0,0,2,,test
0539227_sc-225724.jpg,2,0,0,0,2,,train
0539228_sc-225724.jpg,2,0,0,0,2,,train
0539230_sc-154416.jpg,2,0,0,1,3,,train
0539231_sc-154416.jpg,1,0,0,1,2,,train
0539232_sc-154416.jpg,2,0,0,1,3,,train
0539233_sc-138687.jpg,1,0,0,0,1,,train
0539234_sc-138687.jpg,2,0,0,0,2,,train
0539235_sc-138687.jpg,1,0,0,0,1,,val
0539237_sc-129879.jpg,4,0,0,0,4,,val
0539238_sc-129879.jpg,1,0,0,0,1,,test
0539239_sc-146893.jpg,1,1,1,0,3,,train
0539241_sc-146893.jpg,2,1,1,0,4,,train
0539242_sc-146893.jpg,1,0,1,0,2,,train
0539243_as-3132206.jpg,1,0,0,0,1,,train
0539245_as-0076878.jpg,2,0,0,0,2,,train
0539246_as-3194594.jpg,3,0,0,0,3,,train
0539247_as-3460098.jpg,2,0,0,1,3,,train
0539248_sc-222576.jpg,6,0,0,0,6,,val
0539249_sc-222576.jpg,4,0,0,0,4,,val
0539250_sc-216292.jpg,0,1,0,0,1,,test
0539251_sc-216292.jpg,2,1,0,0,3,,train
0539252_as-2528256.jpg,1,1,1,2,5,,train
0539253_as-3162881.jpg,2,0,2,0,4,,train
0539254_as-7522992.jpg,1,0,0,0,1,,train
0539255_as-3238707.jpg,2,0,0,0,2,,train
0539256_as-3260983.jpg,1,2,2,1,6,,train
0539258_sc-1024959.jpg,2,0,0,0,2,,train
0539259_sc-1024959.jpg,3,0,0,0,3,,val
0539260_sc-183345.jpg,2,1,0,0,3,,val
0539261_sc-183345.jpg,1,0,0,0,1,,test
0539262_sc-183345.jpg,2,0,0,0,2,,train
0539267_sc-1007815.jpg,3,1,1,0,5,,train
0539268_sc-1007815.jpg,2,1,1,0,4,,train
0539269_sc-1007815.jpg,2,0,1,0,3,,train
0539271_sc-1007815.jpg,2,1,1,0,4,,train
0539272_sc-1007815.jpg,3,1,1,0,5,,train
0539274_as-0064563.jpg,1,0,1,0,2,,train
0539275_as-0064563.jpg,2,0,0,0,2,,val
0539279_sc-161261.jpg,0,1,1,0,2,,val
0539280_sc-201549.jpg,2,0,1,0,3,,test
0539281_sc-201549.jpg,1,1,1,0,3,,train
0539282_sc-201549.jpg,4,0,2,0,6,,train
0539285_as-0062988.jpg,3,0,1,0,4,,train
0539287_as-0062988.jpg,3,0,1,0,4,,train
0539288_as-0072997.jpg,8,0,0,2,10,,train
0539289_as-0072997.jpg,2,0,0,1,3,,train
0539290_as-0072997.jpg,3,0,0,0,3,,train
0539291_as-0072997.jpg,1,0,0,0,1,,val
0539292_as-0072997.jpg,0,0,0,1,1,,val
0539293_as-0072997.jpg,0,0,0,2,2,,test
0539298_as-0038357.jpg,8,0,0,1,9,,train
0539299_sc-202938.jpg,2,0,0,0,2,,train
0539300_sc-202938.jpg,1,0,0,0,1,,train
0539301_sc-203402.jpg,1,0,1,0,2,,train
0539302_sc-203402.jpg,0,1,0,0,1,,train
0539303_sc-187128.jpg,3,0,0,0,3,,train
0539304_sc-187128.jpg,3,0,0,1,4,,train
0539305_sc-187128.jpg,3,0,0,0,3,,val
0539306_sc-187128.jpg,3,0,0,0,3,,val
0539307_sc-187128.jpg,3,0,0,0,3,,test
0539308_sc-187128.jpg,4,0,0,1,5,,train
0539310_as-7711082.jpg,0,1,0,0,1,,train
0539311_sc-185898.jpg,3,0,0,1,4,,train
0539313_as-0022030.jpg,2,0,0,0,2,,train
0539314_as-0022030.jpg,1,0,0,0,1,,train
0539315_as-0022030.jpg,2,0,0,0,2,,train
0539316_as-0022030.jpg,3,0,1,0,4,,train
0539317_as-0022030.jpg,2,0,0,0,2,,val
0539318_as-0022030.jpg,3,0,0,0,3,,val
0539319_sc-1016024.jpg,7,0,0,0,7,,test
0539320_sc-1016024.jpg,7,0,0,2,9,,train
0539321_sc-1016024.jpg,11,0,1,4,16,,train
0539322_sc-1016024.jpg,6,0,0,3,9,,train
0539325_sc-147293.jpg,1,0,0,0,1,,train
0539326_sc-147293.jpg,1,0,0,0,1,,train
0539327_sc-147293.jpg,1,0,0,1,2,,train
0539328_sc-147293.jpg,1,0,0,1,2,,train
0539329_sc-147293.jpg,1,0,0,0,1,,val
0539330_sc-147293.jpg,1,0,0,0,1,,val
0539332_as-0085842.jpg,2,0,0,0,2,,test
0539333_as-0077104.jpg,2,0,2,1,5,,train
0539334_as-0077104.jpg,2,0,1,1,4,,train
0539335_as-2737612.jpg,1,0,1,1,3,,train
0539336_as-2701627.jpg,1,0,0,0,1,,train
0539337_as-3103101.jpg,0,1,0,0,1,,train
0539338_as-0098935.jpg,1,0,0,0,1,,train
0539339_as-0098935.jpg,1,0,0,0,1,,train
0539340_as-3014894.jpg,1,0,0,0,1,,val
0539341_as-3430429.jpg,4,0,1,0,5,,val
0539342_sc-209617.jpg,2,0,0,2,4,,test
0539343_sc-209617.jpg,1,0,0,0,1,,train
0539344_sc-209617.jpg,3,0,0,0,3,,train
0539345_as-2841279.jpg,1,0,1,0,2,,train
0539347_as-2910338.jpg,1,0,1,0,2,,train
0539348_as-7775088.jpg,2,0,1,0,3,,train
0539349_as-9073804.jpg,0,1,0,0,1,,train
0539351_sc-218355.jpg,7,0,0,0,7,,train
0539352_sc-218355.jpg,5,0,1,1,7,,val
0539353_sc-218355.jpg,6,0,1,0,7,,val
0539354_sc-218355.jpg,6,0,1,0,7,,test
0539355_sc-218355.jpg,4,0,1,0,5,,train
0539356_sc-218355.jpg,3,1,0,0,4,,train
0539360_as-0050215.jpg,1,0,0,0,1,,train
0539361_as-0050215.jpg,1,0,0,0,1,,train
0539362_as-0050215.jpg,1,0,0,0,1,,train
0539363_as-0050215.jpg,1,0,0,0,1,,train
0539364_as-0050215.jpg,1,0,0,1,2,,train
0539365_as-0050215.jpg,1,0,0,0,1,,val
0539366_as-0050215.jpg,1,0,0,0,1,,val
0539367_as-0050215.jpg,1,0,0,0,1,,test
0539368_as-0050215.jpg,1,0,0,0,1,,train
0539370_as-0050215.jpg,1,0,0,0,1,,train
0539371_as-2701846.jpg,2,0,0,0,2,,train
0539372_as-3087293.jpg,4,0,0,0,4,,train
0539374_sc-160083.jpg,3,0,0,0,3,,train
0539375_sc-160083.jpg,2,0,1,0,3,,train
0539376_sc-137293.jpg,0,1,0,0,1,,train
0539382_as-0007611.jpg,5,1,1,1,8,,val
0539384_sc-172497.jpg,1,0,0,0,1,,val
0539386_as-0034430.jpg,2,0,0,0,2,,test
0539387_as-0034430.jpg,8,0,0,0,8,,train
0539388_as-0034430.jpg,7,0,0,0,7,,train
0539392_as-0077393.jpg,12,2,1,1,16,,train
0539393_sc-174798.jpg,3,0,1,0,4,,train
0539395_sc-174798.jpg,3,0,1,0,4,,train
0539396_sc-174798.jpg,2,0,1,0,3,,train
0539398_sc-1035870.jpg,4,2,2,0,8,,train
0539399_sc-1035870.jpg,3,0,2,0,5,,val
0539402_sc-153655.jpg,4,0,1,0,5,,val
0539405_sc-153655.jpg,3,0,0,0,3,,test
0539406_sc-1036651.jpg,1,0,1,0,2,,train
0539407_sc-1036651.jpg,1,0,1,0,2,,train
0539408_sc-1036651.jpg,2,0,2,0,4,,train
0539409_sc-1036651.jpg,1,0,1,1,3,,train
0539410_sc-1036651.jpg,1,0,1,0,2,,train
0539411_sc-1036651.jpg,1,0,2,0,3,,train
0539413_sc-129326.jpg,3,0,0,0,3,,train
0539414_as-3491362.jpg,6,1,0,0,7,,val
0539415_as-3047084.jpg,8,1,0,1,10,,val
0539416_sc-108959.jpg,4,0,0,1,5,,test
0539417_sc-108959.jpg,5,0,0,0,5,,train
0539418_sc-123236.jpg,1,0,1,0,2,,train
0539419_sc-123236.jpg,2,0,0,0,2,,train
0539422_sc-123236.jpg,1,0,1,0,2,,train
0539424_sc-123236.jpg,1,0,0,0,1,,train
0539425_as-3216533.jpg,1,1,1,0,3,,train
0539426_sc-191903.jpg,1,0,0,1,2,,train
0539427_sc-191903.jpg,1,0,0,1,2,,val
0539428_sc-191903.jpg,3,0,0,0,3,,val
0539429_sc-191903.jpg,1,0,0,0,1,,test
0539430_as-0029353.jpg,5,0,0,0,5,,train
0539431_as-0029353.jpg,11,0,0,0,11,,train
0539433_sc-1008412.jpg,0,0,0,1,1,,train
0539434_as-3212793.jpg,2,0,1,0,3,,train
0539435_sc-205533.jpg,5,1,1,0,7,,train
0539436_sc-205533.jpg,3,1,1,0,5,,train
0539437_sc-205533.jpg,1,0,1,0,2,,train
0539438_sc-205533.jpg,2,1,1,0,4,,val
0539439_sc-205533.jpg,6,2,1,0,9,,val
0539440_sc-205533.jpg,5,1,0,1,7,,test
0539441_sc-205533.jpg,3,1,0,1,5,,train
0539442_sc-205533.jpg,4,1,0,1,6,,train
0539443_sc-205533.jpg,4,1,2,0,7,,train
0539444_sc-205533.jpg,4,2,1,0,7,,train
0539445_sc-205533.jpg,4,1,1,0,6,,train
0539446_sc-205533.jpg,0,0,2,0,2,,train
0539447_sc-205533.jpg,0,0,1,0,1,,train
0539448_sc-205533.jpg,0,0,1,0,1,,val
0539451_as-0021523.jpg,2,0,0,0,2,,val
0539452_as-0021523.jpg,1,0,0,0,1,,test
0539453_as-0021523.jpg,1,0,0,0,1,,train
0539454_as-0021523.jpg,1,0,0,0,1,,train
0539455_as-0021523.jpg,2,0,0,0,2,,train
0539456_as-0021523.jpg,3,0,0,0,3,,train
0539457_as-2589634.jpg,1,0,0,0,1,,train
0539458_sc-116912.jpg,2,0,0,0,2,,train
0539459_sc-116912.jpg,5,1,0,0,6,,train
0539460_sc-116912.jpg,2,1,0,0,3,,val
0539461_sc-116912.jpg,2,1,0,0,3,,val
0539462_as-0057928.jpg,1,0,0,0,1,,test
0539464_sc-224753.jpg,1,0,0,0,1,,train
0539465_sc-224753.jpg,2,0,1,0,3,,train
0539466_sc-224753.jpg,2,0,0,0,2,,train
0539467_sc-224753.jpg,2,0,1,0,3,,train
0539468_sc-224753.jpg,2,0,1,0,3,,train
0539469_sc-224753.jpg,1,0,0,0,1,,train
0539470_sc-224753.jpg,2,0,0,0,2,,train
0539471_sc-224753.jpg,2,0,0,0,2,,val
0539472_sc-224753.jpg,2,0,0,0,2,,val
0539473_sc-224753.jpg,2,0,0,0,2,,test
0539475_sc-224753.jpg,2,0,0,0,2,,train
0539476_sc-224753.jpg,1,0,0,0,1,,train
0539477_sc-224753.jpg,1,0,1,0,2,,train
0539478_sc-215953.jpg,5,0,0,0,5,,train
0539479_sc-215953.jpg,3,0,0,0,3,,train
0539480_sc-215953.jpg,3,0,0,0,3,,train
0539481_sc-215953.jpg,1,0,0,0,1,,train
0539485_as-0050483.jpg,0,2,0,0,2,,val
0539486_as-0050483.jpg,0,2,0,0,2,,val
0539487_as-0050483.jpg,0,2,0,0,2,,test
0539488_as-0050483.jpg,0,2,0,0,2,,train
0539489_as-0050483.jpg,0,1,0,0,1,,train
0539490_as-0050483.jpg,1,1,0,0,2,,train
0539491_as-0050483.jpg,1,1,0,0,2,,train
0539492_as-0050483.jpg,0,1,0,0,1,,train
0539493_as-0050483.jpg,1,0,0,0,1,,train
0539494_as-0050483.jpg,1,0,0,0,1,,train
0539495_as-0050483.jpg,0,0,1,0,1,,val
0539496_as-0050483.jpg,1,2,0,0,3,,val
0539497_as-2648603.jpg,2,0,0,0,2,,test
0539499_as-0072624.jpg,1,1,0,0,2,,train
0539500_as-0072624.jpg,1,1,1,0,3,,train
0539501_as-0072624.jpg,1,0,1,0,2,,train
0539502_as-0072624.jpg,1,1,1,0,3,,train
0539503_as-0072305.jpg,0,0,1,1,2,,train
0539504_as-7594366.jpg,5,1,0,0,6,,train
0539505_sc-145583.jpg,1,0,0,0,1,,train
0539506_sc-134267.jpg,2,1,0,0,3,,val
0539509_as-0073162.jpg,4,0,1,0,5,,val
0539510_as-0073162.jpg,0,0,1,0,1,,test
0539511_as-0073162.jpg,3,0,0,0,3,,train
0539512_sc-1040783.jpg,2,0,0,0,2,,train
0539513_sc-1040783.jpg,1,0,0,1,2,,train
0539514_sc-1040783.jpg,1,0,0,2,3,,train
0539515_sc-1040783.jpg,4,0,0,0,4,,train
0539516_sc-1022127.jpg,1,1,1,0,3,,train
0539517_sc-1022127.jpg,1,1,1,0,3,,train
0539518_sc-1022127.jpg,5,0,0,0,5,,val
0539521_as-0027012.jpg,0,0,2,0,2,,val
0539524_as-0027012.jpg,4,1,1,0,6,,test
0539525_as-0027012.jpg,4,1,1,0,6,,train
0539526_as-0027012.jpg,8,1,1,1,11,,train
0539527_as-0027012.jpg,3,1,2,1,7,,train
0539528_as-0027012.jpg,0,1,2,0,3,,train
0539529_as-0027012.jpg,3,1,2,0,6,,train
0539530_sc-145454.jpg,1,0,0,0,1,,train
0539531_sc-145454.jpg,1,0,0,0,1,,train
0539534_as-0080883.jpg,2,1,0,0,3,,val
0539535_as-0080883.jpg,1,0,0,0,1,,val
0539537_sc-1026728.jpg,2,0,0,0,2,,test
0539538_sc-1026728.jpg,3,0,0,0,3,,train
0539539_sc-1026728.jpg,4,0,0,0,4,,train
0539540_as-0002409.jpg,1,0,1,0,2,,train
0539541_as-0002409.jpg,1,0,1,0,2,,train
0539542_sc-151754.jpg,1,0,1,0,2,,train
0539543_as-3222259.jpg,2,1,1,1,5,,train
0539544_as-3222259.jpg,4,2,0,2,8,,train
0539545_sc-1033000.jpg,2,0,0,0,2,,val
0539546_as-3485019.jpg,4,1,1,3,9,,val
0539547_sc-109754.jpg,3,0,0,1,4,,test
0539548_sc-109754.jpg,2,0,0,1,3,,train
0539549_sc-109754.jpg,1,0,0,1,2,,train
0539550_sc-109754.jpg,1,0,0,1,2,,train
0539551_sc-109754.jpg,1,0,0,1,2,,train
0539552_sc-109754.jpg,1,0,0,1,2,,train
0539553_sc-137965.jpg,1,0,0,0,1,,train
0539554_sc-137965.jpg,1,0,0,0,1,,train
0539556_sc-137965.jpg,2,1,0,2,5,,val
0539557_sc-137965.jpg,5,1,0,2,8,,val
0539558_sc-137965.jpg,2,1,0,2,5,,test
0539559_sc-137965.jpg,2,1,0,2,5,,train
0539560_as-2500287.jpg,3,0,0,0,3,,train
0539561_as-2511955.jpg,1,0,0,0,1,,train
0539562_sc-1035792.jpg,2,0,3,1,6,,train
0539563_sc-1032539.jpg,1,0,0,1,2,,train
0539564_sc-180690.jpg,2,0,0,0,2,,train
0539566_sc-180690.jpg,0,0,1,0,1,,train
0539567_as-3158221.jpg,2,0,1,2,5,,val
0539568_sc-1014600.jpg,1,0,0,0,1,,val
0539569_sc-1014600.jpg,2,0,1,0,3,,test
0539570_sc-1014600.jpg,1,0,1,1,3,,train
0539571_as-0030679.jpg,4,0,1,1,6,,train
0539574_as-0053316.jpg,5,0,0,1,6,,train
0539575_as-0053316.jpg,5,0,1,0,6,,train
0539576_as-0053316.jpg,3,0,2,0,5,,train
0539577_as-0053316.jpg,8,0,1,0,9,,train
0539578_as-0053316.jpg,4,0,1,1,6,,train
0539580_as-0053316.jpg,7,0,1,0,8,,val
0539581_as-3241833.jpg,1,0,0,0,1,,val
0539584_as-0043031.jpg,1,0,0,1,2,,test
0539585_sc-214248.jpg,1,0,0,1,2,,train
0539586_sc-214248.jpg,3,0,0,0,3,,train
0539587_as-3434183.jpg,0,0,2,0,2,,train
0539588_sc-227307.jpg,4,2,1,0,7,,train
0539589_sc-212235.jpg,2,0,0,0,2,,train
0539590_sc-212235.jpg,2,0,0,0,2,,train
0539591_sc-212235.jpg,5,0,0,0,5,,train
0539592_sc-212235.jpg,8,0,0,0,8,,val
0539596_as-7287220.jpg,1,0,0,0,1,,val
0539597_as-7507159.jpg,1,0,0,1,2,,test
0539598_as-3339933.jpg,4,0,1,1,6,,train
0539599_as-3261595.jpg,2,0,0,0,2,,train
0539601_as-3173373.jpg,0,0,1,0,1,,train
0539602_as-3272766.jpg,1,0,0,0,1,,train
0539603_sc-190982.jpg,1,0,1,0,2,,train
0539604_sc-190982.jpg,0,0,0,1,1,,train
0539605_as-3481029.jpg,3,0,1,0,4,,train
0539607_as-0079320.jpg,1,0,0,0,1,,val
0539609_as-0079320.jpg,5,0,1,0,6,,val
0539610_as-0079320.jpg,2,0,1,0,3,,test
0539611_as-0079320.jpg,1,0,1,0,2,,train
0539612_as-0079320.jpg,1,0,0,0,1,,train
0539613_as-0079320.jpg,1,0,0,0,1,,train
0539614_as-3156631.jpg,1,0,0,0,1,,train
0539615_as-0045376.jpg,1,0,0,1,2,,train
0539616_as-0045376.jpg,1,0,0,0,1,,train
0539617_as-0045376.jpg,1,0,0,0,1,,train
0539618_as-0045376.jpg,1,0,0,0,1,,val
0539619_as-0045376.jpg,1,0,0,0,1,,val
0539620_as-0045376.jpg,1,0,0,0,1,,test
0539621_as-0045376.jpg,1,0,0,0,1,,train
0539622_as-0045376.jpg,1,0,0,1,2,,train
0539623_as-0045376.jpg,1,0,0,0,1,,train
0539624_sc-132437.jpg,0,0,0,1,1,,train
0539625_sc-203766.jpg,3,0,0,0,3,,train
0539626_sc-203766.jpg,1,0,2,0,3,,train
0539629_sc-190035.jpg,1,0,0,0,1,,train
0539630_sc-190035.jpg,3,4,0,0,7,,val
0539633_sc-181748.jpg,4,0,0,1,5,,val
0539634_sc-181748.jpg,3,1,0,0,4,,test
0539635_sc-185257.jpg,2,0,1,0,3,,train
0539636_sc-143025.jpg,1,0,0,0,1,,train
0539637_sc-143025.jpg,3,0,0,0,3,,train
0539638_sc-143025.jpg,1,1,0,0,2,,train
0539639_sc-143025.jpg,1,1,0,0,2,,train
0539640_sc-143025.jpg,3,0,0,0,3,,train
0539641_sc-143025.jpg,1,0,0,0,1,,train
0539642_sc-143025.jpg,1,0,0,0,1,,val
0539643_sc-143025.jpg,2,0,0,0,2,,val
0539644_sc-143025.jpg,1,1,0,0,2,,test
0539645_sc-143025.jpg,1,0,0,0,1,,train
0539646_sc-143025.jpg,1,0,0,0,1,,train
0539649_as-3438899.jpg,1,1,2,1,5,,train
0539650_sc-143088.jpg,1,0,0,0,1,,train
0539651_sc-177033.jpg,3,0,0,0,3,,train
0539652_as-0028747.jpg,1,0,1,0,2,,train
0539653_as-0028747.jpg,0,0,0,1,1,,train
0539654_as-0028747.jpg,2,0,0,1,3,,val
0539655_as-0028747.jpg,1,0,0,1,2,,val
0539656_sc-103761.jpg,2,0,0,0,2,,test
0539657_sc-1024127.jpg,0,0,1,0,1,,train
0539658_sc-1024127.jpg,7,2,0,0,9,,train
0539659_as-7789454.jpg,1,0,0,0,1,,train
0539660_as-0080919.jpg,0,1,0,0,1,,train
0539661_as-0080919.jpg,1,0,0,0,1,,train
0539662_as-0080919.jpg,1,0,0,0,1,,train
0539664_as-0080919.jpg,1,1,0,0,2,,train
0539665_as-0080919.jpg,4,0,0,0,4,,val
0539667_as-2986090.jpg,0,0,1,0,1,,val
0539668_as-0060332.jpg,4,0,1,2,7,,test
0539669_as-0060332.jpg,3,0,1,0,4,,train
0539670_as-0060332.jpg,4,0,2,2,8,,train
0539671_as-0060332.jpg,1,0,0,0,1,,train
0539672_as-2936607.jpg,3,0,1,0,4,,train
0539673_as-0027464.jpg,1,0,0,0,1,,train
0539674_as-0027464.jpg,2,0,0,0,2,,train
0539675_as-0027464.jpg,3,0,0,0,3,,train
0539676_as-0030835.jpg,1,0,1,0,2,,val
0539677_as-0030835.jpg,1,0,1,0,2,,val
0539678_sc-213887.jpg,1,0,0,0,1,,test
0539679_sc-213887.jpg,2,0,0,0,2,,train
0539680_sc-213887.jpg,1,0,0,0,1,,train
0539681_sc-213887.jpg,1,0,0,0,1,,train
0539682_sc-226128.jpg,4,0,0,1,5,,train
0539683_sc-226128.jpg,3,0,0,0,3,,train
0539684_sc-226128.jpg,1,1,0,0,2,,train
0539685_sc-226128.jpg,3,0,0,0,3,,train
0539686_sc-226128.jpg,1,0,0,0,1,,val
0539687_as-2765433.jpg,1,0,0,0,1,,val
0539688_sc-174206.jpg,0,0,1,0,1,,test
0539689_sc-174206.jpg,1,0,0,0,1,,train
0539690_sc-174206.jpg,1,0,0,0,1,,train
0539691_sc-174206.jpg,0,0,1,0,1,,train
0539692_sc-174206.jpg,0,1,1,0,2,,train
0539694_sc-229517.jpg,1,0,1,1,3,,train
0539696_as-0014533.jpg,2,1,1,0,4,,train
0539697_as-0014533.jpg,2,0,0,0,2,,train
0539698_as-0014533.jpg,1,1,1,0,3,,val
0539699_as-0014533.jpg,2,1,1,0,4,,val
0539700_as-0014533.jpg,2,0,1,0,3,,test
0539701_as-0014533.jpg,1,0,0,0,1,,train
0539702_as-0014533.jpg,1,0,0,0,1,,train
0539706_sc-157481.jpg,1,0,0,0,1,,train
0539707_sc-157481.jpg,1,0,0,0,1,,train
0539708_sc-157481.jpg,1,0,0,0,1,,train
0539709_sc-157481.jpg,2,0,0,0,2,,train
0539710_sc-157481.jpg,3,0,0,0,3,,train
0539712_as-0058605.jpg,1,0,0,1,2,,val
0539713_sc-204254.jpg,2,0,0,0,2,,val
0539714_sc-204254.jpg,3,0,0,0,3,,test
0539715_sc-204254.jpg,6,0,1,1,8,,train
0539716_sc-204254.jpg,1,0,0,1,2,,train
0539717_sc-204254.jpg,2,0,0,0,2,,train
0539718_sc-204254.jpg,1,0,0,0,1,,train
0539719_sc-204254.jpg,2,0,0,0,2,,train
0539720_sc-204254.jpg,1,0,0,0,1,,train
0539721_sc-204254.jpg,5,0,0,0,5,,train
0539722_sc-204254.jpg,2,1,0,0,3,,val
0539723_sc-204254.jpg,2,0,0,2,4,,val
0539724_sc-204254.jpg,2,0,0,0,2,,test
0539725_sc-204254.jpg,2,0,1,0,3,,train
0539727_sc-191619.jpg,2,2,1,0,5,,train
0539728_sc-191619.jpg,2,1,1,1,5,,train
0539729_sc-191619.jpg,3,1,1,1,6,,train
0539731_as-2803485.jpg,1,0,0,0,1,,train
0539732_as-2955118.jpg,1,1,0,1,3,,train
0539733_sc-1013430.jpg,1,0,0,0,1,,train
0539734_sc-1013430.jpg,1,0,0,0,1,,val
0539735_sc-1013430.jpg,1,0,0,0,1,,val
0539736_sc-1013430.jpg,1,0,0,0,1,,test
0539737_sc-1013430.jpg,1,0,0,0,1,,train
0539738_as-3088556.jpg,3,0,0,0,3,,train
0539740_as-2993449.jpg,1,0,0,0,1,,train
0539741_as-7768865.jpg,1,0,1,0,2,,train
0539743_sc-108517.jpg,1,0,0,0,1,,train
0539744_sc-108517.jpg,2,1,0,0,3,,train
0539745_sc-108517.jpg,2,1,0,0,3,,train
0539746_sc-108517.jpg,2,0,0,0,2,,val
0539747_sc-221927.jpg,1,0,1,0,2,,val
0539748_as-0015345.jpg,10,0,0,1,11,,test
0539750_as-0015345.jpg,5,0,1,1,7,,train
0539751_as-0015345.jpg,1,0,2,1,4,,train
0539752_sc-1037375.jpg,1,0,0,0,1,,train
0539753_sc-1037375.jpg,2,0,0,0,2,,train
0539754_as-2757515.jpg,5,0,0,0,5,,train
0539757_as-0073449.jpg,0,1,0,0,1,,train
0539758_as-0073449.jpg,2,0,1,0,3,,train
0539759_as-0073449.jpg,3,0,1,0,4,,val
0539760_as-0073449.jpg,1,0,1,0,2,,val
0539761_as-0073449.jpg,0,0,2,0,2,,test
0539762_as-0073449.jpg,1,1,0,1,3,,train
0539763_as-0073449.jpg,2,0,1,0,3,,train
0539765_as-0029619.jpg,1,2,1,0,4,,train
0539766_as-0029619.jpg,1,3,0,0,4,,train
0539767_as-0029619.jpg,1,0,1,0,2,,train
0539768_as-7042978.jpg,1,0,0,0,1,,train
0539769_as-3065689.jpg,2,0,0,0,2,,train
0539771_sc-1038078.jpg,2,0,0,0,2,,val
0539772_sc-1038078.jpg,1,0,0,0,1,,val
0539773_sc-1038078.jpg,3,0,0,0,3,,test
0539774_sc-1038078.jpg,3,0,0,0,3,,train
0539775_sc-1038078.jpg,2,0,0,0,2,,train
0539776_sc-1010171.jpg,5,0,2,0,7,,train
0539777_sc-1021209.jpg,2,2,0,0,4,,train
0539778_sc-1021209.jpg,2,2,0,0,4,,train
0539779_sc-1021209.jpg,0,2,0,0,2,,train
0539780_as-0036135.jpg,2,0,0,1,3,,train
0539781_as-0036135.jpg,2,0,0,0,2,,val
0539782_as-0036135.jpg,2,0,0,1,3,,val
0539783_sc-196235.jpg,2,0,0,0,2,,test
0539785_as-0005514.jpg,0,0,1,0,1,,train
0539786_as-2870016.jpg,1,1,2,1,5,,train
0539787_sc-151737.jpg,1,0,0,0,1,,train
0539788_sc-151737.jpg,4,0,0,1,5,,train
0539791_sc-151737.jpg,2,0,0,1,3,,train
0539792_sc-151737.jpg,1,0,0,1,2,,train
0539794_as-0062006.jpg,8,0,0,0,8,,train
0539797_as-0062006.jpg,5,0,0,0,5,,val
0539798_as-0062006.jpg,1,0,0,0,1,,val
0539799_as-0062006.jpg,2,0,0,0,2,,test
0539802_as-0099756.jpg,0,0,0,1,1,,train
0539803_as-0099756.jpg,0,0,0,1,1,,train
0539804_sc-121171.jpg,4,1,3,0,8,,train
0539806_sc-121171.jpg,5,1,3,0,9,,train
0539807_sc-121171.jpg,4,2,2,0,8,,train
0539808_sc-121171.jpg,8,2,1,0,11,,train
0539809_sc-121171.jpg,4,0,1,0,5,,train
0539810_sc-1038982.jpg,1,0,0,0,1,,val
0539811_sc-1038982.jpg,1,0,0,0,1,,val
0539812_sc-1038982.jpg,2,0,0,0,2,,test
0539813_sc-1038982.jpg,1,0,1,0,2,,train
0539814_sc-187203.jpg,0,0,1,0,1,,train
0539815_sc-187203.jpg,0,0,1,0,1,,train
0539816_sc-187203.jpg,0,0,2,0,2,,train
0539817_sc-187203.jpg,0,0,1,0,1,,train
0539818_sc-187203.jpg,0,0,2,0,2,,train
0539819_sc-187203.jpg,0,0,2,0,2,,train
0539820_sc-187203.jpg,0,0,2,0,2,,val
0539821_as-9048909.jpg,1,0,1,0,2,,val
0539823_as-0043839.jpg,1,0,1,1,3,,test
0539824_as-0043839.jpg,1,0,0,0,1,,train
0539830_as-0041430.jpg,1,1,0,0,2,,train
0539831_as-0041430.jpg,4,1,0,0,5,,train
0539832_as-3299807.jpg,2,0,0,1,3,,train
0539833_as-0031947.jpg,1,0,0,0,1,,train
0539834_as-0031947.jpg,1,3,3,1,8,,train
0539835_as-0031947.jpg,2,0,1,1,4,,train
0539836_as-0031947.jpg,2,0,1,0,3,,val
0539837_as-0031947.jpg,1,2,1,1,5,,val
0539840_as-0031947.jpg,3,0,0,1,4,,test
0539842_as-0005976.jpg,1,0,0,0,1,,train
0539845_as-9081940.jpg,1,0,1,0,2,,train
0539846_sc-1039455.jpg,0,0,0,1,1,,train
0539847_as-2962554.jpg,1,0,0,0,1,,train
0539853_as-0027782.jpg,1,0,0,0,1,,train
0539854_as-0027782.jpg,1,0,0,0,1,,train
0539856_as-0027782.jpg,1,1,1,0,3,,train
0539857_sc-114789.jpg,2,0,0,0,2,,val
0539858_sc-114789.jpg,5,0,0,0,5,,val
0539859_as-9038465.jpg,1,0,0,0,1,,test
0539860_sc-226944.jpg,1,0,1,1,3,,train
0539861_sc-226944.jpg,2,0,0,1,3,,train
0539862_as-0055637.jpg,2,0,0,0,2,,train
0539863_as-0055637.jpg,2,0,0,0,2,,train
0539864_as-3313031.jpg,1,0,0,0,1,,train
0539865_as-7148735.jpg,1,2,1,1,5,,train
0539868_sc-110675.jpg,1,0,0,1,2,,train
0539869_sc-110675.jpg,1,0,0,1,2,,val
0539870_sc-110675.jpg,2,0,0,0,2,,val
0539872_sc-110675.jpg,3,0,0,0,3,,test
0539874_sc-112531.jpg,3,0,0,0,3,,train
0539875_sc-112531.jpg,3,0,0,0,3,,train
0539876_sc-112531.jpg,4,0,0,0,4,,train
0539877_sc-112531.jpg,1,0,0,0,1,,train
0539878_sc-112531.jpg,1,0,0,0,1,,train
0539879_sc-112531.jpg,4,0,0,0,4,,train
0539880_as-2822046.jpg,7,0,1,1,9,,train
0539881_as-2921451.jpg,1,0,2,0,3,,val
0539886_as-0041423.jpg,1,0,0,0,1,,val
0539887_as-0041423.jpg,1,0,0,0,1,,test
0539888_as-0041423.jpg,1,0,0,0,1,,train
0539889_sc-214011.jpg,1,0,0,0,1,,train
0539890_sc-214011.jpg,1,0,0,0,1,,train
0539891_sc-214011.jpg,1,0,0,0,1,,train
0539892_sc-171679.jpg,1,1,0,0,2,,train
0539893_sc-171679.jpg,1,1,0,0,2,,train
0539894_sc-171679.jpg,0,1,0,0,1,,train
0539896_as-2620803.jpg,3,0,0,0,3,,val
0539898_sc-1019184.jpg,4,0,0,0,4,,val
0539899_sc-1019184.jpg,4,0,0,0,4,,test
0539902_as-0023632.jpg,2,0,0,0,2,,train
0539904_as-0023632.jpg,4,0,1,0,5,,train
0539905_as-0023632.jpg,7,0,1,0,8,,train
0539906_as-0023632.jpg,2,0,1,0,3,,train
0539909_as-0080957.jpg,2,0,0,0,2,,train
0539910_as-0080957.jpg,2,3,1,0,6,,train
0539912_as-0080957.jpg,1,0,1,0,2,,train
0539913_as-0080957.jpg,12,1,2,1,16,,val
0539914_as-0080957.jpg,7,5,3,3,18,,val
0539919_as-0059070.jpg,0,3,2,1,6,,test
0539920_as-0059070.jpg,0,3,2,1,6,,train
0539922_as-0067100.jpg,1,0,0,1,2,,train
0539923_as-0067100.jpg,1,0,0,0,1,,train
0539924_as-0067100.jpg,1,0,0,1,2,,train
0539925_as-0094682.jpg,1,1,1,1,4,,train
0539926_as-0094682.jpg,0,1,1,1,3,,train
0539927_as-0094682.jpg,0,0,1,0,1,,train
0539928_as-0094682.jpg,1,0,1,0,2,,val
0539929_as-0094682.jpg,0,0,1,0,1,,val
0539930_sc-217020.jpg,1,0,1,1,3,,test
0539931_sc-217020.jpg,1,0,1,1,3,,train
0539932_sc-217020.jpg,2,5,1,1,9,,train
0539933_sc-1011408.jpg,4,0,0,0,4,,train
0539934_sc-221223.jpg,2,0,1,0,3,,train
0539935_sc-221223.jpg,1,0,0,0,1,,train
0539936_sc-221223.jpg,1,0,0,0,1,,train
0539937_as-0060205.jpg,1,0,0,0,1,,train
0539938_as-0060205.jpg,5,0,0,0,5,,val
0539939_as-0010711.jpg,1,0,0,0,1,,val
0539940_as-0010711.jpg,1,0,0,0,1,,test
0539942_as-0001033.jpg,1,2,1,0,4,,train
0539943_as-0001033.jpg,1,2,0,0,3,,train
0539944_as-0020455.jpg,1,0,0,1,2,,train
0539945_as-0020455.jpg,1,0,0,1,2,,train
0539946_as-0020455.jpg,1,0,0,0,1,,train
0539947_as-0020455.jpg,2,0,0,1,3,,train
0539948_as-3418051.jpg,7,2,2,2,13,,train
0539949_sc-126658.jpg,3,0,0,0,3,,val
0539950_sc-126658.jpg,5,0,0,0,5,,val
0539951_sc-126658.jpg,4,0,0,0,4,,test
0539952_sc-126658.jpg,3,0,0,0,3,,train
0539953_sc-126658.jpg,5,0,0,0,5,,train
0539954_sc-178719.jpg,3,0,0,0,3,,train
0539955_sc-178719.jpg,1,0,0,0,1,,train
0539956_sc-178719.jpg,1,0,0,0,1,,train
0539957_sc-178719.jpg,1,0,0,0,1,,train
0539958_sc-178719.jpg,1,0,0,0,1,,train
0539959_as-2888523.jpg,4,0,1,0,5,,val
0539960_as-3111969.jpg,3,0,1,1,5,,val
0539961_as-7254683.jpg,2,0,0,0,2,,test
0539962_as-2969022.jpg,5,0,1,0,6,,train
0539963_as-0003771.jpg,5,1,0,0,6,,train
0539964_as-0003771.jpg,4,0,1,0,5,,train
0539965_as-0003771.jpg,3,0,0,1,4,,train
0539966_as-2911681.jpg,2,0,0,0,2,,train
0539968_sc-224504.jpg,0,0,1,0,1,,train
0539969_sc-224504.jpg,3,0,1,0,4,,train
0539972_as-2705418.jpg,1,0,0,0,1,,val
0539973_as-0059168.jpg,2,0,0,0,2,,val
0539974_as-0059168.jpg,1,0,0,1,2,,test
0539975_as-0059168.jpg,1,0,0,1,2,,train
0539976_as-0059168.jpg,3,0,0,1,4,,train
0539977_as-0059168.jpg,1,0,0,1,2,,train
0539978_as-0038379.jpg,3,1,0,0,4,,train
0539979_as-0038379.jpg,1,1,0,0,2,,train
0539980_sc-160307.jpg,1,0,0,0,1,,train
0539981_sc-160307.jpg,1,0,0,0,1,,train
0539982_sc-160307.jpg,2,0,0,0,2,,val
0539984_as-0056577.jpg,1,0,0,0,1,,val
0539985_as-0056577.jpg,1,0,0,0,1,,test
0539986_as-0056577.jpg,1,0,0,0,1,,train
0539989_sc-159385.jpg,2,1,1,1,5,,train
0539990_sc-159385.jpg,1,1,1,1,4,,train
0539991_sc-194899.jpg,2,0,0,0,2,,train
0539992_sc-194899.jpg,1,0,0,0,1,,train
0539993_sc-194899.jpg,1,0,0,0,1,,train
0539995_sc-191411.jpg,1,0,0,0,1,,train
0539996_sc-191411.jpg,2,0,1,0,3,,val
0539997_sc-191411.jpg,1,0,1,0,2,,val
0539998_sc-174794.jpg,3,0,0,0,3,,test
0539999_sc-174794.jpg,2,0,0,0,2,,train
0540000_sc-174794.jpg,2,0,0,0,2,,train
0540001_sc-174794.jpg,3,0,0,0,3,,train
0540002_sc-174794.jpg,3,0,1,0,4,,train
0540003_sc-174794.jpg,1,0,0,0,1,,train
0540005_sc-174794.jpg,2,0,0,0,2,,train
0540006_sc-174794.jpg,2,0,0,0,2,,train
0540008_sc-174794.jpg,2,0,0,0,2,,val
0540009_sc-174794.jpg,2,0,0,0,2,,val
0540010_as-0012554.jpg,0,0,0,1,1,,test
0540011_as-0012554.jpg,0,0,0,1,1,,train
0540012_as-0012554.jpg,0,0,0,1,1,,train
0540013_as-0010365.jpg,0,0,0,1,1,,train
0540014_as-0010365.jpg,1,0,0,1,2,,train
0540015_as-7263420.jpg,1,1,0,0,2,,train
0540016_sc-203684.jpg,1,1,0,1,3,,train
0540017_sc-203684.jpg,1,1,0,1,3,,train
0540018_as-7457652.jpg,1,0,1,0,2,,val
0540019_as-3496231.jpg,3,0,0,0,3,,val
0540020_as-0005294.jpg,1,0,0,0,1,,test
0540021_as-0005294.jpg,1,0,0,0,1,,train
0540022_as-0005294.jpg,1,0,0,0,1,,train
0540023_as-2882060.jpg,0,0,0,1,1,,train
0540024_sc-208195.jpg,0,1,0,0,1,,train
0540027_as-0081469.jpg,2,0,3,1,6,,train
0540028_as-0081469.jpg,2,0,2,1,5,,train
0540030_sc-198177.jpg,4,0,0,1,5,,train
0540031_sc-198177.jpg,6,0,0,0,6,,val
0540032_sc-181389.jpg,2,1,0,1,4,,val
0540034_sc-199432.jpg,0,0,0,1,1,,test
0540035_sc-199432.jpg,1,0,0,0,1,,train
0540036_as-3149306.jpg,1,0,1,0,2,,train
0540037_as-0045078.jpg,2,0,1,0,3,,train
0540038_sc-156762.jpg,3,0,1,1,5,,train
0540039_sc-156762.jpg,0,0,1,0,1,,train
0540040_sc-156762.jpg,0,0,1,0,1,,train
0540041_sc-156762.jpg,0,0,1,0,1,,train
0540042_sc-156762.jpg,1,0,0,0,1,,val
0540043_sc-156762.jpg,1,0,0,0,1,,val
0540044_sc-156762.jpg,5,0,1,1,7,,test
0540045_sc-156762.jpg,3,0,0,1,4,,train
0540046_sc-156762.jpg,5,0,1,1,7,,train
0540047_sc-228222.jpg,1,0,1,1,3,,train
0540048_sc-228222.jpg,1,0,0,0,1,,train
0540049_as-0088146.jpg,0,0,0,1,1,,train
0540050_as-0088146.jpg,4,0,0,2,6,,train
0540051_as-0056141.jpg,1,0,1,1,3,,train
0540052_as-0056141.jpg,1,0,0,1,2,,val
0540053_as-0056141.jpg,1,0,1,1,3,,val
0540054_as-0056141.jpg,1,0,1,1,3,,test
0540057_sc-107043.jpg,1,0,0,0,1,,train
0540058_as-3065026.jpg,3,0,0,1,4,,train
0540059_sc-141003.jpg,1,1,0,1,3,,train
0540060_sc-141003.jpg,3,0,0,1,4,,train
0540061_sc-141003.jpg,1,0,0,1,2,,train
0540062_as-3317501.jpg,2,3,2,2,9,,train
0540063_sc-181047.jpg,3,1,1,2,7,,train
0540064_sc-181047.jpg,1,2,1,1,5,,val
0540065_as-7796117.jpg,2,0,0,0,2,,val
0540066_sc-206228.jpg,4,0,1,1,6,,test
0540067_sc-206228.jpg,7,0,2,1,10,,train
0540068_sc-206228.jpg,7,0,2,1,10,,train
0540069_sc-206228.jpg,3,0,1,0,4,,train
0540070_sc-206228.jpg,2,0,1,1,4,,train
0540071_sc-1004830.jpg,7,0,0,0,7,,train
0540072_sc-1004830.jpg,2,0,0,0,2,,train
0540073_sc-1004830.jpg,2,0,0,0,2,,train
0540074_sc-222181.jpg,2,0,1,0,3,,val
0540075_sc-222181.jpg,1,0,0,0,1,,val
0540076_as-0023933.jpg,2,0,0,0,2,,test
0540077_as-0023933.jpg,1,0,0,0,1,,train
0540078_as-3061203.jpg,1,1,0,1,3,,train
0540079_as-3070114.jpg,3,0,0,1,4,,train
0540082_sc-108474.jpg,2,1,2,3,8,,train
0540084_sc-185124.jpg,0,0,1,0,1,,train
0540085_sc-185124.jpg,0,0,1,0,1,,train
0540086_sc-211169.jpg,2,0,0,0,2,,train
0540088_as-0038471.jpg,1,0,0,1,2,,val
0540089_as-0038471.jpg,1,0,3,1,5,,val
0540091_as-0038471.jpg,1,1,2,1,5,,test
0540092_as-0038471.jpg,1,1,1,0,3,,train
0540094_as-0047882.jpg,2,0,0,0,2,,train
0540095_as-0047882.jpg,2,0,0,0,2,,train
0540096_as-0047882.jpg,2,0,0,0,2,,train
0540097_as-0047882.jpg,3,0,0,1,4,,train
0540098_as-0047882.jpg,0,0,0,1,1,,train
0540099_as-0047882.jpg,2,0,0,1,3,,train
0540100_as-0047882.jpg,1,0,0,0,1,,val
0540101_as-0047882.jpg,4,0,0,1,5,,val
0540102_as-0047882.jpg,4,0,0,1,5,,test
0540103_as-0047882.jpg,2,0,0,1,3,,train
0540105_as-0047882.jpg,2,0,0,0,2,,train
0540106_as-0047882.jpg,2,0,0,0,2,,train
0540107_as-0047882.jpg,2,0,0,0,2,,train
0540108_as-0047882.jpg,1,0,0,0,1,,train
0540111_sc-127551.jpg,0,0,1,0,1,,train
0540112_sc-127551.jpg,0,0,1,0,1,,train
0540114_sc-127551.jpg,0,0,1,0,1,,val
0540115_sc-127551.jpg,0,0,1,0,1,,val
0540116_as-2768570.jpg,1,0,0,0,1,,test
0540117_as-0055377.jpg,1,0,0,0,1,,train
0540118_as-0055377.jpg,1,0,0,0,1,,train
0540119_as-0055377.jpg,2,0,0,0,2,,train
0540120_as-0055377.jpg,2,0,0,0,2,,train
0540121_as-0055377.jpg,3,0,0,0,3,,train
0540123_as-0039808.jpg,1,0,0,2,3,,train
0540127_as-0039808.jpg,1,0,0,0,1,,train
0540128_as-0039808.jpg,3,0,0,0,3,,val
0540130_as-0001137.jpg,1,0,0,0,1,,val
0540131_as-0001137.jpg,1,0,0,0,1,,test
0540132_as-0001137.jpg,0,0,1,0,1,,train
0540133_as-9069079.jpg,1,0,0,0,1,,train
0540134_as-3199178.jpg,1,0,0,0,1,,train
0540136_sc-215626.jpg,1,0,0,0,1,,train
0540137_sc-215626.jpg,8,0,0,0,8,,train
0540138_sc-127797.jpg,1,0,0,0,1,,train
0540139_sc-127797.jpg,1,0,0,1,2,,train
0540140_sc-1015598.jpg,3,0,0,0,3,,val
0540141_as-2658385.jpg,1,1,0,1,3,,val
0540142_as-3468610.jpg,1,0,0,1,2,,test
0540143_as-0056216.jpg,1,0,0,0,1,,train
0540144_as-0056216.jpg,1,0,0,0,1,,train
0540145_as-0056216.jpg,1,0,0,0,1,,train
0540146_sc-1006315.jpg,0,1,0,0,1,,train
0540147_sc-1006315.jpg,1,0,0,0,1,,train
0540148_as-0070460.jpg,1,0,0,0,1,,train
0540149_as-0070460.jpg,1,0,0,0,1,,train
0540150_as-0070460.jpg,1,0,0,0,1,,val
0540152_sc-117305.jpg,0,1,0,0,1,,val
0540153_sc-117305.jpg,0,1,0,0,1,,test
0540155_sc-188881.jpg,1,0,0,0,1,,train
0540156_as-7577371.jpg,4,0,1,1,6,,train
0540157_as-2663662.jpg,2,0,0,0,2,,train
0540158_as-2673754.jpg,1,0,0,0,1,,train
0540160_sc-1019102.jpg,5,0,0,0,5,,train
0540162_sc-1019102.jpg,2,0,0,0,2,,train
0540163_sc-155679.jpg,4,0,0,0,4,,train
0540164_sc-155679.jpg,4,0,0,0,4,,val
0540165_sc-155679.jpg,4,0,0,0,4,,val
0540166_sc-155679.jpg,3,0,1,0,4,,test
0540167_sc-155679.jpg,6,0,0,0,6,,train
0540168_sc-155679.jpg,6,0,0,0,6,,train
0540169_as-0044285.jpg,2,0,2,0,4,,train
0540171_as-0051005.jpg,6,0,1,0,7,,train
0540173_as-0051005.jpg,5,0,1,0,6,,train
0540174_as-0051005.jpg,1,0,0,0,1,,train
0540175_as-0051005.jpg,3,0,0,0,3,,train
0540176_as-0051005.jpg,3,0,0,0,3,,val
0540177_as-0051005.jpg,2,0,0,0,2,,val
0540179_as-0051005.jpg,1,0,0,0,1,,test
0540181_as-3429959.jpg,2,0,0,0,2,,train
0540183_sc-1038495.jpg,1,0,0,0,1,,train
0540185_sc-1038495.jpg,1,0,0,0,1,,train
0540186_sc-1038495.jpg,1,0,0,0,1,,train
0540187_sc-105234.jpg,0,1,0,0,1,,train
0540188_sc-105234.jpg,0,1,0,0,1,,train
0540194_as-0059909.jpg,3,1,2,0,6,,train
0540195_as-0059909.jpg,2,2,1,0,5,,val
0540196_as-0059909.jpg,1,3,1,0,5,,val
0540197_as-0059909.jpg,2,3,2,0,7,,test
0540198_as-0059909.jpg,0,1,2,0,3,,train
0540199_as-0059909.jpg,1,0,0,0,1,,train
0540200_as-5115229.jpg,1,0,0,0,1,,train
0540201_sc-154378.jpg,4,0,0,1,5,,train
0540202_sc-154378.jpg,4,0,0,1,5,,train
0540203_sc-154378.jpg,3,0,0,1,4,,train
0540204_as-2890906.jpg,1,0,2,1,4,,train
0540207_as-0086483.jpg,1,1,1,0,3,,val
0540208_as-3089487.jpg,2,0,0,0,2,,val
0540209_sc-1006732.jpg,1,0,0,1,2,,test
0540210_as-3051592.jpg,1,0,1,1,3,,train
0540212_as-0065163.jpg,5,0,2,1,8,,train
0540213_as-0065163.jpg,5,0,1,1,7,,train
0540214_as-0065163.jpg,5,0,1,0,6,,train
0540220_as-0065163.jpg,5,0,0,0,5,,train
0540227_as-0038439.jpg,2,3,0,0,5,,train
0540228_as-0038439.jpg,5,1,0,0,6,,train
0540229_as-0038439.jpg,2,0,1,0,3,,val
0540230_as-0038439.jpg,3,0,1,1,5,,val
0540231_as-0038439.jpg,2,0,1,1,4,,test
0540232_as-0038439.jpg,1,0,1,1,3,,train
0540233_as-0038439.jpg,4,0,0,0,4,,train
0540234_as-0038439.jpg,1,0,0,0,1,,train
0540235_sc-135479.jpg,0,0,0,1,1,,train
0540236_sc-152359.jpg,1,0,0,0,1,,train
0540237_sc-152359.jpg,1,0,0,0,1,,train
0540238_sc-152359.jpg,1,0,0,1,2,,train
0540242_sc-201420.jpg,4,0,1,0,5,,val
0540245_as-0050570.jpg,0,0,1,0,1,,val
0540246_as-0050570.jpg,0,0,1,0,1,,test
0540248_as-0050570.jpg,3,0,0,0,3,,train
0540249_as-0050570.jpg,3,0,0,0,3,,train
0540250_as-0050570.jpg,4,0,0,0,4,,train
0540251_as-0050570.jpg,2,0,0,0,2,,train
0540252_as-0050570.jpg,3,0,0,0,3,,train
0540253_as-0050570.jpg,3,0,0,0,3,,train
0540254_as-0050570.jpg,7,0,0,0,7,,train
0540255_as-0050570.jpg,4,0,0,0,4,,val
0540256_as-0050570.jpg,1,0,0,0,1,,val
0540257_as-0050570.jpg,5,0,0,0,5,,test
0540258_as-3116818.jpg,1,0,0,0,1,,train
0540259_as-0039351.jpg,7,0,0,0,7,,train
0540260_sc-120238.jpg,1,0,0,1,2,,train
0540261_sc-120238.jpg,1,0,0,1,2,,train
0540263_sc-120238.jpg,1,0,0,0,1,,train
0540264_sc-120238.jpg,2,0,0,0,2,,train
0540265_sc-120238.jpg,1,0,0,0,1,,train
0540266_sc-120238.jpg,2,0,1,0,3,,val
0540267_sc-120238.jpg,1,0,0,0,1,,val
0540268_sc-120238.jpg,2,0,1,0,3,,test
0540269_sc-120238.jpg,1,0,0,0,1,,train
0540270_sc-1026846.jpg,1,0,0,1,2,,train
0540271_sc-1026846.jpg,1,0,0,1,2,,train
0540272_as-0012843.jpg,2,0,0,0,2,,train
0540273_as-0012843.jpg,2,0,0,0,2,,train
0540274_as-0012843.jpg,1,0,0,0,1,,train
0540275_as-0012843.jpg,3,0,0,0,3,,train
0540276_as-0023120.jpg,1,0,0,0,1,,val
0540277_as-3352968.jpg,1,0,0,0,1,,val
0540278_sc-169253.jpg,1,1,0,0,2,,test
0540279_sc-169253.jpg,4,0,0,0,4,,train
0540280_sc-169253.jpg,3,1,0,1,5,,train
0540281_sc-1025726.jpg,3,0,0,1,4,,train
0540282_sc-1025726.jpg,1,0,0,0,1,,train
0540283_sc-1025726.jpg,1,1,0,1,3,,train
0540284_sc-1025726.jpg,1,0,1,2,4,,train
0540285_sc-1025726.jpg,1,0,0,0,1,,train
0540286_sc-1025726.jpg,1,0,0,0,1,,val
0540287_sc-1025726.jpg,1,0,1,1,3,,val
0540288_sc-1025726.jpg,1,0,1,2,4,,test
0540289_sc-1023082.jpg,6,0,1,0,7,,train
0540291_sc-1023082.jpg,2,0,0,0,2,,train
0540292_sc-1023082.jpg,4,0,1,0,5,,train
0540293_as-3386731.jpg,1,0,1,0,2,,train
0540295_as-2779865.jpg,5,0,1,0,6,,train
0540296_as-0025647.jpg,2,0,0,0,2,,train
0540297_as-7868582.jpg,0,0,0,1,1,,train
0540298_as-3450856.jpg,1,1,0,0,2,,val
0540300_as-0063581.jpg,1,0,0,0,1,,val
0540301_as-0063581.jpg,1,0,0,0,1,,test
0540302_sc-128141.jpg,3,0,0,1,4,,train
0540303_sc-128141.jpg,1,0,0,0,1,,train
0540304_sc-128141.jpg,1,0,0,0,1,,train
0540305_sc-1037888.jpg,3,0,0,0,3,,train
0540306_sc-1037888.jpg,2,0,0,0,2,,train
0540309_as-0076538.jpg,4,1,0,0,5,,train
0540310_as-7954741.jpg,2,0,0,0,2,,train
0540311_sc-219334.jpg,6,0,1,1,8,,val
0540312_as-7931359.jpg,1,0,1,0,2,,val
0540313_as-3431267.jpg,2,0,0,2,4,,test
0540315_as-0026021.jpg,1,1,0,1,3,,train
0540316_as-0026021.jpg,1,1,0,0,2,,train
0540317_sc-213878.jpg,3,1,1,0,5,,train
0540318_sc-127624.jpg,3,0,0,0,3,,train
0540319_sc-127624.jpg,1,0,0,0,1,,train
0540320_sc-127624.jpg,2,0,0,0,2,,train
0540321_sc-127624.jpg,5,0,0,0,5,,train
0540322_sc-127624.jpg,1,0,0,0,1,,val
0540323_sc-127624.jpg,1,0,0,0,1,,val
0540324_sc-127624.jpg,1,3,0,0,4,,test
0540326_as-2641584.jpg,2,0,0,0,2,,train
0540327_as-7124788.jpg,2,0,1,0,3,,train
0540328_as-2604497.jpg,1,0,0,0,1,,train
0540329_as-7063277.jpg,3,0,0,0,3,,train
0540330_sc-1017121.jpg,3,0,0,0,3,,train
0540331_sc-1017121.jpg,3,0,3,0,6,,train
0540332_as-0029711.jpg,2,0,0,0,2,,train
0540333_as-0029711.jpg,2,0,0,0,2,,val
0540335_sc-1035368.jpg,0,1,0,0,1,,val
0540336_sc-1035368.jpg,2,0,1,0,3,,test
0540337_sc-212320.jpg,0,0,1,0,1,,train
0540338_sc-212320.jpg,1,0,1,1,3,,train
0540339_sc-212320.jpg,1,0,1,0,2,,train
0540340_sc-212320.jpg,1,0,1,1,3,,train
0540341_as-7680029.jpg,1,0,0,1,2,,train
0540342_as-9077513.jpg,2,0,0,0,2,,train
0540343_as-2801564.jpg,1,0,0,0,1,,train
0540344_sc-143285.jpg,1,1,0,0,2,,val
0540345_sc-143285.jpg,3,0,0,0,3,,val
0540346_sc-143285.jpg,1,1,0,0,2,,test
0540347_sc-143285.jpg,1,0,0,0,1,,train
0540349_sc-146909.jpg,1,0,0,0,1,,train
0540352_as-0088648.jpg,3,0,0,0,3,,train
0540353_as-0088648.jpg,3,0,0,0,3,,train
0540354_as-0088648.jpg,1,0,0,0,1,,train
0540355_as-0088648.jpg,1,0,0,0,1,,train
0540356_as-0088648.jpg,1,0,0,0,1,,train
0540357_as-0088648.jpg,1,0,0,0,1,,val
0540358_as-0088648.jpg,1,0,0,0,1,,val
0540359_as-0088648.jpg,2,0,0,0,2,,test
0540360_as-0088648.jpg,2,0,0,0,2,,train
0540362_as-0088648.jpg,3,0,0,0,3,,train
0540363_as-0088648.jpg,3,0,0,0,3,,train
0540364_as-0088648.jpg,2,0,1,0,3,,train
0540365_as-0088648.jpg,3,0,0,0,3,,train
0540366_as-3349412.jpg,1,0,1,0,2,,train
0540367_sc-171249.jpg,1,0,0,0,1,,train
0540368_sc-155674.jpg,2,0,0,1,3,,val
0540369_sc-155674.jpg,1,0,0,1,2,,val
0540372_as-0028145.jpg,1,0,1,0,2,,test
0540373_as-0028145.jpg,3,0,1,0,4,,train
0540374_as-3138003.jpg,2,0,0,0,2,,train
0540375_sc-209292.jpg,4,0,0,0,4,,train
0540377_sc-209292.jpg,3,0,0,0,3,,train
0540378_sc-209292.jpg,2,0,0,0,2,,train
0540380_as-0058032.jpg,3,0,1,0,4,,train
0540381_as-0058032.jpg,0,1,0,0,1,,train
0540383_as-0058032.jpg,1,1,0,0,2,,val
0540384_as-0058032.jpg,7,0,0,0,7,,val
0540385_sc-146292.jpg,7,0,0,0,7,,test
0540386_sc-146292.jpg,4,0,1,1,6,,train
0540387_sc-146292.jpg,5,0,0,0,5,,train
0540388_sc-146292.jpg,0,0,1,1,2,,train
0540389_sc-146292.jpg,6,0,1,1,8,,train
0540392_as-0045514.jpg,1,0,0,0,1,,train
0540393_as-0045514.jpg,1,0,0,0,1,,train
0540394_as-0045514.jpg,1,0,0,0,1,,train
0540396_sc-173264.jpg,2,0,0,0,2,,val
0540397_sc-1021230.jpg,2,0,0,1,3,,val
0540398_sc-1021230.jpg,4,0,0,1,5,,test
0540399_sc-1021230.jpg,3,3,0,1,7,,train
0540400_sc-1021230.jpg,3,2,0,1,6,,train
0540402_sc-1021230.jpg,1,0,0,1,2,,train
0540404_sc-119586.jpg,0,1,0,0,1,,train
0540406_as-2595806.jpg,0,0,1,0,1,,train
0540407_as-3296386.jpg,4,0,0,1,5,,train
0540408_as-3253661.jpg,1,1,0,1,3,,train
0540409_sc-137068.jpg,1,0,0,0,1,,val
0540410_sc-137068.jpg,1,0,0,0,1,,val
0540411_sc-147733.jpg,2,1,0,0,3,,test
0540413_sc-147733.jpg,2,1,0,0,3,,train
0540414_sc-147733.jpg,1,1,0,0,2,,train
0540415_as-3360132.jpg,1,0,0,0,1,,train
0540416_sc-192204.jpg,13,0,0,1,14,,train
0540418_as-0063095.jpg,1,0,0,0,1,,train
0540420_as-2919088.jpg,1,0,0,0,1,,train
0540421_as-2919088.jpg,2,1,1,1,5,,train
0540422_sc-173575.jpg,0,1,0,0,1,,val
0540423_as-3372256.jpg,0,0,1,0,1,,val
0540424_as-0064988.jpg,1,0,0,0,1,,test
0540425_as-0064988.jpg,1,0,0,0,1,,train
0540426_as-0064988.jpg,2,0,0,0,2,,train
0540427_as-0064988.jpg,1,0,0,0,1,,train
0540428_as-0064988.jpg,4,0,0,0,4,,train
0540429_as-0064988.jpg,2,0,0,0,2,,train
0540430_as-0064988.jpg,1,0,0,0,1,,train
0540431_as-0064988.jpg,2,0,0,0,2,,train
0540433_as-0045177.jpg,4,0,0,0,4,,val
0540434_as-3190250.jpg,6,0,1,0,7,,val
0540436_sc-105460.jpg,2,1,1,1,5,,test
0540437_sc-105460.jpg,1,1,0,0,2,,train
0540439_sc-112033.jpg,1,1,0,0,2,,train
0540440_sc-112033.jpg,2,1,0,0,3,,train
0540441_sc-112033.jpg,5,0,0,1,6,,train
0540442_sc-112033.jpg,5,1,0,0,6,,train
0540443_sc-112033.jpg,2,1,0,0,3,,train
0540444_sc-112033.jpg,5,0,0,0,5,,train
0540445_as-0065813.jpg,3,0,0,0,3,,val
0540446_as-0065813.jpg,3,0,0,0,3,,val
0540447_as-0065813.jpg,3,0,0,0,3,,test
0540448_as-0065813.jpg,2,0,0,0,2,,train
0540449_as-0065813.jpg,2,0,0,0,2,,train
0540450_as-3247256.jpg,1,0,0,0,1,,train
0540451_as-3247256.jpg,1,0,0,0,1,,train
0540452_as-3397074.jpg,1,0,0,0,1,,train
0540453_sc-1010506.jpg,2,1,1,0,4,,train
0540454_sc-1010506.jpg,2,1,1,0,4,,train
0540455_sc-1010506.jpg,0,0,1,0,1,,val
0540456_sc-1010506.jpg,0,0,1,0,1,,val
0540457_as-3099469.jpg,2,3,0,0,5,,test
0540458_sc-1015340.jpg,3,1,1,0,5,,train
0540459_sc-1015340.jpg,3,2,1,0,6,,train
0540460_sc-1015340.jpg,0,0,2,0,2,,train
0540461_sc-113698.jpg,1,0,1,1,3,,train
0540462_sc-113698.jpg,1,0,0,1,2,,train
0540463_sc-113698.jpg,1,0,0,1,2,,train
0540465_sc-199055.jpg,0,0,0,1,1,,train
0540466_sc-199055.jpg,1,0,0,1,2,,val
0540467_sc-199055.jpg,2,0,0,1,3,,val
0540470_as-0048460.jpg,5,3,2,0,10,,test
0540471_as-0048460.jpg,5,0,1,0,6,,train
0540472_as-0048460.jpg,7,0,3,0,10,,train
0540473_as-0048460.jpg,3,0,1,0,4,,train
0540474_as-0048460.jpg,4,3,2,0,9,,train
0540475_as-0031929.jpg,1,0,0,0,1,,train
0540476_as-0031929.jpg,1,0,0,0,1,,train
0540478_sc-215422.jpg,1,0,1,0,2,,train
0540479_sc-215422.jpg,1,0,1,0,2,,val
0540480_as-7229320.jpg,1,0,0,0,1,,val
0540482_as-0064835.jpg,1,1,2,0,4,,test
0540483_as-0064835.jpg,2,1,2,0,5,,train
0540484_as-0064835.jpg,2,1,2,0,5,,train
0540485_as-0064835.jpg,5,0,0,0,5,,train
0540488_as-0046788.jpg,1,0,0,0,1,,train
0540489_sc-185049.jpg,3,0,0,1,4,,train
0540490_sc-185049.jpg,3,0,0,1,4,,train
0540491_as-3308559.jpg,2,0,1,0,3,,train
0540492_sc-137971.jpg,8,1,0,0,9,,val
0540493_as-2770526.jpg,2,0,0,0,2,,val
0540494_as-3282537.jpg,3,1,0,0,4,,test
0540495_as-3415973.jpg,1,1,1,0,3,,train
0540498_as-3224767.jpg,2,0,0,0,2,,train
0540499_sc-213596.jpg,1,1,0,0,2,,train
0540500_sc-213596.jpg,8,1,1,2,12,,train
0540501_sc-213596.jpg,15,3,2,1,21,,train
0540502_sc-213596.jpg,2,0,1,0,3,,train
0540503_sc-213596.jpg,2,0,1,1,4,,train
0540504_sc-213596.jpg,6,1,0,0,7,,val
0540506_as-0072710.jpg,2,2,2,0,6,,val
0540507_as-0072710.jpg,0,0,1,0,1,,test
0540508_as-0072710.jpg,5,2,0,1,8,,train
0540509_as-2597467.jpg,2,0,0,0,2,,train
0540510_as-2583028.jpg,1,0,0,0,1,,train
0540511_as-2711108.jpg,1,0,0,0,1,,train
0540512_sc-133649.jpg,0,2,0,0,2,,train
0540514_sc-133649.jpg,0,2,1,0,3,,train
0540516_sc-133649.jpg,0,1,1,0,2,,train
0540517_sc-133649.jpg,0,1,1,0,2,,val
0540521_sc-1039764.jpg,1,0,1,1,3,,val
0540522_as-0085516.jpg,0,0,1,0,1,,test
0540523_as-0085516.jpg,0,0,1,0,1,,train
0540524_as-0020104.jpg,4,0,0,0,4,,train
0540525_as-0020104.jpg,1,0,0,0,1,,train
0540527_as-0020104.jpg,2,0,0,0,2,,train
0540528_as-3320074.jpg,2,0,1,0,3,,train
0540529_as-2599776.jpg,0,0,1,0,1,,train
0540530_as-2624284.jpg,5,0,1,0,6,,train
0540533_sc-111232.jpg,1,1,2,0,4,,val
0540534_sc-111232.jpg,1,0,0,0,1,,val
0540535_as-3127364.jpg,1,1,1,2,5,,test
0540536_sc-179711.jpg,2,0,0,0,2,,train
0540538_sc-179711.jpg,1,0,0,0,1,,train
0540539_as-3398987.jpg,2,1,1,1,5,,train
0540540_sc-205622.jpg,1,0,0,0,1,,train
0540541_sc-205622.jpg,1,0,0,0,1,,train
0540542_sc-205622.jpg,2,0,0,0,2,,train
0540543_sc-169836.jpg,11,1,5,0,17,,train
0540544_sc-169836.jpg,15,1,2,0,18,,val
0540545_sc-1008921.jpg,3,0,0,1,4,,val
0540546_sc-1008921.jpg,0,0,1,0,1,,test
0540547_sc-1008921.jpg,1,1,1,1,4,,train
0540548_as-0023820.jpg,2,0,0,0,2,,train
0540549_as-0086540.jpg,4,0,0,0,4,,train
0540550_as-0086540.jpg,5,0,0,0,5,,train
0540552_sc-1016480.jpg,3,0,1,1,5,,train
0540554_as-0027589.jpg,2,0,1,0,3,,train
0540555_as-0027589.jpg,2,0,1,0,3,,train
0540557_as-0057759.jpg,1,0,1,1,3,,val
0540558_as-2571504.jpg,1,0,0,0,1,,val
0540559_sc-191792.jpg,2,1,0,0,3,,test
0540560_sc-191792.jpg,1,0,0,0,1,,train
0540562_sc-191792.jpg,2,1,1,0,4,,train
0540563_sc-191792.jpg,1,1,0,0,2,,train
0540564_sc-191792.jpg,1,1,1,0,3,,train
0540565_sc-191792.jpg,2,1,0,0,3,,train
0540566_sc-191792.jpg,1,0,0,0,1,,train
0540567_sc-191792.jpg,2,0,0,1,3,,train
0540568_sc-191792.jpg,1,0,1,1,3,,val
0540569_sc-191792.jpg,0,1,0,0,1,,val
0540570_as-7231111.jpg,2,0,0,0,2,,test
0540571_sc-1001266.jpg,2,0,1,1,4,,train
0540572_sc-1001266.jpg,2,0,1,1,4,,train
0540573_sc-1001266.jpg,0,0,1,1,2,,train
0540575_sc-105355.jpg,1,0,0,0,1,,train
0540577_sc-105355.jpg,1,0,1,0,2,,train
0540578_sc-202864.jpg,3,0,1,1,5,,train
0540579_sc-202864.jpg,3,0,1,1,5,,train
0540580_sc-202864.jpg,5,0,1,1,7,,val
0540581_sc-202864.jpg,4,0,1,1,6,,val
0540582_as-7144228.jpg,0,0,1,0,1,,test
0540583_as-0061939.jpg,0,0,1,0,1,,train
0540584_sc-170913.jpg,5,0,0,3,8,,train
0540585_sc-170913.jpg,4,0,0,2,6,,train
0540586_sc-170913.jpg,2,0,0,1,3,,train
0540588_as-0050838.jpg,2,0,0,0,2,,train
0540589_as-0050838.jpg,1,0,0,0,1,,train
0540590_as-0050838.jpg,2,0,0,0,2,,train
0540591_sc-104606.jpg,1,0,1,0,2,,val
0540592_sc-104606.jpg,1,0,1,0,2,,val
0540593_sc-104606.jpg,2,0,1,0,3,,test
0540594_sc-104606.jpg,1,0,0,0,1,,train
0540595_sc-104606.jpg,2,0,0,0,2,,train
0540596_sc-104606.jpg,2,0,0,0,2,,train
0540597_sc-104606.jpg,1,0,0,0,1,,train
0540598_sc-104606.jpg,1,0,0,1,2,,train
0540599_sc-104606.jpg,2,0,0,1,3,,train
0540600_sc-104606.jpg,2,0,0,1,3,,train
0540604_sc-129639.jpg,2,1,1,0,4,,val
0540605_sc-129639.jpg,3,1,0,0,4,,val
0540606_sc-129639.jpg,1,2,0,0,3,,test
0540607_as-7619109.jpg,1,0,0,0,1,,train
0540608_sc-1030460.jpg,1,0,1,0,2,,train
0540609_sc-161657.jpg,2,0,0,1,3,,train
0540611_sc-161657.jpg,3,0,0,1,4,,train
0540612_sc-161657.jpg,1,0,0,1,2,,train
0540613_as-7575728.jpg,2,1,0,0,3,,train
0540614_as-7218017.jpg,2,2,0,1,5,,train
0540615_as-0029464.jpg,3,0,0,0,3,,val
0540616_as-0029464.jpg,2,0,0,0,2,,val
0540617_as-0001190.jpg,3,0,0,0,3,,test
0540618_as-0001190.jpg,3,0,0,0,3,,train
0540619_as-2805237.jpg,2,2,0,1,5,,train
0540622_sc-138899.jpg,3,1,1,1,6,,train
0540623_sc-138899.jpg,2,1,1,1,5,,train
0540624_sc-138899.jpg,2,1,1,1,5,,train
0540625_sc-133190.jpg,2,0,1,0,3,,train
0540626_sc-133190.jpg,1,0,1,0,2,,train
0540627_sc-133190.jpg,3,0,0,0,3,,val
0540628_sc-133190.jpg,2,0,1,0,3,,val
0540629_sc-133190.jpg,1,0,0,0,1,,test
0540630_sc-159050.jpg,1,0,0,0,1,,train
0540631_sc-159050.jpg,1,0,0,0,1,,train
0540632_sc-159050.jpg,1,0,0,0,1,,train
0540633_sc-182545.jpg,1,0,0,0,1,,train
0540634_sc-182545.jpg,8,0,1,0,9,,train
0540635_sc-182545.jpg,7,0,1,0,8,,train
0540636_sc-182545.jpg,7,0,1,0,8,,train
0540637_sc-182545.jpg,5,0,1,0,6,,val
0540639_sc-182545.jpg,9,0,0,1,10,,val
0540640_sc-182545.jpg,8,0,0,1,9,,test
0540642_sc-1031428.jpg,2,0,2,0,4,,train
0540643_sc-1031428.jpg,1,0,1,0,2,,train
0540644_sc-1031428.jpg,3,1,1,1,6,,train
0540645_sc-1031428.jpg,2,1,1,3,7,,train
0540646_sc-1031428.jpg,3,0,1,0,4,,train
0540647_as-7831927.jpg,0,1,0,0,1,,train
0540648_sc-1036208.jpg,2,0,0,1,3,,train
0540649_sc-1036208.jpg,1,0,0,0,1,,val
0540650_as-2898396.jpg,0,0,1,0,1,,val
0540651_sc-156258.jpg,1,0,0,0,1,,test
0540652_sc-156258.jpg,1,0,1,0,2,,train
0540654_sc-199596.jpg,1,0,0,0,1,,train
0540655_sc-199596.jpg,1,0,0,0,1,,train
0540656_sc-199596.jpg,1,0,0,0,1,,train
0540657_sc-199596.jpg,1,0,0,0,1,,train
0540658_sc-199596.jpg,1,0,0,0,1,,train
0540659_as-0031504.jpg,2,0,0,0,2,,train
0540660_as-0031504.jpg,0,2,1,0,3,,val
0540662_sc-130510.jpg,0,1,0,0,1,,val
0540664_sc-191585.jpg,4,0,1,1,6,,test
0540667_as-0008828.jpg,2,0,0,0,2,,train
0540668_as-0008828.jpg,1,0,1,0,2,,train
0540669_as-0008828.jpg,1,0,0,0,1,,train
0540670_as-0008828.jpg,1,0,0,0,1,,train
0540672_as-0095830.jpg,1,0,0,0,1,,train
0540673_as-0095830.jpg,1,0,0,0,1,,train
0540674_as-0052432.jpg,1,0,1,0,2,,train
0540675_as-0052432.jpg,3,0,0,0,3,,val
0540676_as-0052432.jpg,2,1,0,0,3,,val
0540677_as-0070784.jpg,1,1,2,1,5,,test
0540678_as-0070784.jpg,2,0,2,1,5,,train
0540679_as-0070784.jpg,2,0,2,0,4,,train
0540680_as-0070784.jpg,2,1,1,0,4,,train
0540681_as-0070784.jpg,3,3,1,0,7,,train
0540682_sc-229461.jpg,2,0,0,1,3,,train
0540684_sc-134129.jpg,0,0,1,0,1,,train
0540685_sc-134129.jpg,0,0,1,0,1,,train
0540686_sc-164239.jpg,1,0,0,0,1,,val
0540687_sc-164239.jpg,1,0,0,0,1,,val
0540688_sc-164239.jpg,1,0,0,0,1,,test
0540690_sc-227370.jpg,3,2,0,1,6,,train
0540691_sc-227370.jpg,0,0,2,0,2,,train
0540692_sc-227370.jpg,1,0,0,1,2,,train
0540696_sc-225256.jpg,0,1,0,0,1,,train
0540697_sc-225256.jpg,0,1,0,0,1,,train
0540698_sc-225256.jpg,0,1,0,0,1,,train
0540700_as-2722267.jpg,2,0,0,0,2,,train
0540701_sc-179992.jpg,1,0,1,1,3,,val
0540702_as-2953753.jpg,1,0,0,0,1,,val
0540703_as-0061333.jpg,0,1,0,0,1,,test
0540704_as-0061333.jpg,2,1,0,0,3,,train
0540705_as-0061333.jpg,1,1,1,0,3,,train
0540706_sc-201681.jpg,1,0,0,0,1,,train
0540707_sc-201681.jpg,1,0,0,0,1,,train
0540708_sc-201681.jpg,1,0,0,0,1,,train
0540709_sc-122447.jpg,1,0,0,0,1,,train
0540713_sc-122447.jpg,3,2,1,0,6,,train
0540714_sc-122447.jpg,1,0,0,0,1,,val
0540716_as-0044322.jpg,2,0,1,0,3,,val
0540717_as-0044322.jpg,2,0,1,0,3,,test
0540718_as-0007930.jpg,1,1,0,0,2,,train
0540719_as-0007930.jpg,1,1,0,0,2,,train
0540720_as-0007930.jpg,1,1,0,0,2,,train
0540722_as-0007930.jpg,0,1,0,0,1,,train
0540723_as-0007930.jpg,0,1,0,0,1,,train
0540724_as-0007930.jpg,0,1,0,0,1,,train
0540725_as-0007930.jpg,1,1,0,0,2,,train
0540726_as-0007930.jpg,1,2,0,0,3,,val
0540727_as-0007930.jpg,1,1,0,0,2,,val
0540728_sc-121529.jpg,1,0,0,0,1,,test
0540729_sc-121529.jpg,1,0,0,0,1,,train
0540730_sc-121529.jpg,2,0,0,0,2,,train
0540731_sc-149643.jpg,1,0,0,0,1,,train
0540732_as-2825909.jpg,1,0,0,0,1,,train
0540733_as-3367589.jpg,4,0,0,0,4,,train
0540734_as-0008239.jpg,1,1,0,0,2,,train
0540735_as-0008239.jpg,1,1,0,0,2,,train
0540736_sc-1021691.jpg,6,0,0,0,6,,val
0540737_as-3060313.jpg,1,0,1,0,2,,val
0540741_sc-139075.jpg,1,0,0,0,1,,test
0540742_sc-139075.jpg,2,0,0,0,2,,train
0540743_sc-139075.jpg,1,0,0,0,1,,train
0540744_sc-141169.jpg,4,1,0,0,5,,train
0540747_sc-141169.jpg,3,2,0,0,5,,train
0540748_as-0021120.jpg,1,1,1,1,4,,train
0540749_as-0021120.jpg,2,0,1,1,4,,train
0540751_as-0021120.jpg,3,0,1,1,5,,train
0540752_as-0021120.jpg,0,0,1,0,1,,val
0540754_as-0021364.jpg,1,0,0,0,1,,val
0540755_as-0021364.jpg,1,0,0,0,1,,test
0540756_as-0021364.jpg,1,0,0,0,1,,train
0540757_as-0021364.jpg,1,0,0,0,1,,train
0540758_as-0021364.jpg,2,0,0,1,3,,train
0540759_as-0021364.jpg,1,0,0,0,1,,train
0540760_as-0021364.jpg,4,0,0,0,4,,train
0540761_as-3426379.jpg,2,2,2,0,6,,train
0540763_sc-161183.jpg,1,0,0,0,1,,train
0540764_sc-161183.jpg,1,1,1,0,3,,val
0540765_sc-161183.jpg,1,0,0,0,1,,val
0540766_sc-161183.jpg,1,0,0,0,1,,test
0540767_sc-161183.jpg,1,1,1,0,3,,train
0540768_sc-161183.jpg,1,1,0,0,2,,train
0540769_sc-191962.jpg,2,1,1,1,5,,train
0540770_sc-191962.jpg,11,2,2,1,16,,train
0540772_sc-191962.jpg,2,1,0,0,3,,train
0540774_as-2922223.jpg,1,2,2,0,5,,train
0540775_sc-132280.jpg,4,0,2,2,8,,train
0540776_sc-132280.jpg,0,0,1,0,1,,val
0540778_as-0081973.jpg,3,0,3,2,8,,val
0540779_as-0081973.jpg,3,0,2,2,7,,test
0540780_as-0081973.jpg,3,0,1,2,6,,train
0540781_as-0081973.jpg,1,0,1,1,3,,train
0540783_as-0081973.jpg,4,0,0,1,5,,train
0540784_as-0081973.jpg,3,0,0,0,3,,train
0540785_as-0081973.jpg,2,0,0,0,2,,train
0540786_as-0081973.jpg,3,0,0,0,3,,train
0540787_as-0081973.jpg,2,0,0,0,2,,train
0540788_as-0081973.jpg,1,0,0,0,1,,val
0540789_as-0081973.jpg,2,0,0,0,2,,val
0540790_as-0081973.jpg,2,0,0,0,2,,test
0540793_as-0047785.jpg,1,0,0,0,1,,train
0540794_as-0047785.jpg,2,0,0,0,2,,train
0540795_as-0047785.jpg,1,0,0,0,1,,train
0540796_as-0047785.jpg,1,0,0,0,1,,train
0540797_as-0047785.jpg,1,0,0,0,1,,train
0540798_as-0047785.jpg,1,0,0,0,1,,train
0540799_as-0047785.jpg,1,0,0,0,1,,train
0540800_sc-143421.jpg,1,0,0,0,1,,val
0540801_sc-1032634.jpg,0,1,0,0,1,,val
0540802_sc-1032634.jpg,1,1,0,0,2,,test
0540804_sc-1032634.jpg,0,1,0,0,1,,train
0540807_sc-112554.jpg,1,0,0,0,1,,train
0540808_sc-112554.jpg,1,0,0,0,1,,train
0540809_sc-112554.jpg,1,0,0,0,1,,train
0540810_sc-112554.jpg,1,0,0,0,1,,train
0540811_as-3088667.jpg,1,0,0,0,1,,train
0540813_as-0042498.jpg,0,0,1,0,1,,train
0540815_as-0098199.jpg,2,0,0,0,2,,val
0540816_sc-210660.jpg,1,0,0,0,1,,val
0540817_sc-210660.jpg,1,0,0,0,1,,test
0540818_as-0074528.jpg,3,0,0,0,3,,train
0540819_as-0074528.jpg,4,0,0,0,4,,train
0540820_as-0074528.jpg,2,0,0,0,2,,train
0540821_as-0074528.jpg,2,0,0,0,2,,train
0540824_as-0082463.jpg,2,0,0,0,2,,train
0540825_as-0082463.jpg,1,0,0,0,1,,train
0540827_sc-162558.jpg,2,1,0,0,3,,train
0540829_as-0041938.jpg,2,0,0,0,2,,val
0540830_as-0041938.jpg,1,0,1,0,2,,val
0540831_as-0061076.jpg,2,0,0,0,2,,test
0540832_as-0061076.jpg,1,0,0,0,1,,train
0540833_as-0061076.jpg,1,0,0,0,1,,train
0540836_as-0061076.jpg,0,3,0,0,3,,train
0540837_as-0061076.jpg,0,4,2,1,7,,train
0540838_as-0061076.jpg,6,0,2,0,8,,train
0540839_sc-150084.jpg,2,0,0,0,2,,train
0540842_sc-150084.jpg,2,0,0,0,2,,train
0540843_sc-150084.jpg,1,0,0,0,1,,val
0540844_sc-150084.jpg,1,0,0,0,1,,val
0540845_sc-150084.jpg,1,1,1,0,3,,test
0540846_sc-150084.jpg,1,1,1,0,3,,train
0540848_as-0080297.jpg,0,0,0,1,1,,train
0540849_as-2914515.jpg,3,1,0,0,4,,train
0540855_sc-1013642.jpg,5,0,0,0,5,,train
0540856_as-2501622.jpg,3,0,0,0,3,,train
0540858_as-2652531.jpg,3,0,0,0,3,,train
0540859_sc-1022797.jpg,9,0,2,0,11,,train
0540860_sc-1022797.jpg,1,0,0,0,1,,val
0540862_sc-1022797.jpg,3,0,3,1,7,,val
0540863_sc-1022797.jpg,1,0,3,1,5,,test
0540864_as-3411782.jpg,2,0,1,1,4,,train
0540865_as-0065613.jpg,1,0,0,0,1,,train
0540866_as-0065613.jpg,4,0,0,0,4,,train
0540867_as-0065613.jpg,1,0,0,0,1,,train
0540868_as-2928099.jpg,3,0,0,0,3,,train
0540869_sc-1035813.jpg,2,0,0,0,2,,train
0540870_sc-180532.jpg,2,1,1,0,4,,train
0540871_as-2634084.jpg,7,0,1,1,9,,val
0540872_sc-1037673.jpg,1,0,0,0,1,,val
0540873_sc-1037673.jpg,1,0,0,0,1,,test
0540874_as-0033412.jpg,0,0,1,0,1,,train
0540875_as-0033412.jpg,1,0,0,0,1,,train
0540876_as-0033412.jpg,1,0,1,0,2,,train
0540877_as-0033412.jpg,0,0,1,0,1,,train
0540878_as-0029459.jpg,5,0,0,0,5,,train
0540881_as-7183303.jpg,1,0,1,0,2,,train
0540884_as-0070436.jpg,3,1,0,0,4,,train
0540885_as-3442771.jpg,1,0,0,0,1,,val
0540886_as-7163461.jpg,4,0,1,1,6,,val
0540888_as-0095687.jpg,1,1,3,1,6,,test
0540889_as-0095687.jpg,3,0,1,0,4,,train
0540892_as-0070100.jpg,0,0,1,0,1,,train
0540893_as-0070100.jpg,1,0,0,0,1,,train
0540894_as-0070100.jpg,2,0,0,0,2,,train
0540895_as-7578040.jpg,1,0,1,1,3,,train
0540896_as-0096183.jpg,2,1,0,0,3,,train
0540899_as-0096183.jpg,3,0,1,0,4,,train
0540900_as-0096183.jpg,5,1,2,0,8,,val
0540901_as-0096183.jpg,7,2,1,0,10,,val
0540902_as-0096183.jpg,3,0,0,0,3,,test
0540903_as-3026781.jpg,2,0,1,1,4,,train
0540904_as-7876286.jpg,1,0,0,0,1,,train
0540905_sc-219022.jpg,1,0,0,0,1,,train
0540906_sc-219022.jpg,3,0,0,0,3,,train
0540907_sc-219022.jpg,1,0,0,0,1,,train
0540908_sc-215511.jpg,0,1,0,0,1,,train
0540909_sc-110204.jpg,0,1,0,0,1,,train
0540912_sc-110204.jpg,0,1,0,0,1,,val
0540913_sc-110204.jpg,0,1,0,0,1,,val
0540914_sc-1034786.jpg,0,2,0,0,2,,test
0540915_sc-1034786.jpg,0,2,0,0,2,,train
0540916_as-3097025.jpg,1,0,4,0,5,,train
0540917_as-2973083.jpg,0,2,1,0,3,,train
0540919_as-0017600.jpg,2,0,0,0,2,,train
0540920_sc-228633.jpg,1,0,0,0,1,,train
0540921_sc-228633.jpg,5,1,0,1,7,,train
0540924_as-0097994.jpg,2,0,3,1,6,,train
0540925_as-0097994.jpg,8,0,1,0,9,,val
0540926_as-0097994.jpg,5,0,4,0,9,,val
0540927_as-0097994.jpg,4,0,0,0,4,,test
0540928_as-0076088.jpg,1,0,1,0,2,,train
0540929_as-0076088.jpg,1,0,1,0,2,,train
0540930_as-2673855.jpg,3,0,0,0,3,,train
0540932_sc-1004910.jpg,1,0,0,0,1,,train
0540934_sc-1020041.jpg,1,1,1,0,3,,train
0540935_sc-1020041.jpg,1,1,0,0,2,,train
0540936_sc-1020041.jpg,0,1,1,0,2,,train
0540939_sc-166672.jpg,2,0,1,0,3,,val
0540941_sc-166672.jpg,1,0,0,0,1,,val
0540943_sc-125753.jpg,0,1,0,0,1,,test
0540944_sc-1025497.jpg,1,0,0,0,1,,train
0540945_sc-1025497.jpg,1,0,0,0,1,,train
0540946_as-2664026.jpg,3,2,2,0,7,,train
0540947_as-7661661.jpg,1,0,0,0,1,,train
0540948_as-3138803.jpg,1,1,0,0,2,,train
0540949_as-7138510.jpg,1,0,1,1,3,,train
0540950_sc-151932.jpg,3,0,0,0,3,,train
0540951_sc-151932.jpg,5,0,1,0,6,,val
0540952_sc-151932.jpg,5,0,0,0,5,,val
0540953_sc-151932.jpg,5,0,1,1,7,,test
0540954_sc-151932.jpg,1,0,0,0,1,,train
0540955_sc-151932.jpg,1,0,0,0,1,,train
0540956_sc-151932.jpg,1,0,0,0,1,,train
0540957_sc-151932.jpg,3,0,0,0,3,,train
0540958_sc-151932.jpg,4,0,0,0,4,,train
0540960_sc-220300.jpg,2,0,0,0,2,,train
0540961_sc-220300.jpg,1,0,0,0,1,,train
0540963_sc-149060.jpg,0,0,0,1,1,,val
0540964_sc-149060.jpg,0,1,0,1,2,,val
0540965_as-7598277.jpg,5,0,1,0,6,,test
0540967_as-0070937.jpg,3,0,0,0,3,,train
0540968_as-0070937.jpg,3,0,1,1,5,,train
0540970_sc-1018047.jpg,1,0,0,0,1,,train
0540971_sc-1018047.jpg,1,0,0,0,1,,train
0540972_sc-1018047.jpg,0,0,1,0,1,,train
0540973_as-0072586.jpg,1,0,0,0,1,,train
0540974_as-0072586.jpg,2,0,0,0,2,,train
0540975_as-0072586.jpg,2,0,0,0,2,,val
0540976_as-0072586.jpg,2,0,0,0,2,,val
0540977_as-0072586.jpg,1,0,0,0,1,,test
0540978_sc-193112.jpg,1,0,0,1,2,,train
0540979_sc-193112.jpg,1,0,0,1,2,,train
0540981_sc-142186.jpg,2,0,0,0,2,,train
0540982_sc-225059.jpg,2,0,0,0,2,,train
0540983_sc-225059.jpg,2,0,0,0,2,,train
0540984_sc-225059.jpg,1,0,0,0,1,,train
0540985_sc-225059.jpg,2,0,0,0,2,,train
0540986_sc-1030557.jpg,1,0,0,0,1,,val
0540987_sc-1030557.jpg,1,0,0,0,1,,val
0540989_sc-1031487.jpg,1,0,0,0,1,,test
0540990_sc-1031487.jpg,1,0,0,0,1,,train
0540992_sc-1031487.jpg,1,0,1,0,2,,train
0540993_sc-1031487.jpg,1,0,1,0,2,,train
0540994_sc-1031487.jpg,3,0,1,0,4,,train
0540997_sc-1040561.jpg,6,0,0,0,6,,train
0540998_sc-1040561.jpg,5,0,0,0,5,,train
0540999_sc-1040561.jpg,4,0,0,0,4,,train
0541000_sc-1040561.jpg,8,1,0,0,9,,val
0541001_as-0064841.jpg,1,0,0,0,1,,val
0541002_as-0064841.jpg,2,0,0,1,3,,test
0541003_as-0064841.jpg,2,0,0,0,2,,train
0541004_as-0064841.jpg,2,0,0,0,2,,train
0541005_as-0064841.jpg,1,0,0,0,1,,train
0541006_as-0032095.jpg,1,1,1,0,3,,train
0541007_as-0032095.jpg,1,1,1,0,3,,train
0541008_as-0032095.jpg,1,1,1,0,3,,train
0541009_as-0032095.jpg,0,1,1,0,2,,train
0541011_as-3393150.jpg,1,0,0,0,1,,val
0541012_as-3319033.jpg,0,0,1,0,1,,val
0541013_as-7888629.jpg,0,0,1,0,1,,test
0541014_sc-118538.jpg,0,1,0,0,1,,train
0541016_as-3303626.jpg,3,1,2,0,6,,train
0541017_as-3071239.jpg,1,0,0,0,1,,train
0541018_as-0065144.jpg,0,0,0,1,1,,train
0541019_as-0065144.jpg,0,0,0,1,1,,train
0541020_as-0065144.jpg,2,0,0,1,3,,train
0541021_as-0065144.jpg,1,0,0,0,1,,train
0541023_as-0065144.jpg,1,0,0,0,1,,val
0541024_as-0065144.jpg,1,0,0,0,1,,val
0541026_as-0065144.jpg,0,0,0,1,1,,test
0541027_as-0065144.jpg,0,0,0,1,1,,train
0541028_sc-192175.jpg,1,0,0,0,1,,train
0541029_as-2512738.jpg,1,0,1,1,3,,train
0541030_as-3223523.jpg,3,0,3,0,6,,train
0541031_sc-1026844.jpg,3,0,0,1,4,,train
0541033_sc-1026844.jpg,1,0,0,1,2,,train
0541034_sc-1026844.jpg,2,0,0,0,2,,train
0541035_sc-1026844.jpg,2,0,0,0,2,,val
0541036_sc-1026844.jpg,2,0,2,3,7,,val
0541038_sc-113915.jpg,1,0,0,0,1,,test
0541039_sc-113915.jpg,1,0,1,0,2,,train
0541042_as-2895188.jpg,2,0,0,0,2,,train
0541045_sc-184042.jpg,2,0,0,0,2,,train
0541046_sc-184042.jpg,3,0,1,0,4,,train
0541047_sc-184042.jpg,5,3,3,0,11,,train
0541048_as-0097645.jpg,3,0,0,0,3,,train
0541049_as-0097645.jpg,2,0,0,0,2,,train
0541050_as-0097645.jpg,3,0,0,0,3,,val
0541052_sc-1002838.jpg,3,0,0,1,4,,val
0541054_as-0044916.jpg,2,0,0,1,3,,test
0541055_as-0044916.jpg,1,0,0,1,2,,train
0541056_as-0044916.jpg,1,0,0,0,1,,train
0541057_as-0044916.jpg,1,0,0,0,1,,train
0541058_as-0044916.jpg,1,0,0,0,1,,train
0541059_as-0044916.jpg,1,0,0,0,1,,train
0541060_as-0044916.jpg,1,0,0,0,1,,train
0541061_as-0042555.jpg,0,0,0,1,1,,train
0541062_sc-221521.jpg,8,0,0,0,8,,val
0541064_sc-211905.jpg,1,0,0,0,1,,val
0541065_sc-211905.jpg,1,0,0,2,3,,test
0541066_sc-211905.jpg,1,0,0,0,1,,train
0541067_sc-211905.jpg,1,0,0,2,3,,train
0541068_sc-211905.jpg,1,0,0,2,3,,train
0541069_sc-211905.jpg,1,0,0,2,3,,train
0541072_as-7422640.jpg,5,0,0,0,5,,train
0541073_as-9054317.jpg,1,1,1,0,3,,train
0541074_as-0026946.jpg,3,0,3,0,6,,train
0541077_sc-1014607.jpg,1,0,1,0,2,,val
0541081_sc-1014607.jpg,1,0,0,0,1,,val
0541082_sc-1023776.jpg,3,0,0,2,5,,test
0541084_sc-1023776.jpg,6,0,0,2,8,,train
0541085_sc-1023776.jpg,2,0,0,0,2,,train
0541086_sc-1023776.jpg,2,0,0,0,2,,train
0541088_sc-176554.jpg,6,0,0,0,6,,train
0541090_as-0039498.jpg,3,0,0,0,3,,train
0541091_as-0039498.jpg,6,0,0,0,6,,train
0541092_sc-1006639.jpg,2,0,0,0,2,,train
0541093_sc-198269.jpg,1,1,0,0,2,,val
0541094_sc-198269.jpg,6,0,0,0,6,,val
0541095_sc-198269.jpg,3,2,2,0,7,,test
0541096_sc-198269.jpg,1,0,1,1,3,,train
0541097_sc-198269.jpg,6,0,1,0,7,,train
0541098_sc-198269.jpg,5,2,0,0,7,,train
0541099_sc-198269.jpg,5,1,1,0,7,,train
0541100_sc-198269.jpg,1,1,1,0,3,,train
0541101_sc-198269.jpg,2,0,0,0,2,,train
0541102_as-2646261.jpg,1,2,1,0,4,,train
0541103_as-0076699.jpg,3,1,0,0,4,,val
0541104_as-0076699.jpg,2,0,0,0,2,,val
0541105_as-2776626.jpg,1,0,0,0,1,,test
0541106_as-3152419.jpg,3,1,0,0,4,,train
0541108_sc-224795.jpg,1,0,0,0,1,,train
0541109_sc-224795.jpg,1,0,0,0,1,,train
0541110_sc-224795.jpg,1,0,0,0,1,,train
0541111_sc-224795.jpg,1,0,0,0,1,,train
0541113_sc-1038588.jpg,1,0,1,1,3,,train
0541114_sc-1038588.jpg,3,0,1,1,5,,train
0541115_as-2517341.jpg,2,0,0,0,2,,val
0541116_sc-193834.jpg,4,0,0,0,4,,val
0541118_as-0006312.jpg,2,0,1,0,3,,test
0541121_as-0006312.jpg,2,0,0,1,3,,train
0541122_sc-203218.jpg,5,0,0,0,5,,train
0541123_sc-203218.jpg,1,0,0,0,1,,train
0541124_sc-203218.jpg,0,1,0,0,1,,train
0541125_sc-203218.jpg,4,0,0,0,4,,train
0541126_sc-203218.jpg,4,0,0,0,4,,train
0541127_sc-203218.jpg,4,0,0,0,4,,train
0541128_as-0078173.jpg,1,0,0,0,1,,val
0541129_as-0078173.jpg,1,0,0,0,1,,val
0541130_as-0078173.jpg,1,0,0,0,1,,test
0541131_as-3291869.jpg,1,0,0,0,1,,train
0541132_sc-184134.jpg,1,0,0,0,1,,train
0541133_sc-1002334.jpg,1,0,0,0,1,,train
0541134_sc-1002334.jpg,1,0,0,0,1,,train
0541135_sc-1002334.jpg,1,0,0,0,1,,train
0541136_sc-173955.jpg,1,0,0,0,1,,train
0541137_sc-173955.jpg,1,0,0,1,2,,train
0541138_sc-173955.jpg,1,0,0,1,2,,val
0541140_as-7855274.jpg,2,0,1,1,4,,val
0541141_as-2728773.jpg,3,1,0,1,5,,test
0541146_as-0081152.jpg,1,0,1,1,3,,train
0541148_as-7363989.jpg,2,1,0,0,3,,train
0541150_as-0024990.jpg,2,0,0,1,3,,train
0541151_sc-165180.jpg,5,0,0,0,5,,train
0541152_as-0030029.jpg,2,0,0,0,2,,train
0541153_as-0030029.jpg,2,0,0,0,2,,train
0541154_as-0030029.jpg,1,1,0,0,2,,train
0541155_as-0030029.jpg,0,2,1,1,4,,val
0541157_as-7853800.jpg,1,2,1,1,5,,val
0541158_as-2787578.jpg,1,0,0,0,1,,test
0541159_sc-214601.jpg,4,0,0,1,5,,train
0541160_sc-214601.jpg,1,0,1,0,2,,train
0541161_sc-214601.jpg,1,0,0,1,2,,train
0541162_sc-214601.jpg,3,0,1,1,5,,train
0541163_sc-214601.jpg,1,0,2,1,4,,train
0541164_as-2737213.jpg,1,0,0,1,2,,train
0541165_as-2682517.jpg,2,0,1,0,3,,train
0541167_sc-215589.jpg,3,1,1,0,5,,val
0541168_sc-215589.jpg,3,1,1,0,5,,val
0541169_as-0087610.jpg,1,0,0,0,1,,test
0541171_as-7863363.jpg,2,0,0,2,4,,train
0541172_sc-151692.jpg,1,1,1,0,3,,train
0541174_as-0000910.jpg,1,0,0,0,1,,train
0541175_as-0000910.jpg,1,0,0,0,1,,train
0541176_as-0000910.jpg,1,0,0,0,1,,train
0541177_as-2839029.jpg,1,0,0,0,1,,train
0541178_sc-221555.jpg,0,1,0,0,1,,train
0541179_sc-221555.jpg,0,1,0,0,1,,val
0541180_sc-221555.jpg,0,1,0,0,1,,val
0541182_sc-127159.jpg,1,1,1,0,3,,test
0541183_as-3146002.jpg,1,1,0,0,2,,train
0541184_as-0056909.jpg,1,0,1,1,3,,train
0541185_as-0056909.jpg,1,0,0,0,1,,train
0541186_as-0056909.jpg,1,0,1,0,2,,train
0541187_as-0056909.jpg,1,0,0,0,1,,train
0541188_as-0056909.jpg,0,0,1,0,1,,train
0541189_as-3464745.jpg,1,0,0,0,1,,train
0541190_sc-198690.jpg,3,1,0,1,5,,val
0541191_sc-198690.jpg,0,2,0,0,2,,val
0541192_sc-198690.jpg,1,1,0,1,3,,test
0541193_sc-198690.jpg,2,0,0,1,3,,train
0541194_sc-198690.jpg,2,0,0,1,3,,train
0541195_sc-198690.jpg,1,1,0,1,3,,train
0541196_sc-198690.jpg,3,0,0,1,4,,train
0541197_sc-198690.jpg,0,1,0,0,1,,train
0541199_as-0081835.jpg,6,0,1,1,8,,train
0541200_as-0081835.jpg,3,0,0,1,4,,train
0541202_as-0081835.jpg,1,0,0,0,1,,val
0541203_as-0081835.jpg,1,0,1,0,2,,val
0541204_as-0081835.jpg,0,0,0,1,1,,test
0541205_as-2508346.jpg,0,0,1,0,1,,train
0541206_as-3368797.jpg,0,1,1,0,2,,train
0541208_as-2681601.jpg,1,1,2,1,5,,train
0541209_as-2784582.jpg,0,2,0,0,2,,train
0541210_sc-161678.jpg,1,0,0,0,1,,train
0541211_as-3355845.jpg,1,0,0,1,2,,train
0541214_sc-221150.jpg,6,1,0,0,7,,train
0541215_sc-221150.jpg,0,2,1,0,3,,val
0541216_sc-221150.jpg,3,0,0,0,3,,val
0541217_sc-221150.jpg,3,1,0,0,4,,test
0541218_sc-221150.jpg,1,0,0,0,1,,train
0541220_as-0068822.jpg,4,0,1,2,7,,train
0541221_as-0068822.jpg,4,1,0,0,5,,train
0541222_as-0068822.jpg,2,0,0,0,2,,train
0541223_as-0068822.jpg,8,0,1,1,10,,train
0541224_as-0068822.jpg,4,0,1,1,6,,train
0541225_as-0068822.jpg,5,0,1,1,7,,train
0541226_as-0068822.jpg,7,0,0,0,7,,val
0541227_as-0068822.jpg,7,0,0,0,7,,val
0541228_as-0068822.jpg,5,0,0,0,5,,test
0541230_sc-194375.jpg,2,0,0,0,2,,train
0541231_sc-194375.jpg,2,0,0,0,2,,train
0541232_sc-194375.jpg,1,0,0,0,1,,train
0541233_sc-194375.jpg,2,0,0,0,2,,train
0541234_sc-194375.jpg,3,0,0,0,3,,train
0541235_sc-1026085.jpg,0,0,0,1,1,,train
0541236_sc-129559.jpg,3,0,0,0,3,,train
0541238_sc-129559.jpg,1,0,0,0,1,,val
0541239_sc-129559.jpg,2,0,0,0,2,,val
0541240_sc-129559.jpg,3,0,0,0,3,,test
0541242_as-0069543.jpg,1,0,0,0,1,,train
0541243_as-0069543.jpg,1,0,0,0,1,,train
0541244_as-7117724.jpg,0,0,1,0,1,,train
0541245_as-2756749.jpg,0,0,2,2,4,,train
0541247_as-0078405.jpg,2,1,0,0,3,,train
0541248_as-0078405.jpg,1,1,1,1,4,,train
0541249_as-2644684.jpg,4,0,0,1,5,,train
0541250_as-0066456.jpg,1,1,0,0,2,,val
0541251_as-0066456.jpg,2,1,0,0,3,,val
0541252_as-2940590.jpg,1,0,0,0,1,,test
0541253_as-2940590.jpg,3,0,0,2,5,,train
0541255_as-0025845.jpg,2,0,0,0,2,,train
0541256_as-0025845.jpg,2,1,0,0,3,,train
0541257_as-0025845.jpg,2,1,0,0,3,,train
0541258_sc-1005945.jpg,2,0,0,0,2,,train
0541259_sc-1005945.jpg,1,0,0,0,1,,train
0541260_as-3341471.jpg,1,1,0,1,3,,train
0541261_sc-1014598.jpg,2,1,0,0,3,,val
0541263_sc-1014598.jpg,2,1,0,0,3,,val
0541266_sc-161506.jpg,3,0,0,0,3,,test
0541267_sc-161506.jpg,4,0,0,0,4,,train
0541269_as-0005157.jpg,1,0,0,0,1,,train
0541270_as-0005157.jpg,1,0,0,0,1,,train
0541271_as-3115353.jpg,1,1,0,1,3,,train
0541272_sc-135755.jpg,0,1,0,0,1,,train
0541273_sc-195710.jpg,2,0,1,0,3,,train
0541274_sc-118729.jpg,0,1,0,0,1,,train
0541275_sc-132643.jpg,1,0,0,0,1,,val
0541276_sc-132643.jpg,1,0,0,0,1,,val
0541277_sc-209326.jpg,2,2,0,0,4,,test
0541278_sc-209326.jpg,2,2,0,0,4,,train
0541279_sc-214157.jpg,1,0,1,0,2,,train
0541280_sc-214157.jpg,1,0,1,0,2,,train
0541281_sc-214157.jpg,1,0,0,0,1,,train
0541282_sc-214157.jpg,2,0,0,0,2,,train
0541283_as-0019457.jpg,0,1,1,1,3,,train
0541284_as-0019457.jpg,0,0,2,1,3,,train
0541285_as-0019457.jpg,0,1,1,0,2,,val
0541287_sc-229373.jpg,2,0,0,0,2,,val
0541290_sc-205643.jpg,2,0,0,0,2,,test
0541291_as-3144875.jpg,1,0,1,1,3,,train
0541293_as-0025298.jpg,2,0,0,1,3,,train
0541294_as-0025298.jpg,2,0,0,0,2,,train
0541295_as-0025298.jpg,1,1,1,0,3,,train
0541297_sc-135768.jpg,1,0,0,1,2,,train
0541298_sc-135768.jpg,1,0,0,1,2,,train
0541299_sc-135768.jpg,1,0,0,1,2,,train
0541300_sc-147200.jpg,4,1,1,1,7,,val
0541301_sc-147200.jpg,2,1,1,2,6,,val
0541302_sc-147200.jpg,3,0,0,0,3,,test
0541303_sc-205789.jpg,0,1,0,0,1,,train
0541304_sc-205789.jpg,2,1,0,0,3,,train
0541305_sc-205789.jpg,0,1,0,0,1,,train
0541306_sc-1031832.jpg,9,0,4,1,14,,train
0541310_as-0050946.jpg,1,0,0,0,1,,train
0541311_as-0050946.jpg,1,0,1,0,2,,train
0541312_as-0050946.jpg,3,0,1,0,4,,train
0541313_as-0050946.jpg,0,0,1,0,1,,val
0541314_as-0050946.jpg,2,1,0,1,4,,val
0541315_as-0050946.jpg,1,2,0,0,3,,test
0541316_as-0050946.jpg,1,1,0,0,2,,train
0541317_as-0050946.jpg,2,1,0,0,3,,train
0541319_as-3225241.jpg,2,1,1,0,4,,train
0541320_sc-1010102.jpg,1,1,1,1,4,,train
0541322_sc-1019197.jpg,1,0,2,0,3,,train
0541324_sc-1019197.jpg,1,0,1,0,2,,train
0541326_sc-136263.jpg,4,0,1,1,6,,train
0541327_sc-136263.jpg,1,0,1,1,3,,val
0541328_sc-136263.jpg,3,0,1,1,5,,val
0541329_sc-216513.jpg,0,2,3,0,5,,test
0541330_sc-216513.jpg,3,5,6,1,15,,train
0541331_sc-216513.jpg,2,4,5,1,12,,train
0541332_sc-216513.jpg,1,4,7,2,14,,train
0541333_sc-216513.jpg,2,1,3,0,6,,train
0541334_sc-219126.jpg,2,0,0,0,2,,train
0541335_sc-219126.jpg,3,0,0,0,3,,train
0541336_sc-219126.jpg,2,0,0,0,2,,train
0541337_sc-219126.jpg,5,0,0,0,5,,val
0541338_sc-219126.jpg,5,0,0,0,5,,val
0541339_sc-219126.jpg,1,0,0,0,1,,test
0541340_sc-219126.jpg,1,2,1,0,4,,train
0541341_sc-219126.jpg,1,0,0,0,1,,train
0541342_as-0089131.jpg,2,0,0,0,2,,train
0541343_sc-215185.jpg,1,1,1,1,4,,train
0541344_sc-215185.jpg,1,0,0,1,2,,train
0541346_as-0078344.jpg,1,0,0,0,1,,train
0541347_as-0078344.jpg,1,0,0,0,1,,train
0541350_as-0078344.jpg,2,0,0,1,3,,val
0541351_as-0078344.jpg,1,0,1,0,2,,val
0541352_as-0078344.jpg,1,0,0,0,1,,test
0541353_as-3032939.jpg,1,0,0,0,1,,train
0541355_sc-196679.jpg,0,1,0,0,1,,train
0541356_sc-196679.jpg,1,0,1,0,2,,train
0541357_as-3390034.jpg,1,0,0,1,2,,train
0541360_sc-164846.jpg,0,1,0,0,1,,train
0541364_as-0092648.jpg,0,0,2,1,3,,train
0541365_as-0092648.jpg,0,0,2,1,3,,train
0541366_as-0092648.jpg,1,0,1,1,3,,val
0541367_sc-157984.jpg,1,0,0,0,1,,val
0541369_sc-157984.jpg,2,0,0,0,2,,test
0541372_as-0095430.jpg,1,1,1,0,3,,train
0541373_as-0095430.jpg,1,1,1,0,3,,train
0541374_sc-222788.jpg,0,0,1,0,1,,train
0541375_sc-222788.jpg,1,0,1,0,2,,train
0541376_sc-222788.jpg,0,0,1,0,1,,train
0541377_as-0054509.jpg,0,0,0,1,1,,train
0541379_sc-1036102.jpg,3,0,0,2,5,,train
0541380_sc-1036102.jpg,1,0,0,1,2,,val
0541383_sc-194967.jpg,3,0,0,0,3,,val
0541384_sc-194967.jpg,4,0,0,0,4,,test
0541385_sc-194967.jpg,2,0,0,1,3,,train
0541386_sc-194967.jpg,2,0,0,1,3,,train
0541387_sc-194967.jpg,2,0,0,2,4,,train
0541388_sc-194967.jpg,1,0,0,2,3,,train
0541389_sc-194967.jpg,2,0,0,0,2,,train
0541390_as-7145682.jpg,1,0,0,0,1,,train
0541393_as-0068593.jpg,1,1,1,1,4,,train
0541394_as-0068593.jpg,1,0,1,1,3,,val
0541398_as-0005256.jpg,2,0,0,1,3,,val
0541399_as-0005256.jpg,2,0,0,1,3,,test
0541400_as-0005256.jpg,2,0,0,1,3,,train
0541402_sc-1021854.jpg,2,0,0,0,2,,train
0541403_sc-1021854.jpg,3,0,1,0,4,,train
0541404_sc-1021854.jpg,0,1,1,0,2,,train
0541407_sc-1033552.jpg,4,0,0,0,4,,train
0541408_as-0004976.jpg,1,0,0,0,1,,train
0541409_as-0004976.jpg,1,0,0,0,1,,train
0541410_sc-221548.jpg,7,1,0,0,8,,val
0541411_sc-221548.jpg,4,0,0,0,4,,val
0541412_sc-221548.jpg,6,0,1,0,7,,test
0541413_sc-221548.jpg,4,0,0,0,4,,train
0541414_sc-221548.jpg,6,0,0,0,6,,train
0541415_sc-221548.jpg,4,0,0,0,4,,train
0541416_as-7042827.jpg,0,0,0,1,1,,train
0541417_sc-195986.jpg,5,0,0,0,5,,train
0541418_sc-195986.jpg,7,0,0,0,7,,train
0541419_sc-195986.jpg,3,0,0,0,3,,train
0541420_sc-195986.jpg,6,0,0,0,6,,val
0541421_sc-195986.jpg,6,0,0,0,6,,val
0541422_sc-195986.jpg,4,0,0,0,4,,test
0541423_sc-195986.jpg,3,0,0,0,3,,train
0541424_sc-195986.jpg,4,0,0,0,4,,train
0541425_sc-195986.jpg,2,0,0,0,2,,train
0541428_sc-173288.jpg,0,0,1,0,1,,train
0541429_sc-173288.jpg,0,1,1,0,2,,train
0541430_sc-173288.jpg,1,1,2,1,5,,train
0541431_sc-173288.jpg,0,0,1,0,1,,train
0541435_as-9018511.jpg,2,0,3,0,5,,val
0541436_sc-1021319.jpg,2,0,0,0,2,,val
0541437_sc-1021319.jpg,1,0,0,0,1,,test
0541438_sc-1021319.jpg,2,0,0,0,2,,train
0541439_sc-1021319.jpg,1,0,0,0,1,,train
0541440_sc-1021319.jpg,2,0,0,0,2,,train
0541441_sc-1021319.jpg,3,0,0,0,3,,train
0541442_sc-1021319.jpg,2,0,0,0,2,,train
0541443_sc-193324.jpg,2,0,0,0,2,,train
0541444_sc-193324.jpg,2,0,0,0,2,,train
0541445_sc-193324.jpg,7,0,0,0,7,,val
0541446_sc-193324.jpg,7,0,0,0,7,,val
0541447_sc-126879.jpg,1,0,0,0,1,,test
0541449_as-0051046.jpg,1,0,0,0,1,,train
0541451_as-0051046.jpg,4,0,0,2,6,,train
0541452_as-0051046.jpg,7,1,1,1,10,,train
0541454_as-0030342.jpg,1,0,0,0,1,,train
0541455_as-0030342.jpg,1,0,0,0,1,,train
0541456_sc-123065.jpg,6,0,0,0,6,,train
0541457_sc-123065.jpg,5,0,0,1,6,,train
0541458_as-3393642.jpg,1,0,1,0,2,,val
0541459_as-3328132.jpg,0,1,3,1,5,,val
0541462_sc-126972.jpg,0,1,0,0,1,,test
0541463_sc-103247.jpg,2,1,0,0,3,,train
0541464_sc-103247.jpg,1,1,0,0,2,,train
0541465_as-0006448.jpg,1,0,0,0,1,,train
0541469_as-0021393.jpg,0,0,1,0,1,,train
0541470_as-0021393.jpg,1,0,1,0,2,,train
0541471_as-0021393.jpg,0,1,1,0,2,,train
0541473_as-2862367.jpg,3,0,0,0,3,,train
0541474_as-0060702.jpg,1,0,1,0,2,,val
0541475_sc-188593.jpg,12,2,0,0,14,,val
0541478_sc-188593.jpg,4,2,1,1,8,,test
0541479_sc-188593.jpg,5,2,1,0,8,,train
0541481_sc-188593.jpg,0,2,0,0,2,,train
0541482_sc-188593.jpg,0,2,0,0,2,,train
0541483_sc-188593.jpg,2,1,1,0,4,,train
0541484_sc-1019416.jpg,1,0,0,0,1,,train
0541485_sc-1019416.jpg,3,0,0,1,4,,train
0541486_sc-1020108.jpg,6,1,1,1,9,,train
0541487_sc-1020108.jpg,7,1,1,1,10,,val
0541489_sc-117728.jpg,4,0,0,0,4,,val
0541490_sc-117728.jpg,2,0,0,0,2,,test
0541491_sc-117728.jpg,3,0,0,0,3,,train
0541492_sc-117728.jpg,1,0,0,0,1,,train
0541493_sc-117728.jpg,2,0,0,0,2,,train
0541494_as-9051288.jpg,10,0,0,0,10,,train
0541495_as-3146741.jpg,3,0,1,1,5,,train
0541496_sc-172327.jpg,3,0,2,0,5,,train
0541498_sc-176683.jpg,0,1,1,0,2,,train
0541500_as-0054589.jpg,4,0,0,0,4,,val
0541501_as-0054589.jpg,1,0,0,0,1,,val
0541502_sc-150996.jpg,2,0,0,1,3,,test
0541503_sc-150996.jpg,1,0,1,1,3,,train
0541504_sc-150996.jpg,1,0,1,1,3,,train
0541505_sc-1016695.jpg,2,0,0,1,3,,train
0541506_as-7027953.jpg,2,0,1,0,3,,train
0541507_sc-197850.jpg,0,1,0,0,1,,train
0541510_as-2508518.jpg,1,0,1,0,2,,train
0541512_as-0061482.jpg,0,0,1,0,1,,train
0541513_as-0061482.jpg,0,0,1,0,1,,val
0541514_as-0061482.jpg,0,0,1,0,1,,val
0541515_as-0061482.jpg,0,0,1,0,1,,test
0541516_as-0061482.jpg,0,0,1,0,1,,train
0541517_as-0022788.jpg,1,0,0,0,1,,train
0541518_as-0022788.jpg,7,0,0,0,7,,train
0541519_as-0022788.jpg,2,0,0,0,2,,train
0541520_as-0022788.jpg,1,0,0,0,1,,train
0541521_as-0022788.jpg,1,0,0,0,1,,train
0541523_as-0022788.jpg,4,0,0,0,4,,train
0541524_as-0022788.jpg,3,0,0,0,3,,val
0541525_as-0022788.jpg,1,0,0,0,1,,val
0541526_as-0022788.jpg,1,0,0,0,1,,test
0541527_sc-220661.jpg,5,0,0,0,5,,train
0541528_sc-220661.jpg,4,0,0,0,4,,train
0541529_sc-220661.jpg,7,0,0,0,7,,train
0541530_sc-220661.jpg,9,0,0,2,11,,train
0541531_sc-220661.jpg,2,0,0,1,3,,train
0541532_sc-220661.jpg,5,0,0,2,7,,train
0541533_sc-214885.jpg,1,0,0,0,1,,train
0541534_sc-214885.jpg,1,0,0,0,1,,val
0541535_sc-214885.jpg,1,0,0,0,1,,val
0541536_sc-214885.jpg,1,0,0,0,1,,test
0541537_sc-214885.jpg,1,0,0,0,1,,train
0541538_sc-214885.jpg,2,0,0,0,2,,train
0541539_sc-149061.jpg,1,1,1,0,3,,train
0541540_as-0048664.jpg,3,0,0,0,3,,train
0541541_as-0048664.jpg,2,0,0,0,2,,train
0541544_as-0040852.jpg,1,0,0,0,1,,train
0541549_sc-1002112.jpg,1,0,0,0,1,,train
0541550_sc-1002112.jpg,1,0,0,0,1,,val
0541551_sc-1002112.jpg,1,0,0,0,1,,val
0541553_sc-147340.jpg,2,1,1,0,4,,test
0541554_sc-147340.jpg,1,1,1,0,3,,train
0541555_as-2779578.jpg,6,1,1,0,8,,train
0541556_sc-160811.jpg,18,0,0,0,18,,train
0541557_sc-160811.jpg,4,0,0,0,4,,train
0541558_sc-160811.jpg,19,0,0,0,19,,train
0541559_sc-160811.jpg,19,0,0,0,19,,train
0541560_as-3237281.jpg,1,0,0,2,3,,train
0541561_sc-168481.jpg,2,1,0,2,5,,val
0541562_as-7196160.jpg,1,0,0,1,2,,val
0541563_sc-126845.jpg,8,0,0,0,8,,test
0541564_sc-126845.jpg,10,0,0,0,10,,train
0541565_sc-126845.jpg,2,0,0,0,2,,train
0541569_as-0016139.jpg,1,0,0,0,1,,train
0541570_as-0016139.jpg,1,0,0,0,1,,train
0541571_as-2612046.jpg,2,0,0,0,2,,train
0541573_as-0076067.jpg,1,0,0,0,1,,train
0541574_sc-1008515.jpg,1,2,0,1,4,,train
0541575_as-3013926.jpg,0,0,1,0,1,,val
0541576_sc-147002.jpg,2,0,0,0,2,,val
0541578_sc-147002.jpg,1,0,0,0,1,,test
0541579_sc-147002.jpg,3,1,0,0,4,,train
0541581_sc-167174.jpg,2,0,2,0,4,,train
0541582_sc-167174.jpg,1,0,1,0,2,,train
0541583_sc-167174.jpg,1,0,1,0,2,,train
0541584_sc-167174.jpg,1,0,0,0,1,,train
0541585_sc-1020550.jpg,0,1,1,0,2,,train
0541586_sc-1020550.jpg,0,1,1,0,2,,train
0541587_sc-1020550.jpg,0,1,1,0,2,,val
0541588_sc-1007800.jpg,1,0,0,0,1,,val
0541589_sc-1007800.jpg,1,0,0,0,1,,test
0541590_sc-1007800.jpg,1,1,1,1,4,,train
0541591_sc-227456.jpg,0,1,0,0,1,,train
0541597_sc-203023.jpg,1,0,0,0,1,,train
0541598_sc-203023.jpg,7,0,1,0,8,,train
0541599_sc-203023.jpg,2,0,0,0,2,,train
0541600_sc-203023.jpg,14,0,1,0,15,,train
0541601_as-2833416.jpg,1,0,0,0,1,,train
0541603_as-0019179.jpg,0,2,0,0,2,,val
0541604_as-0019179.jpg,2,0,0,0,2,,val
0541605_as-0019179.jpg,0,1,0,0,1,,test
0541606_as-2662690.jpg,1,0,0,1,2,,train
0541607_as-2707482.jpg,4,0,0,0,4,,train
0541608_sc-214834.jpg,3,0,0,0,3,,train
0541609_sc-214834.jpg,2,0,0,0,2,,train
0541610_as-3344807.jpg,2,0,3,0,5,,train
0541611_as-0090514.jpg,2,0,0,0,2,,train
0541612_as-0090514.jpg,0,0,0,1,1,,train
0541613_as-0090514.jpg,2,1,0,0,3,,val
0541615_as-0033156.jpg,1,0,0,0,1,,val
0541616_as-0033156.jpg,1,0,1,1,3,,test
0541617_sc-145323.jpg,4,0,0,1,5,,train
0541618_sc-145323.jpg,3,0,0,0,3,,train
0541620_as-0060243.jpg,9,0,1,1,11,,train
0541623_as-0022960.jpg,9,2,0,0,11,,train
0541624_as-0022960.jpg,0,0,1,0,1,,train
0541626_as-0006867.jpg,0,1,1,0,2,,train
0541627_as-0006867.jpg,0,2,0,1,3,,train
0541628_as-0006867.jpg,1,0,3,1,5,,val
0541629_as-0006867.jpg,2,1,2,1,6,,val
0541630_as-0006867.jpg,3,0,3,1,7,,test
0541631_as-0006867.jpg,3,0,3,1,7,,train
0541632_as-0006867.jpg,2,0,2,1,5,,train
0541633_as-0006867.jpg,4,1,3,2,10,,train
0541634_as-0006867.jpg,3,1,2,1,7,,train
0541635_sc-145363.jpg,3,0,0,1,4,,train
0541636_as-0061157.jpg,1,0,0,0,1,,train
0541639_as-0061157.jpg,1,0,0,0,1,,train
0541640_sc-124632.jpg,3,0,1,0,4,,val
0541641_sc-124632.jpg,2,0,1,0,3,,val
0541642_as-3014761.jpg,0,0,1,0,1,,test
0541643_as-7678349.jpg,2,0,1,0,3,,train
0541644_sc-154905.jpg,0,0,1,0,1,,train
0541646_sc-154905.jpg,2,0,1,1,4,,train
0541647_sc-154905.jpg,0,0,2,0,2,,train
0541649_as-0005556.jpg,3,0,1,1,5,,train
0541650_as-3434276.jpg,1,0,2,0,3,,train
0541651_as-2797065.jpg,1,1,1,0,3,,train
0541652_as-3203131.jpg,8,0,0,1,9,,val
0541653_as-3203131.jpg,2,0,0,1,3,,val
0541655_as-0012392.jpg,4,2,1,1,8,,test
0541656_as-0012392.jpg,5,1,0,1,7,,train
0541657_as-0012392.jpg,4,1,0,0,5,,train
0541658_as-3163022.jpg,2,4,0,0,6,,train
0541659_sc-1031572.jpg,3,0,1,0,4,,train
0541661_sc-1031572.jpg,7,0,1,0,8,,train
0541662_as-7342466.jpg,6,0,1,2,9,,train
0541664_sc-139492.jpg,0,0,1,1,2,,train
0541665_sc-139492.jpg,1,1,2,1,5,,val
0541667_as-0004732.jpg,1,1,0,0,2,,val
0541668_as-0004732.jpg,1,1,0,0,2,,test
0541670_sc-144748.jpg,1,1,1,0,3,,train
0541671_sc-144748.jpg,5,1,1,1,8,,train
0541672_sc-144748.jpg,2,0,0,0,2,,train
0541673_sc-144748.jpg,2,0,0,0,2,,train
0541674_sc-144748.jpg,2,0,0,0,2,,train
0541675_sc-144748.jpg,3,0,1,1,5,,train
0541676_sc-204130.jpg,1,0,0,0,1,,train
0541677_sc-204130.jpg,1,0,1,0,2,,val
0541678_sc-204130.jpg,3,0,0,0,3,,val
0541679_sc-204130.jpg,2,0,1,0,3,,test
0541680_sc-204130.jpg,1,0,2,0,3,,train
0541681_sc-204130.jpg,0,0,1,0,1,,train
0541682_sc-204130.jpg,0,0,1,0,1,,train
0541683_sc-204130.jpg,2,0,0,0,2,,train
0541686_as-0017180.jpg,2,1,3,0,6,,train
0541687_as-0017180.jpg,2,0,0,0,2,,train
0541688_as-0017180.jpg,4,0,1,2,7,,train
0541689_as-0017180.jpg,4,0,1,1,6,,val
0541690_as-0017180.jpg,4,0,1,4,9,,val
0541691_as-0017180.jpg,1,0,0,0,1,,test
0541692_as-0017180.jpg,9,0,4,0,13,,train
0541693_as-0017180.jpg,3,0,0,0,3,,train
0541694_as-0017180.jpg,5,0,1,0,6,,train
0541695_as-0017180.jpg,2,0,1,0,3,,train
0541697_as-0017180.jpg,2,0,0,0,2,,train
0541698_sc-215678.jpg,1,0,0,0,1,,train
0541699_sc-215678.jpg,1,0,0,0,1,,train
0541700_as-3074309.jpg,2,0,0,0,2,,val
0541701_as-0034520.jpg,0,0,1,2,3,,val
0541704_as-0071462.jpg,2,1,0,0,3,,test
0541705_as-0071462.jpg,0,1,0,0,1,,train
0541706_as-0071462.jpg,1,0,0,1,2,,train
0541707_as-0071462.jpg,0,1,0,0,1,,train
0541708_sc-218018.jpg,3,0,3,0,6,,train
0541709_sc-218018.jpg,1,0,2,0,3,,train
0541710_sc-218018.jpg,0,0,1,0,1,,train
0541711_sc-218018.jpg,0,0,1,0,1,,train
0541712_as-7494410.jpg,2,0,0,0,2,,val
0541713_sc-117933.jpg,0,1,0,0,1,,val
0541714_as-0068190.jpg,2,0,0,0,2,,test
0541715_as-0068190.jpg,4,1,0,0,5,,train
0541716_as-0068190.jpg,3,2,0,0,5,,train
0541717_as-9045819.jpg,0,0,1,0,1,,train
0541718_sc-1034997.jpg,6,0,0,0,6,,train
0541719_sc-211766.jpg,1,0,1,1,3,,train
0541720_sc-211766.jpg,1,0,1,1,3,,train
0541721_sc-211766.jpg,2,0,1,1,4,,train
0541722_sc-211766.jpg,2,0,1,1,4,,val
0541723_as-3273647.jpg,2,0,0,0,2,,val
0541724_as-7403864.jpg,1,0,1,1,3,,test
0541725_sc-195329.jpg,2,0,0,0,2,,train
0541726_sc-195329.jpg,2,0,0,0,2,,train
0541727_sc-1010270.jpg,5,0,0,0,5,,train
0541728_sc-1010270.jpg,5,0,0,0,5,,train
0541729_as-0094536.jpg,2,0,0,0,2,,train
0541730_as-0094536.jpg,3,0,0,0,3,,train
0541731_as-0094536.jpg,4,0,0,0,4,,train
0541732_as-0094536.jpg,3,0,0,0,3,,val
0541734_as-3238132.jpg,3,2,2,0,7,,val
0541735_as-2682166.jpg,1,0,0,0,1,,test
0541736_as-7671569.jpg,5,0,3,1,9,,train
0541742_as-2814849.jpg,1,0,0,0,1,,train
0541743_sc-1022507.jpg,1,2,1,0,4,,train
0541744_sc-1022507.jpg,1,2,1,0,4,,train
0541745_sc-1022507.jpg,1,1,1,0,3,,train
0541746_sc-1022507.jpg,2,2,1,0,5,,train
0541747_sc-204051.jpg,2,1,1,0,4,,train
0541749_sc-128742.jpg,3,0,0,0,3,,val
0541750_sc-128742.jpg,3,0,0,0,3,,val
0541753_sc-151702.jpg,3,0,0,0,3,,test
0541754_sc-151702.jpg,3,0,0,0,3,,train
0541755_sc-151702.jpg,3,0,0,0,3,,train
0541756_sc-209653.jpg,4,0,0,0,4,,train
0541757_sc-209653.jpg,2,0,0,0,2,,train
0541758_sc-209653.jpg,2,0,0,0,2,,train
0541759_sc-209653.jpg,1,0,1,0,2,,train
0541760_as-7008510.jpg,3,0,0,0,3,,train
0541761_as-7462764.jpg,0,0,0,1,1,,val
0541762_as-0094414.jpg,2,0,0,0,2,,val
0541763_as-0094414.jpg,1,0,0,0,1,,test
0541764_as-7587290.jpg,3,0,1,0,4,,train
0541765_as-2871559.jpg,2,0,1,0,3,,train
0541766_as-0045101.jpg,1,1,0,0,2,,train
0541767_as-2984327.jpg,0,0,1,0,1,,train
0541768_sc-164938.jpg,1,0,0,0,1,,train
0541769_sc-164938.jpg,1,0,0,0,1,,train
0541770_sc-164938.jpg,1,0,0,0,1,,train
0541771_sc-164938.jpg,1,0,0,0,1,,val
0541772_sc-164938.jpg,1,0,0,0,1,,val
0541773_sc-1003298.jpg,1,0,0,0,1,,test
0541775_sc-126246.jpg,5,0,0,0,5,,train
0541776_sc-126246.jpg,9,0,0,0,9,,train
0541777_as-2813010.jpg,1,0,0,0,1,,train
0541778_as-2817348.jpg,2,0,0,0,2,,train
0541782_as-0017533.jpg,3,0,1,0,4,,train
0541783_as-0017533.jpg,1,0,0,0,1,,train
0541784_as-0017533.jpg,2,0,0,0,2,,train
0541785_as-0017533.jpg,2,0,0,0,2,,val
0541786_as-0017533.jpg,3,0,2,1,6,,val
0541787_as-0017533.jpg,1,0,0,0,1,,test
0541791_as-2941634.jpg,0,0,1,0,1,,train
0541792_as-0064912.jpg,1,0,0,2,3,,train
0541793_as-0064912.jpg,1,0,0,0,1,,train
0541794_as-0064912.jpg,1,0,1,0,2,,train
0541795_as-2823639.jpg,1,0,0,0,1,,train
0541796_as-0067488.jpg,3,0,0,0,3,,train
0541797_sc-210514.jpg,1,0,0,1,2,,train
0541798_sc-210514.jpg,2,0,0,1,3,,val
0541799_sc-210514.jpg,6,0,0,0,6,,val
0541800_sc-210514.jpg,2,0,0,0,2,,test
0541801_sc-210514.jpg,3,0,0,0,3,,train
0541802_sc-210514.jpg,1,0,0,0,1,,train
0541803_sc-132133.jpg,2,0,1,0,3,,train
0541804_sc-132133.jpg,0,0,1,0,1,,train
0541805_as-2954715.jpg,2,0,1,1,4,,train
0541807_as-0070726.jpg,2,0,0,1,3,,train
0541808_as-0070726.jpg,1,0,0,0,1,,train
0541809_as-0070726.jpg,1,0,0,1,2,,val
0541810_as-0070726.jpg,1,0,0,0,1,,val
0541811_as-0070726.jpg,5,0,0,0,5,,test
0541813_as-0004020.jpg,3,0,1,0,4,,train
0541814_as-0004020.jpg,1,0,1,0,2,,train
0541815_as-0004020.jpg,2,0,1,0,3,,train
0541819_sc-207572.jpg,7,1,3,2,13,,train
0541820_sc-1006013.jpg,4,0,0,2,6,,train
0541821_sc-1006013.jpg,5,0,0,0,5,,train
0541823_as-0059268.jpg,2,1,0,1,4,,train
0541824_sc-1013145.jpg,1,0,0,0,1,,val
0541826_sc-188000.jpg,4,0,1,1,6,,val
0541827_sc-188000.jpg,1,0,1,1,3,,test
0541829_sc-153249.jpg,2,0,0,0,2,,train
0541830_sc-153249.jpg,1,0,0,0,1,,train
0541831_sc-153249.jpg,2,0,0,0,2,,train
0541832_as-7246449.jpg,0,0,0,1,1,,train
0541834_sc-218706.jpg,1,0,1,1,3,,train
0541835_sc-218706.jpg,1,0,1,1,3,,train
0541836_as-2742006.jpg,4,0,1,1,6,,train
0541837_as-2921318.jpg,3,0,1,1,5,,val
0541838_sc-221979.jpg,2,0,0,0,2,,val
0541839_sc-221979.jpg,3,0,0,0,3,,test
0541840_as-2547661.jpg,3,0,0,0,3,,train
0541841_as-0078395.jpg,1,0,0,0,1,,train
0541842_as-0078395.jpg,2,0,0,0,2,,train
0541843_sc-196975.jpg,1,1,1,1,4,,train
0541844_as-0059281.jpg,2,0,0,0,2,,train
0541845_as-0059281.jpg,2,0,0,0,2,,train
0541846_as-2930268.jpg,1,0,0,0,1,,train
0541848_sc-1020715.jpg,5,0,0,1,6,,val
0541850_as-0035200.jpg,4,0,0,0,4,,val
0541851_as-0035200.jpg,2,0,0,0,2,,test
0541852_as-0035200.jpg,4,0,2,0,6,,train
0541854_sc-134019.jpg,2,0,0,0,2,,train
0541855_sc-134019.jpg,1,0,0,0,1,,train
0541856_sc-132591.jpg,3,2,1,0,6,,train
0541858_sc-132591.jpg,0,0,1,0,1,,train
0541859_sc-132591.jpg,2,1,1,0,4,,train
0541860_sc-138629.jpg,1,0,0,0,1,,train
0541862_sc-1012783.jpg,2,0,1,0,3,,val
0541863_sc-1012783.jpg,2,1,0,0,3,,val
0541864_as-3353521.jpg,0,0,1,0,1,,test
0541868_sc-151574.jpg,0,0,1,2,3,,train
0541869_sc-151574.jpg,2,0,1,1,4,,train
0541871_sc-151574.jpg,1,0,0,1,2,,train
0541873_sc-151574.jpg,1,0,1,2,4,,train
0541874_sc-151574.jpg,0,0,1,2,3,,train
0541875_as-3472283.jpg,8,1,0,1,10,,train
0541876_sc-1011946.jpg,1,2,1,0,4,,train
0541877_sc-1011946.jpg,1,1,1,0,3,,val
0541879_sc-1011946.jpg,2,2,1,0,5,,val
0541881_as-0086652.jpg,4,0,0,1,5,,test
0541882_as-0086652.jpg,2,0,0,1,3,,train
0541883_as-0086652.jpg,2,0,0,0,2,,train
0541884_as-0086652.jpg,1,0,0,1,2,,train
0541885_as-0086652.jpg,3,0,0,2,5,,train
0541886_as-2972634.jpg,3,0,0,1,4,,train
0541887_sc-187914.jpg,1,0,0,0,1,,train
0541888_sc-187914.jpg,1,0,0,0,1,,train
0541889_as-9004012.jpg,2,0,0,0,2,,val
0541891_as-0076178.jpg,1,1,0,1,3,,val
0541892_as-0078251.jpg,2,1,0,0,3,,test
0541893_as-0078251.jpg,2,1,0,0,3,,train
0541895_as-0078251.jpg,2,1,0,0,3,,train
0541896_as-0081303.jpg,5,0,0,1,6,,train
0541899_sc-1021707.jpg,0,0,1,0,1,,train
0541900_sc-1021707.jpg,2,1,1,1,5,,train
0541903_sc-169956.jpg,9,0,1,0,10,,train
0541904_sc-169956.jpg,3,0,1,0,4,,train
0541905_as-0055208.jpg,3,0,0,0,3,,val
0541906_as-0055208.jpg,3,0,0,0,3,,val
0541907_sc-128595.jpg,1,0,0,1,2,,test
0541908_sc-128595.jpg,5,0,0,0,5,,train
0541910_as-0013000.jpg,3,0,0,0,3,,train
0541911_as-0013000.jpg,2,0,0,0,2,,train
0541912_as-0013000.jpg,2,0,0,0,2,,train
0541913_as-0013000.jpg,1,0,0,0,1,,train
0541914_as-0013000.jpg,1,0,0,0,1,,train
0541915_as-0013000.jpg,1,0,0,0,1,,train
0541918_as-0057859.jpg,1,0,0,0,1,,val
0541919_as-0057859.jpg,5,0,1,0,6,,val
0541920_as-0057859.jpg,6,0,3,0,9,,test
0541921_sc-114113.jpg,4,2,2,0,8,,train
0541922_as-0008421.jpg,4,0,0,0,4,,train
0541923_sc-1009114.jpg,3,0,1,0,4,,train
0541924_sc-1009114.jpg,2,0,0,0,2,,train
0541925_sc-1009114.jpg,2,0,1,0,3,,train
0541926_sc-1009114.jpg,4,0,1,0,5,,train
0541927_sc-1009114.jpg,2,0,0,0,2,,train
0541928_sc-1009114.jpg,2,0,1,1,4,,val
0541929_as-0032375.jpg,2,0,0,0,2,,val
0541930_as-0071426.jpg,2,0,0,0,2,,test
0541931_as-0071426.jpg,1,0,0,0,1,,train
0541932_as-0071426.jpg,2,0,1,0,3,,train
0541933_as-0071426.jpg,1,0,1,0,2,,train
0541934_as-0071426.jpg,1,0,1,0,2,,train
0541935_as-0071426.jpg,2,0,1,0,3,,train
0541936_as-0071426.jpg,3,0,1,0,4,,train
0541937_as-0071426.jpg,2,0,1,0,3,,train
0541939_as-9016689.jpg,3,0,2,1,6,,val
0541940_as-3068768.jpg,1,0,0,1,2,,val
0541944_as-0018344.jpg,20,0,0,0,20,,test
0541945_as-0018344.jpg,3,0,0,0,3,,train
0541946_as-0018344.jpg,7,0,0,0,7,,train
0541947_sc-1006233.jpg,3,0,0,0,3,,train
0541948_sc-1006233.jpg,5,0,0,0,5,,train
0541949_sc-1006233.jpg,1,0,0,0,1,,train
0541950_sc-1006233.jpg,2,0,0,0,2,,train
0541951_sc-1006233.jpg,2,0,0,0,2,,train
0541953_as-0063509.jpg,1,0,1,0,2,,val
0541954_as-0063509.jpg,0,0,1,0,1,,val
0541957_as-0069209.jpg,2,1,0,0,3,,test
0541958_as-0069209.jpg,2,0,0,0,2,,train
0541959_as-0069209.jpg,2,0,0,0,2,,train
0541960_sc-172709.jpg,2,0,0,1,3,,train
0541961_sc-172709.jpg,2,0,0,1,3,,train
0541962_as-0026310.jpg,4,0,0,2,6,,train
0541963_as-0026310.jpg,0,0,0,1,1,,train
0541964_sc-208298.jpg,1,1,0,0,2,,train
0541965_sc-208298.jpg,2,1,0,0,3,,val
0541966_as-7490395.jpg,2,0,0,0,2,,val
0541967_as-0082698.jpg,3,3,2,0,8,,test
0541968_as-0082698.jpg,2,0,1,0,3,,train
0541969_as-0082698.jpg,0,0,1,0,1,,train
0541970_as-0082698.jpg,3,1,1,0,5,,train
0541971_as-0082698.jpg,3,4,2,1,10,,train
0541974_as-2914534.jpg,3,1,0,0,4,,train
0541975_sc-118237.jpg,4,0,0,0,4,,train
0541976_sc-118237.jpg,4,0,0,0,4,,train
0541977_sc-118237.jpg,2,0,0,0,2,,val
0541978_as-0013005.jpg,2,0,0,0,2,,val
0541979_as-0013005.jpg,2,0,0,0,2,,test
0541980_as-2878064.jpg,1,0,0,0,1,,train
0541981_sc-1007691.jpg,1,0,0,0,1,,train
0541982_sc-1007691.jpg,1,0,0,0,1,,train
0541983_as-3424868.jpg,2,0,0,0,2,,train
0541985_as-0036591.jpg,1,0,0,0,1,,train
0541986_as-0036591.jpg,1,0,1,1,3,,train
0541988_as-0036591.jpg,2,0,1,0,3,,train
0541990_as-0031283.jpg,1,2,2,0,5,,val
0541991_as-0031283.jpg,2,1,1,0,4,,val
0541992_as-0031283.jpg,0,0,3,0,3,,test
0541993_sc-195503.jpg,1,0,0,0,1,,train
0541994_sc-195503.jpg,1,0,0,0,1,,train
0541995_sc-195503.jpg,1,0,1,0,2,,train
0541996_sc-1013346.jpg,1,0,0,0,1,,train
0541997_as-0080616.jpg,3,0,1,1,5,,train
0541998_sc-134104.jpg,8,0,0,0,8,,train
0541999_sc-134104.jpg,1,2,1,0,4,,train
0542003_as-0038563.jpg,2,0,1,0,3,,val
0542004_as-0038563.jpg,1,0,1,0,2,,val
0542005_as-0038563.jpg,1,0,1,0,2,,test
0542006_as-2705226.jpg,3,0,0,0,3,,train
0542007_sc-208357.jpg,3,0,0,0,3,,train
0542008_sc-1002111.jpg,1,1,0,0,2,,train
0542009_sc-1002111.jpg,1,1,0,0,2,,train
0542011_as-0018138.jpg,2,0,0,0,2,,train
0542012_sc-212111.jpg,1,1,0,1,3,,train
0542013_sc-212111.jpg,1,1,1,1,4,,train
0542014_sc-212111.jpg,1,1,1,1,4,,val
0542015_sc-212111.jpg,2,2,1,1,6,,val
0542016_sc-212111.jpg,1,0,0,0,1,,test
0542017_sc-212111.jpg,1,0,0,0,1,,train
0542018_as-0057084.jpg,1,0,0,0,1,,train
0542019_as-0057084.jpg,1,0,0,0,1,,train
0542020_as-0057084.jpg,1,0,0,1,2,,train
0542021_as-0057084.jpg,1,0,0,0,1,,train
0542022_as-0057084.jpg,1,0,0,0,1,,train
0542023_as-0057084.jpg,1,0,0,0,1,,train
0542026_sc-1019266.jpg,1,0,1,1,3,,val
0542027_sc-1019266.jpg,1,0,1,0,2,,val
0542028_sc-1019266.jpg,1,0,1,1,3,,test
0542029_sc-1019266.jpg,1,0,0,1,2,,train
0542034_as-0092667.jpg,1,0,0,0,1,,train
0542037_as-0092667.jpg,1,1,0,1,3,,train
0542038_as-0092667.jpg,1,0,0,0,1,,train
0542043_as-0092667.jpg,3,1,0,1,5,,train
0542044_as-0092667.jpg,2,0,0,1,3,,train
0542045_as-0092667.jpg,1,0,0,0,1,,train
0542046_as-0092667.jpg,1,0,0,0,1,,val
0542052_as-0092667.jpg,1,0,1,0,2,,val
0542053_as-0092667.jpg,1,0,0,0,1,,test
0542054_as-0092667.jpg,1,0,2,0,3,,train
0542057_as-0092667.jpg,1,0,1,0,2,,train
0542059_as-0092667.jpg,1,0,0,0,1,,train
0542060_as-2938866.jpg,0,0,2,0,2,,train
0542064_as-0089097.jpg,0,3,6,2,11,,train
0542065_as-0089097.jpg,0,3,3,2,8,,train
0542066_as-0089097.jpg,0,2,4,1,7,,train
0542067_as-0089097.jpg,1,2,3,1,7,,val
0542068_as-0089097.jpg,2,2,3,1,8,,val
0542069_as-0089097.jpg,0,2,5,2,9,,test
0542070_as-0089097.jpg,0,2,4,2,8,,train
0542071_as-0089097.jpg,2,2,3,2,9,,train
0542072_as-0089097.jpg,1,0,1,0,2,,train
0542073_as-0089097.jpg,0,4,3,2,9,,train
0542075_as-0089097.jpg,0,0,1,0,1,,train
0542077_as-0038554.jpg,7,0,0,0,7,,train
0542078_as-0038554.jpg,6,0,1,1,8,,train
0542079_as-3020534.jpg,4,0,0,0,4,,val
0542080_sc-140741.jpg,2,1,0,2,5,,val
0542081_sc-140741.jpg,1,1,0,1,3,,test
0542082_sc-106090.jpg,1,0,1,0,2,,train
0542083_sc-106090.jpg,2,0,1,0,3,,train
0542084_sc-1040796.jpg,5,0,0,1,6,,train
0542085_sc-1040796.jpg,5,0,0,1,6,,train
0542086_sc-1040796.jpg,4,0,0,0,4,,train
0542087_sc-1040796.jpg,1,0,0,0,1,,train
0542088_sc-1040796.jpg,5,0,0,0,5,,train
0542090_as-3275700.jpg,0,1,1,0,2,,val
0542091_as-3275700.jpg,1,0,0,1,2,,val
0542092_as-9031382.jpg,2,0,0,0,2,,test
0542093_as-0028740.jpg,1,0,0,0,1,,train
0542095_as-0028740.jpg,1,0,0,0,1,,train
0542096_sc-126581.jpg,0,1,0,0,1,,train
0542097_sc-126581.jpg,0,1,0,0,1,,train
0542098_sc-1012379.jpg,2,0,0,0,2,,train
0542101_sc-1012379.jpg,1,0,0,0,1,,train
0542102_sc-1012379.jpg,7,0,0,0,7,,train
0542103_sc-1012379.jpg,2,0,0,0,2,,val
0542105_sc-1012379.jpg,2,1,0,0,3,,val
0542106_as-7296912.jpg,0,2,0,0,2,,test
0542107_as-3126748.jpg,4,0,0,0,4,,train
0542108_sc-202379.jpg,1,0,1,1,3,,train
0542109_sc-202379.jpg,1,0,0,1,2,,train
0542110_sc-202379.jpg,2,0,1,1,4,,train
0542111_sc-202379.jpg,1,0,0,1,2,,train
0542112_sc-1003106.jpg,3,0,0,1,4,,train
0542113_sc-1003106.jpg,4,0,0,1,5,,train
0542114_sc-1003106.jpg,1,0,0,1,2,,val
0542115_sc-109350.jpg,2,0,3,0,5,,val
0542116_sc-109350.jpg,0,0,1,0,1,,test
0542117_sc-114936.jpg,2,0,2,1,5,,train
0542118_sc-114936.jpg,2,0,2,1,5,,train
0542119_as-0048812.jpg,1,0,0,0,1,,train
0542120_as-0048812.jpg,1,0,0,0,1,,train
0542121_as-0048812.jpg,2,0,0,0,2,,train
0542122_as-0048812.jpg,2,0,0,0,2,,train
0542123_as-0048812.jpg,1,0,0,0,1,,train
0542124_as-0054278.jpg,1,0,1,1,3,,val
0542125_as-0054278.jpg,1,0,0,1,2,,val
0542126_as-0054278.jpg,1,0,0,0,1,,test
0542129_as-0043465.jpg,2,1,0,0,3,,train
0542131_as-0049611.jpg,1,0,0,1,2,,train
0542132_as-0049611.jpg,1,0,0,1,2,,train
0542133_as-0049611.jpg,1,0,0,1,2,,train
0542135_sc-228861.jpg,0,0,1,0,1,,train
0542137_as-0061611.jpg,3,2,0,0,5,,train
0542138_as-0061611.jpg,2,3,0,0,5,,train
0542139_as-0061611.jpg,3,2,0,0,5,,val
0542140_as-0061611.jpg,1,3,1,0,5,,val
0542143_sc-1004855.jpg,1,1,0,0,2,,test
0542145_as-0026500.jpg,9,0,0,1,10,,train
0542146_as-2886409.jpg,1,0,0,0,1,,train
0542150_as-0038359.jpg,0,3,1,0,4,,train
0542154_as-0038359.jpg,0,0,1,1,2,,train
0542155_as-0038359.jpg,0,0,1,1,2,,train
0542156_as-9069531.jpg,1,0,0,0,1,,train
0542157_sc-221098.jpg,7,1,1,1,10,,train
0542158_sc-221098.jpg,5,1,1,1,8,,val
0542159_sc-221098.jpg,6,1,0,1,8,,val
0542160_sc-221098.jpg,6,1,0,1,8,,test
0542161_sc-221098.jpg,6,1,0,0,7,,train
0542162_sc-221098.jpg,2,1,0,0,3,,train
0542163_sc-221098.jpg,2,1,0,0,3,,train
0542164_sc-221098.jpg,3,0,0,1,4,,train
0542165_sc-221098.jpg,2,0,1,0,3,,train
0542166_sc-221098.jpg,3,0,0,0,3,,train
0542167_sc-221098.jpg,2,0,0,0,2,,train
0542168_sc-221098.jpg,3,0,0,0,3,,val
0542169_sc-221098.jpg,2,0,0,0,2,,val
0542170_sc-221098.jpg,6,1,0,0,7,,test
0542171_sc-221098.jpg,3,0,0,1,4,,train
0542172_sc-221098.jpg,1,0,0,1,2,,train
0542173_sc-221098.jpg,1,0,0,0,1,,train
0542174_sc-221098.jpg,1,0,0,0,1,,train
0542175_sc-221098.jpg,1,0,0,0,1,,train
0542176_sc-221098.jpg,1,0,1,1,3,,train
0542177_sc-221098.jpg,1,0,1,1,3,,train
0542178_sc-221098.jpg,2,0,1,0,3,,val
0542179_sc-221098.jpg,2,0,0,0,2,,val
0542180_sc-221098.jpg,2,0,1,0,3,,test
0542181_sc-221098.jpg,7,0,1,1,9,,train
0542182_sc-221098.jpg,8,0,1,1,10,,train
0542183_sc-221098.jpg,2,0,1,1,4,,train
0542184_sc-221098.jpg,1,0,0,0,1,,train
0542185_as-0002165.jpg,1,0,0,0,1,,train
0542186_as-0002165.jpg,1,0,0,0,1,,train
0542187_as-0002165.jpg,1,0,0,0,1,,train
0542188_as-0002165.jpg,1,0,0,0,1,,val
0542189_as-0002165.jpg,1,0,0,0,1,,val
0542190_sc-205248.jpg,3,0,1,1,5,,test
0542191_sc-1014751.jpg,1,0,0,1,2,,train
0542192_sc-1014751.jpg,1,1,0,1,3,,train
0542193_sc-1014751.jpg,1,1,0,1,3,,train
0542195_as-0034262.jpg,3,0,0,0,3,,train
0542196_as-0034262.jpg,1,1,0,0,2,,train
0542197_as-0034262.jpg,1,1,1,0,3,,train
0542198_as-0034262.jpg,1,0,1,0,2,,train
0542199_as-0034262.jpg,3,1,1,0,5,,val
0542200_as-0034262.jpg,6,0,0,0,6,,val
0542201_as-0034262.jpg,0,1,1,0,2,,test
0542202_as-0034262.jpg,2,2,0,0,4,,train
0542204_as-0018229.jpg,1,0,0,0,1,,train
0542205_as-0018229.jpg,1,0,0,0,1,,train
0542206_as-0056870.jpg,3,0,0,0,3,,train
0542207_as-0056870.jpg,2,0,0,0,2,,train
0542208_as-0056870.jpg,2,0,0,0,2,,train
0542209_as-0056870.jpg,1,0,0,0,1,,train
0542210_as-0056870.jpg,3,0,0,0,3,,val
0542211_as-0056870.jpg,2,0,0,0,2,,val
0542212_as-7513865.jpg,1,1,0,0,2,,test
0542213_as-2747247.jpg,3,0,1,0,4,,train
0542215_as-3327904.jpg,0,0,1,0,1,,train
0542216_sc-153301.jpg,1,0,0,0,1,,train
0542217_sc-118913.jpg,2,0,0,1,3,,train
0542218_sc-118913.jpg,1,0,0,2,3,,train
0542219_sc-118913.jpg,1,0,0,1,2,,train
0542221_sc-118913.jpg,1,0,0,1,2,,train
0542222_sc-118913.jpg,1,0,0,2,3,,val
0542224_as-0014587.jpg,1,0,0,0,1,,val
0542225_as-0014587.jpg,1,0,0,0,1,,test
0542227_as-0014587.jpg,2,0,0,0,2,,train
0542228_as-0059082.jpg,1,0,0,0,1,,train
0542230_as-0059082.jpg,1,0,0,1,2,,train
0542231_as-0059082.jpg,1,0,0,1,2,,train
0542232_as-0059082.jpg,1,0,0,1,2,,train
0542233_as-0059082.jpg,1,0,0,0,1,,train
0542234_as-0059082.jpg,1,0,0,0,1,,train
0542235_as-0059082.jpg,1,1,0,0,2,,val
0542237_sc-215128.jpg,3,0,1,1,5,,val
0542238_sc-215128.jpg,5,0,1,0,6,,test
0542239_sc-215128.jpg,5,0,1,0,6,,train
0542240_sc-223166.jpg,12,0,0,0,12,,train
0542241_sc-223166.jpg,9,0,0,0,9,,train
0542245_sc-1015019.jpg,4,2,0,0,6,,train
0542247_as-0034738.jpg,1,0,0,0,1,,train
0542248_as-0034738.jpg,2,0,0,0,2,,train
0542249_as-0034738.jpg,1,0,0,0,1,,train
0542251_as-0034738.jpg,1,0,0,0,1,,val
0542252_as-0004951.jpg,0,0,0,1,1,,val
0542253_as-0004951.jpg,0,0,0,1,1,,test
0542254_sc-113060.jpg,7,2,0,3,12,,train
0542255_as-2949302.jpg,8,0,0,0,8,,train
0542257_as-0084704.jpg,1,0,0,0,1,,train
0542259_as-0084704.jpg,1,0,0,0,1,,train
0542260_as-0084704.jpg,2,0,0,0,2,,train
0542261_as-0084704.jpg,2,0,0,0,2,,train
0542262_as-0084704.jpg,3,0,0,0,3,,train
0542263_as-3422854.jpg,4,1,0,0,5,,val
0542264_as-3361335.jpg,0,1,2,1,4,,val
0542265_sc-1005582.jpg,3,0,1,0,4,,test
0542266_sc-1005582.jpg,3,0,0,0,3,,train
0542267_sc-1005582.jpg,2,0,0,0,2,,train
0542268_sc-1005582.jpg,3,0,0,0,3,,train
0542269_sc-1005582.jpg,3,0,1,1,5,,train
0542270_sc-1005582.jpg,2,0,1,1,4,,train
0542271_sc-1005582.jpg,2,1,0,0,3,,train
0542272_as-3403504.jpg,1,1,1,0,3,,train
0542273_as-0009594.jpg,3,0,0,0,3,,val
0542274_as-0033144.jpg,1,0,0,0,1,,val
0542276_as-0033144.jpg,1,0,0,0,1,,test
0542277_as-0051923.jpg,3,0,0,0,3,,train
0542278_as-0051923.jpg,4,0,0,0,4,,train
0542279_as-0051923.jpg,2,0,0,0,2,,train
0542280_as-0051923.jpg,1,0,0,1,2,,train
0542281_as-0051923.jpg,4,0,0,1,5,,train
0542282_as-3018041.jpg,0,1,1,0,2,,train
0542284_sc-166149.jpg,4,1,2,1,8,,train
0542285_sc-166149.jpg,3,1,2,1,7,,val
0542288_as-0058773.jpg,1,3,0,0,4,,val
0542289_as-0058773.jpg,1,2,0,0,3,,test
0542290_sc-144225.jpg,0,1,0,0,1,,train
0542291_sc-144225.jpg,0,1,0,0,1,,train
0542292_sc-144225.jpg,0,1,0,0,1,,train
0542293_sc-144225.jpg,0,1,0,0,1,,train
0542294_sc-147682.jpg,0,1,0,0,1,,train
0542295_sc-147682.jpg,0,1,0,0,1,,train
0542296_sc-147682.jpg,0,1,0,0,1,,train
0542297_sc-147682.jpg,0,1,0,0,1,,val
0542298_sc-147682.jpg,0,1,0,0,1,,val
0542299_as-0046319.jpg,7,0,1,2,10,,test
0542300_as-0046319.jpg,9,1,1,2,13,,train
0542301_as-0046319.jpg,4,0,1,2,7,,train
0542302_as-0046319.jpg,7,0,1,2,10,,train
0542304_sc-147229.jpg,0,1,0,0,1,,train
0542305_sc-105965.jpg,1,0,0,0,1,,train
0542306_sc-105965.jpg,1,0,0,0,1,,train
0542307_sc-105965.jpg,3,0,0,0,3,,train
0542308_sc-105965.jpg,1,0,0,0,1,,val
0542309_sc-105965.jpg,3,0,0,0,3,,val
0542311_sc-193548.jpg,4,0,0,0,4,,test
0542313_as-0083951.jpg,2,1,0,1,4,,train
0542314_as-0083951.jpg,1,0,0,0,1,,train
0542315_as-0083951.jpg,2,0,0,0,2,,train
0542316_as-0083951.jpg,0,0,1,0,1,,train
0542317_sc-124813.jpg,1,0,1,2,4,,train
0542318_sc-124813.jpg,1,0,1,1,3,,train
0542319_sc-124813.jpg,1,0,1,2,4,,train
0542320_as-2745464.jpg,2,1,0,0,3,,val
0542321_sc-1025291.jpg,0,0,0,1,1,,val
0542323_sc-1025291.jpg,0,0,0,1,1,,test
0542324_sc-1025291.jpg,0,0,0,1,1,,train
0542325_sc-1025291.jpg,1,0,0,0,1,,train
0542326_sc-204261.jpg,4,0,1,0,5,,train
0542327_sc-204261.jpg,4,0,0,0,4,,train
0542328_sc-204261.jpg,4,0,1,0,5,,train
0542329_sc-204261.jpg,4,0,1,0,5,,train
0542332_as-0082649.jpg,3,0,1,0,4,,train
0542333_as-0082649.jpg,8,0,1,5,14,,val
0542335_as-0082649.jpg,3,0,1,2,6,,val
0542336_as-0082649.jpg,4,0,0,5,9,,test
0542337_as-0082649.jpg,3,0,0,5,8,,train
0542338_as-0082649.jpg,3,0,0,1,4,,train
0542340_sc-1016772.jpg,0,0,0,1,1,,train
0542341_sc-1016772.jpg,0,1,0,1,2,,train
0542342_sc-1005641.jpg,1,0,0,0,1,,train
0542343_sc-1005641.jpg,1,0,0,0,1,,train
0542345_sc-228499.jpg,1,0,0,0,1,,train
0542346_sc-228499.jpg,1,0,0,0,1,,val
0542347_sc-228499.jpg,1,0,0,0,1,,val
0542348_as-0032598.jpg,1,0,0,0,1,,test
0542349_as-0032598.jpg,2,1,0,0,3,,train
0542350_as-0032598.jpg,3,1,0,0,4,,train
0542351_as-0032598.jpg,2,1,0,0,3,,train
0542353_sc-130828.jpg,1,0,0,1,2,,train
0542354_sc-130828.jpg,1,0,0,1,2,,train
0542355_sc-205467.jpg,2,0,1,0,3,,train
0542356_sc-205467.jpg,1,1,2,0,4,,train
0542357_sc-205467.jpg,2,1,2,0,5,,val
0542359_as-0063788.jpg,1,0,1,0,2,,val
0542361_as-0063788.jpg,1,0,0,1,2,,test
0542366_as-0063788.jpg,0,0,2,1,3,,train
0542369_as-0026889.jpg,5,1,0,1,7,,train
0542371_as-2788726.jpg,3,0,0,1,4,,train
0542373_sc-159449.jpg,13,0,1,1,15,,train
0542374_sc-159449.jpg,10,0,1,1,12,,train
0542375_as-7907198.jpg,0,0,2,1,3,,train
0542376_sc-162747.jpg,1,0,1,1,3,,train
0542377_sc-162747.jpg,1,0,0,0,1,,val
0542378_sc-162747.jpg,1,0,2,0,3,,val
0542379_sc-162747.jpg,1,0,1,1,3,,test
0542380_sc-162747.jpg,1,0,1,1,3,,train
0542383_as-0012655.jpg,6,1,0,0,7,,train
0542384_as-0012655.jpg,2,1,0,0,3,,train
0542385_as-0012655.jpg,4,0,0,0,4,,train
0542387_as-0012655.jpg,3,0,0,0,3,,train
0542388_as-0012655.jpg,3,0,0,0,3,,train
0542390_as-7146567.jpg,1,0,0,0,1,,train
0542391_as-2780827.jpg,4,0,1,0,5,,val
0542393_sc-133090.jpg,1,0,1,0,2,,val
0542394_as-9047482.jpg,3,0,0,0,3,,test
0542396_sc-164227.jpg,1,0,0,0,1,,train
0542398_as-0095307.jpg,1,0,2,1,4,,train
0542399_as-0095307.jpg,3,1,2,1,7,,train
0542400_as-0095307.jpg,1,0,1,1,3,,train
0542401_as-0095307.jpg,2,1,1,1,5,,train
0542402_as-0095307.jpg,3,1,1,0,5,,train
0542403_sc-196179.jpg,2,2,1,1,6,,train
0542404_sc-196179.jpg,2,1,0,1,4,,val
0542406_sc-196179.jpg,2,0,0,0,2,,val
0542409_sc-150640.jpg,3,0,2,1,6,,test
0542410_sc-150640.jpg,2,0,1,0,3,,train
0542411_sc-150640.jpg,3,0,2,1,6,,train
0542412_sc-150640.jpg,3,0,2,1,6,,train
0542413_sc-127003.jpg,2,0,0,1,3,,train
0542416_sc-127003.jpg,1,0,0,1,2,,train
0542417_sc-127003.jpg,1,0,0,1,2,,train
0542419_as-0082419.jpg,1,0,0,1,2,,train
0542420_as-0082419.jpg,1,0,0,0,1,,val
0542421_as-0082419.jpg,1,0,0,1,2,,val
0542423_as-0082419.jpg,1,0,1,0,2,,test
0542424_as-0082419.jpg,1,0,0,0,1,,train
0542425_as-0082419.jpg,0,0,1,0,1,,train
0542426_as-0082419.jpg,0,0,1,0,1,,train
0542427_as-0082419.jpg,0,1,0,1,2,,train
0542429_as-0082419.jpg,1,0,0,0,1,,train
0542430_as-0082419.jpg,0,0,1,0,1,,train
0542431_as-0082419.jpg,0,0,1,0,1,,train
0542432_as-0082419.jpg,0,1,1,0,2,,val
0542433_as-0082419.jpg,0,1,1,0,2,,val
0542434_as-0082419.jpg,0,0,0,1,1,,test
0542435_as-0082419.jpg,1,0,0,0,1,,train
0542436_as-0082419.jpg,0,0,0,1,1,,train
0542438_as-0082419.jpg,1,0,0,0,1,,train
0542439_as-0082419.jpg,1,0,0,0,1,,train
0542440_as-7262500.jpg,1,0,0,1,2,,train
0542442_as-2839336.jpg,0,1,0,0,1,,train
0542444_sc-214440.jpg,5,0,0,0,5,,train
0542445_sc-214440.jpg,3,0,0,0,3,,val
0542446_sc-214440.jpg,4,0,0,0,4,,val
0542447_sc-214440.jpg,3,0,0,0,3,,test
0542448_sc-214440.jpg,5,0,0,0,5,,train
0542449_sc-214440.jpg,2,0,0,1,3,,train
0542450_as-2871685.jpg,1,1,1,0,3,,train
0542451_as-0037565.jpg,1,1,1,0,3,,train
0542452_as-0037565.jpg,1,1,1,1,4,,train
0542453_as-0037565.jpg,1,1,0,1,3,,train
0542454_as-0037565.jpg,3,1,0,1,5,,train
0542457_sc-182938.jpg,1,0,0,0,1,,val
0542460_sc-182938.jpg,1,1,0,0,2,,val
0542461_as-0016067.jpg,0,1,2,1,4,,test
0542462_as-0016067.jpg,1,1,0,1,3,,train
0542463_as-0016067.jpg,1,1,2,3,7,,train
0542464_as-0016067.jpg,1,1,0,0,2,,train
0542465_as-0016067.jpg,1,0,0,0,1,,train
0542466_as-0016067.jpg,1,0,0,0,1,,train
0542467_as-0016067.jpg,1,1,0,2,4,,train
0542468_as-0016067.jpg,1,0,2,0,3,,train
0542469_as-0032291.jpg,4,0,0,0,4,,val
0542470_as-0032291.jpg,3,0,0,0,3,,val
0542471_as-3330241.jpg,4,0,3,3,10,,test
0542472_as-3330241.jpg,4,0,0,0,4,,train
0542474_sc-105103.jpg,2,0,0,1,3,,train
0542475_sc-105103.jpg,2,0,0,0,2,,train
0542476_sc-105103.jpg,2,0,0,0,2,,train
0542477_sc-105103.jpg,1,0,0,0,1,,train
0542479_sc-105103.jpg,2,0,0,0,2,,train
0542480_sc-105103.jpg,1,0,0,0,1,,train
0542481_sc-105103.jpg,2,0,0,0,2,,val
0542482_sc-105103.jpg,1,0,0,0,1,,val
0542483_as-2857493.jpg,0,3,0,2,5,,test
0542484_sc-103328.jpg,4,2,3,0,9,,train
0542485_as-3436341.jpg,1,0,2,1,4,,train
0542486_as-9062528.jpg,1,1,1,0,3,,train
0542487_as-7839010.jpg,3,0,1,0,4,,train
0542488_sc-134092.jpg,6,1,2,0,9,,train
0542489_sc-134092.jpg,11,1,1,0,13,,train
0542490_sc-134092.jpg,7,0,1,0,8,,train
0542492_sc-134092.jpg,4,1,0,0,5,,val
0542494_as-0079065.jpg,2,0,3,1,6,,val
0542495_as-0079065.jpg,1,0,0,0,1,,test
0542496_as-0079065.jpg,1,0,0,0,1,,train
0542497_as-0079065.jpg,6,0,1,1,8,,train
0542498_as-0079065.jpg,4,1,1,0,6,,train
0542500_as-0071112.jpg,1,0,0,1,2,,train
0542501_as-0071112.jpg,1,0,0,1,2,,train
0542503_as-0005007.jpg,6,0,1,1,8,,train
0542504_as-0005007.jpg,4,0,0,1,5,,train
0542505_as-0005007.jpg,3,0,0,1,4,,val
0542506_sc-1024828.jpg,2,0,0,0,2,,val
0542507_as-2744442.jpg,0,1,2,0,3,,test
0542509_as-0043348.jpg,2,0,0,0,2,,train
0542511_sc-218029.jpg,0,0,0,1,1,,train
0542512_sc-218029.jpg,0,0,0,1,1,,train
0542513_sc-1001467.jpg,5,0,0,0,5,,train
0542514_sc-1001467.jpg,1,1,0,0,2,,train
0542515_sc-1001467.jpg,6,0,0,0,6,,train
0542516_as-3298929.jpg,1,0,0,0,1,,train
0542517_as-0007625.jpg,2,0,0,0,2,,val
0542518_sc-185902.jpg,3,0,0,0,3,,val
0542519_sc-185902.jpg,1,0,1,0,2,,test
0542520_sc-185902.jpg,1,0,0,0,1,,train
0542521_sc-185902.jpg,0,0,1,0,1,,train
0542522_sc-185902.jpg,5,0,0,1,6,,train
0542523_sc-1020216.jpg,1,0,0,0,1,,train
0542524_sc-1020216.jpg,5,0,0,0,5,,train
0542526_as-3302302.jpg,1,0,0,1,2,,train
0542527_sc-1008827.jpg,2,0,1,0,3,,train
0542529_sc-190292.jpg,1,0,2,0,3,,val
0542530_sc-190292.jpg,0,1,4,0,5,,val
0542533_sc-203746.jpg,3,0,0,0,3,,test
0542534_sc-203746.jpg,3,0,0,0,3,,train
0542535_sc-203746.jpg,3,0,0,0,3,,train
0542536_sc-203746.jpg,1,1,0,0,2,,train
0542537_as-2648273.jpg,3,0,1,0,4,,train
0542538_as-0081894.jpg,2,0,0,0,2,,train
0542539_as-0081894.jpg,0,1,0,0,1,,train
0542540_as-0081894.jpg,1,2,0,0,3,,train
0542541_as-0081894.jpg,1,1,0,0,2,,val
0542542_as-0087203.jpg,1,0,0,0,1,,val
0542544_sc-168301.jpg,2,0,0,0,2,,test
0542545_sc-168301.jpg,1,0,0,0,1,,train
0542548_sc-1030747.jpg,0,1,0,0,1,,train
0542550_as-2981514.jpg,1,0,0,0,1,,train
0542551_as-7940501.jpg,1,0,1,0,2,,train
0542552_as-0071205.jpg,1,0,0,0,1,,train
0542553_as-0071205.jpg,1,0,0,0,1,,train
0542554_as-0071205.jpg,0,1,0,0,1,,train
0542555_as-0071205.jpg,1,0,0,0,1,,val
0542557_sc-224847.jpg,3,0,0,0,3,,val
0542558_sc-224847.jpg,6,0,0,0,6,,test
0542560_as-0055451.jpg,1,0,0,0,1,,train
0542561_as-0055451.jpg,1,0,0,0,1,,train
0542562_as-0055451.jpg,1,0,0,0,1,,train
0542563_as-0055451.jpg,1,1,0,0,2,,train
0542564_sc-222655.jpg,3,3,3,2,11,,train
0542565_sc-222655.jpg,3,3,3,2,11,,train
0542567_as-0082286.jpg,1,0,0,0,1,,train
0542570_as-0082286.jpg,2,0,0,0,2,,val
0542571_as-3317666.jpg,2,0,0,0,2,,val
0542572_as-3317666.jpg,0,0,1,1,2,,test
0542574_sc-103001.jpg,2,1,2,1,6,,train
0542575_sc-103001.jpg,0,1,1,0,2,,train
0542576_as-3239139.jpg,1,0,0,0,1,,train
0542577_as-2672439.jpg,0,0,0,1,1,,train
0542578_as-0078083.jpg,3,0,0,0,3,,train
0542580_sc-198795.jpg,1,0,0,0,1,,train
0542581_sc-198795.jpg,1,0,0,0,1,,train
0542583_sc-198795.jpg,1,0,0,0,1,,val
0542584_sc-198795.jpg,2,0,0,0,2,,val
0542585_sc-198795.jpg,1,0,0,0,1,,test
0542587_sc-198795.jpg,2,0,0,0,2,,train
0542588_sc-198795.jpg,2,0,1,0,3,,train
0542589_sc-198795.jpg,1,0,0,0,1,,train
0542590_as-2779389.jpg,2,0,1,0,3,,train
0542591_as-0002074.jpg,3,0,1,0,4,,train
0542592_sc-1015847.jpg,4,0,0,1,5,,train
0542593_sc-1015847.jpg,1,0,1,3,5,,train
0542595_sc-1015847.jpg,5,0,2,3,10,,val
0542596_sc-1015847.jpg,8,0,2,3,13,,val
0542597_sc-1015847.jpg,2,0,1,1,4,,test
0542598_sc-1015847.jpg,4,0,1,3,8,,train
0542599_sc-1015847.jpg,4,0,1,1,6,,train
0542600_sc-1015847.jpg,4,0,1,2,7,,train
0542601_as-3324173.jpg,3,0,1,0,4,,train
0542602_sc-131680.jpg,0,0,1,0,1,,train
0542603_sc-131680.jpg,0,0,1,0,1,,train
0542604_sc-163297.jpg,0,0,1,0,1,,train
0542605_sc-163297.jpg,0,0,1,0,1,,val
0542607_as-0055795.jpg,2,3,0,5,10,,val
0542608_as-0055795.jpg,3,3,0,5,11,,test
0542609_as-2647843.jpg,1,0,0,0,1,,train
0542610_as-2973473.jpg,1,0,0,0,1,,train
0542611_sc-192667.jpg,2,2,1,1,6,,train
0542612_sc-192667.jpg,1,1,0,0,2,,train
0542613_sc-192667.jpg,3,1,1,1,6,,train
0542614_sc-192667.jpg,3,2,1,1,7,,train
0542615_sc-159019.jpg,3,0,1,2,6,,train
0542618_as-0000755.jpg,2,1,0,0,3,,val
0542619_as-3434342.jpg,3,0,0,0,3,,val
0542620_as-7463697.jpg,0,0,0,2,2,,test
0542622_sc-219245.jpg,4,0,0,0,4,,train
0542623_sc-219245.jpg,3,0,0,0,3,,train
0542624_sc-219245.jpg,4,0,0,0,4,,train
0542625_sc-219245.jpg,2,0,0,0,2,,train
0542626_sc-219245.jpg,1,0,0,0,1,,train
0542627_sc-219245.jpg,1,0,0,0,1,,train
0542628_sc-219245.jpg,3,0,0,0,3,,train
0542629_sc-219245.jpg,3,0,0,0,3,,val
0542630_sc-219245.jpg,1,0,0,0,1,,val
0542631_sc-165797.jpg,7,0,1,2,10,,test
0542633_sc-165797.jpg,11,0,2,2,15,,train
0542634_sc-121146.jpg,4,0,0,0,4,,train
0542635_sc-121146.jpg,3,0,0,0,3,,train
0542636_sc-220050.jpg,0,1,0,0,1,,train
0542637_sc-220050.jpg,1,1,0,0,2,,train
0542639_sc-121670.jpg,2,0,0,0,2,,train
0542640_sc-121670.jpg,1,0,0,1,2,,train
0542641_sc-121670.jpg,3,0,0,1,4,,val
0542642_sc-121670.jpg,1,0,0,1,2,,val
0542643_sc-121670.jpg,1,0,0,1,2,,test
0542644_sc-225108.jpg,1,0,1,0,2,,train
0542645_sc-225108.jpg,5,0,0,0,5,,train
0542646_sc-1007931.jpg,1,1,0,0,2,,train
0542647_sc-1007931.jpg,1,1,0,0,2,,train
0542648_sc-1007931.jpg,0,1,0,0,1,,train
0542649_as-0030417.jpg,1,0,0,0,1,,train
0542650_as-0030417.jpg,3,1,0,0,4,,train
0542651_as-0030417.jpg,1,1,0,0,2,,val
0542652_as-0030417.jpg,1,0,0,0,1,,val
0542653_sc-202415.jpg,5,0,1,1,7,,test
0542654_sc-202415.jpg,4,0,2,0,6,,train
0542655_sc-202415.jpg,2,0,0,1,3,,train
0542656_sc-202415.jpg,1,0,2,0,3,,train
0542657_sc-202415.jpg,1,0,2,0,3,,train
0542658_sc-202415.jpg,5,1,0,2,8,,train
0542659_sc-202415.jpg,4,0,1,1,6,,train
0542661_as-0087845.jpg,1,1,0,0,2,,train
0542662_as-0087845.jpg,1,1,0,0,2,,val
0542663_sc-208806.jpg,2,0,0,0,2,,val
0542664_as-0033275.jpg,1,0,0,0,1,,test
0542665_sc-142049.jpg,2,1,0,0,3,,train
0542666_sc-142049.jpg,3,1,2,1,7,,train
0542668_as-0081653.jpg,1,0,0,1,2,,train
0542669_as-0028208.jpg,8,1,2,0,11,,train
0542670_as-2530013.jpg,2,0,0,0,2,,train
0542671_as-3281591.jpg,3,0,1,0,4,,train
0542674_as-0069286.jpg,1,0,0,0,1,,train
0542675_as-0069286.jpg,3,1,0,0,4,,val
0542676_as-0069286.jpg,2,0,0,0,2,,val
0542677_as-0069286.jpg,1,1,1,0,3,,test
0542678_as-0069286.jpg,3,1,1,0,5,,train
0542679_as-0031852.jpg,2,0,1,0,3,,train
0542680_as-0031852.jpg,5,0,1,0,6,,train
0542682_as-0031852.jpg,2,0,0,0,2,,train
0542683_as-0031852.jpg,3,0,0,0,3,,train
0542684_as-0031852.jpg,0,1,0,0,1,,train
0542686_as-0031852.jpg,1,0,0,0,1,,train
0542688_sc-123166.jpg,2,1,1,0,4,,val
0542689_sc-123166.jpg,2,0,1,0,3,,val
0542691_as-2560310.jpg,4,0,1,1,6,,test
0542693_sc-105018.jpg,1,0,0,0,1,,train
0542695_as-0058339.jpg,2,0,0,0,2,,train
0542697_sc-1032575.jpg,1,0,0,0,1,,train
0542698_sc-1032575.jpg,2,0,0,0,2,,train
0542699_sc-1032575.jpg,2,0,0,0,2,,train
0542701_sc-1032575.jpg,3,1,0,0,4,,train
0542702_as-0064648.jpg,1,0,0,0,1,,train
0542703_as-0064648.jpg,1,0,0,0,1,,val
0542704_sc-108909.jpg,1,0,0,0,1,,val
0542705_sc-108909.jpg,1,0,1,0,2,,test
0542706_sc-108909.jpg,2,0,0,0,2,,train
0542707_sc-108909.jpg,1,0,0,0,1,,train
0542709_sc-1002257.jpg,2,0,0,0,2,,train
0542712_as-2847340.jpg,0,0,1,0,1,,train
0542713_as-3377076.jpg,1,0,2,0,3,,train
0542714_as-3318100.jpg,2,0,0,0,2,,train
0542715_as-3227087.jpg,1,0,1,0,2,,train
0542716_as-7759056.jpg,1,1,0,0,2,,val
0542717_as-0053684.jpg,2,0,0,0,2,,val
0542718_as-0053684.jpg,8,0,0,0,8,,test
0542719_as-0053684.jpg,5,0,0,0,5,,train
0542720_as-0053684.jpg,3,0,0,0,3,,train
0542721_as-2520114.jpg,0,0,1,0,1,,train
0542723_sc-1040116.jpg,1,0,0,1,2,,train
0542724_as-3379338.jpg,6,0,1,0,7,,train
0542725_sc-119989.jpg,1,0,0,0,1,,train
0542726_as-0094180.jpg,2,0,2,1,5,,train
0542728_as-0094180.jpg,3,0,1,2,6,,val
0542729_as-0094180.jpg,5,0,0,0,5,,val
0542730_as-0094180.jpg,1,0,1,2,4,,test
0542731_as-0094180.jpg,2,1,1,1,5,,train
0542732_as-0094180.jpg,2,0,1,2,5,,train
0542733_as-3347854.jpg,4,4,1,0,9,,train
0542734_sc-1006725.jpg,3,0,1,2,6,,train
0542735_sc-1018793.jpg,2,0,0,2,4,,train
0542736_sc-1018793.jpg,4,3,0,0,7,,train
0542737_as-3124930.jpg,2,0,0,0,2,,train
0542738_sc-113472.jpg,5,0,0,1,6,,val
0542741_as-0071780.jpg,1,0,0,0,1,,val
0542742_as-0071780.jpg,1,0,0,0,1,,test
0542743_as-3206145.jpg,1,0,1,0,2,,train
0542744_as-3337863.jpg,1,0,0,0,1,,train
0542745_as-0055686.jpg,3,0,0,0,3,,train
0542746_as-0055686.jpg,4,0,0,0,4,,train
0542747_as-0055686.jpg,4,0,0,0,4,,train
0542749_sc-112534.jpg,6,0,0,0,6,,train
0542750_sc-112534.jpg,4,0,0,0,4,,train
0542751_sc-112534.jpg,3,0,0,0,3,,val
0542752_sc-223200.jpg,2,1,0,0,3,,val
0542753_sc-223200.jpg,1,0,0,0,1,,test
0542754_sc-223200.jpg,1,0,0,0,1,,train
0542755_sc-223200.jpg,1,0,0,0,1,,train
0542756_sc-183344.jpg,1,0,0,0,1,,train
0542757_sc-183344.jpg,2,0,1,0,3,,train
0542758_as-2785441.jpg,1,0,0,0,1,,train
0542759_as-3162573.jpg,0,0,1,0,1,,train
0542760_sc-126323.jpg,0,2,0,0,2,,train
0542761_sc-127706.jpg,2,0,0,0,2,,val
0542762_sc-163826.jpg,0,0,0,1,1,,val
0542763_sc-220101.jpg,4,0,1,0,5,,test
0542764_sc-220101.jpg,4,0,0,0,4,,train
0542765_sc-220101.jpg,3,0,0,1,4,,train
0542766_sc-220101.jpg,1,0,0,1,2,,train
0542767_sc-220101.jpg,2,0,1,0,3,,train
0542768_sc-220101.jpg,3,0,0,0,3,,train
0542770_sc-165233.jpg,3,0,0,1,4,,train
0542771_sc-165233.jpg,3,0,0,1,4,,train
0542772_sc-165233.jpg,2,0,0,0,2,,val
0542773_as-2532031.jpg,1,0,0,0,1,,val
0542774_as-9089437.jpg,1,0,0,0,1,,test
0542775_sc-1013013.jpg,2,0,0,0,2,,train
0542776_sc-1013013.jpg,1,0,0,1,2,,train
0542777_sc-110095.jpg,2,0,0,0,2,,train
0542779_as-2507261.jpg,2,0,0,0,2,,train
0542781_as-0036461.jpg,1,0,0,0,1,,train
0542782_as-0036461.jpg,1,0,0,0,1,,train
0542783_as-0036461.jpg,1,0,0,0,1,,train
0542784_as-0036461.jpg,1,0,0,0,1,,val
0542786_as-2776416.jpg,0,1,0,0,1,,val
0542787_as-3331954.jpg,1,0,0,0,1,,test
0542788_sc-128319.jpg,1,0,0,0,1,,train
0542789_sc-128319.jpg,5,0,0,0,5,,train
0542790_sc-190932.jpg,1,0,0,1,2,,train
0542791_sc-190932.jpg,2,0,0,0,2,,train
0542792_sc-190932.jpg,2,0,0,1,3,,train
0542793_sc-190932.jpg,3,0,0,1,4,,train
0542794_sc-190932.jpg,2,0,0,0,2,,train
0542795_sc-190932.jpg,0,1,0,0,1,,val
0542796_as-0042049.jpg,3,0,1,0,4,,val
0542797_as-0042049.jpg,2,0,0,0,2,,test
0542798_as-0042049.jpg,3,0,0,0,3,,train
0542799_as-2559921.jpg,0,0,1,0,1,,train
0542800_as-3049992.jpg,2,0,0,0,2,,train
0542801_sc-142403.jpg,0,1,0,0,1,,train
0542802_as-2955324.jpg,1,0,1,1,3,,train
0542808_as-9078337.jpg,2,0,0,0,2,,train
0542809_as-0034196.jpg,4,0,1,1,6,,train
0542810_as-0034196.jpg,2,0,1,0,3,,val
0542811_as-0034196.jpg,4,0,1,2,7,,val
0542815_as-0083123.jpg,3,0,0,0,3,,test
0542817_as-0083123.jpg,2,0,0,0,2,,train
0542818_as-0083123.jpg,4,0,0,0,4,,train
0542819_as-0083123.jpg,1,0,0,0,1,,train
0542821_as-0067258.jpg,2,2,2,1,7,,train
0542823_as-0054374.jpg,1,0,0,0,1,,train
0542824_as-0054374.jpg,1,0,1,0,2,,train
0542825_as-0054374.jpg,1,0,0,0,1,,train
0542826_as-0054374.jpg,2,0,0,0,2,,val
0542827_as-0054374.jpg,1,0,1,1,3,,val
0542828_sc-1008653.jpg,3,0,0,0,3,,test
0542829_sc-1008653.jpg,2,0,0,0,2,,train
0542830_sc-1018084.jpg,3,0,0,0,3,,train
0542832_as-0048984.jpg,1,0,0,0,1,,train
0542833_as-0048984.jpg,4,0,0,0,4,,train
0542834_sc-1023497.jpg,7,0,0,0,7,,train
0542835_sc-1023497.jpg,2,0,0,0,2,,train
0542836_sc-1023497.jpg,1,0,0,0,1,,train
0542837_sc-1023497.jpg,3,0,0,0,3,,val
0542838_as-3219037.jpg,1,0,2,0,3,,val
0542839_sc-1015391.jpg,2,0,0,0,2,,test
0542840_sc-1015391.jpg,0,3,0,0,3,,train
0542842_as-0026240.jpg,1,0,0,0,1,,train
0542843_as-0000625.jpg,3,0,1,0,4,,train
0542844_sc-1023249.jpg,6,1,1,2,10,,train
0542845_sc-1023249.jpg,3,0,0,1,4,,train
0542846_sc-1023249.jpg,0,0,1,0,1,,train
0542847_sc-1023249.jpg,2,0,0,0,2,,train
0542848_sc-1023249.jpg,1,1,0,1,3,,val
0542849_sc-1023249.jpg,2,0,2,1,5,,val
0542850_sc-1023249.jpg,1,0,0,0,1,,test
0542851_sc-1023249.jpg,1,0,0,0,1,,train
0542852_sc-1023249.jpg,3,1,0,1,5,,train
0542853_sc-134823.jpg,2,0,0,0,2,,train
0542854_sc-134823.jpg,4,0,0,0,4,,train
0542855_sc-1040476.jpg,3,1,1,0,5,,train
0542856_sc-1040476.jpg,2,0,1,0,3,,train
0542858_as-3025682.jpg,2,1,0,0,3,,train
0542861_as-0041009.jpg,2,0,0,2,4,,val
0542862_as-0041009.jpg,2,0,0,2,4,,val
0542863_as-0041009.jpg,5,0,0,1,6,,test
0542864_as-0041009.jpg,2,0,0,2,4,,train
0542866_as-7526160.jpg,2,1,0,0,3,,train
0542868_as-7996263.jpg,1,0,0,0,1,,train
0542869_sc-1026831.jpg,2,1,2,0,5,,train
0542870_sc-1026831.jpg,2,2,1,1,6,,train
0542871_sc-1026831.jpg,1,2,1,1,5,,train
0542872_sc-1026831.jpg,1,1,1,0,3,,train
0542873_sc-1026831.jpg,0,1,1,0,2,,val
0542874_sc-1026831.jpg,0,0,2,1,3,,val
0542875_sc-108713.jpg,6,0,0,1,7,,test
0542876_sc-108713.jpg,2,0,0,1,3,,train
0542877_as-0030087.jpg,4,0,0,0,4,,train
0542878_as-0030087.jpg,1,0,1,0,2,,train
0542879_as-0030087.jpg,2,0,1,0,3,,train
0542880_sc-106370.jpg,1,0,0,1,2,,train
0542881_sc-106370.jpg,1,0,0,1,2,,train
0542882_sc-133358.jpg,2,0,0,1,3,,train
0542883_sc-133358.jpg,1,0,0,1,2,,val
0542884_sc-133358.jpg,1,1,0,1,3,,val
0542887_sc-1005554.jpg,7,0,0,0,7,,test
0542888_sc-1005554.jpg,6,0,0,0,6,,train
0542889_sc-133438.jpg,1,0,0,0,1,,train
0542890_sc-112653.jpg,2,0,1,1,4,,train
0542891_sc-112653.jpg,2,0,1,1,4,,train
0542892_sc-112653.jpg,3,0,1,0,4,,train
0542893_sc-1001062.jpg,2,0,1,1,4,,train
0542894_sc-1001062.jpg,2,0,1,1,4,,train
0542898_as-0060348.jpg,4,0,1,0,5,,val
0542899_as-0060348.jpg,1,0,1,0,2,,val
0542902_sc-1033095.jpg,3,0,0,2,5,,test
0542903_sc-1033095.jpg,2,0,0,2,4,,train
0542904_sc-1022819.jpg,2,0,1,0,3,,train
0542905_sc-1022819.jpg,3,1,1,0,5,,train
0542907_as-9029580.jpg,1,0,0,0,1,,train
0542908_sc-1041166.jpg,1,0,0,1,2,,train
0542909_sc-1041166.jpg,2,0,0,1,3,,train
0542911_as-3431669.jpg,1,0,0,0,1,,train
0542914_as-0082719.jpg,0,0,1,0,1,,val
0542915_as-0082719.jpg,1,0,1,0,2,,val
0542916_as-0082719.jpg,0,0,1,0,1,,test
0542917_as-7440203.jpg,0,0,2,1,3,,train
0542918_sc-1037520.jpg,3,0,0,0,3,,train
0542919_sc-1037520.jpg,0,0,1,0,1,,train
0542920_sc-1037520.jpg,6,0,0,0,6,,train
0542921_sc-206979.jpg,3,0,5,0,8,,train
0542922_sc-206979.jpg,2,2,2,0,6,,train
0542923_sc-206979.jpg,1,1,2,0,4,,train
0542924_sc-206979.jpg,4,1,2,0,7,,val
0542925_sc-206979.jpg,0,0,1,0,1,,val
0542926_sc-206979.jpg,0,0,1,0,1,,test
0542927_as-0002803.jpg,2,0,0,0,2,,train
0542928_as-0002803.jpg,3,0,0,0,3,,train
0542929_as-0002803.jpg,6,0,0,0,6,,train
0542930_as-0002803.jpg,1,0,0,0,1,,train
0542931_as-2541367.jpg,3,0,0,0,3,,train
0542932_as-3002799.jpg,1,0,0,0,1,,train
0542933_sc-196261.jpg,1,0,1,0,2,,train
0542934_sc-196261.jpg,1,0,0,0,1,,val
0542935_sc-196261.jpg,1,0,0,0,1,,val
0542937_sc-1013433.jpg,2,0,0,0,2,,test
0542938_sc-1013433.jpg,4,0,3,0,7,,train
0542939_sc-1013433.jpg,4,0,0,0,4,,train
0542940_sc-1013433.jpg,2,0,2,0,4,,train
0542941_sc-1013433.jpg,1,0,0,0,1,,train
0542942_sc-161089.jpg,3,0,1,1,5,,train
0542943_sc-161089.jpg,1,0,1,1,3,,train
0542944_sc-161089.jpg,3,0,1,1,5,,train
0542945_sc-1039542.jpg,2,1,0,1,4,,val
0542946_sc-1039542.jpg,1,0,0,1,2,,val
0542947_sc-1039542.jpg,1,0,0,1,2,,test
0542948_sc-1039542.jpg,2,0,0,1,3,,train
0542949_sc-1039542.jpg,2,0,1,1,4,,train
0542950_sc-1039542.jpg,2,0,1,1,4,,train
0542951_sc-1039542.jpg,2,0,1,0,3,,train
0542952_as-2710882.jpg,1,0,0,0,1,,train
0542954_as-0001135.jpg,4,0,1,1,6,,train
0542955_as-0001135.jpg,4,0,2,5,11,,train
0542956_as-0001135.jpg,11,0,1,5,17,,val
0542957_sc-146044.jpg,1,0,2,1,4,,val
0542958_sc-146044.jpg,1,0,2,1,4,,test
0542959_sc-146044.jpg,3,0,2,1,6,,train
0542960_sc-146044.jpg,1,0,2,1,4,,train
0542961_as-2917122.jpg,4,0,0,0,4,,train
0542963_sc-218425.jpg,2,0,1,0,3,,train
0542964_sc-218425.jpg,1,0,1,0,2,,train
0542965_sc-218425.jpg,0,0,1,0,1,,train
0542966_sc-218425.jpg,1,0,1,0,2,,train
0542967_sc-218425.jpg,4,0,1,0,5,,val
0542968_sc-218425.jpg,4,0,2,0,6,,val
0542969_sc-218425.jpg,1,1,0,1,3,,test
0542970_sc-218425.jpg,1,1,0,1,3,,train
0542971_sc-218425.jpg,5,1,0,0,6,,train
0542972_sc-218425.jpg,4,0,0,0,4,,train
0542973_sc-218425.jpg,3,0,1,0,4,,train
0542974_sc-218425.jpg,2,0,0,0,2,,train
0542975_sc-1016979.jpg,0,0,0,1,1,,train
0542976_as-3171326.jpg,5,3,1,3,12,,train
0542977_sc-203781.jpg,1,1,0,0,2,,val
0542978_as-7656936.jpg,0,0,2,0,2,,val
0542979_as-7600896.jpg,1,0,0,1,2,,test
0542980_as-3062740.jpg,1,0,1,2,4,,train
0542981_sc-1021527.jpg,3,0,0,0,3,,train
0542982_sc-202106.jpg,5,0,1,0,6,,train
0542984_sc-118779.jpg,1,0,1,0,2,,train
0542985_sc-198252.jpg,3,0,0,0,3,,train
0542988_sc-115679.jpg,2,0,1,1,4,,train
0542989_sc-115679.jpg,1,0,1,1,3,,train
0542990_as-2739131.jpg,1,0,0,0,1,,val
0542994_sc-191672.jpg,3,1,2,0,6,,val
0542995_sc-191672.jpg,0,0,0,1,1,,test
0542996_as-2706592.jpg,1,0,0,0,1,,train
0542997_as-2601946.jpg,0,1,0,0,1,,train
0542999_as-0040048.jpg,2,0,0,0,2,,train
0543000_as-0040048.jpg,1,0,0,0,1,,train
0543001_as-0040048.jpg,1,0,0,0,1,,train
0543002_as-0044337.jpg,5,1,0,0,6,,train
0543003_sc-198091.jpg,1,0,0,0,1,,train
0543004_sc-198091.jpg,1,0,0,0,1,,val
0543005_sc-198091.jpg,1,0,0,0,1,,val
0543006_sc-198091.jpg,1,0,0,0,1,,test
0543007_sc-198091.jpg,0,1,1,0,2,,train
0543008_as-3266605.jpg,1,0,1,0,2,,train
0543009_sc-136041.jpg,1,0,0,0,1,,train
0543010_sc-136041.jpg,0,1,0,0,1,,train
0543011_sc-136041.jpg,0,1,0,0,1,,train
0543012_sc-136041.jpg,0,1,0,0,1,,train
0543013_sc-136041.jpg,0,1,0,0,1,,train
0543014_sc-1029326.jpg,0,0,1,0,1,,val
0543015_sc-1029326.jpg,1,0,0,1,2,,val
0543016_sc-1029326.jpg,1,0,0,1,2,,test
0543017_sc-1029326.jpg,1,0,1,1,3,,train
0543019_sc-1029326.jpg,1,0,0,0,1,,train
0543020_sc-1029326.jpg,2,0,2,0,4,,train
0543021_sc-1029326.jpg,4,1,1,0,6,,train
0543022_sc-1029326.jpg,2,0,0,0,2,,train
0543023_sc-1029326.jpg,1,0,1,0,2,,train
0543024_sc-1029326.jpg,2,0,2,0,4,,train
0543025_sc-1029326.jpg,2,0,0,0,2,,val
0543026_sc-1029326.jpg,1,0,0,0,1,,val
0543027_sc-1029326.jpg,1,0,1,1,3,,test
0543028_sc-1029326.jpg,1,0,1,1,3,,train
0543029_sc-1029326.jpg,1,0,1,1,3,,train
0543030_sc-1029326.jpg,1,0,1,0,2,,train
0543031_sc-1029326.jpg,0,0,0,1,1,,train
0543032_sc-1029326.jpg,1,0,1,0,2,,train
0543033_sc-1029326.jpg,2,0,1,1,4,,train
0543034_sc-210189.jpg,4,0,1,0,5,,train
0543035_as-0054986.jpg,2,0,0,0,2,,val
0543036_sc-210095.jpg,1,0,1,0,2,,val
0543037_sc-210095.jpg,1,0,1,0,2,,test
0543038_sc-210095.jpg,2,0,1,0,3,,train
0543039_sc-210095.jpg,3,0,1,0,4,,train
0543040_as-0052230.jpg,1,0,0,0,1,,train
0543041_as-0003803.jpg,3,0,0,1,4,,train
0543042_as-0003803.jpg,2,2,1,0,5,,train
0543043_as-0003803.jpg,1,1,0,0,2,,train
0543044_as-0003803.jpg,3,0,2,0,5,,train
0543045_as-7254844.jpg,0,0,1,0,1,,val
0543046_sc-104102.jpg,7,0,0,1,8,,val
0543048_as-0097413.jpg,1,0,1,1,3,,test
0543049_as-0097413.jpg,1,0,1,0,2,,train
0543050_sc-211271.jpg,4,0,0,2,6,,train
0543051_sc-211271.jpg,2,0,0,0,2,,train
0543053_sc-182942.jpg,7,0,0,1,8,,train
0543054_sc-182942.jpg,3,0,0,1,4,,train
0543057_as-3006531.jpg,2,0,0,0,2,,train
0543058_as-2947758.jpg,2,1,0,0,3,,train
0543059_sc-1015141.jpg,4,1,2,2,9,,val
0543061_as-0016948.jpg,1,0,2,0,3,,val
0543062_as-0016948.jpg,0,0,2,0,2,,test
0543063_as-0016948.jpg,0,0,1,0,1,,train
0543065_as-0081606.jpg,1,0,1,1,3,,train
0543066_as-0081606.jpg,1,0,1,1,3,,train
0543067_as-0081606.jpg,1,0,1,1,3,,train
0543068_as-0081606.jpg,1,0,1,1,3,,train
0543070_sc-117454.jpg,2,0,0,1,3,,train
0543071_sc-117454.jpg,1,0,0,0,1,,train
0543072_sc-117454.jpg,2,0,0,1,3,,val
0543073_sc-1003175.jpg,1,1,0,0,2,,val
0543074_sc-1003175.jpg,0,1,0,0,1,,test
0543075_sc-1003175.jpg,0,3,0,0,3,,train
0543076_sc-1003175.jpg,0,3,0,0,3,,train
0543077_as-0083360.jpg,1,0,0,0,1,,train
0543078_sc-1020142.jpg,1,0,0,1,2,,train
0543079_sc-1020142.jpg,2,0,0,0,2,,train
0543081_as-0005089.jpg,1,2,1,0,4,,train
0543083_as-0005089.jpg,0,0,1,0,1,,train
0543085_as-0058588.jpg,1,1,1,0,3,,val
0543087_as-0030605.jpg,2,0,0,0,2,,val
0543088_as-0030605.jpg,2,0,0,0,2,,test
0543089_as-0030605.jpg,2,0,1,0,3,,train
0543090_as-0030605.jpg,2,0,0,0,2,,train
0543091_sc-129175.jpg,2,0,1,1,4,,train
0543092_sc-129175.jpg,1,0,1,1,3,,train
0543093_sc-129175.jpg,1,0,1,1,3,,train
0543095_sc-129175.jpg,3,0,1,0,4,,train
0543096_sc-129175.jpg,3,0,0,0,3,,train
0543097_sc-129175.jpg,6,0,0,0,6,,val
0543099_as-3089123.jpg,3,1,1,0,5,,val
0543100_as-3397070.jpg,0,0,1,1,2,,test
0543101_sc-206080.jpg,1,0,1,0,2,,train
0543102_sc-206080.jpg,0,0,1,0,1,,train
0543104_sc-203462.jpg,5,3,1,0,9,,train
0543105_sc-184563.jpg,1,0,0,1,2,,train
0543106_sc-184563.jpg,1,0,0,1,2,,train
0543108_as-0038790.jpg,0,1,0,0,1,,train
0543112_as-0038790.jpg,1,1,1,1,4,,train
0543113_as-0038790.jpg,1,1,1,1,4,,val
0543114_sc-111337.jpg,2,2,0,0,4,,val
0543115_sc-111337.jpg,2,2,0,0,4,,test
0543116_sc-1026013.jpg,1,0,0,0,1,,train
0543119_sc-1026013.jpg,1,0,1,0,2,,train
0543120_as-3486297.jpg,2,0,1,0,3,,train
0543121_sc-211242.jpg,6,0,0,0,6,,train
0543122_sc-211242.jpg,4,2,0,0,6,,train
0543123_sc-211242.jpg,4,0,0,0,4,,train
0543124_sc-211242.jpg,0,0,1,0,1,,train
0543125_as-0020031.jpg,1,1,0,0,2,,val
0543126_as-0020031.jpg,2,0,0,0,2,,val
0543127_as-0020031.jpg,2,0,0,0,2,,test
0543129_as-0037199.jpg,1,0,1,0,2,,train
0543130_sc-210239.jpg,2,0,0,0,2,,train
0543131_sc-210239.jpg,1,0,0,0,1,,train
0543132_sc-182564.jpg,4,0,0,0,4,,train
0543133_sc-182564.jpg,4,0,0,0,4,,train
0543134_sc-182564.jpg,5,1,0,3,9,,train
0543135_sc-182564.jpg,4,0,1,3,8,,train
0543136_sc-182564.jpg,4,2,0,2,8,,val
0543137_sc-182564.jpg,2,0,1,0,3,,val
0543138_sc-182564.jpg,2,0,0,0,2,,test
0543139_sc-182564.jpg,3,0,0,0,3,,train
0543140_sc-182564.jpg,2,0,0,0,2,,train
0543141_sc-182564.jpg,2,0,0,0,2,,train
0543142_sc-104245.jpg,0,1,1,0,2,,train
0543143_sc-104245.jpg,1,1,1,0,3,,train
0543144_sc-104245.jpg,1,1,0,0,2,,train
0543145_sc-104245.jpg,1,1,0,0,2,,train
0543146_sc-104245.jpg,2,1,1,1,5,,val
0543147_sc-132939.jpg,3,0,0,0,3,,val
0543148_sc-132939.jpg,7,0,0,0,7,,test
0543149_as-2995560.jpg,3,0,0,0,3,,train
0543150_as-3324653.jpg,1,0,1,0,2,,train
0543153_as-0085878.jpg,1,0,1,0,2,,train
0543155_as-9015046.jpg,1,0,0,0,1,,train
0543156_sc-1033358.jpg,1,0,1,0,2,,train
0543159_sc-1033358.jpg,1,0,1,0,2,,train
0543160_sc-103805.jpg,3,0,0,0,3,,train
0543161_sc-103805.jpg,4,0,0,0,4,,val
0543162_sc-103805.jpg,3,0,0,0,3,,val
0543163_sc-103805.jpg,4,0,0,0,4,,test
0543164_sc-103805.jpg,4,0,0,0,4,,train
0543165_sc-1030356.jpg,1,0,1,1,3,,train
0543166_sc-229447.jpg,0,1,1,0,2,,train
0543167_sc-229447.jpg,1,3,1,1,6,,train
0543168_sc-229447.jpg,1,3,2,0,6,,train
0543169_as-3393232.jpg,2,0,0,0,2,,train
0543173_as-0041947.jpg,3,0,0,0,3,,train
0543174_as-0041947.jpg,2,0,0,1,3,,val
0543175_as-0041947.jpg,4,0,0,1,5,,val
0543176_as-0075389.jpg,1,1,1,1,4,,test
0543177_as-7649941.jpg,1,0,0,0,1,,train
0543179_sc-1034383.jpg,1,0,0,0,1,,train
0543180_sc-194063.jpg,1,0,2,0,3,,train
0543181_sc-194063.jpg,0,0,2,0,2,,train
0543183_sc-194063.jpg,5,1,0,0,6,,train
0543184_sc-194063.jpg,1,0,2,0,3,,train
0543186_sc-194063.jpg,7,1,1,0,9,,train
0543187_sc-194063.jpg,2,2,2,0,6,,val
0543188_sc-194063.jpg,3,0,0,0,3,,val
0543189_sc-194063.jpg,4,1,2,0,7,,test
0543190_sc-194063.jpg,3,1,1,0,5,,train
0543191_sc-194063.jpg,0,0,2,0,2,,train
0543192_sc-194063.jpg,0,0,1,0,1,,train
0543194_sc-152712.jpg,10,1,0,0,11,,train
0543195_sc-157223.jpg,1,2,0,0,3,,train
0543196_as-9006899.jpg,2,1,0,0,3,,train
0543197_sc-1015965.jpg,1,0,1,0,2,,train
0543198_sc-1015965.jpg,1,0,1,0,2,,val
0543199_sc-1015965.jpg,1,0,0,0,1,,val
0543200_as-2516470.jpg,1,0,0,0,1,,test
0543202_as-0030638.jpg,5,2,1,0,8,,train
0543203_as-0030638.jpg,3,0,2,0,5,,train
0543204_as-0030638.jpg,3,3,5,2,13,,train
0543205_as-0030638.jpg,10,3,5,1,19,,train
0543206_as-0053079.jpg,0,1,0,0,1,,train
0543207_as-0053079.jpg,0,0,1,0,1,,train
0543208_as-0053079.jpg,0,0,1,0,1,,train
0543209_as-0053079.jpg,0,0,1,0,1,,val
0543210_as-0053079.jpg,0,0,1,0,1,,val
0543211_sc-1038992.jpg,5,2,0,0,7,,test
0543212_sc-1038992.jpg,4,1,0,1,6,,train
0543214_sc-1012115.jpg,1,1,0,0,2,,train
0543216_as-0089728.jpg,2,0,0,0,2,,train
0543217_as-0089728.jpg,2,0,0,0,2,,train
0543218_as-0089728.jpg,3,0,0,0,3,,train
0543219_as-0089728.jpg,2,0,0,0,2,,train
0543220_sc-153647.jpg,3,0,1,0,4,,train
0543224_sc-153647.jpg,4,0,0,0,4,,val
0543225_sc-153647.jpg,2,0,0,0,2,,val
0543226_sc-153647.jpg,7,0,1,0,8,,test
0543227_as-0029111.jpg,2,0,1,0,3,,train
0543228_as-0029111.jpg,2,0,0,0,2,,train
0543230_sc-1013913.jpg,1,0,1,1,3,,train
0543231_sc-1013913.jpg,1,0,1,0,2,,train
0543232_sc-1004330.jpg,1,0,0,0,1,,train
0543234_as-0001434.jpg,1,0,0,0,1,,train
0543238_sc-164283.jpg,1,0,0,1,2,,train
0543239_sc-164283.jpg,2,1,0,1,4,,val
0543240_sc-164283.jpg,3,1,0,1,5,,val
0543243_as-0050541.jpg,1,0,0,0,1,,test
0543244_as-0050541.jpg,1,0,0,0,1,,train
0543245_as-0050541.jpg,1,0,0,0,1,,train
0543246_as-0050541.jpg,0,0,0,1,1,,train
0543247_as-0050541.jpg,1,0,0,0,1,,train
0543248_as-0050541.jpg,1,0,1,0,2,,train
0543249_as-0050541.jpg,1,0,2,1,4,,train
0543250_as-0050541.jpg,1,0,0,1,2,,train
0543251_as-0050541.jpg,1,0,0,1,2,,val
0543253_as-0050541.jpg,1,0,0,1,2,,val
0543254_as-0050541.jpg,1,0,0,1,2,,test
0543255_as-0050541.jpg,1,0,1,1,3,,train
0543256_as-0050541.jpg,1,0,1,1,3,,train
0543257_as-0050541.jpg,3,0,1,1,5,,train
0543258_as-0050541.jpg,3,0,1,2,6,,train
0543259_as-0050541.jpg,1,0,1,2,4,,train
0543260_as-0050541.jpg,1,0,1,1,3,,train
0543261_as-0050541.jpg,1,0,1,1,3,,train
0543262_as-0050541.jpg,1,0,1,1,3,,val
0543263_as-0050541.jpg,4,0,0,1,5,,val
0543264_as-0050541.jpg,1,0,0,1,2,,test
0543265_as-0050541.jpg,1,0,1,1,3,,train
0543266_as-0050541.jpg,1,0,0,0,1,,train
0543267_as-0050541.jpg,1,0,0,0,1,,train
0543268_as-0050541.jpg,1,0,0,0,1,,train
0543269_as-7327009.jpg,2,0,1,0,3,,train
0543270_as-2728128.jpg,1,0,1,0,2,,train
0543271_as-2948603.jpg,1,0,0,0,1,,train
0543272_as-7958401.jpg,1,0,0,0,1,,val
0543273_sc-225240.jpg,1,0,1,1,3,,val
0543274_sc-225240.jpg,3,0,0,0,3,,test
0543275_sc-225240.jpg,4,0,1,2,7,,train
0543276_sc-225240.jpg,5,0,1,2,8,,train
0543277_sc-225240.jpg,6,0,1,2,9,,train
0543278_sc-225240.jpg,4,0,1,1,6,,train
0543279_sc-225240.jpg,2,0,0,2,4,,train
0543280_sc-225240.jpg,2,0,0,2,4,,train
0543281_sc-225240.jpg,2,0,0,2,4,,train
0543282_as-0075963.jpg,0,0,1,0,1,,val
0543284_as-0035590.jpg,3,0,0,1,4,,val
0543285_as-0035590.jpg,5,0,0,1,6,,test
0543286_sc-136953.jpg,1,0,0,0,1,,train
0543287_sc-136953.jpg,1,0,0,0,1,,train
0543290_sc-229865.jpg,3,1,0,0,4,,train
0543291_sc-108313.jpg,1,1,0,0,2,,train
0543292_sc-108313.jpg,1,1,0,0,2,,train
0543293_sc-108313.jpg,3,1,0,0,4,,train
0543294_sc-108313.jpg,0,1,0,0,1,,train
0543295_sc-108313.jpg,3,1,0,0,4,,val
0543296_sc-108313.jpg,3,1,0,0,4,,val
0543297_sc-1022963.jpg,2,0,0,0,2,,test
0543298_as-9079910.jpg,1,0,0,0,1,,train
0543299_sc-219914.jpg,1,0,1,1,3,,train
0543300_as-0003251.jpg,2,0,0,0,2,,train
0543301_sc-164386.jpg,4,0,0,0,4,,train
0543302_sc-164386.jpg,2,0,0,0,2,,train
0543303_sc-164386.jpg,2,0,0,0,2,,train
0543305_sc-1005562.jpg,3,0,1,0,4,,train
0543306_sc-1005562.jpg,2,0,0,0,2,,val
0543308_sc-198765.jpg,3,0,0,0,3,,val
0543309_sc-198765.jpg,5,0,1,1,7,,test
0543311_sc-143889.jpg,1,0,0,0,1,,train
0543312_sc-143889.jpg,1,0,1,0,2,,train
0543313_sc-143889.jpg,1,0,0,0,1,,train
0543314_sc-143889.jpg,1,0,0,0,1,,train
0543315_sc-143889.jpg,1,0,0,0,1,,train
0543316_sc-143889.jpg,1,1,0,0,2,,train
0543317_sc-143889.jpg,2,0,0,0,2,,train
0543319_sc-164734.jpg,0,1,0,0,1,,val
0543321_sc-1014581.jpg,7,1,2,0,10,,val
0543322_sc-1014581.jpg,4,1,1,0,6,,test
0543325_as-3059030.jpg,1,1,0,0,2,,train
0543328_as-0024131.jpg,1,0,0,0,1,,train
0543329_as-0000126.jpg,0,1,0,0,1,,train
0543330_as-0000126.jpg,0,1,0,0,1,,train
0543331_as-0000126.jpg,0,1,0,0,1,,train
0543332_as-0000126.jpg,1,0,1,0,2,,train
0543333_as-0000126.jpg,1,0,1,0,2,,train
0543334_as-0000126.jpg,0,1,1,0,2,,val
0543335_as-0000126.jpg,0,1,1,0,2,,val
0543336_as-0000126.jpg,1,0,0,0,1,,test
0543337_as-0000126.jpg,1,1,0,0,2,,train
0543338_as-0000126.jpg,1,0,1,0,2,,train
0543339_as-0000126.jpg,1,0,0,0,1,,train
0543340_as-0000126.jpg,1,0,2,0,3,,train
0543342_as-0000126.jpg,1,0,1,0,2,,train
0543343_as-0000126.jpg,1,0,1,0,2,,train
0543344_as-0000126.jpg,0,1,1,0,2,,train
0543345_as-0000126.jpg,1,0,0,0,1,,val
0543348_as-2936741.jpg,3,0,0,0,3,,val
0543349_sc-1028034.jpg,3,0,1,2,6,,test
0543351_as-0048910.jpg,8,0,1,0,9,,train
0543352_as-0048910.jpg,2,0,1,0,3,,train
0543353_as-0048910.jpg,1,0,1,0,2,,train
0543354_as-0048910.jpg,1,1,0,0,2,,train
0543355_as-0048910.jpg,4,2,0,0,6,,train
0543356_as-0048910.jpg,3,2,2,0,7,,train
0543357_as-0048910.jpg,2,1,2,0,5,,train
0543358_as-0048910.jpg,4,1,1,0,6,,val
0543359_as-0048910.jpg,5,1,0,0,6,,val
0543360_as-0048910.jpg,2,1,0,0,3,,test
0543361_as-0048910.jpg,0,0,1,0,1,,train
0543362_as-0048910.jpg,2,1,2,0,5,,train
0543363_as-0048910.jpg,0,1,1,0,2,,train
0543364_as-0048910.jpg,0,1,1,0,2,,train
0543365_as-0048910.jpg,0,1,1,0,2,,train
0543366_as-0048910.jpg,0,1,1,0,2,,train
0543367_as-0048910.jpg,4,1,2,0,7,,train
0543369_as-2752556.jpg,2,0,0,0,2,,val
0543370_sc-140702.jpg,1,0,0,0,1,,val
0543371_sc-140702.jpg,1,0,0,0,1,,test
0543372_sc-140702.jpg,2,0,0,0,2,,train
0543373_sc-140702.jpg,1,0,0,0,1,,train
0543375_sc-171646.jpg,4,1,1,0,6,,train
0543376_sc-171646.jpg,4,1,1,0,6,,train
0543377_sc-171646.jpg,1,1,1,0,3,,train
0543378_sc-171646.jpg,1,0,0,0,1,,train
0543379_as-0088086.jpg,1,0,0,0,1,,train
0543380_as-0088086.jpg,1,0,0,0,1,,val
0543381_as-0008400.jpg,1,1,1,0,3,,val
0543384_as-2827944.jpg,2,0,1,0,3,,test
0543385_sc-190584.jpg,1,1,0,0,2,,train
0543386_sc-190584.jpg,1,1,0,0,2,,train
0543387_sc-210172.jpg,4,1,0,1,6,,train
0543388_sc-210172.jpg,4,1,0,1,6,,train
0543389_sc-210172.jpg,2,0,0,1,3,,train
0543390_sc-210172.jpg,2,1,0,0,3,,train
0543391_sc-210172.jpg,1,0,1,0,2,,train
0543392_as-0044846.jpg,6,0,0,0,6,,val
0543393_sc-116905.jpg,2,3,1,1,7,,val
0543394_sc-116905.jpg,2,1,1,1,5,,test
0543395_sc-116905.jpg,2,0,1,2,5,,train
0543397_as-0030214.jpg,1,1,1,2,5,,train
0543398_as-0030214.jpg,2,1,1,1,5,,train
0543399_as-0030214.jpg,1,1,1,2,5,,train
0543401_sc-1030944.jpg,1,1,1,1,4,,train
0543402_sc-1030944.jpg,1,1,1,1,4,,train
0543403_sc-1030944.jpg,1,1,1,1,4,,train
0543404_sc-114882.jpg,0,0,1,0,1,,val
0543406_as-0021643.jpg,3,0,0,1,4,,val
0543407_as-0021643.jpg,2,0,1,0,3,,test
0543408_as-0021643.jpg,0,0,1,0,1,,train
0543409_as-0021643.jpg,7,0,0,1,8,,train
0543410_sc-1040889.jpg,1,0,0,0,1,,train
0543411_sc-1040889.jpg,1,0,0,0,1,,train
0543412_sc-1040889.jpg,3,0,0,0,3,,train
0543413_sc-1040889.jpg,1,0,0,0,1,,train
0543414_sc-1040889.jpg,6,0,0,0,6,,train
0543415_sc-177100.jpg,4,0,0,0,4,,val
0543416_as-3373885.jpg,1,1,0,0,2,,val
0543421_as-7594454.jpg,2,0,1,0,3,,test
0543422_as-7594454.jpg,1,0,0,0,1,,train
0543424_as-0056773.jpg,0,1,0,0,1,,train
0543425_as-0056773.jpg,0,1,0,0,1,,train
0543426_sc-149193.jpg,1,0,0,0,1,,train
0543427_sc-149193.jpg,1,0,0,0,1,,train
0543428_as-2870446.jpg,3,0,0,2,5,,train
0543429_as-7443754.jpg,0,0,1,1,2,,train
0543432_sc-124847.jpg,1,0,0,0,1,,val
0543433_as-3176341.jpg,2,0,1,0,3,,val
0543435_sc-209755.jpg,0,1,1,0,2,,test
0543438_as-2857641.jpg,1,0,1,0,2,,train
0543439_sc-1023345.jpg,1,0,1,0,2,,train
0543440_sc-1023345.jpg,2,0,0,0,2,,train
0543441_sc-1023345.jpg,2,0,0,1,3,,train
0543442_sc-1023345.jpg,1,0,0,0,1,,train
0543443_sc-1023345.jpg,1,0,0,0,1,,train
0543444_sc-1023345.jpg,2,0,0,0,2,,train
0543445_sc-1023345.jpg,1,0,0,1,2,,val
0543446_as-0071114.jpg,1,0,0,0,1,,val
0543447_as-0071114.jpg,0,0,0,1,1,,test
0543448_as-0034805.jpg,1,1,0,0,2,,train
0543449_as-0034805.jpg,0,1,0,0,1,,train
0543450_as-0069834.jpg,9,0,1,1,11,,train
0543451_as-0069834.jpg,4,0,0,1,5,,train
0543452_as-7770457.jpg,0,0,1,1,2,,train
0543453_sc-227929.jpg,5,0,0,0,5,,train
0543454_as-2719658.jpg,3,0,0,0,3,,train
0543455_sc-159063.jpg,2,0,0,0,2,,val
0543456_sc-159063.jpg,3,1,2,0,6,,val
0543457_sc-159063.jpg,0,0,0,1,1,,test
0543458_sc-159063.jpg,1,0,0,1,2,,train
0543459_sc-159063.jpg,5,0,0,0,5,,train
0543460_sc-159063.jpg,2,1,1,0,4,,train
0543461_as-3336418.jpg,1,0,0,0,1,,train
0543464_as-3477195.jpg,1,0,0,0,1,,train
0543465_as-3332680.jpg,2,0,1,2,5,,train
0543466_as-0067110.jpg,6,1,1,1,9,,train
0543468_as-0067110.jpg,2,0,0,0,2,,val
0543469_as-7797972.jpg,1,0,0,0,1,,val
0543471_sc-107423.jpg,2,1,0,1,4,,test
0543472_sc-107423.jpg,1,1,0,1,3,,train
0543474_sc-1004044.jpg,2,0,0,0,2,,train
0543475_sc-1004044.jpg,2,0,0,0,2,,train
0543476_sc-1004044.jpg,1,0,0,0,1,,train
0543477_sc-196291.jpg,2,0,0,0,2,,train
0543478_sc-196291.jpg,2,0,0,0,2,,train
0543479_sc-196291.jpg,2,0,0,0,2,,train
0543480_sc-196291.jpg,2,0,0,1,3,,val
0543481_as-7788434.jpg,1,1,2,0,4,,val
0543482_as-3445031.jpg,4,0,0,1,5,,test
0543484_as-0061362.jpg,3,0,0,0,3,,train
0543485_as-0061362.jpg,0,0,1,0,1,,train
0543486_as-0061362.jpg,0,0,1,0,1,,train
0543488_sc-213763.jpg,2,0,0,0,2,,train
0543490_as-0013870.jpg,1,0,0,0,1,,train
0543491_as-0013870.jpg,1,0,1,0,2,,train
0543492_as-0013870.jpg,0,0,1,0,1,,train
0543494_sc-201336.jpg,1,1,3,1,6,,val
0543495_sc-201336.jpg,1,0,1,0,2,,val
0543496_sc-201336.jpg,1,1,2,0,4,,test
0543498_as-7109529.jpg,0,1,0,0,1,,train
0543499_as-3469094.jpg,8,0,0,0,8,,train
0543500_as-3184401.jpg,1,1,0,0,2,,train
0543502_sc-177006.jpg,1,0,0,0,1,,train
0543503_sc-177006.jpg,1,0,0,0,1,,train
0543504_as-0021464.jpg,1,0,1,0,2,,train
0543505_sc-221221.jpg,1,0,1,1,3,,train
0543506_sc-221221.jpg,2,0,2,1,5,,val
0543507_sc-221221.jpg,1,1,3,1,6,,val
0543508_sc-1040228.jpg,5,0,1,0,6,,test
0543510_sc-1032070.jpg,4,0,0,1,5,,train
0543511_sc-1032070.jpg,1,0,0,1,2,,train
0543512_sc-1032070.jpg,1,0,0,1,2,,train
0543513_sc-1032070.jpg,2,0,1,0,3,,train
0543514_sc-194252.jpg,2,0,0,0,2,,train
0543515_as-2668937.jpg,3,0,1,0,4,,train
0543516_sc-1008288.jpg,1,1,1,1,4,,train
0543517_sc-1008288.jpg,1,0,0,0,1,,val
0543518_sc-1008288.jpg,1,0,0,0,1,,val
0543519_sc-1008288.jpg,1,0,1,1,3,,test
0543520_sc-1008288.jpg,1,0,0,1,2,,train
0543521_sc-1008288.jpg,1,0,1,1,3,,train
0543522_sc-1008288.jpg,1,0,0,0,1,,train
0543523_sc-1008288.jpg,1,0,1,0,2,,train
0543526_sc-1008288.jpg,1,1,1,0,3,,train
0543527_sc-1008288.jpg,0,0,0,1,1,,train
0543528_sc-1008288.jpg,0,0,0,1,1,,train
0543529_as-0046593.jpg,1,0,1,1,3,,val
0543530_as-0046593.jpg,1,0,1,1,3,,val
0543531_as-0046593.jpg,3,0,0,0,3,,test
0543532_as-0046593.jpg,6,0,0,0,6,,train
0543533_as-0046593.jpg,1,0,1,1,3,,train
0543534_as-0046593.jpg,1,0,1,0,2,,train
0543535_as-0046593.jpg,1,0,1,0,2,,train
0543536_as-0046593.jpg,1,0,0,0,1,,train
0543537_as-0046593.jpg,1,0,0,0,1,,train
0543538_as-0046593.jpg,1,0,0,0,1,,train
0543539_as-0046593.jpg,2,0,0,0,2,,val
0543540_as-3012636.jpg,2,0,0,0,2,,val
0543541_as-7103304.jpg,3,0,0,0,3,,test
0543544_sc-209464.jpg,2,0,0,0,2,,train
0543546_sc-209464.jpg,5,0,1,0,6,,train
0543548_as-9097223.jpg,0,1,2,2,5,,train
0543549_as-3150034.jpg,1,0,0,0,1,,train
0543550_as-9099839.jpg,2,0,0,2,4,,train
0543552_sc-175271.jpg,2,0,0,0,2,,train
0543554_sc-175271.jpg,2,0,1,0,3,,train
0543555_sc-175271.jpg,1,0,1,1,3,,val
0543556_sc-175271.jpg,1,0,1,1,3,,val
0543559_sc-175271.jpg,1,0,0,1,2,,test
0543560_sc-1038398.jpg,0,0,0,1,1,,train
0543561_sc-1038398.jpg,0,0,0,1,1,,train
0543562_sc-1019842.jpg,3,0,2,0,5,,train
0543563_sc-1019842.jpg,1,0,0,0,1,,train
0543564_sc-1019842.jpg,8,0,2,0,10,,train
0543567_as-2755476.jpg,3,0,0,0,3,,train
0543569_sc-1002630.jpg,6,2,1,2,11,,train
0543570_sc-1002630.jpg,6,1,2,1,10,,val
0543571_sc-1016151.jpg,2,1,1,0,4,,val
0543573_sc-1016151.jpg,2,2,2,0,6,,test
0543574_sc-1016151.jpg,2,2,2,0,6,,train
0543575_as-0032877.jpg,2,0,0,0,2,,train
0543576_as-0032877.jpg,2,0,0,0,2,,train
0543577_as-0032877.jpg,4,0,1,1,6,,train
0543580_sc-170439.jpg,2,1,2,1,6,,train
0543582_sc-1038650.jpg,0,1,0,0,1,,train
0543583_sc-1038650.jpg,0,1,0,0,1,,train
0543584_sc-129029.jpg,5,0,1,0,6,,val
0543586_sc-129029.jpg,6,0,1,0,7,,val
0543587_sc-129029.jpg,5,0,1,0,6,,test
0543588_as-0044707.jpg,2,0,0,2,4,,train
0543589_as-0044707.jpg,2,0,0,2,4,,train
0543590_as-2884027.jpg,0,0,1,0,1,,train
0543591_as-3010986.jpg,1,0,0,0,1,,train
0543592_as-2959293.jpg,5,0,1,0,6,,train
0543593_as-0046626.jpg,0,3,2,0,5,,train
0543595_sc-213450.jpg,2,0,0,0,2,,train
0543596_sc-213450.jpg,1,0,0,0,1,,val
0543597_sc-213450.jpg,2,0,0,0,2,,val
0543598_sc-164493.jpg,1,0,0,0,1,,test
0543599_as-3402638.jpg,1,0,2,0,3,,train
0543600_as-0045313.jpg,2,1,0,0,3,,train
0543601_as-0045313.jpg,2,1,0,0,3,,train
0543602_as-2995203.jpg,2,0,0,0,2,,train
0543604_as-0060575.jpg,1,0,0,0,1,,train
0543605_as-0060575.jpg,1,0,0,0,1,,train
0543606_as-0060575.jpg,1,0,0,0,1,,train
0543608_as-0060575.jpg,1,0,0,0,1,,val
0543609_as-0060575.jpg,3,0,0,0,3,,val
0543610_as-0098044.jpg,5,0,0,0,5,,test
0543611_as-0098044.jpg,4,1,0,0,5,,train
0543612_as-0098044.jpg,3,1,0,0,4,,train
0543613_sc-158605.jpg,0,0,0,1,1,,train
0543614_sc-158605.jpg,2,0,0,1,3,,train
0543615_sc-158605.jpg,2,0,0,1,3,,train
0543616_as-2984095.jpg,0,0,1,0,1,,train
0543617_sc-167677.jpg,3,0,0,1,4,,train
0543618_sc-167677.jpg,2,0,0,1,3,,val
0543619_sc-167677.jpg,3,0,0,1,4,,val
0543620_sc-167677.jpg,2,0,0,1,3,,test
0543621_sc-167677.jpg,1,0,0,0,1,,train
0543622_sc-147817.jpg,4,0,1,1,6,,train
0543623_sc-147817.jpg,5,0,1,1,7,,train
0543625_as-3483964.jpg,3,1,0,0,4,,train
0543626_as-0021202.jpg,2,0,1,0,3,,train
0543627_as-0021202.jpg,1,0,0,0,1,,train
0543628_as-2634472.jpg,0,1,0,0,1,,train
0543632_as-0087856.jpg,1,0,0,0,1,,val
0543633_as-0087856.jpg,2,0,0,0,2,,val
0543634_as-3477271.jpg,1,0,0,0,1,,test
0543635_sc-166339.jpg,5,0,1,1,7,,train
0543636_sc-166339.jpg,3,0,1,1,5,,train
0543637_sc-166339.jpg,2,0,2,1,5,,train
0543638_sc-166339.jpg,2,0,1,1,4,,train
0543641_sc-166339.jpg,2,0,1,1,4,,train
0543642_sc-166339.jpg,3,0,1,1,5,,train
0543643_sc-166339.jpg,0,0,1,0,1,,train
0543644_sc-168945.jpg,1,0,0,0,1,,val
0543645_as-7214274.jpg,2,0,0,0,2,,val
0543646_as-2978818.jpg,1,1,0,0,2,,test
0543647_sc-1013121.jpg,1,0,0,0,1,,train
0543649_sc-133354.jpg,1,1,0,1,3,,train
0543650_sc-201455.jpg,6,0,0,0,6,,train
0543651_sc-201455.jpg,1,0,0,0,1,,train
0543652_sc-206667.jpg,1,0,1,0,2,,train
0543654_as-0072263.jpg,2,1,0,0,3,,train
0543655_as-0072263.jpg,3,1,0,0,4,,train
0543657_sc-139624.jpg,1,0,0,0,1,,val
0543660_sc-139624.jpg,1,0,0,0,1,,val
0543661_sc-139624.jpg,2,1,1,1,5,,test
0543662_sc-139624.jpg,2,1,1,1,5,,train
0543663_sc-223098.jpg,1,0,0,0,1,,train
0543664_sc-223098.jpg,1,0,0,0,1,,train
0543665_sc-223098.jpg,1,0,0,0,1,,train
0543666_sc-1037274.jpg,8,0,0,0,8,,train
0543667_sc-190961.jpg,6,0,0,0,6,,train
0543668_sc-190961.jpg,4,0,0,0,4,,train
0543669_sc-190961.jpg,1,0,1,0,2,,val
0543670_sc-190961.jpg,1,0,0,0,1,,val
0543671_sc-190961.jpg,1,0,0,0,1,,test
0543672_sc-190961.jpg,7,0,0,0,7,,train
0543673_sc-190961.jpg,2,0,0,0,2,,train
0543674_sc-190961.jpg,1,0,0,0,1,,train
0543675_as-3340614.jpg,1,0,0,0,1,,train
0543676_as-0082475.jpg,2,2,0,0,4,,train
0543677_as-2574827.jpg,5,0,0,0,5,,train
0543678_as-3408320.jpg,3,0,0,0,3,,train
0543679_as-0013994.jpg,1,0,2,1,4,,val
0543680_as-0013994.jpg,2,0,2,1,5,,val
0543681_as-0013994.jpg,2,0,1,1,4,,test
0543683_as-0005048.jpg,2,0,0,0,2,,train
0543684_sc-1002610.jpg,1,0,0,0,1,,train
0543685_sc-1023188.jpg,1,0,0,0,1,,train
0543686_as-0000621.jpg,1,0,0,0,1,,train
0543687_as-0000621.jpg,1,0,0,0,1,,train
0543689_as-0050646.jpg,1,1,1,0,3,,train
0543691_sc-130188.jpg,4,1,2,1,8,,train
0543692_sc-130188.jpg,1,0,0,0,1,,val
0543696_sc-168068.jpg,1,1,0,1,3,,val
0543699_sc-173224.jpg,2,0,0,0,2,,test
0543700_sc-173224.jpg,1,0,1,1,3,,train
0543701_sc-173224.jpg,1,0,1,1,3,,train
0543702_as-0091136.jpg,1,0,0,0,1,,train
0543703_as-0091136.jpg,1,1,1,0,3,,train
0543704_sc-206540.jpg,5,0,1,0,6,,train
0543705_sc-206540.jpg,1,0,2,0,3,,train
0543706_sc-206540.jpg,5,0,0,0,5,,train
0543707_sc-206540.jpg,4,0,0,0,4,,val
0543708_sc-111383.jpg,1,0,0,0,1,,val
0543709_sc-111383.jpg,1,0,0,0,1,,test
0543710_as-2773774.jpg,1,0,0,0,1,,train
0543711_sc-143958.jpg,1,0,0,0,1,,train
0543712_sc-143958.jpg,6,1,1,0,8,,train
0543713_sc-143958.jpg,9,0,1,0,10,,train
0543714_as-2855168.jpg,3,0,0,0,3,,train
0543716_as-0021509.jpg,0,1,0,0,1,,train
0543718_sc-1023730.jpg,2,0,0,0,2,,train
0543719_sc-1023730.jpg,1,0,0,0,1,,val
0543720_sc-1010790.jpg,6,0,0,1,7,,val
0543721_sc-1010790.jpg,6,0,0,0,6,,test
0543723_sc-1010790.jpg,3,0,0,1,4,,train
0543724_sc-1010790.jpg,6,0,0,0,6,,train
0543725_as-2503661.jpg,2,0,1,0,3,,train
0543726_as-3403014.jpg,1,0,0,0,1,,train
0543727_as-0019622.jpg,0,0,0,1,1,,train
0543728_as-0019622.jpg,0,0,0,1,1,,train
0543729_as-0005214.jpg,6,3,10,1,20,,train
0543733_as-0005214.jpg,0,0,1,0,1,,val
0543734_as-0005214.jpg,2,0,2,0,4,,val
0543735_as-2652726.jpg,1,0,0,0,1,,test
0543736_sc-213668.jpg,2,0,1,0,3,,train
0543737_sc-213668.jpg,3,0,2,0,5,,train
0543738_sc-213668.jpg,0,0,1,0,1,,train
0543739_sc-213668.jpg,7,0,2,0,9,,train
0543740_as-3450481.jpg,0,0,1,0,1,,train
0543741_as-0032271.jpg,2,0,0,1,3,,train
0543742_as-0032271.jpg,1,0,0,0,1,,train
0543743_as-0032271.jpg,1,0,0,0,1,,val
0543745_sc-176258.jpg,6,0,0,1,7,,val
0543746_sc-218167.jpg,0,0,0,1,1,,test
0543747_sc-218167.jpg,5,0,0,1,6,,train
0543748_sc-218167.jpg,6,0,0,1,7,,train
0543749_sc-128875.jpg,1,1,0,0,2,,train
0543750_sc-128875.jpg,0,1,0,0,1,,train
0543751_sc-1003940.jpg,1,0,0,0,1,,train
0543752_sc-1003940.jpg,1,0,0,0,1,,train
0543753_as-0023768.jpg,2,1,2,0,5,,train
0543754_as-0023768.jpg,2,0,1,0,3,,val
0543755_as-0023768.jpg,5,1,3,0,9,,val
0543756_as-3334964.jpg,2,0,0,0,2,,test
0543761_as-0058926.jpg,2,0,0,0,2,,train
0543762_as-2734743.jpg,2,0,0,0,2,,train
0543763_as-9012337.jpg,1,0,1,0,2,,train
0543764_as-0036930.jpg,10,0,1,1,12,,train
0543765_as-0036930.jpg,3,0,1,2,6,,train
0543766_as-0036930.jpg,3,1,1,2,7,,train
0543767_as-0036930.jpg,6,1,1,1,9,,train
0543768_as-0036930.jpg,4,0,1,1,6,,val
0543769_as-7562250.jpg,3,0,0,0,3,,val
0543770_as-7439323.jpg,1,0,2,1,4,,test
0543771_sc-108053.jpg,1,0,1,0,2,,train
0543772_sc-108053.jpg,2,0,0,0,2,,train
0543773_as-0087633.jpg,3,3,1,0,7,,train
0543774_as-0087633.jpg,1,2,0,0,3,,train
0543775_as-0087633.jpg,1,3,0,0,4,,train
0543776_as-0087633.jpg,1,3,0,0,4,,train
0543777_as-0087633.jpg,3,1,0,0,4,,train
0543778_as-0087633.jpg,1,0,0,0,1,,val
0543779_as-0087633.jpg,3,1,0,0,4,,val
0543780_sc-141926.jpg,3,0,1,1,5,,test
0543781_sc-141926.jpg,2,0,1,1,4,,train
0543782_sc-199906.jpg,0,1,3,0,4,,train
0543783_sc-199906.jpg,0,1,0,0,1,,train
0543784_sc-199906.jpg,0,0,1,0,1,,train
0543786_sc-199906.jpg,2,0,0,1,3,,train
0543787_sc-166759.jpg,3,2,0,0,5,,train
0543788_sc-166759.jpg,4,3,0,0,7,,train
0543790_sc-166759.jpg,4,2,0,1,7,,val
0543791_sc-166759.jpg,6,2,0,0,8,,val
0543792_sc-166759.jpg,3,2,0,1,6,,test
0543793_sc-194246.jpg,4,0,1,0,5,,train
0543794_sc-194246.jpg,3,0,1,0,4,,train
0543795_sc-194246.jpg,3,0,1,0,4,,train
0543796_sc-1006691.jpg,2,0,1,0,3,,train
0543797_as-3137213.jpg,2,0,0,0,2,,train
0543800_as-3494066.jpg,4,0,0,0,4,,train
0543801_as-9028126.jpg,0,1,0,0,1,,train
0543802_as-0046791.jpg,0,1,0,0,1,,val
0543803_as-0046791.jpg,0,1,0,0,1,,val
0543804_as-0046791.jpg,0,1,0,0,1,,test
0543805_as-0046791.jpg,0,1,0,0,1,,train
0543807_as-0028547.jpg,1,0,0,1,2,,train
0543808_as-0028547.jpg,1,0,0,1,2,,train
0543809_as-0028547.jpg,1,0,0,0,1,,train
0543810_as-3318911.jpg,3,1,1,0,5,,train
0543811_as-2653147.jpg,1,0,0,0,1,,train
0543812_sc-206976.jpg,1,0,0,0,1,,train
0543813_sc-206976.jpg,1,0,0,0,1,,val
0543815_as-2926054.jpg,1,0,0,0,1,,val
0543816_as-0001921.jpg,2,0,2,1,5,,test
0543818_as-0001921.jpg,2,0,2,0,4,,train
0543819_as-0001921.jpg,3,0,0,0,3,,train
0543820_as-0001921.jpg,1,1,3,1,6,,train
0543821_as-0001921.jpg,2,0,2,1,5,,train
0543822_as-0001921.jpg,1,0,0,1,2,,train
0543823_sc-1006303.jpg,2,1,0,0,3,,train
0543825_as-0007780.jpg,0,0,2,0,2,,train
0543826_as-3156736.jpg,1,0,0,0,1,,val
0543828_as-0001479.jpg,1,0,0,0,1,,val
0543829_as-0001479.jpg,1,0,0,0,1,,test
0543830_as-0001479.jpg,1,0,0,0,1,,train
0543831_as-0095389.jpg,2,1,2,2,7,,train
0543832_as-0095389.jpg,2,1,1,2,6,,train
0543833_as-0095389.jpg,1,0,0,0,1,,train
0543834_as-0095389.jpg,1,0,1,1,3,,train
0543835_as-0095389.jpg,2,0,0,0,2,,train
0543836_sc-1038086.jpg,0,1,0,0,1,,train
0543837_as-7244988.jpg,3,0,0,0,3,,val
0543838_as-0031128.jpg,2,0,0,0,2,,val
0543839_as-0031128.jpg,3,0,0,0,3,,test
0543840_as-0031128.jpg,2,0,0,0,2,,train
0543841_sc-153663.jpg,1,0,0,0,1,,train
0543842_sc-153663.jpg,1,0,0,0,1,,train
0543843_sc-1005561.jpg,3,0,0,0,3,,train
0543844_as-0036404.jpg,1,0,0,0,1,,train
0543845_as-0036404.jpg,1,0,0,0,1,,train
0543847_as-0036404.jpg,8,0,1,1,10,,train
0543850_as-0038691.jpg,1,0,0,0,1,,val
0543851_as-0038691.jpg,1,0,0,0,1,,val
0543852_as-0038691.jpg,1,0,0,0,1,,test
0543853_as-0038691.jpg,1,0,0,0,1,,train
0543854_as-0038691.jpg,1,0,0,0,1,,train
0543855_as-0038691.jpg,1,0,0,0,1,,train
0543856_as-0038691.jpg,1,0,0,0,1,,train
0543857_as-0038691.jpg,1,0,0,0,1,,train
0543858_as-0038691.jpg,2,0,0,0,2,,train
0543859_as-0038691.jpg,1,1,0,0,2,,train
0543860_as-0072605.jpg,1,0,1,0,2,,val
0543861_as-0072605.jpg,1,0,0,0,1,,val
0543862_as-0072605.jpg,1,0,1,0,2,,test
0543863_as-0033323.jpg,0,0,1,1,2,,train
0543864_as-0033323.jpg,1,1,1,1,4,,train
0543865_as-0033323.jpg,0,0,1,1,2,,train
0543866_as-2705928.jpg,1,0,1,0,2,,train
0543867_sc-118574.jpg,7,0,0,0,7,,train
0543868_sc-138114.jpg,0,1,0,0,1,,train
0543869_sc-138114.jpg,0,1,0,0,1,,train
0543871_as-3311245.jpg,0,0,1,0,1,,val
0543872_as-3178917.jpg,1,1,0,0,2,,val
0543873_as-0033202.jpg,1,0,0,0,1,,test
0543874_sc-141724.jpg,2,0,0,0,2,,train
0543875_sc-141724.jpg,3,0,0,0,3,,train
0543877_sc-141724.jpg,2,0,0,0,2,,train
0543880_sc-227340.jpg,1,0,0,1,2,,train
0543881_sc-1013886.jpg,0,1,1,0,2,,train
0543882_sc-1013886.jpg,0,1,0,0,1,,train
0543883_sc-1013886.jpg,3,0,0,0,3,,train
0543884_sc-1013886.jpg,0,1,1,0,2,,val
0543885_sc-1013886.jpg,2,1,0,0,3,,val
0543887_as-0084404.jpg,6,0,0,0,6,,test
0543888_as-2938643.jpg,1,0,0,0,1,,train
0543889_sc-113512.jpg,2,0,0,1,3,,train
0543890_sc-220238.jpg,1,0,1,0,2,,train
0543891_sc-220238.jpg,5,0,0,0,5,,train
0543892_sc-220238.jpg,2,0,0,0,2,,train
0543893_sc-220238.jpg,1,0,0,0,1,,train
0543894_sc-220238.jpg,3,0,0,0,3,,train
0543895_sc-220238.jpg,1,0,1,0,2,,val
0543896_sc-220238.jpg,1,1,0,1,3,,val
0543897_as-2837000.jpg,1,0,0,0,1,,test
0543898_sc-192867.jpg,1,0,0,0,1,,train
0543899_sc-192867.jpg,1,0,0,0,1,,train
0543900_sc-192867.jpg,3,0,0,0,3,,train
0543901_sc-192867.jpg,3,0,1,0,4,,train
0543902_sc-126783.jpg,2,1,1,1,5,,train
0543903_sc-126783.jpg,1,1,0,1,3,,train
0543904_sc-126783.jpg,3,1,0,1,5,,train
0543905_sc-1031348.jpg,1,0,0,1,2,,val
0543908_as-0058747.jpg,1,1,0,0,2,,val
0543909_as-0058747.jpg,0,1,0,0,1,,test
0543910_as-0058747.jpg,0,1,0,0,1,,train
0543913_as-0059607.jpg,7,3,3,0,13,,train
0543914_as-0059607.jpg,2,0,0,0,2,,train
0543919_as-0043806.jpg,3,0,1,0,4,,train
0543920_as-3258118.jpg,1,0,0,0,1,,train
0543922_sc-1027276.jpg,2,0,0,1,3,,train
0543923_sc-1027276.jpg,5,0,0,0,5,,train
0543925_sc-1027276.jpg,1,0,0,0,1,,val
0543926_sc-1027276.jpg,3,0,0,0,3,,val
0543927_as-7331864.jpg,1,0,0,1,2,,test
0543928_sc-116431.jpg,6,0,0,0,6,,train
0543929_sc-116431.jpg,1,0,0,0,1,,train
0543932_sc-116431.jpg,8,0,0,0,8,,train
0543933_sc-116431.jpg,7,0,1,1,9,,train
0543934_sc-116431.jpg,5,0,1,1,7,,train
0543936_sc-116431.jpg,3,0,0,0,3,,train
0543938_sc-211168.jpg,1,1,0,0,2,,train
0543939_sc-211168.jpg,2,1,0,0,3,,val
0543940_sc-211168.jpg,1,0,0,0,1,,val
0543941_sc-211168.jpg,2,0,0,0,2,,test
0543942_sc-186266.jpg,4,0,0,0,4,,train
0543943_sc-186266.jpg,3,0,0,0,3,,train
0543944_sc-190270.jpg,0,0,0,2,2,,train
0543945_as-7972271.jpg,4,0,0,0,4,,train
0543947_as-0057320.jpg,8,0,0,0,8,,train
0543948_as-0057320.jpg,10,0,0,0,10,,train
0543949_as-0057320.jpg,5,0,0,0,5,,train
0543950_as-0057320.jpg,5,0,0,0,5,,val
0543951_as-0057320.jpg,3,0,0,0,3,,val
0543952_as-0057320.jpg,4,0,0,0,4,,test
0543953_as-0057320.jpg,7,0,0,0,7,,train
0543954_as-0057320.jpg,6,0,0,0,6,,train
0543955_as-0057320.jpg,2,0,0,0,2,,train
0543956_as-0057320.jpg,6,0,0,0,6,,train
0543957_as-2741185.jpg,2,0,0,0,2,,train
0543958_sc-174020.jpg,0,0,0,1,1,,train
0543959_sc-217007.jpg,1,0,0,0,1,,train
0543960_sc-217007.jpg,1,0,0,0,1,,val
0543961_sc-217007.jpg,1,0,0,0,1,,val
0543962_sc-142544.jpg,1,1,2,1,5,,test
0543963_sc-142544.jpg,2,1,1,1,5,,train
0543964_as-3265355.jpg,1,0,0,0,1,,train
0543965_as-0004671.jpg,2,0,0,0,2,,train
0543966_as-0004671.jpg,1,0,0,0,1,,train
0543967_sc-1025495.jpg,1,0,0,0,1,,train
0543969_sc-1025495.jpg,1,0,0,0,1,,train
0543973_sc-126590.jpg,2,1,2,0,5,,train
0543975_sc-134755.jpg,0,1,0,0,1,,val
0543976_sc-134755.jpg,0,1,0,0,1,,val
0543977_sc-134755.jpg,0,1,0,0,1,,test
0543978_sc-196990.jpg,3,1,0,0,4,,train
0543982_as-0060705.jpg,1,1,0,0,2,,train
0543983_as-0060705.jpg,1,1,0,0,2,,train
0543987_as-0060154.jpg,1,0,0,0,1,,train
0543988_as-0060154.jpg,1,0,0,0,1,,train
0543989_as-0067934.jpg,3,0,1,0,4,,train
0543990_as-0067934.jpg,0,0,0,1,1,,train
0543991_as-0067934.jpg,2,1,0,1,4,,val
0543992_as-0067934.jpg,2,1,0,1,4,,val
0543993_sc-133676.jpg,2,0,0,0,2,,test
0543994_sc-140538.jpg,1,1,0,0,2,,train
0543995_sc-140538.jpg,3,0,0,0,3,,train
0543996_sc-140538.jpg,0,0,1,1,2,,train
0543997_sc-140538.jpg,2,0,0,1,3,,train
0543998_sc-140538.jpg,1,0,0,1,2,,train
0544001_as-0069082.jpg,3,0,0,0,3,,train
0544002_as-0069082.jpg,3,1,1,0,5,,train
0544004_as-3087357.jpg,0,0,1,0,1,,val
0544005_sc-171668.jpg,2,0,0,0,2,,val
0544006_sc-171668.jpg,3,0,0,0,3,,test
0544007_sc-171668.jpg,4,0,0,0,4,,train
0544008_sc-171668.jpg,4,0,3,0,7,,train
0544010_as-0045757.jpg,1,1,1,1,4,,train
0544011_sc-1000665.jpg,1,0,1,0,2,,train
0544012_sc-172960.jpg,0,0,1,1,2,,train
0544013_sc-172960.jpg,1,0,1,2,4,,train
0544014_sc-172960.jpg,1,0,1,1,3,,train
0544015_sc-172960.jpg,1,0,0,1,2,,val
0544018_as-0001022.jpg,1,2,0,0,3,,val
0544019_as-0001022.jpg,0,0,1,0,1,,test
0544020_as-0001022.jpg,0,0,1,0,1,,train
0544021_as-0001022.jpg,0,0,2,0,2,,train
0544022_as-0001022.jpg,1,3,0,0,4,,train
0544023_as-0001022.jpg,1,0,0,0,1,,train
0544024_as-2704947.jpg,1,0,0,0,1,,train
0544026_sc-163957.jpg,0,2,0,0,2,,train
0544027_sc-163957.jpg,1,2,1,0,4,,train
0544028_sc-163957.jpg,2,1,0,0,3,,val
0544029_as-0007064.jpg,6,0,1,0,7,,val
0544030_as-0000712.jpg,1,0,2,1,4,,test
0544031_sc-157383.jpg,2,0,0,0,2,,train
0544032_sc-157383.jpg,1,0,0,0,1,,train
0544033_sc-157383.jpg,2,0,0,0,2,,train
0544034_sc-157383.jpg,0,0,1,0,1,,train
0544036_sc-157383.jpg,0,0,1,0,1,,train
0544037_as-7877064.jpg,4,2,0,0,6,,train
0544039_as-7582405.jpg,1,0,2,1,4,,train
0544040_sc-221768.jpg,1,0,0,0,1,,val
0544041_sc-221768.jpg,2,0,0,0,2,,val
0544044_as-0080172.jpg,1,0,0,0,1,,test
0544045_as-0080172.jpg,1,0,0,0,1,,train
0544046_as-0080172.jpg,1,0,0,0,1,,train
0544047_sc-1000159.jpg,0,0,1,0,1,,train
0544048_sc-1000159.jpg,1,0,0,0,1,,train
0544050_as-0080949.jpg,0,1,2,0,3,,train
0544051_as-0080949.jpg,0,1,2,0,3,,train
0544052_sc-124928.jpg,1,0,0,0,1,,train
0544053_sc-130987.jpg,1,1,0,0,2,,val
0544054_sc-130987.jpg,2,1,0,0,3,,val
0544055_sc-1038539.jpg,0,0,1,0,1,,test
0544056_sc-1038539.jpg,1,0,0,0,1,,train
0544057_sc-1038539.jpg,1,0,1,1,3,,train
0544060_sc-135896.jpg,7,0,0,0,7,,train
0544061_sc-135896.jpg,3,0,0,0,3,,train
0544062_sc-135896.jpg,7,0,0,0,7,,train
0544063_sc-135896.jpg,5,0,0,0,5,,train
0544064_as-0065607.jpg,2,0,0,0,2,,train
0544068_as-0065607.jpg,3,2,0,0,5,,val
0544069_as-0065607.jpg,2,1,0,0,3,,val
0544070_as-0065607.jpg,2,1,0,0,3,,test
0544071_as-0065607.jpg,0,2,0,0,2,,train
0544072_as-0065607.jpg,2,1,0,0,3,,train
0544073_as-0065607.jpg,0,1,0,0,1,,train
0544075_as-0065607.jpg,2,0,0,0,2,,train
0544077_as-0065607.jpg,2,0,0,0,2,,train
0544080_as-2589939.jpg,5,0,0,0,5,,train
0544081_sc-213875.jpg,2,0,0,0,2,,train
0544082_sc-213875.jpg,1,0,0,0,1,,val
0544083_as-2502960.jpg,2,0,0,0,2,,val
0544084_as-3245666.jpg,1,0,0,0,1,,test
0544085_as-3355667.jpg,2,2,2,1,7,,train
0544091_as-0076004.jpg,4,0,0,0,4,,train
0544092_sc-167336.jpg,0,0,0,1,1,,train
0544094_sc-207149.jpg,1,1,2,0,4,,train
0544095_sc-207149.jpg,2,1,1,0,4,,train
0544096_sc-207149.jpg,0,0,1,0,1,,train
0544098_sc-138157.jpg,5,2,0,2,9,,train
0544100_sc-138157.jpg,4,2,0,1,7,,val
0544101_sc-138157.jpg,3,1,0,2,6,,val
0544102_sc-143468.jpg,4,0,0,0,4,,test
0544103_as-2943933.jpg,2,0,0,0,2,,train
0544104_as-3389112.jpg,1,0,0,0,1,,train
0544105_as-2527248.jpg,1,0,1,0,2,,train
0544106_sc-1005319.jpg,1,0,1,1,3,,train
0544107_sc-1005319.jpg,1,0,0,1,2,,train
0544108_sc-1005319.jpg,2,0,0,1,3,,train
0544109_sc-1005319.jpg,2,0,0,1,3,,train
0544113_sc-1004528.jpg,1,0,0,0,1,,val
0544115_sc-1004528.jpg,2,0,0,0,2,,val
0544117_sc-165736.jpg,1,2,0,1,4,,test
0544118_sc-165736.jpg,2,1,0,1,4,,train
0544119_sc-1022206.jpg,2,0,0,0,2,,train
0544120_sc-1022206.jpg,2,0,0,0,2,,train
0544122_as-3385569.jpg,3,0,0,0,3,,train
0544123_as-7931167.jpg,1,0,0,2,3,,train
0544124_sc-154732.jpg,1,0,0,0,1,,train
0544125_sc-154732.jpg,1,0,0,0,1,,train
0544126_sc-154732.jpg,1,0,0,0,1,,val
0544127_sc-1030186.jpg,1,0,0,0,1,,val
0544128_sc-1030186.jpg,1,0,0,0,1,,test
0544129_as-0098850.jpg,1,0,1,0,2,,train
0544130_as-0098850.jpg,1,0,0,2,3,,train
0544132_sc-205282.jpg,2,2,1,0,5,,train
0544135_as-0010728.jpg,1,0,0,0,1,,train
0544136_as-7629639.jpg,4,0,0,0,4,,train
0544137_as-0003142.jpg,1,0,0,0,1,,train
0544138_as-0003142.jpg,1,0,0,0,1,,train
0544139_as-7021257.jpg,5,0,0,0,5,,val
0544140_as-2807431.jpg,3,0,0,0,3,,val
0544141_as-0025014.jpg,4,1,0,0,5,,test
0544142_as-0025014.jpg,1,0,0,0,1,,train
0544143_sc-220144.jpg,10,0,0,0,10,,train
0544146_as-0058725.jpg,1,0,0,0,1,,train
0544148_as-0058725.jpg,2,0,0,0,2,,train
0544149_as-0058725.jpg,2,0,0,0,2,,train
0544150_sc-197665.jpg,1,0,0,0,1,,train
0544151_sc-197665.jpg,1,0,1,0,2,,train
0544152_sc-197665.jpg,2,0,2,0,4,,val
0544153_as-7688882.jpg,2,0,2,0,4,,val
0544154_sc-120114.jpg,1,0,0,0,1,,test
0544155_sc-120114.jpg,1,0,0,0,1,,train
0544156_sc-120114.jpg,1,0,0,0,1,,train
0544157_sc-120114.jpg,1,0,0,0,1,,train
0544158_sc-1007419.jpg,1,1,1,0,3,,train
0544159_sc-1012608.jpg,4,0,0,0,4,,train
0544161_sc-1012608.jpg,3,0,0,0,3,,train
0544162_sc-1012608.jpg,4,0,0,1,5,,train
0544163_sc-1024696.jpg,2,0,0,0,2,,val
0544164_sc-1024696.jpg,2,0,0,0,2,,val
0544169_as-0041214.jpg,0,0,1,1,2,,test
0544170_as-0041214.jpg,0,0,1,0,1,,train
0544171_as-2805301.jpg,1,0,0,0,1,,train
0544172_sc-129380.jpg,3,0,0,0,3,,train
0544173_sc-129380.jpg,4,0,0,0,4,,train
0544174_sc-129380.jpg,2,0,0,0,2,,train
0544175_sc-216104.jpg,1,0,0,2,3,,train
0544176_sc-216104.jpg,1,0,0,1,2,,train
0544177_sc-1012074.jpg,3,0,0,1,4,,val
0544178_sc-1012074.jpg,1,0,0,0,1,,val
0544179_sc-1012074.jpg,4,0,0,0,4,,test
0544180_sc-1012074.jpg,2,0,0,0,2,,train
0544181_sc-184320.jpg,4,1,0,0,5,,train
0544182_sc-205750.jpg,1,0,0,0,1,,train
0544183_sc-205750.jpg,1,0,1,0,2,,train
0544184_sc-205750.jpg,1,0,1,0,2,,train
0544185_as-3494655.jpg,5,0,1,0,6,,train
0544188_sc-203109.jpg,2,0,1,0,3,,train
0544190_as-7023961.jpg,1,1,1,1,4,,val
0544191_as-0099838.jpg,1,0,0,0,1,,val
0544192_as-0099838.jpg,1,0,0,0,1,,test
0544193_as-0099838.jpg,1,0,0,0,1,,train
0544196_sc-223082.jpg,1,1,0,0,2,,train
0544197_sc-223082.jpg,1,1,0,0,2,,train
0544198_sc-223082.jpg,1,1,0,0,2,,train
0544199_sc-223082.jpg,4,0,0,1,5,,train
0544200_sc-223082.jpg,2,0,0,1,3,,train
0544201_sc-223082.jpg,2,0,0,0,2,,train
0544202_as-0017942.jpg,4,0,0,0,4,,val
0544203_as-0017942.jpg,5,0,0,0,5,,val
0544204_as-0017942.jpg,4,0,0,0,4,,test
0544205_as-0017942.jpg,1,0,0,0,1,,train
0544207_as-3187611.jpg,1,1,3,2,7,,train
0544208_sc-140275.jpg,3,0,0,0,3,,train
0544209_sc-140275.jpg,2,0,0,0,2,,train
0544210_sc-140275.jpg,2,0,0,0,2,,train
0544211_sc-140275.jpg,0,0,0,1,1,,train
0544212_sc-140275.jpg,0,0,0,1,1,,train
0544213_sc-140275.jpg,7,1,1,1,10,,val
0544214_sc-140275.jpg,4,0,1,0,5,,val
0544215_sc-140275.jpg,1,1,1,1,4,,test
0544216_sc-140275.jpg,3,2,0,1,6,,train
0544217_sc-140275.jpg,1,0,0,1,2,,train
0544218_sc-140275.jpg,1,0,0,0,1,,train
0544219_sc-140275.jpg,1,0,0,0,1,,train
0544221_as-0006157.jpg,2,2,0,0,4,,train
0544222_as-0006157.jpg,2,2,0,0,4,,train
0544223_as-0006157.jpg,0,1,0,0,1,,train
0544228_sc-112768.jpg,4,1,0,0,5,,val
0544229_sc-112768.jpg,2,1,1,2,6,,val
0544230_sc-112768.jpg,3,1,1,1,6,,test
0544231_sc-112768.jpg,1,1,1,0,3,,train
0544235_as-0068438.jpg,15,1,1,0,17,,train
0544236_as-0068438.jpg,2,1,0,0,3,,train
0544237_as-0068438.jpg,2,0,0,0,2,,train
0544238_as-0068438.jpg,1,0,0,0,1,,train
0544239_as-3283503.jpg,0,0,1,0,1,,train
0544241_as-0082869.jpg,4,1,0,1,6,,train
0544242_as-0082869.jpg,4,1,1,1,7,,val
0544244_as-0082869.jpg,2,0,0,0,2,,val
0544245_as-0082869.jpg,3,0,0,0,3,,test
0544248_as-0082869.jpg,1,1,0,0,2,,train
0544249_as-0082869.jpg,3,1,1,2,7,,train
0544255_as-0082869.jpg,2,1,0,2,5,,train
0544256_as-7354218.jpg,1,0,0,0,1,,train
0544257_sc-1012149.jpg,1,0,1,0,2,,train
0544258_sc-1012149.jpg,1,0,0,1,2,,train
0544259_sc-1012149.jpg,1,0,1,1,3,,train
0544261_sc-156594.jpg,2,0,1,0,3,,val
0544262_sc-156594.jpg,1,0,2,1,4,,val
0544263_sc-156594.jpg,1,0,0,0,1,,test
0544264_sc-156594.jpg,2,1,0,0,3,,train
0544265_sc-1011027.jpg,1,0,0,0,1,,train
0544266_sc-1011027.jpg,0,0,1,0,1,,train
0544267_as-7016636.jpg,2,1,1,1,5,,train
0544268_sc-103496.jpg,2,0,1,1,4,,train
0544269_sc-103496.jpg,4,2,2,5,13,,train
0544270_sc-103496.jpg,2,2,2,1,7,,train
0544271_sc-103496.jpg,2,2,1,0,5,,val
0544272_sc-150961.jpg,3,0,0,0,3,,val
0544275_as-3041126.jpg,1,0,0,1,2,,test
0544276_sc-196636.jpg,4,0,0,0,4,,train
0544277_sc-196636.jpg,3,0,0,0,3,,train
0544278_as-7490416.jpg,0,0,2,1,3,,train
0544279_sc-225683.jpg,1,1,0,0,2,,train
0544280_sc-225683.jpg,1,0,0,0,1,,train
0544281_sc-225683.jpg,1,0,0,0,1,,train
0544282_sc-225683.jpg,1,0,0,0,1,,train
0544283_sc-225683.jpg,1,0,0,0,1,,val
0544284_sc-194035.jpg,1,0,0,0,1,,val
0544285_as-3140233.jpg,1,0,0,0,1,,test
0544286_as-3106901.jpg,3,0,0,0,3,,train
0544287_sc-131545.jpg,1,0,0,0,1,,train
0544288_sc-131545.jpg,1,0,0,0,1,,train
0544291_sc-1039831.jpg,1,0,0,1,2,,train
0544292_as-0032517.jpg,6,0,1,0,7,,train
0544294_as-0032517.jpg,5,0,1,0,6,,train
0544295_as-0032517.jpg,5,0,0,0,5,,train
0544296_as-0029417.jpg,1,0,1,0,2,,val
0544297_as-0029417.jpg,0,1,0,0,1,,val
0544298_sc-120926.jpg,4,1,0,0,5,,test
0544299_sc-221107.jpg,1,1,0,0,2,,train
0544300_sc-221107.jpg,0,0,1,0,1,,train
0544301_as-0039631.jpg,1,1,2,1,5,,train
0544302_as-0039631.jpg,0,0,2,0,2,,train
0544304_as-0039631.jpg,0,1,2,1,4,,train
0544305_as-0039631.jpg,0,0,1,0,1,,train
0544306_as-0039631.jpg,1,0,0,0,1,,train
0544307_sc-148945.jpg,0,1,0,0,1,,val
0544308_sc-148945.jpg,0,1,0,0,1,,val
0544309_sc-148945.jpg,1,1,0,0,2,,test
0544310_sc-148945.jpg,1,0,0,0,1,,train
0544311_sc-148945.jpg,1,0,0,0,1,,train
0544312_sc-148945.jpg,1,0,0,0,1,,train
0544316_as-0040867.jpg,0,1,0,0,1,,train
0544317_as-0040867.jpg,1,2,1,1,5,,train
0544321_as-0040867.jpg,0,1,1,0,2,,train
0544323_as-2621226.jpg,1,0,2,1,4,,train
0544325_as-0077556.jpg,2,0,0,0,2,,val
0544326_as-0077556.jpg,1,0,0,0,1,,val
0544329_as-0072931.jpg,2,1,1,2,6,,test
0544330_as-0072931.jpg,1,1,1,1,4,,train
0544332_sc-143363.jpg,1,0,0,0,1,,train
0544333_sc-143363.jpg,3,0,0,0,3,,train
0544334_as-0023372.jpg,0,0,1,1,2,,train
0544335_as-9086240.jpg,1,0,2,0,3,,train
0544337_sc-141058.jpg,4,1,0,0,5,,train
0544338_sc-141058.jpg,6,0,0,0,6,,train
0544339_as-7171546.jpg,0,0,0,1,1,,val
0544340_sc-1007318.jpg,1,0,1,0,2,,val
0544341_sc-1007318.jpg,2,0,1,0,3,,test
0544342_sc-141155.jpg,3,0,0,0,3,,train
0544344_as-3086956.jpg,1,0,0,0,1,,train
0544345_sc-180078.jpg,0,2,0,1,3,,train
0544346_sc-180078.jpg,0,1,0,1,2,,train
0544347_sc-180078.jpg,3,1,0,0,4,,train
0544348_sc-180078.jpg,1,2,0,0,3,,train
0544349_sc-180078.jpg,3,2,0,0,5,,train
0544350_sc-180078.jpg,1,0,0,0,1,,val
0544351_sc-180078.jpg,8,1,0,3,12,,val
0544352_sc-226423.jpg,2,1,0,0,3,,test
0544353_sc-226423.jpg,5,0,0,0,5,,train
0544354_sc-226423.jpg,2,1,0,0,3,,train
0544355_sc-206581.jpg,2,0,0,0,2,,train
0544356_as-0004028.jpg,0,1,0,0,1,,train
0544357_as-7927343.jpg,2,1,2,1,6,,train
0544358_as-7214321.jpg,0,0,2,0,2,,train
0544359_sc-205013.jpg,1,1,0,0,2,,train
0544360_sc-205013.jpg,1,1,0,1,3,,val
0544361_sc-205013.jpg,0,1,2,1,4,,val
0544362_sc-205013.jpg,0,1,2,0,3,,test
0544363_sc-205013.jpg,0,1,1,0,2,,train
0544364_sc-205013.jpg,2,1,1,1,5,,train
0544365_sc-205013.jpg,0,1,1,0,2,,train
0544366_sc-205013.jpg,1,3,0,0,4,,train
0544367_sc-205013.jpg,1,1,1,1,4,,train
0544368_sc-205013.jpg,0,1,0,0,1,,train
0544370_sc-181038.jpg,1,0,0,0,1,,train
0544371_sc-181038.jpg,1,0,0,0,1,,val
0544373_as-3350515.jpg,3,0,1,0,4,,val
0544374_as-3332134.jpg,1,0,1,0,2,,test
0544375_as-7786992.jpg,5,0,0,1,6,,train
0544377_sc-169757.jpg,0,0,1,0,1,,train
0544380_sc-169757.jpg,2,0,0,0,2,,train
0544381_as-0034694.jpg,1,0,0,0,1,,train
0544382_as-0034694.jpg,0,0,1,0,1,,train
0544383_as-0034694.jpg,0,0,1,0,1,,train
0544384_as-0034694.jpg,0,0,1,0,1,,train
0544385_as-0034694.jpg,0,2,0,0,2,,val
0544386_sc-1025298.jpg,2,0,1,0,3,,val
0544389_sc-177300.jpg,2,1,0,1,4,,test
0544390_as-2908403.jpg,7,0,1,0,8,,train
0544391_sc-137619.jpg,3,1,0,0,4,,train
0544392_sc-137619.jpg,1,0,0,0,1,,train
0544393_sc-137619.jpg,2,1,0,0,3,,train
0544394_sc-137619.jpg,1,0,0,0,1,,train
0544395_sc-137619.jpg,1,0,0,0,1,,train
0544396_sc-137619.jpg,1,0,0,0,1,,train
0544397_sc-137619.jpg,1,1,0,0,2,,val
0544398_sc-1006058.jpg,2,0,0,0,2,,val
0544399_as-0005964.jpg,1,0,0,0,1,,test
0544401_as-0005964.jpg,0,0,0,1,1,,train
0544402_sc-1036671.jpg,5,0,2,1,8,,train
0544403_sc-1036671.jpg,2,0,1,1,4,,train
0544404_sc-1036671.jpg,1,0,1,0,2,,train
0544405_as-2889423.jpg,1,0,1,1,3,,train
0544406_as-0074095.jpg,3,0,0,0,3,,train
0544407_as-0074095.jpg,3,0,0,0,3,,train
0544408_as-0074095.jpg,2,0,0,0,2,,val
0544409_as-0055822.jpg,1,0,0,0,1,,val
0544410_as-0055822.jpg,1,0,1,0,2,,test
0544411_as-0055822.jpg,0,0,1,0,1,,train
0544415_as-0066472.jpg,2,0,0,1,3,,train
0544416_as-0066472.jpg,2,0,0,1,3,,train
0544418_as-0066472.jpg,2,0,0,1,3,,train
0544419_as-0066472.jpg,2,0,0,1,3,,train
0544420_as-0066472.jpg,5,0,0,1,6,,train
0544425_as-0026980.jpg,1,0,0,0,1,,train
0544426_as-0026980.jpg,1,0,0,0,1,,val
0544427_as-0052927.jpg,1,0,0,0,1,,val
0544428_as-0052927.jpg,3,0,0,0,3,,test
0544429_as-0052927.jpg,2,0,1,0,3,,train
0544430_as-0052927.jpg,5,0,0,0,5,,train
0544431_as-2983695.jpg,3,0,0,1,4,,train
0544432_sc-213206.jpg,1,0,0,0,1,,train
0544433_sc-213206.jpg,1,0,0,0,1,,train
0544434_sc-213206.jpg,2,0,0,0,2,,train
0544435_sc-184015.jpg,1,0,0,0,1,,train
0544436_sc-184015.jpg,1,0,0,0,1,,val
0544437_sc-184015.jpg,2,0,0,0,2,,val
0544439_as-0069265.jpg,1,0,0,0,1,,test
0544440_as-0069265.jpg,1,0,0,0,1,,train
0544441_as-0069265.jpg,1,0,0,0,1,,train
0544442_as-0069265.jpg,1,0,0,0,1,,train
0544443_as-0069265.jpg,1,0,0,0,1,,train
0544444_as-0069265.jpg,2,0,0,0,2,,train
0544446_as-0057404.jpg,1,0,0,0,1,,train
0544447_as-0057404.jpg,1,0,0,0,1,,train
0544448_as-0057404.jpg,1,0,0,0,1,,val
0544449_as-0057404.jpg,1,0,0,0,1,,val
0544450_as-0057404.jpg,0,1,0,0,1,,test
0544451_as-0057404.jpg,0,1,0,0,1,,train
0544452_as-2598617.jpg,2,0,1,0,3,,train
0544453_sc-1000040.jpg,1,0,0,1,2,,train
0544454_as-3015233.jpg,4,0,1,2,7,,train
0544457_as-0086251.jpg,0,0,1,1,2,,train
0544459_as-0086251.jpg,0,0,1,3,4,,train
0544461_sc-1026499.jpg,4,0,0,0,4,,train
0544462_sc-1026499.jpg,4,0,0,0,4,,val
0544464_sc-1026499.jpg,10,0,0,0,10,,val
0544465_sc-1026499.jpg,5,0,0,0,5,,test
0544466_sc-1026499.jpg,3,0,0,0,3,,train
0544467_sc-1026499.jpg,5,0,0,1,6,,train
0544468_sc-1026499.jpg,7,0,0,1,8,,train
0544469_as-0010376.jpg,1,0,0,0,1,,train
0544470_as-0010376.jpg,1,0,0,0,1,,train
0544471_as-0010376.jpg,1,0,0,0,1,,train
0544473_as-0091778.jpg,2,0,1,0,3,,train
0544474_as-0091778.jpg,3,0,1,0,4,,val
0544475_as-0091778.jpg,3,0,0,0,3,,val
0544476_as-0091778.jpg,2,0,0,0,2,,test
0544477_as-0091778.jpg,2,0,0,0,2,,train
0544479_as-0091778.jpg,1,0,0,0,1,,train
0544481_as-0084215.jpg,1,0,0,0,1,,train
0544482_as-0084215.jpg,1,0,0,1,2,,train
0544483_as-0084215.jpg,1,0,0,1,2,,train
0544484_as-0084215.jpg,1,0,0,1,2,,train
0544485_as-0084215.jpg,2,0,0,0,2,,train
0544486_sc-147923.jpg,3,0,0,1,4,,val
0544487_as-3231077.jpg,1,0,0,0,1,,val
0544489_as-0027852.jpg,3,0,0,1,4,,test
0544490_as-0027852.jpg,4,0,0,0,4,,train
0544492_as-0027852.jpg,4,0,0,0,4,,train
0544493_as-0027852.jpg,3,0,0,0,3,,train
0544495_as-0086422.jpg,1,0,0,0,1,,train
0544496_as-0086422.jpg,1,0,0,0,1,,train
0544497_as-0086422.jpg,1,0,0,0,1,,train
0544498_as-0086422.jpg,1,0,0,0,1,,train
0544499_sc-143354.jpg,3,0,1,0,4,,val
0544501_sc-143354.jpg,2,1,1,0,4,,val
0544502_sc-143354.jpg,2,1,1,0,4,,test
0544503_sc-143354.jpg,1,0,0,0,1,,train
0544504_sc-191120.jpg,1,1,1,0,3,,train
0544505_as-2684962.jpg,3,0,0,0,3,,train
0544506_as-2541086.jpg,1,0,1,1,3,,train
0544510_as-0059825.jpg,3,0,1,1,5,,train
0544511_sc-184796.jpg,1,0,0,0,1,,train
0544512_sc-184796.jpg,1,0,0,0,1,,train
0544513_as-2581977.jpg,6,0,2,1,9,,val
0544514_as-7840409.jpg,0,0,0,1,1,,val
0544515_as-7900428.jpg,2,0,0,0,2,,test
0544516_as-0083710.jpg,2,0,0,0,2,,train
0544517_as-0083710.jpg,1,0,0,0,1,,train
0544518_as-0083710.jpg,1,0,1,0,2,,train
0544519_as-0083710.jpg,1,0,0,0,1,,train
0544520_as-0083710.jpg,2,0,0,0,2,,train
0544521_as-0083710.jpg,2,0,0,0,2,,train
0544522_as-0083710.jpg,1,0,0,0,1,,train
0544523_as-0083710.jpg,1,0,0,0,1,,val
0544524_as-0083710.jpg,2,0,0,0,2,,val
0544527_as-0020530.jpg,2,0,1,0,3,,test
0544528_as-0020530.jpg,1,0,0,0,1,,train
0544529_as-0020530.jpg,1,0,1,0,2,,train
0544530_as-0020530.jpg,2,0,1,0,3,,train
0544534_as-0045599.jpg,2,0,2,0,4,,train
0544535_as-0045599.jpg,0,0,2,0,2,,train
0544536_sc-1018111.jpg,3,0,0,0,3,,train
0544537_sc-1018111.jpg,2,0,0,0,2,,train
0544538_sc-1018111.jpg,5,0,2,0,7,,val
0544539_sc-196485.jpg,1,0,0,0,1,,val
0544540_sc-196485.jpg,2,0,1,1,4,,test
0544541_sc-196485.jpg,4,1,2,2,9,,train
0544542_sc-196485.jpg,1,0,0,0,1,,train
0544543_sc-196485.jpg,3,0,1,0,4,,train
0544544_sc-196485.jpg,1,0,1,0,2,,train
0544545_sc-196485.jpg,1,0,0,0,1,,train
0544547_as-0071516.jpg,1,0,0,0,1,,train
0544548_as-0071516.jpg,1,0,0,0,1,,train
0544549_as-0071516.jpg,1,0,0,0,1,,val
0544550_as-0071516.jpg,1,0,0,0,1,,val
0544551_as-0071516.jpg,1,0,0,0,1,,test
0544552_as-0071516.jpg,1,0,0,0,1,,train
0544553_as-0071516.jpg,1,0,0,0,1,,train
0544554_as-3455945.jpg,0,0,1,1,2,,train
0544555_sc-134276.jpg,1,1,1,4,7,,train
0544556_sc-134276.jpg,0,1,0,0,1,,train
0544558_sc-106236.jpg,5,0,0,0,5,,train
0544559_sc-106236.jpg,2,0,0,2,4,,train
0544560_sc-106236.jpg,4,0,0,0,4,,val
0544561_sc-106236.jpg,2,0,0,0,2,,val
0544562_sc-106236.jpg,5,0,0,0,5,,test
0544563_as-2530545.jpg,2,0,0,0,2,,train
0544564_as-3343488.jpg,1,0,0,0,1,,train
0544565_as-3128886.jpg,2,0,0,0,2,,train
0544566_sc-209622.jpg,1,0,1,0,2,,train
0544567_as-0046876.jpg,7,0,0,0,7,,train
0544568_as-0046876.jpg,9,1,1,0,11,,train
0544569_as-0046876.jpg,1,0,0,0,1,,train
0544573_as-0046876.jpg,1,0,0,0,1,,val
0544575_sc-220541.jpg,2,0,0,0,2,,val
0544576_sc-220541.jpg,1,0,0,0,1,,test
0544577_sc-220541.jpg,1,0,0,0,1,,train
0544578_sc-114101.jpg,2,1,0,0,3,,train
0544579_sc-114101.jpg,3,1,0,0,4,,train
0544580_as-7357774.jpg,3,0,0,1,4,,train
0544581_as-9022560.jpg,7,0,2,0,9,,train
0544582_sc-177321.jpg,1,1,0,0,2,,train
0544583_sc-177321.jpg,1,0,0,0,1,,train
0544584_as-3010059.jpg,1,0,0,0,1,,val
0544585_sc-1020228.jpg,1,0,1,0,2,,val
0544586_sc-1020228.jpg,2,0,0,0,2,,test
0544587_sc-1020228.jpg,0,0,1,1,2,,train
0544588_sc-1020228.jpg,3,0,0,0,3,,train
0544589_sc-159140.jpg,4,0,1,0,5,,train
0544591_sc-159140.jpg,5,0,0,0,5,,train
0544592_sc-159140.jpg,6,0,0,0,6,,train
0544593_as-2665282.jpg,1,0,0,0,1,,train
0544595_as-0071834.jpg,2,1,1,1,5,,train
0544596_as-0071834.jpg,2,0,0,0,2,,val
0544597_as-0071834.jpg,1,0,0,0,1,,val
0544598_sc-109090.jpg,1,0,0,1,2,,test
0544599_as-0021791.jpg,0,1,0,0,1,,train
0544600_as-0021791.jpg,0,1,0,0,1,,train
0544601_as-7206186.jpg,0,0,1,0,1,,train
0544603_as-0040489.jpg,1,1,0,0,2,,train
0544604_as-0040489.jpg,0,1,0,0,1,,train
0544605_as-0040489.jpg,1,1,0,0,2,,train
0544607_as-7069981.jpg,2,0,0,0,2,,train
0544608_sc-1010241.jpg,3,0,0,0,3,,val
0544609_as-0028835.jpg,2,1,0,2,5,,val
0544610_as-0028835.jpg,4,0,1,3,8,,test
0544611_as-0028835.jpg,1,0,0,1,2,,train
0544612_as-0028835.jpg,2,0,0,0,2,,train
0544614_as-0024290.jpg,4,1,1,2,8,,train
0544615_as-0024290.jpg,3,7,0,0,10,,train
0544616_as-0024290.jpg,6,1,1,2,10,,train
0544618_as-0069240.jpg,1,0,0,0,1,,train
0544619_as-0069240.jpg,1,0,0,0,1,,train
0544621_as-3354120.jpg,4,0,0,0,4,,val
0544623_sc-206563.jpg,2,0,1,0,3,,val
0544624_as-0083715.jpg,1,0,0,0,1,,test
0544625_as-0083715.jpg,0,0,1,0,1,,train
0544626_as-0083715.jpg,0,0,1,0,1,,train
0544627_as-0083715.jpg,1,0,0,0,1,,train
0544628_as-2938070.jpg,0,2,0,0,2,,train
0544629_sc-222070.jpg,2,0,0,0,2,,train
0544630_sc-222070.jpg,3,0,1,1,5,,train
0544631_sc-222070.jpg,3,1,0,2,6,,train
0544632_sc-222070.jpg,2,0,0,2,4,,val
0544633_sc-222070.jpg,4,0,1,1,6,,val
0544634_sc-222070.jpg,2,0,0,0,2,,test
0544635_sc-222070.jpg,1,0,0,2,3,,train
0544636_sc-222070.jpg,1,0,1,0,2,,train
0544637_as-0016792.jpg,1,0,0,0,1,,train
0544638_as-0016792.jpg,1,0,0,0,1,,train
0544639_as-0016792.jpg,1,0,0,0,1,,train
0544640_as-2527125.jpg,1,0,0,0,1,,train
0544641_sc-228794.jpg,1,0,0,0,1,,train
0544642_sc-202536.jpg,5,0,1,1,7,,val
0544643_sc-130576.jpg,2,0,0,0,2,,val
0544644_as-0034644.jpg,1,0,0,0,1,,test
0544645_as-0034644.jpg,1,0,0,0,1,,train
0544646_sc-145042.jpg,2,1,0,0,3,,train
0544649_as-0079573.jpg,2,0,0,0,2,,train
0544650_as-0079573.jpg,0,0,1,1,2,,train
0544652_sc-163734.jpg,0,1,0,0,1,,train
0544653_sc-163734.jpg,4,2,2,1,9,,train
0544654_as-7359906.jpg,4,0,1,3,8,,train
0544655_as-2975284.jpg,2,0,0,0,2,,val
0544656_sc-170019.jpg,0,1,0,0,1,,val
0544657_sc-209269.jpg,0,1,0,0,1,,test
0544659_as-0058761.jpg,7,0,0,0,7,,train
0544660_as-0058761.jpg,2,0,0,0,2,,train
0544661_sc-1000365.jpg,1,0,0,1,2,,train
0544662_sc-1000365.jpg,4,0,0,0,4,,train
0544663_sc-1000365.jpg,3,0,0,1,4,,train
0544664_sc-1000365.jpg,2,0,0,1,3,,train
0544665_as-0065553.jpg,4,0,0,0,4,,train
0544666_as-2793589.jpg,2,0,0,0,2,,val
0544667_as-3245964.jpg,1,0,0,0,1,,val
0544668_as-0064251.jpg,2,0,1,1,4,,test
0544670_as-0064251.jpg,1,0,1,1,3,,train
0544672_as-0064251.jpg,4,0,0,1,5,,train
0544674_as-0064251.jpg,0,1,0,0,1,,train
0544675_as-9054842.jpg,1,0,0,1,2,,train
0544676_as-3212348.jpg,2,0,0,1,3,,train
0544677_as-9037672.jpg,2,0,1,0,3,,train
0544678_as-0027644.jpg,1,0,0,0,1,,train
0544679_as-7164532.jpg,0,1,0,0,1,,val
0544681_as-0054925.jpg,1,0,0,0,1,,val
0544682_as-0054925.jpg,1,0,0,0,1,,test
0544683_as-0054925.jpg,1,0,0,0,1,,train
0544684_sc-1023746.jpg,5,0,0,1,6,,train
0544685_sc-202040.jpg,0,3,0,0,3,,train
0544686_sc-202040.jpg,1,4,1,0,6,,train
0544687_sc-202040.jpg,0,2,0,0,2,,train
0544688_sc-218871.jpg,2,0,0,0,2,,train
0544689_as-0088368.jpg,1,0,0,0,1,,train
0544690_as-0088368.jpg,1,0,0,0,1,,val
0544691_as-0088368.jpg,1,0,1,0,2,,val
0544692_as-0088368.jpg,1,0,0,0,1,,test
0544693_as-0088368.jpg,1,0,0,0,1,,train
0544696_as-0017578.jpg,1,0,1,0,2,,train
0544697_as-0017578.jpg,1,0,1,0,2,,train
0544698_as-0017578.jpg,1,0,0,0,1,,train
0544699_sc-171767.jpg,1,0,0,0,1,,train
0544700_sc-171767.jpg,1,0,0,0,1,,train
0544701_sc-171767.jpg,1,0,0,0,1,,train
0544702_sc-171767.jpg,2,0,0,0,2,,val
0544703_as-3299343.jpg,2,0,1,0,3,,val
0544705_sc-211552.jpg,2,0,1,0,3,,test
0544706_sc-137930.jpg,1,0,0,1,2,,train
0544708_sc-137930.jpg,3,0,0,3,6,,train
0544709_sc-137930.jpg,2,0,0,2,4,,train
0544710_sc-137930.jpg,1,0,0,1,2,,train
0544711_sc-137930.jpg,1,0,0,1,2,,train
0544712_sc-137930.jpg,0,1,0,0,1,,train
0544713_sc-137930.jpg,1,0,1,0,2,,train
0544714_sc-137930.jpg,1,0,0,1,2,,val
0544715_sc-137930.jpg,1,0,0,1,2,,val
0544718_as-0002721.jpg,4,0,0,0,4,,test
0544719_as-0002721.jpg,2,0,0,0,2,,train
0544721_as-3250068.jpg,4,0,0,0,4,,train
0544722_as-3477399.jpg,1,0,0,1,2,,train
0544723_as-2933056.jpg,1,0,1,0,2,,train
0544724_sc-205966.jpg,1,1,0,0,2,,train
0544727_sc-1011387.jpg,2,0,0,0,2,,train
0544728_sc-1011387.jpg,2,0,0,0,2,,train
0544729_sc-1011387.jpg,3,0,1,0,4,,val
0544730_sc-1011387.jpg,3,0,1,1,5,,val
0544731_sc-1011387.jpg,1,0,0,0,1,,test
0544732_as-0003845.jpg,2,0,2,1,5,,train
0544733_as-0003845.jpg,2,0,2,1,5,,train
0544734_as-3014487.jpg,5,0,0,0,5,,train
0544735_as-7889118.jpg,1,0,0,1,2,,train
0544736_as-3096133.jpg,0,0,1,1,2,,train
0544738_sc-178304.jpg,0,1,1,0,2,,train
0544739_sc-178304.jpg,0,1,0,0,1,,train
0544740_as-0044686.jpg,1,0,0,0,1,,val
0544741_sc-226138.jpg,1,1,0,1,3,,val
0544742_sc-112585.jpg,1,0,1,0,2,,test
0544744_sc-112585.jpg,1,0,1,0,2,,train
0544745_sc-112585.jpg,1,0,1,0,2,,train
0544748_as-3417100.jpg,1,0,0,0,1,,train
0544750_sc-206708.jpg,4,0,2,0,6,,train
0544751_sc-206708.jpg,1,0,1,0,2,,train
0544752_sc-206708.jpg,2,0,0,0,2,,train
0544753_sc-206708.jpg,4,0,0,0,4,,train
0544754_sc-206708.jpg,1,0,0,0,1,,val
0544755_sc-206708.jpg,1,0,0,0,1,,val
0544756_sc-206708.jpg,1,0,0,0,1,,test
0544757_sc-206708.jpg,3,0,0,0,3,,train
0544758_as-3222576.jpg,2,0,0,0,2,,train
0544760_as-0036933.jpg,0,0,1,0,1,,train
0544761_as-0036933.jpg,2,0,0,0,2,,train
0544762_sc-1006789.jpg,1,0,0,0,1,,train
0544764_sc-1006789.jpg,2,0,0,0,2,,train
0544766_as-0003900.jpg,5,0,0,0,5,,train
0544768_sc-1035748.jpg,5,0,0,0,5,,val
0544769_sc-1035748.jpg,12,0,0,0,12,,val
0544770_sc-226780.jpg,4,0,0,0,4,,test
0544771_sc-226780.jpg,4,0,1,0,5,,train
0544772_sc-217414.jpg,1,1,1,1,4,,train
0544773_sc-217414.jpg,1,3,1,1,6,,train
0544774_sc-217414.jpg,0,1,0,0,1,,train
0544775_sc-217414.jpg,0,1,1,1,3,,train
0544776_sc-217414.jpg,0,1,1,1,3,,train
0544777_as-7922562.jpg,3,0,0,0,3,,train
0544778_sc-126002.jpg,3,0,0,2,5,,val
0544780_sc-1038090.jpg,2,0,0,2,4,,val
0544781_as-2957932.jpg,2,1,0,0,3,,test
0544783_as-3213818.jpg,3,0,0,0,3,,train
0544785_sc-110079.jpg,5,2,1,0,8,,train
0544786_sc-110079.jpg,1,0,1,0,2,,train
0544787_sc-110079.jpg,2,0,0,1,3,,train
0544788_sc-110079.jpg,1,0,0,0,1,,train
0544789_sc-110079.jpg,2,0,0,0,2,,train
0544791_sc-110079.jpg,1,1,0,0,2,,train
0544792_sc-1003522.jpg,2,1,2,0,5,,val
0544793_sc-1003522.jpg,2,1,0,0,3,,val
0544794_sc-1003522.jpg,1,1,1,0,3,,test
0544795_sc-1003522.jpg,1,0,0,0,1,,train
0544796_sc-1003522.jpg,2,1,1,0,4,,train
0544797_sc-1003522.jpg,2,1,1,0,4,,train
0544798_sc-1018839.jpg,2,0,0,0,2,,train
0544799_sc-1011526.jpg,5,0,1,1,7,,train
0544800_sc-1011526.jpg,1,0,1,0,2,,train
0544801_sc-1011526.jpg,1,0,1,1,3,,train
0544802_sc-1011526.jpg,2,0,1,0,3,,val
0544803_sc-1033091.jpg,0,1,0,0,1,,val
0544804_as-3288152.jpg,1,0,1,0,2,,test
0544805_as-0035650.jpg,1,0,0,0,1,,train
0544806_as-0035650.jpg,1,0,0,0,1,,train
0544807_as-0035650.jpg,2,0,0,0,2,,train
0544808_as-0035650.jpg,1,0,0,0,1,,train
0544809_sc-149482.jpg,1,0,0,0,1,,train
0544810_sc-149482.jpg,4,1,1,0,6,,train
0544811_sc-149482.jpg,1,0,0,0,1,,train
0544812_sc-149482.jpg,6,1,1,0,8,,val
0544813_as-3163272.jpg,4,0,1,1,6,,val
0544814_as-0001867.jpg,1,1,0,0,2,,test
0544815_as-0001867.jpg,1,1,0,0,2,,train
0544817_sc-206194.jpg,3,0,0,0,3,,train
0544818_sc-206194.jpg,3,0,0,0,3,,train
0544819_sc-206194.jpg,3,0,0,0,3,,train
0544820_sc-206194.jpg,6,0,0,0,6,,train
0544821_sc-206194.jpg,2,0,0,0,2,,train
0544822_sc-206194.jpg,6,0,0,0,6,,train
0544823_sc-206194.jpg,3,0,0,0,3,,val
0544824_sc-206194.jpg,2,0,0,0,2,,val
0544826_as-0011730.jpg,9,4,0,1,14,,test
0544827_as-0011730.jpg,3,0,0,0,3,,train
0544828_as-0011730.jpg,1,0,0,0,1,,train
0544829_as-0011730.jpg,0,0,1,0,1,,train
0544830_as-0011730.jpg,1,0,1,0,2,,train
0544832_as-0011730.jpg,3,0,0,0,3,,train
0544833_as-0011730.jpg,2,0,1,0,3,,train
0544834_as-0011730.jpg,2,0,1,0,3,,train
0544835_as-0011730.jpg,0,0,1,0,1,,val
0544836_as-0011730.jpg,1,0,1,0,2,,val
0544837_as-0011730.jpg,2,1,1,0,4,,test
0544840_as-0079701.jpg,1,0,0,0,1,,train
0544846_sc-1008647.jpg,7,0,2,0,9,,train
0544847_sc-1008647.jpg,3,0,0,2,5,,train
0544848_sc-1008647.jpg,6,1,1,0,8,,train
0544851_as-2931864.jpg,0,1,1,0,2,,train
0544853_sc-121504.jpg,4,0,0,0,4,,train
0544855_as-0078473.jpg,0,1,0,1,2,,train
0544856_as-0078473.jpg,3,0,0,0,3,,val
0544857_as-0078473.jpg,0,1,0,0,1,,val
0544858_as-0078473.jpg,0,0,0,2,2,,test
0544859_as-0078473.jpg,0,0,0,1,1,,train
0544861_sc-197835.jpg,0,0,1,0,1,,train
0544862_sc-133480.jpg,2,0,0,1,3,,train
0544863_sc-133480.jpg,4,0,0,4,8,,train
0544865_sc-133480.jpg,3,0,1,4,8,,train
0544866_sc-133480.jpg,3,1,1,4,9,,train
0544867_sc-133480.jpg,2,0,1,4,7,,train
0544868_sc-133480.jpg,2,0,1,0,3,,val
0544869_as-2612421.jpg,1,0,1,1,3,,val
0544870_sc-208308.jpg,4,2,2,2,10,,test
0544871_sc-208308.jpg,0,0,1,1,2,,train
0544872_sc-208308.jpg,3,3,2,2,10,,train
0544873_sc-208308.jpg,6,3,1,2,12,,train
0544874_sc-208308.jpg,4,1,0,2,7,,train
0544875_sc-208308.jpg,1,0,1,0,2,,train
0544876_sc-1039604.jpg,0,0,0,1,1,,train
0544877_sc-1039604.jpg,3,0,0,1,4,,train
0544879_sc-1039604.jpg,2,0,1,1,4,,val
0544881_sc-1039604.jpg,1,0,0,1,2,,val
0544886_as-0065609.jpg,2,0,0,0,2,,test
0544887_as-2985380.jpg,1,0,0,0,1,,train
0544888_as-2916983.jpg,6,0,0,1,7,,train
0544889_sc-201068.jpg,3,0,0,0,3,,train
0544890_sc-201068.jpg,1,0,0,0,1,,train
0544891_sc-144040.jpg,1,1,2,1,5,,train
0544893_as-9080815.jpg,1,0,0,0,1,,train
0544894_sc-1040840.jpg,4,0,0,0,4,,train
0544895_sc-1040840.jpg,1,0,0,0,1,,val
0544896_sc-161431.jpg,1,0,1,1,3,,val
0544897_sc-160212.jpg,1,1,0,0,2,,test
0544898_sc-160212.jpg,3,1,0,0,4,,train
0544899_sc-160212.jpg,0,1,0,0,1,,train
0544900_sc-160212.jpg,2,2,0,0,4,,train
0544902_as-2697161.jpg,2,0,0,0,2,,train
0544906_as-0040508.jpg,1,1,0,0,2,,train
0544907_as-0040508.jpg,1,0,0,1,2,,train
0544909_as-0040508.jpg,2,1,0,0,3,,train
0544910_as-0040508.jpg,1,1,0,1,3,,val
0544911_as-0040508.jpg,1,1,0,1,3,,val
0544913_as-0040508.jpg,1,2,0,1,4,,test
0544914_as-0040508.jpg,0,1,0,1,2,,train
0544916_as-0040508.jpg,3,1,0,1,5,,train
0544917_as-7136887.jpg,1,0,1,1,3,,train
0544918_as-0028890.jpg,3,0,0,1,4,,train
0544919_as-0028890.jpg,3,2,0,0,5,,train
0544922_sc-134124.jpg,2,0,1,0,3,,train
0544923_sc-134124.jpg,1,0,0,0,1,,train
0544924_sc-134124.jpg,2,0,0,0,2,,val
0544925_as-2860859.jpg,1,1,3,2,7,,val
0544926_as-9040765.jpg,0,1,1,0,2,,test
0544928_sc-200328.jpg,2,0,0,1,3,,train
0544929_sc-200328.jpg,3,0,0,1,4,,train
0544930_sc-200328.jpg,4,0,0,1,5,,train
0544931_sc-200328.jpg,2,0,1,0,3,,train
0544933_sc-220856.jpg,1,0,0,0,1,,train
0544934_sc-220856.jpg,2,0,0,2,4,,train
0544935_sc-220856.jpg,2,0,0,1,3,,train
0544936_sc-220856.jpg,3,0,0,0,3,,val
0544937_sc-220856.jpg,3,0,0,2,5,,val
0544939_as-3173663.jpg,1,0,0,0,1,,test
0544942_as-3044444.jpg,1,0,1,0,2,,train
0544943_as-2697824.jpg,4,0,0,0,4,,train
0544945_sc-229773.jpg,7,0,0,0,7,,train
0544946_sc-229773.jpg,5,1,1,0,7,,train
0544947_sc-229773.jpg,6,0,0,0,6,,train
0544948_sc-229773.jpg,2,1,1,0,4,,train
0544949_sc-159900.jpg,2,0,0,0,2,,train
0544950_as-2716585.jpg,1,0,0,0,1,,val
0544951_as-2733500.jpg,1,0,0,1,2,,val
0544953_as-7871716.jpg,5,0,3,0,8,,test
0544954_as-2821287.jpg,2,0,0,0,2,,train
0544956_as-2837019.jpg,4,1,0,0,5,,train
0544958_sc-212005.jpg,4,0,0,1,5,,train
0544959_sc-186915.jpg,4,0,0,0,4,,train
0544960_sc-186915.jpg,1,0,0,0,1,,train
0544961_sc-186915.jpg,2,0,0,0,2,,train
0544962_sc-186915.jpg,3,0,0,0,3,,train
0544963_sc-186915.jpg,4,0,0,0,4,,val
0544965_as-0039735.jpg,2,0,0,1,3,,val
0544966_as-0039735.jpg,2,0,0,1,3,,test
0544967_as-0039735.jpg,2,0,0,0,2,,train
0544969_as-0052460.jpg,2,0,0,0,2,,train
0544970_as-0052460.jpg,1,0,0,1,2,,train
0544971_as-0052460.jpg,1,0,0,1,2,,train
0544972_as-0052460.jpg,2,0,0,1,3,,train
0544973_as-0052460.jpg,2,0,0,2,4,,train
0544974_as-0052460.jpg,2,0,0,1,3,,train
0544977_as-0052460.jpg,3,0,0,0,3,,val
0544978_as-0052460.jpg,2,0,0,0,2,,val
0544979_as-7523278.jpg,1,0,0,0,1,,test
0544980_as-0047058.jpg,1,0,0,0,1,,train
0544981_as-0047058.jpg,1,0,0,0,1,,train
0544982_as-0047058.jpg,1,0,0,0,1,,train
0544983_as-0047058.jpg,1,0,0,0,1,,train
0544984_as-0047058.jpg,1,0,0,1,2,,train
0544985_as-0047058.jpg,1,0,0,1,2,,train
0544986_as-0047058.jpg,1,0,0,1,2,,train
0544987_sc-226806.jpg,1,0,0,1,2,,val
0544988_sc-226806.jpg,1,0,0,1,2,,val
0544989_sc-226806.jpg,1,0,0,1,2,,test
0544990_sc-226806.jpg,1,0,0,1,2,,train
0544991_sc-226806.jpg,1,0,0,1,2,,train
0544992_sc-226806.jpg,1,0,0,1,2,,train
0544993_sc-226806.jpg,1,0,0,0,1,,train
0544994_sc-226806.jpg,2,0,0,0,2,,train
0544995_sc-226806.jpg,1,0,1,0,2,,train
0544996_as-3497975.jpg,6,0,1,1,8,,train
0544998_as-3106759.jpg,1,1,1,1,4,,val
0544999_as-0010567.jpg,1,0,1,1,3,,val
0545000_as-0010567.jpg,1,0,1,1,3,,test
0545001_as-0010567.jpg,1,0,1,1,3,,train
0545004_as-0022055.jpg,3,0,0,0,3,,train
0545005_as-0022055.jpg,1,0,1,0,2,,train
0545006_as-0022055.jpg,2,0,5,1,8,,train
0545007_as-0022055.jpg,1,0,1,0,2,,train
0545008_as-0022055.jpg,1,0,1,1,3,,train
0545009_as-0022055.jpg,3,0,1,1,5,,train
0545010_as-0022055.jpg,1,0,1,0,2,,val
0545011_as-0022055.jpg,1,0,1,0,2,,val
0545012_as-0022055.jpg,3,0,0,0,3,,test
0545014_sc-144710.jpg,1,0,0,0,1,,train
0545015_sc-144710.jpg,1,0,0,1,2,,train
0545016_sc-144710.jpg,1,0,0,1,2,,train
0545017_sc-213662.jpg,1,0,1,0,2,,train
0545018_sc-213662.jpg,1,0,1,0,2,,train
0545019_sc-213662.jpg,0,0,1,0,1,,train
0545020_sc-188275.jpg,1,0,0,0,1,,train
0545021_sc-188275.jpg,3,0,1,0,4,,val
0545022_sc-188275.jpg,3,0,0,0,3,,val
0545023_sc-188275.jpg,3,0,0,0,3,,test
0545024_sc-1026860.jpg,3,1,0,0,4,,train
0545026_sc-158280.jpg,1,0,0,2,3,,train
0545027_as-3118069.jpg,1,0,0,1,2,,train
0545028_sc-128913.jpg,2,1,0,0,3,,train
0545029_sc-128913.jpg,3,2,0,0,5,,train
0545030_sc-128913.jpg,4,2,1,1,8,,train
0545031_sc-128913.jpg,3,1,0,0,4,,train
0545034_sc-128913.jpg,1,1,0,0,2,,val
0545036_sc-198687.jpg,2,0,0,0,2,,val
0545038_sc-198687.jpg,2,0,0,0,2,,test
0545039_as-0016532.jpg,2,3,1,0,6,,train
0545040_as-0016532.jpg,2,4,1,0,7,,train
0545041_as-0016532.jpg,0,0,1,0,1,,train
0545042_sc-168920.jpg,2,0,1,1,4,,train
0545043_sc-168920.jpg,1,0,1,1,3,,train
0545044_sc-168920.jpg,1,0,0,0,1,,train
0545045_sc-105754.jpg,7,0,2,1,10,,train
0545046_sc-105754.jpg,5,1,1,1,8,,val
0545047_sc-105754.jpg,9,0,2,2,13,,val
0545048_sc-105754.jpg,0,2,0,0,2,,test
0545049_sc-105754.jpg,3,0,1,1,5,,train
0545050_sc-106902.jpg,1,0,2,0,3,,train
0545051_sc-106902.jpg,1,0,2,2,5,,train
0545052_sc-106902.jpg,1,0,0,1,2,,train
0545053_sc-106902.jpg,1,0,1,1,3,,train
0545054_sc-106902.jpg,2,0,2,1,5,,train
0545055_sc-132914.jpg,2,0,1,1,4,,train
0545056_sc-132914.jpg,1,0,0,1,2,,val
0545057_sc-132914.jpg,1,0,0,1,2,,val
0545058_sc-132914.jpg,1,0,0,0,1,,test
0545059_sc-132914.jpg,1,0,0,0,1,,train
0545060_sc-132914.jpg,1,0,0,1,2,,train
0545061_as-2528454.jpg,1,0,0,0,1,,train
0545062_sc-221683.jpg,4,2,3,1,10,,train
0545063_sc-221683.jpg,5,1,1,1,8,,train
0545064_sc-221683.jpg,3,2,0,0,5,,train
0545065_sc-221683.jpg,5,1,0,0,6,,train
0545066_sc-221683.jpg,4,1,0,0,5,,val
0545067_sc-221683.jpg,1,1,0,0,2,,val
0545068_sc-221683.jpg,7,1,0,0,8,,test
0545069_sc-221683.jpg,4,1,2,1,8,,train
0545070_sc-221683.jpg,0,1,1,1,3,,train
0545071_sc-221683.jpg,1,1,1,1,4,,train
0545072_as-7486490.jpg,1,0,0,0,1,,train
0545073_as-0083808.jpg,1,0,0,0,1,,train
0545074_as-0083808.jpg,2,0,0,0,2,,train
0545075_as-0083808.jpg,1,0,0,0,1,,train
0545076_sc-144808.jpg,0,1,0,0,1,,val
0545077_sc-144808.jpg,6,0,1,1,8,,val
0545078_sc-144808.jpg,4,0,1,1,6,,test
0545079_sc-144808.jpg,7,0,1,1,9,,train
0545080_sc-144808.jpg,4,0,1,1,6,,train
0545081_sc-144808.jpg,0,1,0,0,1,,train
0545083_as-3417851.jpg,0,0,2,0,2,,train
0545084_sc-143264.jpg,3,0,2,0,5,,train
0545085_as-7998114.jpg,1,0,0,0,1,,train
0545086_as-7017868.jpg,5,0,0,0,5,,train
0545087_as-0035309.jpg,2,0,0,1,3,,val
0545088_as-0035309.jpg,2,0,0,1,3,,val
0545089_sc-1027721.jpg,8,1,1,1,11,,test
0545090_sc-1027721.jpg,2,0,0,0,2,,train
0545091_as-0059795.jpg,1,0,0,0,1,,train
0545092_as-0059795.jpg,3,0,0,0,3,,train
0545093_as-0059795.jpg,2,0,0,0,2,,train
0545094_as-0059795.jpg,1,0,0,0,1,,train
0545097_as-0059795.jpg,6,1,1,1,9,,train
0545098_as-0059795.jpg,1,1,0,0,2,,train
0545101_as-0024807.jpg,0,1,0,0,1,,val
0545102_as-0024807.jpg,1,0,0,0,1,,val
0545104_as-3324889.jpg,1,1,0,0,2,,test
0545105_sc-130186.jpg,3,0,0,1,4,,train
0545106_sc-158934.jpg,2,0,0,0,2,,train
0545107_sc-158934.jpg,1,0,0,0,1,,train
0545108_sc-158934.jpg,1,0,0,0,1,,train
0545109_sc-158934.jpg,1,0,0,0,1,,train
0545110_sc-158934.jpg,2,0,0,0,2,,train
0545111_sc-158934.jpg,1,0,0,0,1,,train
0545112_as-3447172.jpg,1,0,1,0,2,,val
0545113_as-0097577.jpg,1,0,0,0,1,,val
0545114_as-0097577.jpg,1,0,0,0,1,,test
0545115_sc-161445.jpg,3,1,0,0,4,,train
0545116_sc-226493.jpg,0,0,1,0,1,,train
0545117_sc-226493.jpg,1,1,1,0,3,,train
0545118_sc-226493.jpg,1,0,1,0,2,,train
0545122_sc-190879.jpg,2,0,0,1,3,,train
0545123_sc-190879.jpg,4,0,0,0,4,,train
0545124_sc-190879.jpg,2,1,0,0,3,,train
0545125_sc-190879.jpg,2,3,0,0,5,,val
0545126_sc-190879.jpg,2,0,0,1,3,,val
0545127_sc-190879.jpg,3,0,0,1,4,,test
0545128_sc-195392.jpg,2,0,0,0,2,,train
0545129_sc-195392.jpg,1,0,0,0,1,,train
0545130_sc-195392.jpg,6,0,0,0,6,,train
0545132_sc-151094.jpg,0,1,0,0,1,,train
0545133_sc-1004106.jpg,2,0,0,0,2,,train
0545134_sc-1004106.jpg,3,0,0,0,3,,train
0545137_sc-216212.jpg,2,0,1,0,3,,train
0545138_as-0037095.jpg,3,0,0,0,3,,val
0545139_as-0037095.jpg,2,0,0,0,2,,val
0545140_as-0037095.jpg,1,0,0,0,1,,test
0545141_as-0037095.jpg,1,0,0,0,1,,train
0545142_as-2657785.jpg,3,0,0,0,3,,train
0545143_sc-1014339.jpg,1,0,1,0,2,,train
0545144_sc-1014339.jpg,1,0,1,0,2,,train
0545145_sc-1014339.jpg,2,0,1,0,3,,train
0545146_sc-209364.jpg,4,0,1,1,6,,train
0545147_sc-209364.jpg,2,0,1,1,4,,train
0545148_sc-209364.jpg,2,0,0,1,3,,val
0545149_sc-209364.jpg,4,0,0,0,4,,val
0545150_sc-209364.jpg,1,0,1,1,3,,test
0545151_sc-209364.jpg,3,0,2,1,6,,train
0545152_as-0072885.jpg,2,0,1,1,4,,train
0545153_sc-152837.jpg,1,0,0,0,1,,train
0545154_sc-152837.jpg,2,1,0,0,3,,train
0545155_sc-152837.jpg,2,2,1,0,5,,train
0545156_sc-152837.jpg,4,2,1,0,7,,train
0545157_sc-208442.jpg,1,0,1,1,3,,train
0545158_sc-208442.jpg,0,0,1,0,1,,val
0545159_sc-214141.jpg,2,1,0,0,3,,val
0545160_sc-214141.jpg,2,0,0,0,2,,test
0545161_sc-214141.jpg,4,0,0,0,4,,train
0545162_sc-214141.jpg,5,0,0,0,5,,train
0545163_sc-214141.jpg,1,0,0,0,1,,train
0545164_sc-214141.jpg,1,0,1,0,2,,train
0545165_as-3111492.jpg,7,2,4,4,17,,train
0545166_as-3044583.jpg,1,0,1,0,2,,train
0545168_as-0068950.jpg,1,0,0,0,1,,train
0545169_sc-1026376.jpg,1,1,1,1,4,,val
0545170_sc-1026376.jpg,4,1,0,0,5,,val
0545171_sc-1026376.jpg,1,0,0,0,1,,test
0545172_sc-1009413.jpg,0,1,0,0,1,,train
0545173_sc-1009413.jpg,0,2,0,0,2,,train
0545174_as-2767205.jpg,1,0,0,0,1,,train
0545175_sc-217062.jpg,1,2,1,0,4,,train
0545176_as-2986319.jpg,0,0,1,0,1,,train
0545177_sc-194028.jpg,1,0,0,0,1,,train
0545178_as-0030179.jpg,0,1,0,0,1,,train
0545179_as-0030179.jpg,1,0,0,1,2,,val
0545180_as-0030179.jpg,1,0,0,1,2,,val
0545182_as-0060841.jpg,1,0,1,0,2,,test
0545183_as-0060841.jpg,1,0,0,0,1,,train
0545184_as-0060841.jpg,0,0,1,0,1,,train
0545185_as-0060841.jpg,0,0,2,0,2,,train
0545189_sc-217731.jpg,0,0,0,1,1,,train
0545190_sc-217731.jpg,0,0,0,1,1,,train
0545191_sc-217731.jpg,0,0,0,1,1,,train
0545192_sc-217731.jpg,0,0,0,1,1,,train
0545193_sc-217731.jpg,0,0,0,1,1,,val
0545194_as-2883859.jpg,0,1,0,0,1,,val
0545195_sc-1040797.jpg,3,0,0,1,4,,test
0545196_sc-1040797.jpg,3,0,0,0,3,,train
0545197_sc-1040797.jpg,4,0,0,1,5,,train
0545198_as-2783304.jpg,2,0,0,0,2,,train
0545201_as-0045679.jpg,2,0,0,0,2,,train
0545204_as-0078165.jpg,1,0,0,0,1,,train
0545205_as-0038731.jpg,1,0,0,0,1,,train
0545206_as-0069573.jpg,2,0,0,1,3,,train
0545207_as-0069573.jpg,3,0,0,1,4,,val
0545208_as-0069573.jpg,3,0,0,0,3,,val
0545209_as-0069573.jpg,1,0,0,0,1,,test
0545210_as-0069573.jpg,1,0,0,0,1,,train
0545211_sc-1034967.jpg,4,0,0,0,4,,train
0545212_sc-137437.jpg,7,0,0,0,7,,train
0545213_sc-137437.jpg,5,0,1,0,6,,train
0545214_sc-109030.jpg,1,0,1,0,2,,train
0545215_sc-109030.jpg,1,0,0,0,1,,train
0545216_sc-109030.jpg,1,0,0,0,1,,train
0545217_sc-109030.jpg,1,0,0,0,1,,val
0545218_sc-109030.jpg,2,0,0,0,2,,val
0545219_sc-109030.jpg,1,0,0,0,1,,test
0545220_sc-109030.jpg,2,0,0,0,2,,train
0545221_as-0093922.jpg,2,0,0,0,2,,train
0545222_as-0093922.jpg,3,0,0,0,3,,train
0545223_as-0093922.jpg,0,0,1,0,1,,train
0545224_as-0093922.jpg,3,0,1,0,4,,train
0545225_sc-125904.jpg,1,0,0,0,1,,train
0545226_sc-125904.jpg,2,0,0,0,2,,train
0545227_sc-125904.jpg,1,0,0,0,1,,val
0545228_sc-125904.jpg,1,0,0,0,1,,val
0545231_as-7490620.jpg,2,0,0,0,2,,test
0545232_as-3183981.jpg,3,0,0,0,3,,train
0545236_sc-116491.jpg,2,0,0,0,2,,train
0545237_sc-116491.jpg,1,0,0,0,1,,train
0545238_sc-1007829.jpg,1,0,0,0,1,,train
0545239_sc-1007829.jpg,3,0,0,0,3,,train
0545240_sc-1007829.jpg,3,0,0,0,3,,train
0545241_as-0035328.jpg,1,0,1,0,2,,train
0545242_as-0035328.jpg,1,0,1,0,2,,val
0545243_sc-205481.jpg,1,0,0,0,1,,val
0545244_sc-205481.jpg,1,0,0,0,1,,test
0545245_sc-129206.jpg,2,0,0,0,2,,train
0545246_sc-119892.jpg,3,0,0,0,3,,train
0545248_sc-223979.jpg,2,0,0,0,2,,train
0545249_as-0036202.jpg,5,0,1,1,7,,train
0545250_as-0036202.jpg,1,0,1,1,3,,train
0545251_as-0036202.jpg,1,0,1,0,2,,train
0545252_as-0036202.jpg,2,0,0,1,3,,train
0545254_as-4761068.jpg,1,0,0,0,1,,val
0545256_as-0018943.jpg,1,1,3,0,5,,val
0545257_as-0018943.jpg,3,1,3,0,7,,test
0545258_as-0018943.jpg,1,0,1,0,2,,train
0545259_as-0018943.jpg,6,1,3,0,10,,train
0545261_as-0018943.jpg,0,1,0,0,1,,train
0545262_as-0018943.jpg,0,1,0,0,1,,train
0545264_sc-221937.jpg,3,0,0,0,3,,train
0545265_sc-221937.jpg,2,0,1,0,3,,train
0545266_sc-123177.jpg,1,0,0,0,1,,train
0545267_as-3028841.jpg,1,0,0,0,1,,val
0545269_as-3151138.jpg,1,0,0,0,1,,val
0545274_sc-142494.jpg,9,1,1,0,11,,test
0545276_sc-142494.jpg,3,1,0,0,4,,train
0545277_sc-142494.jpg,7,0,0,0,7,,train
0545278_sc-142494.jpg,6,1,0,0,7,,train
0545279_sc-142494.jpg,7,1,0,0,8,,train
0545280_as-3444256.jpg,1,0,1,1,3,,train
0545281_sc-226576.jpg,5,0,1,0,6,,train
0545282_sc-226576.jpg,2,0,0,0,2,,train
0545283_sc-226576.jpg,2,0,1,0,3,,val
0545284_sc-226576.jpg,2,0,0,0,2,,val
0545285_sc-226576.jpg,5,0,0,0,5,,test
0545286_sc-226576.jpg,0,0,1,0,1,,train
0545287_sc-226576.jpg,6,0,1,0,7,,train
0545288_as-0012835.jpg,2,0,0,0,2,,train
0545289_as-0032786.jpg,2,0,1,0,3,,train
0545290_as-0032786.jpg,0,0,2,0,2,,train
0545291_as-2697810.jpg,1,0,0,0,1,,train
0545292_as-0060926.jpg,1,1,1,1,4,,train
0545294_as-0060926.jpg,2,0,0,0,2,,val
0545295_as-0060926.jpg,1,1,1,0,3,,val
0545296_as-0060926.jpg,1,1,1,0,3,,test
0545297_as-0060926.jpg,2,3,0,0,5,,train
0545298_as-7271200.jpg,1,0,1,1,3,,train
0545299_sc-113107.jpg,4,1,0,0,5,,train
0545300_sc-113107.jpg,1,1,0,0,2,,train
0545301_sc-158824.jpg,2,0,1,1,4,,train
0545302_sc-158824.jpg,1,0,1,1,3,,train
0545303_sc-158824.jpg,1,0,0,0,1,,train
0545304_sc-158824.jpg,1,0,0,0,1,,val
0545306_sc-158824.jpg,3,0,0,0,3,,val
0545307_sc-158824.jpg,2,0,0,0,2,,test
0545309_sc-157201.jpg,1,0,1,0,2,,train
0545310_sc-157201.jpg,5,1,3,2,11,,train
0545312_sc-157201.jpg,3,1,3,2,9,,train
0545313_as-2577953.jpg,7,1,1,0,9,,train
0545314_as-2971573.jpg,0,0,1,0,1,,train
0545315_as-3236009.jpg,1,0,0,0,1,,train
0545318_sc-1038474.jpg,1,1,0,0,2,,train
0545319_sc-1038474.jpg,1,0,0,0,1,,val
0545322_sc-1038474.jpg,3,0,0,0,3,,val
0545324_sc-194155.jpg,1,1,1,0,3,,test
0545325_sc-194155.jpg,1,1,1,0,3,,train
0545326_sc-194155.jpg,1,0,0,0,1,,train
0545327_sc-194155.jpg,1,0,0,0,1,,train
0545328_sc-194155.jpg,1,2,1,0,4,,train
0545329_sc-148672.jpg,3,0,1,0,4,,train
0545331_as-0015141.jpg,1,2,1,1,5,,train
0545332_as-0015141.jpg,1,3,2,1,7,,train
0545333_as-0015141.jpg,0,0,1,0,1,,val
0545334_as-0015141.jpg,1,2,3,1,7,,val
0545335_as-0015141.jpg,1,2,1,1,5,,test
0545336_as-0015141.jpg,1,4,0,1,6,,train
0545337_as-0015141.jpg,0,0,1,0,1,,train
0545338_as-0015141.jpg,0,0,1,0,1,,train
0545339_as-0015141.jpg,0,0,1,0,1,,train
0545340_as-0015141.jpg,1,2,1,1,5,,train
0545341_sc-192370.jpg,1,0,0,1,2,,train
0545342_sc-192370.jpg,1,0,0,1,2,,train
0545343_sc-123675.jpg,1,0,1,1,3,,val
0545344_sc-123675.jpg,1,0,0,0,1,,val
0545346_as-0069720.jpg,1,0,0,0,1,,test
0545347_as-0069720.jpg,4,0,0,0,4,,train
0545348_as-7597046.jpg,2,0,0,0,2,,train
0545349_as-3224923.jpg,1,0,0,0,1,,train
0545350_sc-207336.jpg,2,0,0,0,2,,train
0545351_sc-222368.jpg,1,0,0,0,1,,train
0545352_sc-222368.jpg,5,0,0,0,5,,train
0545353_sc-222368.jpg,7,0,0,0,7,,train
0545354_sc-222368.jpg,7,0,0,0,7,,val
0545355_sc-222368.jpg,6,0,0,0,6,,val
0545356_sc-222368.jpg,5,0,0,0,5,,test
0545357_sc-222368.jpg,4,0,0,0,4,,train
0545358_sc-222368.jpg,7,0,0,0,7,,train
0545359_sc-222368.jpg,1,0,0,0,1,,train
0545360_sc-222368.jpg,1,0,0,0,1,,train
0545361_as-7961401.jpg,0,1,0,1,2,,train
0545362_as-0070738.jpg,0,0,1,0,1,,train
0545363_as-0070738.jpg,0,0,1,0,1,,train
0545364_sc-199535.jpg,1,1,1,2,5,,val
0545365_sc-199535.jpg,2,1,1,0,4,,val
0545366_sc-199535.jpg,1,2,1,0,4,,test
0545367_as-0078690.jpg,4,0,1,0,5,,train
0545370_as-0078690.jpg,1,0,0,0,1,,train
0545371_as-0078690.jpg,2,0,0,0,2,,train
0545372_as-0095392.jpg,1,0,0,0,1,,train
0545373_as-0095392.jpg,1,0,0,0,1,,train
0545374_as-0095392.jpg,1,0,0,0,1,,train
0545375_as-0095392.jpg,1,0,0,1,2,,train
0545376_as-0095392.jpg,1,0,0,1,2,,val
0545377_as-0095392.jpg,1,0,0,0,1,,val
0545378_as-3101567.jpg,1,0,0,0,1,,test
0545380_as-0082183.jpg,1,0,1,0,2,,train
0545381_as-0082183.jpg,1,0,1,0,2,,train
0545382_sc-130281.jpg,0,1,0,0,1,,train
0545383_sc-130281.jpg,0,1,0,0,1,,train
0545385_as-0029760.jpg,1,0,0,0,1,,train
0545387_as-0029760.jpg,1,0,0,0,1,,train
0545388_as-0029760.jpg,1,0,0,0,1,,train
0545389_as-0029760.jpg,1,0,0,0,1,,val
0545390_sc-176007.jpg,1,0,0,0,1,,val
0545391_as-2994328.jpg,5,0,1,4,10,,test
0545393_sc-143559.jpg,3,1,2,0,6,,train
0545394_sc-143559.jpg,1,0,1,0,2,,train
0545398_sc-143559.jpg,2,2,3,1,8,,train
0545399_as-3258779.jpg,1,1,2,1,5,,train
0545400_sc-131425.jpg,2,0,1,0,3,,train
0545401_sc-131425.jpg,2,0,0,0,2,,train
0545402_sc-159523.jpg,0,0,1,0,1,,train
0545403_sc-159523.jpg,0,0,1,0,1,,val
0545406_as-0019825.jpg,1,0,0,0,1,,val
0545407_as-0019825.jpg,1,0,0,0,1,,test
0545408_sc-1010346.jpg,3,0,0,2,5,,train
0545409_sc-1010346.jpg,3,0,0,0,3,,train
0545410_sc-1010346.jpg,3,0,0,1,4,,train
0545411_sc-1010346.jpg,3,0,0,1,4,,train
0545412_sc-1011302.jpg,6,0,1,0,7,,train
0545413_sc-1011302.jpg,8,0,1,1,10,,train
0545415_sc-120339.jpg,3,2,2,1,8,,train
0545416_sc-120339.jpg,7,2,2,0,11,,val
0545417_sc-120339.jpg,1,1,1,0,3,,val
0545419_sc-120339.jpg,3,2,1,0,6,,test
0545420_sc-120339.jpg,3,2,1,0,6,,train
0545422_as-2546003.jpg,1,0,1,0,2,,train
0545423_as-3276090.jpg,2,0,0,0,2,,train
0545426_as-0048671.jpg,1,0,0,0,1,,train
0545427_as-0048671.jpg,5,0,0,0,5,,train
0545428_as-0048671.jpg,2,0,0,0,2,,train
0545429_as-0048671.jpg,1,0,0,0,1,,train
0545430_as-0048671.jpg,1,0,0,0,1,,val
0545431_as-0048671.jpg,1,0,0,0,1,,val
0545432_as-0048671.jpg,2,0,0,0,2,,test
0545433_as-7081722.jpg,2,0,0,0,2,,train
0545434_as-7312787.jpg,0,1,2,2,5,,train
0545435_sc-221560.jpg,5,0,0,0,5,,train
0545436_sc-221560.jpg,5,0,1,0,6,,train
0545437_as-7831381.jpg,6,0,1,2,9,,train
0545439_as-0096839.jpg,1,1,0,1,3,,train
0545440_as-0096839.jpg,1,0,1,0,2,,train
0545441_sc-158356.jpg,2,0,0,0,2,,val
0545442_sc-158356.jpg,2,0,0,0,2,,val
0545443_sc-158356.jpg,1,0,0,0,1,,test
0545444_as-3084319.jpg,1,0,0,2,3,,train
0545446_as-9072668.jpg,3,0,0,0,3,,train
0545447_sc-1033526.jpg,1,0,1,0,2,,train
0545448_sc-1033526.jpg,3,0,2,1,6,,train
0545449_sc-1033526.jpg,2,0,4,1,7,,train
0545451_sc-1033526.jpg,2,0,1,0,3,,train
0545452_sc-1033526.jpg,1,0,1,1,3,,train
0545453_sc-1033526.jpg,1,0,2,0,3,,val
0545454_sc-1033526.jpg,1,0,2,0,3,,val
0545455_sc-1033526.jpg,1,1,3,1,6,,test
0545457_sc-1033526.jpg,2,1,1,0,4,,train
0545459_sc-1033526.jpg,2,1,1,1,5,,train
0545460_as-0031725.jpg,2,0,0,0,2,,train
0545461_as-0031725.jpg,2,0,0,0,2,,train
0545462_as-0031725.jpg,1,0,0,0,1,,train
0545463_as-2771929.jpg,1,0,0,0,1,,train
0545465_as-0038235.jpg,4,0,1,2,7,,train
0545466_as-0038235.jpg,2,1,2,0,5,,val
0545467_as-0038235.jpg,7,0,1,0,8,,val
0545468_as-0038235.jpg,1,0,1,2,4,,test
0545469_as-2859134.jpg,1,0,1,0,2,,train
0545470_sc-122320.jpg,4,0,1,0,5,,train
0545471_sc-179888.jpg,1,0,0,0,1,,train
0545472_sc-179888.jpg,1,0,0,0,1,,train
0545476_sc-131482.jpg,2,0,0,0,2,,train
0545477_sc-131482.jpg,3,0,0,0,3,,train
0545480_sc-131482.jpg,3,0,0,0,3,,train
0545481_sc-131482.jpg,6,0,0,0,6,,val
0545482_sc-131482.jpg,2,0,0,0,2,,val
0545484_as-0010512.jpg,1,0,0,0,1,,test
0545485_as-0010512.jpg,2,1,0,0,3,,train
0545486_as-0010512.jpg,1,0,0,0,1,,train
0545489_as-0075825.jpg,1,0,2,0,3,,train
0545490_as-0075825.jpg,0,0,2,0,2,,train
0545491_as-0075825.jpg,1,2,2,1,6,,train
0545492_as-0075825.jpg,5,0,2,1,8,,train
0545494_as-3242492.jpg,0,0,1,0,1,,train
0545496_as-0052418.jpg,4,1,1,1,7,,val
0545497_as-0052418.jpg,1,2,2,0,5,,val
0545498_as-0052418.jpg,0,1,2,0,3,,test
0545500_as-7857006.jpg,2,0,1,1,4,,train
0545501_as-2772545.jpg,2,0,0,0,2,,train
0545505_as-3352065.jpg,6,2,3,1,12,,train
0545506_sc-217840.jpg,3,0,0,0,3,,train
0545507_sc-217840.jpg,2,0,0,0,2,,train
0545509_as-0074973.jpg,1,0,0,1,2,,train
0545510_as-0074973.jpg,1,0,0,0,1,,train
0545511_as-0074973.jpg,1,0,0,1,2,,val
0545513_sc-229104.jpg,1,0,1,1,3,,val
0545514_sc-229104.jpg,1,1,0,0,2,,test
0545515_sc-185508.jpg,1,0,0,0,1,,train
0545516_sc-185508.jpg,2,0,1,1,4,,train
0545518_sc-160091.jpg,9,0,1,1,11,,train
0545519_sc-160091.jpg,5,0,0,1,6,,train
0545520_sc-204734.jpg,2,0,0,1,3,,train
0545521_sc-204734.jpg,1,0,0,2,3,,train
0545522_sc-204734.jpg,2,0,0,0,2,,train
0545523_sc-204734.jpg,2,0,0,1,3,,val
0545524_sc-204734.jpg,2,0,0,2,4,,val
0545525_sc-204734.jpg,3,0,0,0,3,,test
0545526_sc-204734.jpg,3,0,0,0,3,,train
0545527_sc-204734.jpg,3,0,0,2,5,,train
0545528_as-2718983.jpg,4,1,0,0,5,,train
0545529_sc-141604.jpg,4,1,0,3,8,,train
0545530_sc-141604.jpg,3,0,0,0,3,,train
0545531_as-0045845.jpg,2,0,0,0,2,,train
0545532_as-0045845.jpg,3,0,0,0,3,,train
0545533_as-0045845.jpg,2,0,0,0,2,,val
0545535_as-0075543.jpg,1,0,0,0,1,,val
0545536_as-0075543.jpg,2,0,1,0,3,,test
0545537_as-0075543.jpg,4,0,1,1,6,,train
0545538_as-0075543.jpg,0,0,0,1,1,,train
0545539_as-0075543.jpg,3,0,1,0,4,,train
0545542_as-2604110.jpg,1,1,0,0,2,,train
0545546_as-0059022.jpg,1,1,0,0,2,,train
0545547_as-3012813.jpg,1,0,1,2,4,,train
0545548_as-3012813.jpg,1,0,0,0,1,,train
0545549_as-9038941.jpg,1,1,0,0,2,,val
0545550_sc-114515.jpg,3,0,2,1,6,,val
0545551_sc-114515.jpg,7,0,0,1,8,,test
0545552_sc-114515.jpg,3,0,0,0,3,,train
0545553_sc-114515.jpg,4,0,0,0,4,,train
0545554_sc-114515.jpg,3,0,0,0,3,,train
0545557_sc-194294.jpg,3,0,0,0,3,,train
0545558_sc-125061.jpg,2,0,0,0,2,,train
0545559_sc-125061.jpg,3,0,0,0,3,,train
0545560_sc-125061.jpg,1,0,0,0,1,,train
0545563_as-0088794.jpg,2,0,0,1,3,,val
0545564_as-0088794.jpg,2,0,0,1,3,,val
0545565_as-0088794.jpg,2,0,0,1,3,,test
0545566_as-2754859.jpg,1,0,0,0,1,,train
0545567_sc-204640.jpg,4,0,0,1,5,,train
0545568_sc-204640.jpg,4,0,1,1,6,,train
0545569_sc-150353.jpg,1,0,0,1,2,,train
0545570_sc-150353.jpg,1,0,0,1,2,,train
0545571_sc-150353.jpg,1,0,0,1,2,,train
0545573_as-7768109.jpg,1,0,1,0,2,,train
0545574_as-0045860.jpg,1,0,0,0,1,,val
0545575_as-0046358.jpg,2,0,0,0,2,,val
0545576_as-0046358.jpg,0,0,1,0,1,,test
0545577_as-0046358.jpg,0,0,1,0,1,,train
0545578_as-0046358.jpg,1,0,0,0,1,,train
0545579_as-0046358.jpg,4,0,0,0,4,,train
0545580_as-0046358.jpg,1,0,0,0,1,,train
0545581_as-0046358.jpg,1,0,0,0,1,,train
0545582_as-0046358.jpg,1,0,0,0,1,,train
0545583_as-0046358.jpg,1,0,0,0,1,,train
0545584_as-0046358.jpg,1,0,3,0,4,,val
0545585_as-0046358.jpg,1,0,3,0,4,,val
0545586_as-0046358.jpg,0,0,3,0,3,,test
0545587_as-0046358.jpg,0,0,1,0,1,,train
0545588_as-0046358.jpg,1,0,0,0,1,,train
0545589_as-0046358.jpg,1,0,0,0,1,,train
0545590_as-0046358.jpg,1,0,0,0,1,,train
0545591_as-0046358.jpg,1,0,0,0,1,,train
0545592_as-0046358.jpg,1,0,1,0,2,,train
0545593_as-0046358.jpg,1,0,0,0,1,,train
0545594_as-0046358.jpg,1,0,0,0,1,,val
0545595_as-0046358.jpg,1,0,0,0,1,,val
0545596_as-2654149.jpg,5,0,0,0,5,,test
0545598_as-0030211.jpg,2,0,0,0,2,,train
0545599_as-2559479.jpg,1,0,1,2,4,,train
0545600_sc-114265.jpg,1,1,0,0,2,,train
0545601_sc-114265.jpg,1,0,0,0,1,,train
0545602_sc-114265.jpg,4,0,0,0,4,,train
0545603_sc-114265.jpg,2,0,0,0,2,,train
0545604_sc-114265.jpg,3,0,0,0,3,,train
0545605_sc-168721.jpg,2,1,1,0,4,,val
0545606_sc-1027148.jpg,1,0,0,0,1,,val
0545607_sc-1027148.jpg,2,0,1,0,3,,test
0545608_sc-1027148.jpg,2,1,1,0,4,,train
0545610_sc-1030086.jpg,1,0,1,1,3,,train
0545611_as-3291615.jpg,1,0,1,1,3,,train
0545613_sc-163116.jpg,3,0,0,0,3,,train
0545614_sc-177478.jpg,1,0,0,1,2,,train
0545615_sc-177478.jpg,6,2,0,1,9,,train
0545616_sc-228575.jpg,1,0,0,0,1,,train
0545617_sc-228575.jpg,2,1,2,2,7,,val
0545618_sc-228575.jpg,2,0,1,0,3,,val
0545619_sc-228575.jpg,5,1,1,1,8,,test
0545620_sc-228575.jpg,4,1,3,3,11,,train
0545621_sc-228575.jpg,4,0,1,1,6,,train
0545622_as-2750358.jpg,2,0,0,0,2,,train
0545625_as-0092196.jpg,2,0,0,0,2,,train
0545626_as-0092196.jpg,2,0,0,0,2,,train
0545629_as-0092196.jpg,1,0,0,0,1,,train
0545630_as-0092196.jpg,3,0,0,0,3,,train
0545632_as-0023335.jpg,9,1,0,0,10,,val
0545633_as-0023335.jpg,13,0,2,4,19,,val
0545634_as-0023335.jpg,2,0,0,0,2,,test
0545635_as-0023335.jpg,3,0,1,2,6,,train
0545636_as-0023335.jpg,8,0,0,0,8,,train
0545637_sc-1034214.jpg,2,0,0,0,2,,train
0545638_sc-1034214.jpg,6,0,0,0,6,,train
0545639_sc-1034214.jpg,1,0,0,1,2,,train
0545641_sc-1034214.jpg,1,1,0,1,3,,train
0545642_sc-137527.jpg,3,0,0,0,3,,train
0545643_sc-137527.jpg,2,0,1,0,3,,val
0545644_sc-137527.jpg,1,0,0,0,1,,val
0545646_sc-137527.jpg,1,0,1,0,2,,test
0545647_sc-1040782.jpg,1,0,0,0,1,,train
0545648_as-3358547.jpg,1,0,0,0,1,,train
0545650_sc-227656.jpg,4,0,2,0,6,,train
0545651_sc-227656.jpg,7,0,2,0,9,,train
0545652_sc-227656.jpg,7,0,2,0,9,,train
0545653_sc-227656.jpg,6,0,2,0,8,,train
0545654_as-2858769.jpg,1,0,0,0,1,,train
0545657_sc-1004816.jpg,6,0,1,1,8,,val
0545659_sc-1004816.jpg,6,0,1,1,8,,val
0545660_sc-1004816.jpg,2,0,0,1,3,,test
0545661_sc-1004816.jpg,4,0,1,1,6,,train
0545662_sc-1004816.jpg,1,0,1,1,3,,train
0545663_sc-1004816.jpg,1,0,1,1,3,,train
0545664_as-3333903.jpg,1,1,0,0,2,,train
0545665_as-3306592.jpg,2,0,0,0,2,,train
0545666_as-0035469.jpg,3,0,0,0,3,,train
0545667_as-0035469.jpg,2,0,0,0,2,,train
0545668_as-0035469.jpg,0,1,0,0,1,,val
0545669_as-0035469.jpg,0,1,0,0,1,,val
0545670_as-0035469.jpg,0,2,0,0,2,,test
0545671_as-0035469.jpg,2,0,0,0,2,,train
0545672_as-0035469.jpg,2,2,2,1,7,,train
0545674_as-0035469.jpg,0,1,0,0,1,,train
0545675_as-0035469.jpg,1,2,1,3,7,,train
0545676_as-0035469.jpg,3,0,0,0,3,,train
0545678_as-0070231.jpg,0,0,3,0,3,,train
0545679_as-0070231.jpg,0,0,2,0,2,,train
0545680_as-0070231.jpg,1,0,4,0,5,,val
0545681_as-0070231.jpg,4,1,0,0,5,,val
0545682_as-0070231.jpg,2,0,0,0,2,,test
0545683_as-0070231.jpg,0,0,1,0,1,,train
0545684_as-0070231.jpg,0,0,1,0,1,,train
0545685_as-0070231.jpg,0,0,1,0,1,,train
0545686_as-0070231.jpg,0,0,1,0,1,,train
0545687_as-2934109.jpg,0,0,1,0,1,,train
0545688_as-2797227.jpg,2,0,1,0,3,,train
0545689_as-9080751.jpg,1,0,0,0,1,,train
0545690_sc-110222.jpg,2,0,1,0,3,,val
0545692_sc-110222.jpg,3,0,0,1,4,,val
0545693_sc-110222.jpg,3,0,0,0,3,,test
0545694_as-2872684.jpg,0,1,0,0,1,,train
0545696_as-2623465.jpg,1,0,0,0,1,,train
0545698_as-0080895.jpg,2,0,0,3,5,,train
0545700_as-0048802.jpg,1,0,0,0,1,,train
0545701_as-0048802.jpg,1,0,0,0,1,,train
0545702_as-0048802.jpg,1,0,0,0,1,,train
0545705_sc-163752.jpg,2,0,0,0,2,,train
0545706_sc-163752.jpg,1,0,0,0,1,,val
0545708_sc-1025336.jpg,1,0,0,0,1,,val
0545709_sc-1025336.jpg,1,0,0,0,1,,test
0545710_sc-149936.jpg,0,1,2,0,3,,train
0545711_sc-149936.jpg,0,1,2,0,3,,train
0545713_sc-149936.jpg,1,0,0,0,1,,train
0545714_sc-149936.jpg,2,0,0,0,2,,train
0545715_sc-149936.jpg,0,1,2,0,3,,train
0545716_sc-149936.jpg,0,2,3,0,5,,train
0545717_sc-149936.jpg,0,2,2,0,4,,train
0545719_as-2764624.jpg,2,0,0,0,2,,val
0545720_as-3305069.jpg,1,0,0,0,1,,val
0545721_as-3326023.jpg,1,0,1,0,2,,test
0545723_as-7863808.jpg,1,0,1,1,3,,train
0545724_sc-1030608.jpg,1,0,0,0,1,,train
0545725_sc-1030608.jpg,1,0,0,0,1,,train
0545726_as-9042682.jpg,0,0,1,0,1,,train
0545727_sc-144109.jpg,2,1,2,1,6,,train
0545728_sc-144109.jpg,2,1,1,0,4,,train
0545729_sc-144109.jpg,1,0,1,1,3,,train
0545730_sc-144109.jpg,2,1,0,1,4,,val
0545731_sc-144109.jpg,1,0,0,0,1,,val
0545732_sc-144109.jpg,3,1,1,0,5,,test
0545733_sc-1010660.jpg,1,0,0,0,1,,train
0545734_as-2872991.jpg,3,0,1,1,5,,train
0545735_as-0014299.jpg,1,0,0,0,1,,train
0545736_as-0014299.jpg,1,0,0,0,1,,train
0545737_as-0014299.jpg,2,0,0,0,2,,train
0545738_as-0014299.jpg,1,0,0,0,1,,train
0545739_sc-184340.jpg,2,0,0,0,2,,train
0545741_sc-184340.jpg,3,1,0,0,4,,val
0545742_sc-184340.jpg,2,1,0,0,3,,val
0545745_sc-182934.jpg,0,1,1,0,2,,test
0545746_as-2996146.jpg,6,0,0,0,6,,train
0545749_sc-1039646.jpg,2,0,0,0,2,,train
0545752_as-0065337.jpg,1,0,1,0,2,,train
0545753_as-0065337.jpg,1,0,2,0,3,,train
0545754_as-0065337.jpg,0,0,1,0,1,,train
0545755_as-0065337.jpg,1,0,2,0,3,,train
0545756_as-0065337.jpg,1,0,1,0,2,,train
0545757_as-0065337.jpg,2,0,1,0,3,,val
0545758_as-0065337.jpg,3,1,2,0,6,,val
0545760_as-0065337.jpg,1,0,2,0,3,,test
0545761_as-0065337.jpg,0,1,2,0,3,,train
0545762_as-0065337.jpg,2,1,1,0,4,,train
0545764_as-0065337.jpg,1,1,1,1,4,,train
0545765_as-0065337.jpg,1,1,1,0,3,,train
0545766_as-0065337.jpg,1,1,1,0,3,,train
0545767_as-0065337.jpg,0,0,1,0,1,,train
0545768_sc-227652.jpg,0,1,0,0,1,,train
0545772_as-0012915.jpg,2,0,1,0,3,,val
0545773_as-0012915.jpg,2,0,1,0,3,,val
0545774_as-0012915.jpg,2,0,0,0,2,,test
0545775_as-0012915.jpg,4,0,0,0,4,,train
0545777_as-0012915.jpg,1,0,1,0,2,,train
0545778_as-0012915.jpg,1,0,1,0,2,,train
0545779_as-0012915.jpg,1,0,1,0,2,,train
0545780_as-0012915.jpg,0,0,1,0,1,,train
0545781_as-0005310.jpg,1,0,0,0,1,,train
0545782_as-9017322.jpg,1,0,1,0,2,,train
0545783_sc-153625.jpg,1,0,0,0,1,,val
0545784_as-2877339.jpg,0,1,1,0,2,,val
0545785_as-3341775.jpg,0,1,0,0,1,,test
0545786_as-0001138.jpg,2,0,0,0,2,,train
0545787_sc-1005281.jpg,3,0,1,0,4,,train
0545788_sc-1005281.jpg,2,0,1,0,3,,train
0545791_as-0080174.jpg,1,1,1,0,3,,train
0545794_as-0080174.jpg,6,0,0,0,6,,train
0545795_as-0080174.jpg,3,0,2,0,5,,train
0545797_as-0080174.jpg,4,1,1,0,6,,train
0545798_as-3451583.jpg,1,0,0,0,1,,val
0545801_sc-183599.jpg,1,0,1,0,2,,val
0545802_sc-183599.jpg,1,0,1,0,2,,test
0545803_sc-183599.jpg,4,0,0,0,4,,train
0545804_sc-183599.jpg,3,0,0,0,3,,train
0545805_sc-1027167.jpg,1,0,0,0,1,,train
0545806_sc-1027167.jpg,1,0,0,0,1,,train
0545807_sc-1027167.jpg,2,0,0,0,2,,train
0545808_sc-1027167.jpg,1,0,0,1,2,,train
0545810_as-0099865.jpg,5,0,1,0,6,,train
0545811_sc-202473.jpg,1,0,0,0,1,,val
0545812_sc-202473.jpg,0,0,0,1,1,,val
0545813_sc-202473.jpg,1,0,0,1,2,,test
0545814_as-2506430.jpg,1,0,0,0,1,,train
0545815_as-2970137.jpg,1,0,0,0,1,,train
0545816_sc-165413.jpg,2,0,1,0,3,,train
0545817_sc-1001824.jpg,2,0,0,2,4,,train
0545821_as-0044603.jpg,1,0,0,0,1,,train
0545822_as-0044603.jpg,1,0,0,0,1,,train
0545823_as-0044603.jpg,1,0,0,0,1,,train
0545824_as-0044603.jpg,1,0,0,0,1,,val
0545825_sc-141937.jpg,1,0,0,0,1,,val
0545826_sc-141937.jpg,1,0,0,0,1,,test
0545827_sc-141937.jpg,2,0,0,0,2,,train
0545830_as-0074208.jpg,2,0,1,0,3,,train
0545831_as-0074208.jpg,3,0,3,0,6,,train
0545832_as-0074208.jpg,2,0,2,0,4,,train
0545833_as-0074208.jpg,2,0,0,0,2,,train
0545834_as-0074208.jpg,0,1,1,0,2,,train
0545835_as-7381352.jpg,1,0,0,1,2,,train
0545837_as-0021271.jpg,0,0,1,0,1,,val
0545839_as-0021271.jpg,1,0,0,1,2,,val
0545840_as-0021271.jpg,1,0,0,0,1,,test
0545841_as-0021271.jpg,0,0,1,0,1,,train
0545842_as-0021271.jpg,0,0,1,0,1,,train
0545843_sc-222432.jpg,0,1,2,0,3,,train
0545844_sc-222432.jpg,0,1,1,0,2,,train
0545845_sc-222432.jpg,0,1,0,0,1,,train
0545846_sc-222432.jpg,1,0,0,0,1,,train
0545847_sc-222432.jpg,5,1,0,0,6,,train
0545848_as-2854733.jpg,1,0,0,0,1,,val
0545850_as-0027353.jpg,5,1,0,3,9,,val
0545851_as-0027353.jpg,2,0,0,0,2,,test
0545852_sc-110566.jpg,1,0,0,0,1,,train
0545853_sc-110566.jpg,1,0,0,0,1,,train
0545854_sc-110566.jpg,1,0,0,0,1,,train
0545855_sc-110566.jpg,1,0,0,0,1,,train
0545856_as-3045994.jpg,6,0,1,1,8,,train
0545857_sc-206291.jpg,2,0,0,1,3,,train
0545858_sc-144958.jpg,3,0,0,0,3,,train
0545859_sc-114243.jpg,4,0,0,0,4,,val
0545860_sc-114243.jpg,4,0,0,0,4,,val
0545861_as-2526061.jpg,1,0,1,0,2,,test
0545862_sc-122851.jpg,3,1,2,2,8,,train
0545863_sc-122851.jpg,2,1,1,2,6,,train
0545864_sc-122851.jpg,4,1,0,1,6,,train
0545865_sc-122851.jpg,4,1,2,2,9,,train
0545866_sc-122851.jpg,4,1,0,2,7,,train
0545867_sc-122851.jpg,4,1,2,2,9,,train
0545870_as-0020930.jpg,0,0,1,0,1,,train
0545871_as-0020930.jpg,0,0,1,0,1,,val
0545872_as-0020930.jpg,0,0,1,0,1,,val
0545873_as-2995738.jpg,2,0,0,0,2,,test
0545874_as-3464622.jpg,4,0,0,1,5,,train
0545875_as-0035169.jpg,1,0,0,0,1,,train
0545876_as-0035169.jpg,4,1,2,2,9,,train
0545877_as-0035169.jpg,2,1,0,0,3,,train
0545881_as-2545167.jpg,3,0,1,0,4,,train
0545882_sc-1017876.jpg,1,0,2,0,3,,train
0545884_sc-1017876.jpg,1,1,2,0,4,,train
0545885_as-7539841.jpg,5,0,1,0,6,,val
0545886_as-3265165.jpg,0,1,1,2,4,,val
0545887_as-0033475.jpg,0,0,2,0,2,,test
0545888_as-2966038.jpg,1,1,0,0,2,,train
0545889_sc-203737.jpg,3,1,0,0,4,,train
0545890_sc-203737.jpg,2,1,1,0,4,,train
0545891_sc-203737.jpg,3,0,2,1,6,,train
0545893_as-0036854.jpg,3,0,0,0,3,,train
0545894_as-0036854.jpg,2,0,0,0,2,,train
0545895_as-0036854.jpg,2,0,0,0,2,,train
0545896_as-7708853.jpg,5,1,0,0,6,,val
0545897_as-9044916.jpg,5,0,1,0,6,,val
0545898_sc-1025090.jpg,0,1,0,0,1,,test
0545899_sc-1025090.jpg,0,1,0,0,1,,train
0545900_sc-1025090.jpg,0,1,0,0,1,,train
0545902_as-0062409.jpg,1,0,0,0,1,,train
0545905_sc-179797.jpg,1,0,0,0,1,,train
0545906_sc-179797.jpg,3,0,1,0,4,,train
0545907_sc-179797.jpg,4,0,1,0,5,,train
0545908_sc-179797.jpg,4,0,0,0,4,,train
0545910_sc-1018039.jpg,7,0,0,0,7,,val
0545911_sc-104492.jpg,3,0,0,1,4,,val
0545912_sc-104492.jpg,1,0,0,1,2,,test
0545914_sc-104492.jpg,1,0,0,1,2,,train
0545915_as-0053014.jpg,1,0,0,0,1,,train
0545916_as-0053014.jpg,2,0,1,0,3,,train
0545917_as-0053014.jpg,2,0,1,0,3,,train
0545918_as-0053014.jpg,2,0,1,0,3,,train
0545919_as-0053014.jpg,2,0,0,0,2,,train
0545920_sc-126526.jpg,3,2,1,1,7,,train
0545921_sc-117541.jpg,2,1,0,1,4,,val
0545922_sc-117541.jpg,5,1,1,0,7,,val
0545923_sc-117541.jpg,5,1,1,0,7,,test
0545924_sc-117541.jpg,3,0,1,0,4,,train
0545925_sc-117541.jpg,1,0,0,1,2,,train
0545926_sc-169529.jpg,1,0,0,0,1,,train
0545927_sc-169529.jpg,1,0,0,0,1,,train
0545928_sc-169529.jpg,1,0,0,0,1,,train
0545931_as-0060598.jpg,1,0,0,0,1,,train
0545932_as-0060598.jpg,1,0,0,0,1,,train
0545933_as-2978309.jpg,1,0,0,0,1,,val
0545935_sc-1003365.jpg,3,1,0,0,4,,val
0545936_as-2830587.jpg,2,0,2,2,6,,test
0545937_sc-202121.jpg,2,0,1,0,3,,train
0545938_sc-202121.jpg,1,0,0,0,1,,train
0545939_sc-202121.jpg,2,0,0,0,2,,train
0545940_sc-202121.jpg,3,0,0,0,3,,train
0545941_sc-202121.jpg,1,0,0,0,1,,train
0545942_sc-202121.jpg,1,0,0,0,1,,train
0545943_sc-202121.jpg,2,0,0,0,2,,train
0545944_sc-202121.jpg,2,0,0,0,2,,val
0545945_sc-202121.jpg,1,0,0,0,1,,val
0545946_sc-202121.jpg,2,0,0,0,2,,test
0545947_sc-202121.jpg,1,0,0,0,1,,train
0545948_as-2995231.jpg,1,0,0,1,2,,train
0545949_as-0057216.jpg,1,0,0,0,1,,train
0545950_as-0057216.jpg,2,0,0,0,2,,train
0545951_as-0057216.jpg,1,0,0,0,1,,train
0545952_as-0057216.jpg,1,0,0,0,1,,train
0545953_as-0057216.jpg,2,0,0,0,2,,train
0545954_as-0057216.jpg,1,0,0,0,1,,val
0545957_sc-142523.jpg,1,1,0,0,2,,val
0545958_sc-142523.jpg,1,1,0,1,3,,test
0545960_sc-142523.jpg,1,1,0,1,3,,train
0545961_as-5242630.jpg,2,0,0,0,2,,train
0545962_sc-1037350.jpg,3,0,0,0,3,,train
0545963_sc-1037350.jpg,2,0,0,0,2,,train
0545964_sc-1037350.jpg,2,0,0,0,2,,train
0545965_sc-220971.jpg,11,0,1,1,13,,train
0545966_sc-220971.jpg,6,0,1,1,8,,train
0545967_sc-220971.jpg,10,0,1,1,12,,val
0545968_sc-220971.jpg,12,0,1,1,14,,val
0545969_sc-221950.jpg,1,0,0,0,1,,test
0545970_sc-221950.jpg,2,1,0,0,3,,train
0545971_sc-221950.jpg,0,1,0,0,1,,train
0545972_as-3407107.jpg,2,0,0,0,2,,train
0545974_as-3105657.jpg,1,0,0,0,1,,train
0545975_as-7116687.jpg,2,0,2,0,4,,train
0545976_as-3351337.jpg,1,0,0,0,1,,train
0545977_sc-197092.jpg,2,0,0,0,2,,train
0545978_sc-197092.jpg,1,0,0,0,1,,val
0545979_sc-197092.jpg,1,0,0,0,1,,val
0545980_sc-197092.jpg,2,0,0,0,2,,test
0545981_sc-197092.jpg,2,0,0,0,2,,train
0545982_sc-197092.jpg,1,0,1,0,2,,train
0545985_sc-193144.jpg,3,0,0,2,5,,train
0545986_sc-193144.jpg,1,0,0,1,2,,train
0545987_sc-193144.jpg,1,0,0,1,2,,train
0545988_sc-193144.jpg,2,0,0,2,4,,train
0545989_sc-193144.jpg,1,0,0,1,2,,train
0545990_sc-193144.jpg,1,0,0,1,2,,val
0545994_sc-161982.jpg,1,0,0,0,1,,val
0545995_sc-161982.jpg,1,0,1,0,2,,test
0545996_sc-161982.jpg,2,0,1,0,3,,train
0545997_sc-161982.jpg,1,0,1,0,2,,train
0546000_sc-196095.jpg,5,0,2,1,8,,train
0546001_sc-196095.jpg,5,0,0,1,6,,train
0546002_sc-196095.jpg,3,0,1,1,5,,train
0546003_as-0083159.jpg,0,0,1,0,1,,train
0546007_as-0083159.jpg,1,1,1,2,5,,train
0546008_as-0083159.jpg,2,2,2,0,6,,val
0546009_as-0083159.jpg,0,1,1,0,2,,val
0546010_as-0083159.jpg,1,1,1,0,3,,test
0546011_as-0083159.jpg,1,1,1,1,4,,train
0546012_as-0083159.jpg,0,0,2,1,3,,train
0546013_as-0083159.jpg,0,0,1,0,1,,train
0546014_as-0083159.jpg,1,0,0,0,1,,train
0546015_as-0049890.jpg,2,0,0,0,2,,train
0546016_sc-203610.jpg,4,0,0,0,4,,train
0546017_sc-203610.jpg,5,1,0,1,7,,train
0546018_sc-203610.jpg,3,2,1,1,7,,val
0546019_sc-203610.jpg,0,1,0,0,1,,val
0546020_as-3202261.jpg,1,0,0,1,2,,test
0546021_as-3185723.jpg,1,0,0,0,1,,train
0546022_sc-111199.jpg,1,0,0,2,3,,train
0546023_sc-111199.jpg,3,0,0,0,3,,train
0546024_sc-111199.jpg,3,0,0,0,3,,train
0546025_sc-111199.jpg,2,0,0,1,3,,train
0546026_sc-111199.jpg,2,0,0,0,2,,train
0546028_as-0019302.jpg,2,0,0,1,3,,train
0546032_as-0048018.jpg,0,1,1,0,2,,val
0546033_as-0048018.jpg,3,3,1,0,7,,val
0546034_as-0048018.jpg,1,1,0,0,2,,test
0546035_as-7720417.jpg,3,1,0,0,4,,train
0546037_sc-122665.jpg,1,0,0,0,1,,train
0546038_sc-122665.jpg,1,0,0,0,1,,train
0546039_sc-227317.jpg,1,0,0,0,1,,train
0546040_sc-227317.jpg,1,0,0,0,1,,train
0546041_sc-227317.jpg,1,0,0,0,1,,train
0546042_sc-227317.jpg,1,0,0,0,1,,train
0546043_sc-227317.jpg,1,0,0,0,1,,val
0546044_sc-174158.jpg,0,0,1,0,1,,val
0546045_sc-174158.jpg,1,0,0,0,1,,test
0546046_sc-174158.jpg,1,0,1,0,2,,train
0546047_sc-174158.jpg,1,0,0,0,1,,train
0546048_as-2647070.jpg,1,0,0,0,1,,train
0546052_sc-158847.jpg,2,2,0,0,4,,train
0546053_as-2756634.jpg,1,0,0,0,1,,train
0546054_as-3158855.jpg,1,0,0,0,1,,train
0546055_as-7251190.jpg,0,3,0,0,3,,train
0546056_sc-151980.jpg,1,0,1,0,2,,val
0546057_sc-151980.jpg,2,3,0,1,6,,val
0546058_sc-175238.jpg,0,0,1,0,1,,test
0546059_sc-175238.jpg,0,0,1,0,1,,train
0546060_sc-175238.jpg,2,0,0,0,2,,train
0546062_as-0073397.jpg,1,0,0,0,1,,train
0546063_as-0073397.jpg,2,0,0,0,2,,train
0546064_as-2571348.jpg,1,0,0,0,1,,train
0546066_sc-226147.jpg,1,0,0,0,1,,train
0546067_sc-226147.jpg,3,0,2,1,6,,train
0546068_sc-226147.jpg,1,0,2,1,4,,val
0546070_sc-1008684.jpg,7,0,0,0,7,,val
0546071_sc-1008684.jpg,4,0,0,0,4,,test
0546072_sc-1008684.jpg,4,1,0,0,5,,train
0546073_sc-1008684.jpg,1,0,0,0,1,,train
0546076_as-0062134.jpg,2,0,0,0,2,,train
0546077_as-0062134.jpg,2,0,0,0,2,,train
0546078_as-0062134.jpg,4,0,0,0,4,,train
0546083_as-0091589.jpg,5,2,2,1,10,,train
0546084_as-0091589.jpg,5,0,3,2,10,,train
0546085_as-0091589.jpg,1,0,2,1,4,,val
0546086_as-0091589.jpg,4,0,1,1,6,,val
0546087_as-0091589.jpg,3,0,1,2,6,,test
0546088_as-0091589.jpg,1,1,1,2,5,,train
0546089_as-0091589.jpg,0,1,1,0,2,,train
0546090_as-0091589.jpg,1,1,0,1,3,,train
0546091_as-0091589.jpg,7,1,2,1,11,,train
0546092_as-0091589.jpg,2,0,1,1,4,,train
0546093_as-0091589.jpg,2,0,0,1,3,,train
0546094_as-0091589.jpg,2,0,1,1,4,,train
0546095_as-0091589.jpg,1,0,1,0,2,,val
0546096_as-0091589.jpg,2,0,1,0,3,,val
0546097_as-0091589.jpg,2,0,1,0,3,,test
0546098_as-2980132.jpg,1,0,0,0,1,,train
0546099_as-2710991.jpg,1,0,0,0,1,,train
0546100_sc-1017770.jpg,4,0,0,0,4,,train
0546101_sc-1017770.jpg,2,0,1,2,5,,train
0546102_sc-1017770.jpg,1,0,1,2,4,,train
0546103_sc-1017770.jpg,1,0,1,2,4,,train
0546104_sc-1017770.jpg,2,0,1,2,5,,train
0546107_as-0073630.jpg,8,0,0,1,9,,val
0546109_as-3263751.jpg,4,0,0,0,4,,val
0546110_sc-164970.jpg,1,1,0,0,2,,test
0546111_sc-164970.jpg,1,1,0,0,2,,train
0546112_sc-164970.jpg,2,1,0,0,3,,train
0546113_sc-164970.jpg,4,1,0,0,5,,train
0546117_sc-209879.jpg,2,0,0,0,2,,train
0546118_sc-209879.jpg,1,0,0,0,1,,train
0546119_sc-209879.jpg,1,0,0,0,1,,train
0546120_sc-209879.jpg,0,0,1,0,1,,train
0546121_sc-209879.jpg,4,0,0,0,4,,val
0546122_sc-209879.jpg,4,0,0,0,4,,val
0546123_sc-209879.jpg,2,0,1,0,3,,test
0546124_as-2771199.jpg,0,0,2,2,4,,train
0546125_sc-120519.jpg,1,0,0,0,1,,train
0546128_as-0059438.jpg,3,1,0,0,4,,train
0546130_as-0059438.jpg,0,0,1,0,1,,train
0546131_as-0059438.jpg,0,0,1,0,1,,train
0546132_sc-215641.jpg,2,0,1,1,4,,train
0546133_sc-215641.jpg,2,0,0,0,2,,train
0546134_as-3300312.jpg,1,0,1,0,2,,val
0546135_as-9098065.jpg,2,0,1,1,4,,val
0546136_sc-215167.jpg,1,0,0,0,1,,test
0546137_sc-215167.jpg,1,0,0,0,1,,train
0546138_sc-216045.jpg,1,0,1,0,2,,train
0546139_sc-216045.jpg,1,1,0,0,2,,train
0546140_sc-216045.jpg,1,0,1,0,2,,train
0546141_sc-216045.jpg,1,0,1,0,2,,train
0546142_as-7252340.jpg,2,0,0,0,2,,train
0546143_sc-207419.jpg,1,0,1,0,2,,train
0546144_sc-207419.jpg,3,0,1,0,4,,val
0546145_sc-207419.jpg,3,0,1,0,4,,val
0546147_sc-1041841.jpg,6,0,0,0,6,,test
0546148_sc-1041841.jpg,5,1,0,0,6,,train
0546151_sc-140739.jpg,3,1,2,0,6,,train
0546152_sc-160891.jpg,1,0,0,0,1,,train
0546153_sc-160891.jpg,1,0,0,0,1,,train
0546154_as-2566683.jpg,4,0,1,1,6,,train
0546155_sc-221804.jpg,1,0,0,0,1,,train
0546156_sc-142322.jpg,3,0,0,0,3,,train
0546157_sc-142322.jpg,2,0,0,0,2,,val
0546158_as-0028708.jpg,2,0,1,1,4,,val
0546159_as-0028708.jpg,1,0,1,1,3,,test
0546161_as-0028708.jpg,2,0,0,0,2,,train
0546162_as-2986245.jpg,1,0,1,0,2,,train
0546163_sc-1036904.jpg,1,1,0,0,2,,train
0546165_sc-1030128.jpg,1,0,0,1,2,,train
0546166_as-7034833.jpg,1,0,0,0,1,,train
0546167_as-3276483.jpg,4,0,0,2,6,,train
0546168_sc-158086.jpg,0,1,0,0,1,,train
0546169_sc-158086.jpg,0,1,0,0,1,,val
0546170_as-9051555.jpg,2,0,1,0,3,,val
0546171_as-3495061.jpg,8,2,3,1,14,,test
0546172_sc-153299.jpg,2,0,0,1,3,,train
0546173_sc-153299.jpg,1,0,1,0,2,,train
0546175_sc-164671.jpg,4,2,1,1,8,,train
0546176_sc-164671.jpg,1,2,0,1,4,,train
0546177_sc-164671.jpg,3,1,2,0,6,,train
0546178_sc-164671.jpg,3,3,4,2,12,,train
0546179_sc-164671.jpg,3,1,3,1,8,,train
0546181_as-0062935.jpg,1,0,0,0,1,,val
0546182_as-0062935.jpg,0,0,1,1,2,,val
0546184_as-0062935.jpg,1,2,1,1,5,,test
0546185_as-0062935.jpg,2,0,1,0,3,,train
0546186_as-0062935.jpg,3,1,2,0,6,,train
0546188_as-2624549.jpg,0,2,1,0,3,,train
0546189_sc-209493.jpg,3,0,0,0,3,,train
0546190_sc-209493.jpg,4,0,0,0,4,,train
0546191_sc-209493.jpg,1,0,0,0,1,,train
0546192_sc-209493.jpg,4,0,0,0,4,,train
0546196_sc-193075.jpg,1,0,2,0,3,,val
0546197_sc-193075.jpg,4,0,1,0,5,,val
0546198_sc-193075.jpg,3,0,1,0,4,,test
0546201_sc-1026630.jpg,3,2,1,0,6,,train
0546202_sc-1026630.jpg,2,2,1,0,5,,train
0546203_sc-1026630.jpg,3,0,0,0,3,,train
0546204_as-2645489.jpg,4,0,0,0,4,,train
0546205_as-2645489.jpg,1,0,1,3,5,,train
0546206_as-0047378.jpg,1,1,0,0,2,,train
0546207_as-0047378.jpg,1,1,0,0,2,,train
0546208_as-2590517.jpg,1,0,0,0,1,,val
0546209_sc-199512.jpg,2,0,2,0,4,,val
0546210_as-2657148.jpg,1,0,0,1,2,,test
0546212_sc-142189.jpg,3,0,1,1,5,,train
0546213_sc-142189.jpg,1,0,1,0,2,,train
0546214_sc-142189.jpg,2,0,0,1,3,,train
0546215_sc-142189.jpg,4,0,1,1,6,,train
0546216_as-7119308.jpg,7,1,1,1,10,,train
0546217_sc-141646.jpg,4,0,0,0,4,,train
0546219_sc-141646.jpg,4,0,0,0,4,,train
0546220_sc-141646.jpg,1,0,2,0,3,,val
0546222_as-0027640.jpg,2,0,0,0,2,,val
0546225_as-0027640.jpg,2,0,0,2,4,,test
0546226_as-0027640.jpg,2,0,0,1,3,,train
0546228_sc-107627.jpg,4,0,0,0,4,,train
0546229_as-2854583.jpg,4,0,0,0,4,,train
0546230_sc-1007154.jpg,1,3,1,0,5,,train
0546232_sc-129758.jpg,1,0,1,1,3,,train
0546233_as-2543368.jpg,3,0,0,1,4,,train
0546234_as-0045736.jpg,1,1,1,1,4,,train
0546235_as-0045736.jpg,1,1,1,1,4,,val
0546236_as-0045736.jpg,6,0,1,0,7,,val
0546237_as-0045736.jpg,5,0,1,1,7,,test
0546238_as-0045736.jpg,7,1,1,0,9,,train
0546241_as-0085015.jpg,1,1,1,1,4,,train
0546243_as-0085015.jpg,2,0,2,1,5,,train
0546244_as-0085015.jpg,3,0,0,1,4,,train
0546245_as-0085015.jpg,1,0,0,1,2,,train
0546246_as-0085015.jpg,2,0,0,1,3,,train
0546247_as-0085015.jpg,2,0,0,0,2,,train
0546248_as-0085015.jpg,1,0,0,0,1,,val
0546249_as-0085015.jpg,1,0,0,0,1,,val
0546250_sc-165112.jpg,1,0,0,0,1,,test
0546252_sc-165112.jpg,2,0,1,0,3,,train
0546253_as-2790176.jpg,1,0,1,0,2,,train
0546254_as-0054098.jpg,1,0,0,0,1,,train
0546255_as-0054098.jpg,1,0,0,0,1,,train
0546256_as-0054098.jpg,1,0,0,0,1,,train
0546257_as-0054098.jpg,1,0,0,1,2,,train
0546258_sc-191449.jpg,3,0,0,1,4,,train
0546259_sc-191449.jpg,1,0,1,0,2,,val
0546260_sc-191449.jpg,2,0,1,1,4,,val
0546261_sc-191449.jpg,1,0,0,0,1,,test
0546262_sc-191449.jpg,3,0,0,1,4,,train
0546264_as-0075194.jpg,6,0,2,0,8,,train
0546265_as-0075194.jpg,4,0,1,0,5,,train
0546266_as-0075194.jpg,2,0,1,0,3,,train
0546267_as-0075194.jpg,4,0,2,0,6,,train
0546268_sc-156685.jpg,3,0,0,0,3,,train
0546269_sc-156685.jpg,0,1,0,0,1,,train
0546270_sc-156685.jpg,2,1,0,0,3,,val
0546271_sc-156685.jpg,3,0,0,0,3,,val
0546272_sc-156685.jpg,3,1,0,0,4,,test
0546273_sc-156685.jpg,3,0,0,0,3,,train
0546274_sc-156685.jpg,0,0,1,0,1,,train
0546275_sc-140794.jpg,3,1,1,3,8,,train
0546276_sc-140794.jpg,4,1,0,3,8,,train
0546277_sc-140794.jpg,3,1,0,2,6,,train
0546278_sc-140794.jpg,4,1,0,1,6,,train
0546279_sc-140794.jpg,0,0,1,0,1,,train
0546280_sc-140794.jpg,7,1,0,1,9,,val
0546281_sc-140794.jpg,7,1,0,2,10,,val
0546282_as-0030637.jpg,1,1,0,0,2,,test
0546283_as-0030637.jpg,1,0,0,0,1,,train
0546284_as-0030637.jpg,2,0,0,0,2,,train
0546285_as-0030637.jpg,3,2,1,1,7,,train
0546286_as-0030637.jpg,2,1,2,1,6,,train
0546287_as-0030637.jpg,3,1,0,0,4,,train
0546288_as-0030637.jpg,0,0,1,0,1,,train
0546289_sc-135890.jpg,2,0,0,0,2,,train
0546290_sc-135890.jpg,1,0,0,0,1,,val
0546291_sc-135890.jpg,1,0,0,0,1,,val
0546292_sc-135890.jpg,2,0,0,0,2,,test
0546293_sc-135890.jpg,2,0,0,0,2,,train
0546294_sc-135890.jpg,2,0,0,0,2,,train
0546295_sc-135890.jpg,1,0,0,0,1,,train
0546296_sc-140649.jpg,4,0,0,1,5,,train
0546297_as-7072445.jpg,3,0,0,0,3,,train
0546298_as-3240211.jpg,2,0,0,0,2,,train
0546299_sc-132299.jpg,1,0,0,0,1,,train
0546300_sc-132299.jpg,1,0,0,0,1,,val
0546301_sc-132299.jpg,2,0,0,0,2,,val
0546302_sc-128621.jpg,1,0,0,1,2,,test
0546303_as-3166880.jpg,4,0,0,0,4,,train
0546304_as-3177588.jpg,2,1,2,1,6,,train
0546305_as-0019417.jpg,2,2,1,0,5,,train
0546306_as-0019417.jpg,3,1,0,0,4,,train
0546309_as-0072356.jpg,2,0,2,2,6,,train
0546310_as-0072356.jpg,2,3,1,1,7,,train
0546311_as-0072356.jpg,2,2,2,1,7,,train
0546312_as-0072356.jpg,1,0,1,0,2,,val
0546313_as-3214431.jpg,1,1,1,1,4,,val
0546315_sc-1013795.jpg,2,0,0,1,3,,test
0546317_as-0075380.jpg,1,0,0,0,1,,train
0546318_as-0075380.jpg,2,0,0,0,2,,train
0546319_as-0075380.jpg,1,0,0,0,1,,train
0546320_as-0075380.jpg,0,0,0,2,2,,train
0546321_as-0075380.jpg,1,0,0,0,1,,train
0546323_sc-209221.jpg,3,1,0,0,4,,train
0546324_sc-172869.jpg,8,0,2,0,10,,train
0546325_sc-172869.jpg,7,0,2,0,9,,val
0546327_sc-172869.jpg,3,1,1,0,5,,val
0546328_as-2622765.jpg,0,0,1,1,2,,test
0546330_as-0002896.jpg,2,2,0,2,6,,train
0546331_as-0002896.jpg,3,4,0,3,10,,train
0546332_as-0002896.jpg,6,1,1,0,8,,train
0546333_as-0002896.jpg,0,0,1,1,2,,train
0546334_as-0002896.jpg,7,1,0,1,9,,train
0546335_sc-137439.jpg,2,1,0,0,3,,train
0546336_sc-137439.jpg,0,1,1,0,2,,train
0546337_sc-137439.jpg,0,1,0,1,2,,val
0546338_sc-137439.jpg,2,1,0,0,3,,val
0546339_sc-137439.jpg,0,1,0,0,1,,test
0546340_as-2925614.jpg,1,0,1,0,2,,train
0546341_as-3091005.jpg,1,0,0,0,1,,train
0546342_sc-1023722.jpg,3,0,0,0,3,,train
0546343_sc-1023722.jpg,4,0,0,0,4,,train
0546345_sc-1028960.jpg,1,0,0,1,2,,train
0546346_sc-1028960.jpg,1,0,1,0,2,,train
0546347_sc-1028960.jpg,3,0,1,0,4,,train
0546348_sc-1028960.jpg,2,0,0,1,3,,val
0546349_sc-1028960.jpg,3,0,0,0,3,,val
0546351_sc-1027198.jpg,2,1,1,0,4,,test
0546352_sc-1027198.jpg,9,1,0,0,10,,train
0546355_as-0065506.jpg,1,0,0,0,1,,train
0546356_sc-138495.jpg,1,0,0,0,1,,train
0546357_sc-138495.jpg,1,0,0,0,1,,train
0546359_as-0067440.jpg,2,0,0,0,2,,train
0546360_as-0067440.jpg,1,0,0,0,1,,train
0546362_as-0030704.jpg,1,0,0,0,1,,train
0546363_as-0030704.jpg,0,2,0,0,2,,val
0546364_as-0030704.jpg,2,0,0,0,2,,val
0546365_as-0030704.jpg,1,2,1,0,4,,test
0546366_as-0030704.jpg,0,1,0,0,1,,train
0546367_as-0030704.jpg,0,1,1,0,2,,train
0546368_as-0030704.jpg,3,2,1,0,6,,train
0546370_as-2572697.jpg,2,0,0,0,2,,train
0546371_as-0000199.jpg,0,1,0,0,1,,train
0546372_as-0000199.jpg,1,0,0,0,1,,train
0546373_as-0000199.jpg,5,0,0,0,5,,train
0546375_sc-105981.jpg,2,1,0,0,3,,val
0546376_sc-105981.jpg,1,0,0,1,2,,val
0546377_sc-105981.jpg,3,1,0,0,4,,test
0546378_as-2775212.jpg,1,0,0,0,1,,train
0546380_as-0073110.jpg,3,0,0,0,3,,train
0546381_as-0073110.jpg,7,0,0,0,7,,train
0546382_as-0047231.jpg,2,1,0,0,3,,train
0546383_as-0047231.jpg,1,0,0,0,1,,train
0546384_as-0047231.jpg,1,0,0,0,1,,train
0546385_as-0047231.jpg,2,0,0,0,2,,train
0546386_as-0047231.jpg,2,0,0,0,2,,val
0546387_as-3296944.jpg,1,0,0,0,1,,val
0546388_sc-118895.jpg,0,0,1,0,1,,test
0546389_sc-118895.jpg,2,0,1,1,4,,train
0546390_sc-118895.jpg,3,0,1,1,5,,train
0546392_sc-118895.jpg,2,0,0,1,3,,train
0546393_sc-213829.jpg,1,0,0,0,1,,train
0546394_as-0053378.jpg,1,0,0,0,1,,train
0546395_as-2670243.jpg,0,0,1,0,1,,train
0546396_as-0039713.jpg,1,1,0,0,2,,train
0546397_as-0039713.jpg,0,1,0,0,1,,val
0546398_as-0039713.jpg,0,0,1,0,1,,val
0546400_sc-116241.jpg,4,0,0,2,6,,test
0546401_sc-116241.jpg,1,0,0,1,2,,train
0546402_sc-116241.jpg,4,0,0,2,6,,train
0546403_sc-116241.jpg,1,0,0,1,2,,train
0546405_as-0094611.jpg,1,0,0,0,1,,train
0546406_as-0094611.jpg,1,0,0,0,1,,train
0546407_as-0094611.jpg,2,0,0,0,2,,train
0546408_sc-199047.jpg,2,0,0,0,2,,train
0546409_sc-199047.jpg,1,0,0,0,1,,val
0546410_sc-199047.jpg,3,0,0,0,3,,val
0546411_sc-208285.jpg,0,0,1,0,1,,test
0546412_as-2758541.jpg,11,3,1,2,17,,train
0546415_as-0019181.jpg,2,0,0,0,2,,train
0546416_as-0019181.jpg,2,0,0,1,3,,train
0546417_as-0019181.jpg,2,0,0,0,2,,train
0546418_as-0019181.jpg,2,0,0,0,2,,train
0546420_as-2554959.jpg,3,0,0,0,3,,train
0546425_sc-141055.jpg,1,0,0,0,1,,train
0546427_sc-141055.jpg,1,0,1,0,2,,val
0546428_sc-141055.jpg,5,1,1,0,7,,val
0546429_sc-141055.jpg,4,0,1,0,5,,test
0546430_sc-141055.jpg,3,0,1,0,4,,train
0546431_sc-1031556.jpg,1,0,2,0,3,,train
0546432_sc-1031556.jpg,3,0,1,0,4,,train
0546434_sc-1031556.jpg,2,1,1,0,4,,train
0546435_as-0061120.jpg,1,0,0,0,1,,train
0546437_as-0006631.jpg,1,0,0,0,1,,train
0546441_sc-152433.jpg,2,0,0,0,2,,train
0546442_sc-152433.jpg,3,0,0,0,3,,val
0546446_as-0075457.jpg,1,2,1,0,4,,val
0546447_as-0075457.jpg,1,2,1,0,4,,test
0546448_as-0075457.jpg,1,1,0,0,2,,train
0546449_as-0075457.jpg,3,2,0,1,6,,train
0546450_as-0075457.jpg,1,0,0,0,1,,train
0546453_sc-214954.jpg,0,0,0,1,1,,train
0546454_sc-214954.jpg,6,0,2,1,9,,train
0546455_sc-214954.jpg,6,0,2,1,9,,train
0546456_sc-214954.jpg,3,0,2,2,7,,train
0546457_sc-214954.jpg,2,0,1,1,4,,val
0546458_as-3251214.jpg,1,1,0,1,3,,val
0546459_sc-172632.jpg,2,0,0,0,2,,test
0546460_sc-187954.jpg,1,0,0,0,1,,train
0546461_sc-187954.jpg,2,0,0,0,2,,train
0546462_as-0001928.jpg,4,0,0,0,4,,train
0546463_sc-109888.jpg,5,0,0,2,7,,train
0546464_sc-109888.jpg,1,0,0,2,3,,train
0546465_sc-168841.jpg,1,0,0,3,4,,train
0546466_sc-168841.jpg,1,0,0,3,4,,train
0546467_sc-229241.jpg,1,0,1,0,2,,val
0546469_sc-229241.jpg,2,0,0,0,2,,val
0546470_sc-229241.jpg,4,0,0,0,4,,test
0546471_as-0017530.jpg,1,0,0,0,1,,train
0546474_as-0017530.jpg,2,0,2,1,5,,train
0546475_as-0017530.jpg,1,0,2,1,4,,train
0546476_as-0017530.jpg,1,0,1,1,3,,train
0546477_as-0017530.jpg,3,0,3,1,7,,train
0546479_as-0017530.jpg,3,1,1,0,5,,train
0546481_as-0017530.jpg,1,0,1,1,3,,train
0546483_as-0017530.jpg,4,0,1,1,6,,val
0546484_as-0017530.jpg,3,0,0,0,3,,val
0546486_as-0059120.jpg,3,0,0,0,3,,test
0546488_sc-224364.jpg,0,1,1,0,2,,train
0546489_as-3381026.jpg,1,0,0,0,1,,train
0546490_as-3381026.jpg,1,0,1,1,3,,train
0546492_as-0020026.jpg,1,3,0,0,4,,train
0546495_sc-125119.jpg,2,0,0,0,2,,train
0546496_as-0017637.jpg,4,0,0,0,4,,train
0546497_as-0017637.jpg,1,0,0,0,1,,train
0546498_sc-206987.jpg,0,1,0,0,1,,val
0546499_sc-106156.jpg,1,0,0,0,1,,val
0546500_sc-106156.jpg,1,0,0,0,1,,test
0546501_sc-106156.jpg,1,0,0,0,1,,train
0546502_sc-106156.jpg,1,0,0,0,1,,train
0546504_sc-106156.jpg,1,0,0,0,1,,train
0546507_sc-214180.jpg,2,0,0,0,2,,train
0546509_sc-214180.jpg,3,0,1,0,4,,train
0546510_sc-214180.jpg,2,1,2,1,6,,train
0546512_sc-214180.jpg,1,0,1,1,3,,train
0546513_sc-214180.jpg,1,0,1,1,3,,val
0546514_sc-214180.jpg,1,1,0,0,2,,val
0546515_as-0044795.jpg,2,0,2,1,5,,test
0546516_as-0036893.jpg,1,0,0,0,1,,train
0546517_as-0036893.jpg,1,0,0,0,1,,train
0546518_as-0036893.jpg,2,0,0,0,2,,train
0546519_as-0036893.jpg,0,0,1,0,1,,train
0546520_as-0036893.jpg,1,0,0,0,1,,train
0546521_sc-145601.jpg,7,0,0,0,7,,train
0546523_sc-145601.jpg,3,0,0,0,3,,train
0546525_sc-114678.jpg,1,0,0,0,1,,val
0546526_sc-114678.jpg,2,0,0,0,2,,val
0546527_sc-114678.jpg,1,0,0,0,1,,test
0546528_as-3359366.jpg,1,0,1,0,2,,train
0546529_as-0032943.jpg,1,0,0,0,1,,train
0546530_as-7855824.jpg,5,1,0,0,6,,train
0546531_as-7506053.jpg,1,0,0,0,1,,train
0546532_as-2695770.jpg,2,0,0,1,3,,train
0546533_sc-150031.jpg,1,0,0,0,1,,train
0546537_as-0078883.jpg,2,0,0,1,3,,train
0546538_as-2512363.jpg,1,0,0,0,1,,val
0546539_sc-213948.jpg,5,0,4,1,10,,val
0546540_sc-213948.jpg,4,0,1,0,5,,test
0546541_sc-213948.jpg,4,0,1,0,5,,train
0546542_sc-213948.jpg,3,0,1,0,4,,train
0546543_as-7486727.jpg,2,0,1,0,3,,train
0546544_sc-151699.jpg,0,1,0,0,1,,train
0546545_sc-151699.jpg,1,2,1,0,4,,train
0546546_sc-151699.jpg,1,2,1,0,4,,train
0546547_sc-151699.jpg,1,4,1,0,6,,train
0546548_sc-151699.jpg,3,0,1,0,4,,val
0546549_sc-151699.jpg,2,1,1,0,4,,val
0546550_as-0036234.jpg,1,0,0,0,1,,test
0546551_as-0036234.jpg,2,0,0,0,2,,train
0546552_as-0036234.jpg,2,1,0,1,4,,train
0546553_as-0036234.jpg,1,1,0,1,3,,train
0546554_as-0036234.jpg,1,1,0,1,3,,train
0546555_as-0036234.jpg,1,1,0,1,3,,train
0546556_as-0036234.jpg,1,0,0,0,1,,train
0546557_as-0036234.jpg,4,0,0,0,4,,train
0546558_as-0036234.jpg,1,1,0,0,2,,val
0546559_as-0035435.jpg,2,0,2,2,6,,val
0546560_as-0035435.jpg,4,0,0,0,4,,test
0546561_as-0035435.jpg,2,0,2,1,5,,train
0546562_as-0035435.jpg,3,0,3,2,8,,train
0546563_as-0035435.jpg,2,0,1,1,4,,train
0546565_as-9048960.jpg,2,0,0,0,2,,train
0546566_as-3058051.jpg,0,0,2,2,4,,train
0546567_sc-179946.jpg,1,0,0,0,1,,train
0546568_sc-199428.jpg,2,0,1,0,3,,train
0546569_sc-199428.jpg,2,0,0,0,2,,val
0546570_sc-199428.jpg,1,0,0,0,1,,val
0546571_sc-199428.jpg,2,0,0,0,2,,test
0546572_sc-199428.jpg,1,0,0,0,1,,train
0546573_sc-199428.jpg,1,0,0,0,1,,train
0546574_sc-199428.jpg,1,0,1,0,2,,train
0546575_sc-199428.jpg,1,0,0,0,1,,train
0546576_sc-199428.jpg,2,0,1,0,3,,train
0546577_sc-199428.jpg,1,0,0,0,1,,train
0546578_sc-199428.jpg,2,0,0,0,2,,train
0546579_sc-199428.jpg,1,0,0,0,1,,val
0546581_sc-227090.jpg,2,0,0,0,2,,val
0546582_sc-150509.jpg,1,0,0,0,1,,test
0546584_sc-126059.jpg,1,0,0,0,1,,train
0546585_sc-1001900.jpg,2,0,0,0,2,,train
0546587_sc-1001900.jpg,1,0,1,0,2,,train
0546588_sc-1001900.jpg,6,0,0,0,6,,train
0546589_sc-1001900.jpg,1,0,0,0,1,,train
0546590_sc-218908.jpg,2,0,0,0,2,,train
0546591_sc-218908.jpg,3,0,0,0,3,,train
0546592_as-3318552.jpg,6,3,1,0,10,,val
0546593_as-2920928.jpg,1,1,0,1,3,,val
0546595_as-0072066.jpg,1,0,0,0,1,,test
0546596_as-0072066.jpg,1,0,1,0,2,,train
0546597_as-0072066.jpg,2,0,1,0,3,,train
0546599_sc-202991.jpg,1,1,0,0,2,,train
0546600_sc-202991.jpg,1,1,0,0,2,,train
0546601_sc-202991.jpg,2,2,0,0,4,,train
0546603_sc-124824.jpg,0,1,0,0,1,,train
0546604_as-3419694.jpg,3,0,0,0,3,,train
0546605_sc-201175.jpg,11,0,1,2,14,,val
0546606_sc-201175.jpg,4,0,0,0,4,,val
0546607_sc-201175.jpg,6,0,0,0,6,,test
0546608_as-9081741.jpg,2,0,0,0,2,,train
0546609_as-7610093.jpg,2,0,1,1,4,,train
0546612_sc-194831.jpg,2,1,1,0,4,,train
0546613_sc-194831.jpg,5,1,1,0,7,,train
0546614_as-2519833.jpg,0,1,0,0,1,,train
0546615_as-0026690.jpg,1,0,2,1,4,,train
0546616_as-0026690.jpg,1,0,1,1,3,,train
0546617_as-0026690.jpg,1,0,1,1,3,,val
0546618_as-0026690.jpg,1,0,1,1,3,,val
0546620_as-0006869.jpg,0,0,1,0,1,,test
0546621_as-0006869.jpg,0,0,1,0,1,,train
0546622_as-0006869.jpg,0,0,1,0,1,,train
0546623_as-0006869.jpg,0,0,2,0,2,,train
0546624_sc-1012718.jpg,1,0,0,0,1,,train
0546625_as-7322781.jpg,1,0,0,0,1,,train
0546626_sc-169889.jpg,3,0,2,1,6,,train
0546627_sc-1012553.jpg,2,0,0,0,2,,train
0546628_sc-1012553.jpg,2,0,1,0,3,,val
0546629_sc-212546.jpg,1,0,1,0,2,,val
0546630_as-7744304.jpg,4,0,1,0,5,,test
0546631_sc-220678.jpg,1,0,1,0,2,,train
0546632_sc-130032.jpg,1,0,0,0,1,,train
0546634_as-3237429.jpg,5,0,1,0,6,,train
0546635_as-0094991.jpg,2,0,0,0,2,,train
0546636_as-0094991.jpg,1,0,0,0,1,,train
0546637_sc-225295.jpg,1,0,0,0,1,,train
0546639_sc-225295.jpg,0,0,1,0,1,,train
0546640_sc-225295.jpg,1,0,0,0,1,,val
0546641_sc-225295.jpg,1,0,2,0,3,,val
0546642_sc-225295.jpg,1,0,0,0,1,,test
0546643_sc-225295.jpg,6,0,1,0,7,,train
0546644_sc-225295.jpg,4,0,1,0,5,,train
0546645_as-3075957.jpg,6,0,0,0,6,,train
0546646_as-3436819.jpg,2,0,0,0,2,,train
0546647_as-7870900.jpg,1,0,1,1,3,,train
0546648_sc-147203.jpg,1,1,1,0,3,,train
0546649_as-7441581.jpg,2,0,1,0,3,,train
0546650_sc-208496.jpg,3,0,1,0,4,,val
0546652_as-0081129.jpg,0,0,1,0,1,,val
0546653_as-7475602.jpg,4,0,1,0,5,,test
0546654_sc-121291.jpg,1,0,0,0,1,,train
0546655_sc-121291.jpg,2,0,0,0,2,,train
0546656_sc-115989.jpg,2,0,0,0,2,,train
0546659_as-0059308.jpg,1,0,0,0,1,,train
0546661_as-0055213.jpg,1,0,0,0,1,,train
0546662_as-0055213.jpg,2,0,0,0,2,,train
0546663_as-0055213.jpg,1,0,0,2,3,,train
0546664_as-0055213.jpg,1,1,0,1,3,,val
0546665_as-3058749.jpg,3,0,0,0,3,,val
0546666_sc-206151.jpg,3,0,1,0,4,,test
0546667_sc-206151.jpg,1,0,2,1,4,,train
0546668_sc-206151.jpg,4,1,0,0,5,,train
0546670_sc-1030623.jpg,2,1,0,0,3,,train
0546671_sc-1030623.jpg,3,0,1,1,5,,train
0546672_sc-1030623.jpg,2,0,0,1,3,,train
0546674_sc-163342.jpg,10,3,0,0,13,,train
0546675_sc-163342.jpg,1,0,0,0,1,,train
0546676_sc-163342.jpg,5,0,0,0,5,,val
0546677_sc-163342.jpg,3,0,0,0,3,,val
0546678_sc-163342.jpg,8,2,0,0,10,,test
0546679_sc-163342.jpg,7,3,0,0,10,,train
0546680_sc-163342.jpg,3,0,0,1,4,,train
0546681_sc-163342.jpg,2,0,0,2,4,,train
0546682_as-0031706.jpg,1,0,0,0,1,,train
0546683_as-0031706.jpg,2,0,1,0,3,,train
0546684_as-0031706.jpg,1,0,1,0,2,,train
0546685_as-0031706.jpg,2,0,1,0,3,,train
0546686_as-0031706.jpg,2,0,1,0,3,,val
0546687_as-0031706.jpg,0,0,1,0,1,,val
0546688_as-0031706.jpg,0,0,1,0,1,,test
0546689_as-0031706.jpg,1,0,1,0,2,,train
0546690_as-0031706.jpg,3,0,1,1,5,,train
0546691_as-0031706.jpg,3,1,2,1,7,,train
0546692_as-0031706.jpg,3,0,2,1,6,,train
0546694_sc-1021640.jpg,2,0,0,0,2,,train
0546695_sc-216173.jpg,1,0,0,0,1,,train
0546696_sc-216173.jpg,1,0,0,1,2,,train
0546697_sc-216173.jpg,1,0,0,1,2,,val
0546698_sc-216173.jpg,1,0,0,1,2,,val
0546699_sc-177527.jpg,1,0,1,1,3,,test
0546700_sc-177527.jpg,2,0,1,1,4,,train
0546701_sc-127626.jpg,0,0,1,0,1,,train
0546702_as-0073156.jpg,1,0,0,0,1,,train
0546703_as-0073156.jpg,5,0,1,0,6,,train
0546704_as-0073156.jpg,4,0,1,0,5,,train
0546705_as-0073156.jpg,5,0,1,0,6,,train
0546706_as-0073156.jpg,4,0,1,0,5,,train
0546707_as-0073156.jpg,1,0,1,0,2,,val
0546708_as-0073156.jpg,3,0,0,0,3,,val
0546709_sc-228600.jpg,3,0,1,1,5,,test
0546710_sc-228600.jpg,6,3,1,1,11,,train
0546712_sc-1036084.jpg,1,1,3,0,5,,train
0546715_sc-183356.jpg,2,0,1,0,3,,train
0546716_sc-183356.jpg,3,0,1,1,5,,train
0546717_sc-183356.jpg,0,0,0,2,2,,train
0546718_sc-157659.jpg,2,0,0,1,3,,train
0546719_as-0000424.jpg,1,0,0,0,1,,train
0546720_as-0000424.jpg,0,0,0,1,1,,val
0546721_as-7006085.jpg,1,0,1,0,2,,val
0546724_as-0074210.jpg,1,1,0,1,3,,test
0546725_as-0074210.jpg,3,0,0,1,4,,train
0546726_as-0074210.jpg,1,1,0,1,3,,train
0546727_as-0074210.jpg,2,1,0,1,4,,train
0546728_as-0074210.jpg,1,1,0,1,3,,train
0546729_as-0074210.jpg,1,1,1,1,4,,train
0546730_as-2618044.jpg,2,0,0,1,3,,train
0546731_as-0003017.jpg,3,0,0,1,4,,train
0546732_as-0003017.jpg,2,0,0,1,3,,val
0546733_as-0003017.jpg,3,1,0,0,4,,val
0546734_as-0003017.jpg,3,2,0,0,5,,test
0546736_as-9063437.jpg,2,0,0,0,2,,train
0546737_as-7608834.jpg,2,0,0,1,3,,train
0546738_as-0079867.jpg,1,0,0,0,1,,train
0546739_sc-1037465.jpg,4,0,1,1,6,,train
0546740_sc-1037465.jpg,2,0,0,2,4,,train
0546741_as-3003677.jpg,2,1,2,2,7,,train
0546742_sc-180880.jpg,2,0,0,0,2,,train
0546743_sc-180880.jpg,2,0,0,1,3,,val
0546744_sc-180880.jpg,2,0,0,1,3,,val
0546745_sc-180880.jpg,2,0,0,1,3,,test
0546746_sc-180880.jpg,1,0,0,0,1,,train
0546748_sc-1023979.jpg,1,0,0,1,2,,train
0546749_sc-1023979.jpg,1,0,1,1,3,,train
0546750_as-0025069.jpg,1,0,0,0,1,,train
0546751_as-2609495.jpg,4,0,0,0,4,,train
0546752_as-0082675.jpg,2,0,0,0,2,,train
0546753_as-0082675.jpg,2,1,1,3,7,,train
0546754_as-0082675.jpg,2,0,0,2,4,,val
0546756_as-0082675.jpg,2,0,0,3,5,,val
0546758_as-0082675.jpg,1,0,0,1,2,,test
0546759_as-0082675.jpg,1,0,2,0,3,,train
0546760_as-0082675.jpg,2,0,0,4,6,,train
0546762_sc-219925.jpg,4,0,0,1,5,,train
0546763_sc-219925.jpg,2,0,0,1,3,,train
0546764_sc-219925.jpg,4,1,0,0,5,,train
0546765_sc-219925.jpg,3,1,0,0,4,,train
0546766_sc-219925.jpg,2,1,0,0,3,,train
0546767_as-0095081.jpg,3,0,0,1,4,,val
0546768_as-0095081.jpg,0,0,0,1,1,,val
0546769_as-2859407.jpg,3,0,0,0,3,,test
0546770_as-0045605.jpg,4,0,0,0,4,,train
0546771_as-0045605.jpg,1,0,0,0,1,,train
0546772_as-0045605.jpg,4,0,0,0,4,,train
0546773_as-0045605.jpg,1,0,0,0,1,,train
0546775_as-0011475.jpg,3,0,1,2,6,,train
0546776_as-0011475.jpg,2,0,1,0,3,,train
0546779_sc-200945.jpg,1,0,0,0,1,,train
0546780_sc-200945.jpg,1,0,0,0,1,,val
0546781_sc-200945.jpg,1,0,0,0,1,,val
0546782_sc-200945.jpg,1,0,0,0,1,,test
0546783_sc-200945.jpg,1,0,1,0,2,,train
0546784_sc-200945.jpg,2,0,0,0,2,,train
0546785_sc-200945.jpg,1,0,1,0,2,,train
0546786_sc-104050.jpg,1,2,1,0,4,,train
0546787_sc-104050.jpg,1,1,0,0,2,,train
0546788_sc-113200.jpg,2,0,0,0,2,,train
0546789_sc-113200.jpg,3,0,0,0,3,,train
0546791_sc-113200.jpg,1,0,0,0,1,,val
0546792_sc-182426.jpg,1,0,0,1,2,,val
0546794_sc-197147.jpg,3,0,0,0,3,,test
0546795_sc-197147.jpg,4,0,0,0,4,,train
0546796_as-0046691.jpg,11,0,0,0,11,,train
0546797_as-0046691.jpg,15,0,0,0,15,,train
0546798_as-0046691.jpg,10,1,2,0,13,,train
0546799_as-0046691.jpg,3,0,0,0,3,,train
0546800_as-0046691.jpg,5,0,0,0,5,,train
0546801_as-0046691.jpg,1,0,0,0,1,,train
0546802_as-0046691.jpg,0,1,1,0,2,,val
0546803_as-0086697.jpg,0,0,1,0,1,,val
0546805_as-0086697.jpg,1,0,1,1,3,,test
0546806_as-0086697.jpg,1,0,0,0,1,,train
0546807_as-0086697.jpg,2,0,1,1,4,,train
0546809_sc-135824.jpg,2,2,0,1,5,,train
0546810_sc-135824.jpg,2,4,0,1,7,,train
0546811_sc-135824.jpg,3,2,0,1,6,,train
0546812_sc-135824.jpg,2,1,0,0,3,,train
0546815_as-0058909.jpg,1,0,0,0,1,,train
0546816_as-0058909.jpg,1,0,1,1,3,,val
0546819_as-0029860.jpg,2,0,0,0,2,,val
0546820_as-0029860.jpg,2,0,0,0,2,,test
0546822_as-0061666.jpg,1,0,0,0,1,,train
0546827_as-0061666.jpg,3,0,0,0,3,,train
0546828_as-0061666.jpg,1,1,1,1,4,,train
0546829_as-0061666.jpg,2,0,0,0,2,,train
0546830_as-0061666.jpg,1,0,0,0,1,,train
0546831_as-0061666.jpg,1,0,2,0,3,,train
0546832_as-0061666.jpg,2,0,2,0,4,,train
0546833_as-0061666.jpg,1,0,1,0,2,,val
0546836_as-0010684.jpg,2,0,0,0,2,,val
0546837_as-0010684.jpg,2,0,0,0,2,,test
0546838_sc-116117.jpg,2,0,1,0,3,,train
0546839_sc-116117.jpg,1,0,1,0,2,,train
0546840_sc-116117.jpg,1,0,0,0,1,,train
0546841_sc-116117.jpg,2,0,1,0,3,,train
0546842_sc-116117.jpg,1,0,1,0,2,,train
0546843_sc-116117.jpg,1,0,0,0,1,,train
0546844_sc-116117.jpg,1,0,0,0,1,,train
0546846_sc-179616.jpg,2,1,1,1,5,,val
0546847_sc-179616.jpg,2,1,1,1,5,,val
0546848_sc-179616.jpg,2,1,1,1,5,,test
0546850_sc-179616.jpg,2,1,1,1,5,,train
0546851_sc-225703.jpg,1,0,1,0,2,,train
0546852_sc-225703.jpg,1,0,1,0,2,,train
0546853_sc-225703.jpg,1,0,1,0,2,,train
0546854_as-9099664.jpg,2,0,1,1,4,,train
0546855_sc-120542.jpg,2,0,0,0,2,,train
0546856_sc-120542.jpg,1,0,0,0,1,,train
0546857_sc-120542.jpg,8,0,2,0,10,,val
0546858_sc-120542.jpg,3,0,0,0,3,,val
0546860_as-0036063.jpg,2,0,1,0,3,,test
0546861_as-0036063.jpg,1,0,0,0,1,,train
0546862_as-0036063.jpg,1,0,1,0,2,,train
0546863_as-0036063.jpg,1,0,1,0,2,,train
0546864_as-0036063.jpg,2,0,1,0,3,,train
0546865_as-0036063.jpg,1,0,1,0,2,,train
0546866_as-0036063.jpg,3,0,3,0,6,,train
0546867_as-0036063.jpg,2,0,0,0,2,,train
0546868_as-2587820.jpg,1,1,1,0,3,,val
0546869_sc-209764.jpg,7,1,0,2,10,,val
0546871_sc-209764.jpg,2,0,0,0,2,,test
0546872_sc-209764.jpg,2,0,0,0,2,,train
0546873_sc-209764.jpg,3,0,0,0,3,,train
0546874_sc-209764.jpg,2,0,1,0,3,,train
0546875_sc-209764.jpg,2,1,0,0,3,,train
0546876_as-0040925.jpg,1,0,0,0,1,,train
0546878_as-0040925.jpg,2,0,0,0,2,,train
0546879_as-0040925.jpg,3,0,0,0,3,,train
0546880_as-0040925.jpg,1,0,0,0,1,,val
0546884_as-0088833.jpg,1,0,0,0,1,,val
0546885_as-0088833.jpg,3,0,1,1,5,,test
0546888_as-0075053.jpg,5,0,1,2,8,,train
0546889_as-0075053.jpg,3,0,1,0,4,,train
0546890_as-0075053.jpg,1,0,1,1,3,,train
0546891_as-0075053.jpg,4,0,1,2,7,,train
0546892_as-0075053.jpg,1,0,0,0,1,,train
0546893_as-0075053.jpg,1,0,0,0,1,,train
0546894_as-0075053.jpg,1,0,1,2,4,,train
0546895_as-0061197.jpg,0,0,1,0,1,,val
0546896_as-0061197.jpg,1,0,1,0,2,,val
0546897_as-2660667.jpg,6,0,0,2,8,,test
0546898_sc-180865.jpg,2,0,0,0,2,,train
0546899_sc-180865.jpg,3,0,0,2,5,,train
0546900_sc-180865.jpg,3,0,0,2,5,,train
0546902_sc-180865.jpg,3,0,0,3,6,,train
0546903_sc-180865.jpg,4,0,0,1,5,,train
0546904_sc-180865.jpg,5,0,0,3,8,,train
0546906_as-0061402.jpg,10,2,2,0,14,,train
0546908_as-0061402.jpg,3,0,0,0,3,,val
0546909_as-0061402.jpg,2,0,0,0,2,,val
0546910_as-0061402.jpg,1,0,0,0,1,,test
0546911_sc-1024972.jpg,0,0,3,0,3,,train
0546912_sc-1024972.jpg,0,0,2,0,2,,train
0546913_sc-1024972.jpg,1,0,2,0,3,,train
0546914_sc-162129.jpg,1,0,1,0,2,,train
0546915_sc-162129.jpg,0,0,2,0,2,,train
0546916_sc-162129.jpg,0,0,1,0,1,,train
0546917_as-3469709.jpg,1,0,0,0,1,,train
0546918_sc-106843.jpg,2,0,2,1,5,,val
0546920_sc-106843.jpg,2,0,2,1,5,,val
0546922_sc-106843.jpg,2,0,2,1,5,,test
0546923_sc-106843.jpg,1,0,1,1,3,,train
0546924_sc-106843.jpg,1,0,1,1,3,,train
0546925_as-0095227.jpg,3,0,0,0,3,,train
0546926_as-0095227.jpg,4,0,0,1,5,,train
0546929_as-0072219.jpg,4,1,0,0,5,,train
0546930_as-0072219.jpg,5,1,0,0,6,,train
0546931_as-0072219.jpg,1,0,0,0,1,,train
0546932_as-0072219.jpg,3,2,0,0,5,,val
0546933_as-0072219.jpg,0,0,0,1,1,,val
0546934_as-0072219.jpg,0,0,0,1,1,,test
0546935_as-0072219.jpg,4,0,0,0,4,,train
0546936_sc-204752.jpg,1,0,0,0,1,,train
0546937_sc-204752.jpg,1,0,0,0,1,,train
0546938_as-0007564.jpg,0,0,0,1,1,,train
0546939_as-0034912.jpg,7,2,3,1,13,,train
0546940_as-0034912.jpg,4,1,2,1,8,,train
0546943_sc-1025573.jpg,1,0,1,0,2,,train
0546944_sc-1025573.jpg,0,0,1,0,1,,val
0546946_sc-1025573.jpg,1,0,1,0,2,,val
0546947_sc-1025573.jpg,0,0,1,0,1,,test
0546949_sc-226824.jpg,3,0,0,0,3,,train
0546950_sc-226824.jpg,2,0,1,1,4,,train
0546951_sc-226824.jpg,2,1,1,1,5,,train
0546953_as-0072552.jpg,2,0,0,0,2,,train
0546954_sc-219071.jpg,2,0,1,0,3,,train
0546955_sc-219071.jpg,1,0,0,0,1,,train
0546957_sc-192812.jpg,1,1,0,1,3,,train
0546958_sc-192812.jpg,3,0,0,0,3,,val
0546959_sc-192812.jpg,2,0,0,0,2,,val
0546960_sc-192812.jpg,4,0,0,0,4,,test
0546961_sc-192812.jpg,1,1,0,0,2,,train
0546962_sc-192812.jpg,1,1,0,1,3,,train
0546963_sc-192812.jpg,1,1,0,1,3,,train
0546964_sc-192812.jpg,2,0,0,0,2,,train
0546965_sc-139995.jpg,1,0,1,1,3,,train
0546966_sc-139995.jpg,1,0,0,1,2,,train
0546967_sc-139995.jpg,1,0,0,0,1,,train
0546968_as-2740037.jpg,4,0,4,0,8,,val
0546971_as-0017194.jpg,1,0,1,1,3,,val
0546972_as-0017194.jpg,2,0,1,1,4,,test
0546974_as-0017194.jpg,4,0,0,0,4,,train
0546975_as-0017194.jpg,6,0,0,0,6,,train
0546976_as-0017194.jpg,4,1,1,0,6,,train
0546977_as-0017194.jpg,0,1,0,0,1,,train
0546978_sc-180990.jpg,1,0,0,1,2,,train
0546979_sc-180990.jpg,1,0,0,1,2,,train
0546980_sc-180990.jpg,1,0,0,1,2,,train
0546981_sc-180990.jpg,1,0,0,1,2,,val
0546983_sc-221507.jpg,1,0,0,1,2,,val
0546984_sc-221507.jpg,2,0,0,1,3,,test
0546985_sc-221507.jpg,4,0,0,0,4,,train
0546986_sc-221507.jpg,2,0,1,0,3,,train
0546987_sc-201601.jpg,2,1,1,0,4,,train
0546988_sc-201601.jpg,5,2,1,0,8,,train
0546989_sc-201601.jpg,2,1,1,0,4,,train
0546990_sc-201601.jpg,13,0,0,0,13,,train
0546991_as-0029495.jpg,1,0,0,0,1,,train
0546992_as-0029495.jpg,1,0,0,0,1,,val
0546993_as-0029495.jpg,1,0,0,0,1,,val
0546994_as-0029495.jpg,1,0,0,1,2,,test
0546996_as-0029495.jpg,1,0,0,2,3,,train
0546997_sc-121609.jpg,1,3,0,1,5,,train
0546999_sc-121609.jpg,3,0,1,0,4,,train
0547000_sc-121609.jpg,2,0,0,0,2,,train
0547002_as-0082687.jpg,1,0,1,1,3,,train
0547004_as-0082687.jpg,1,0,1,0,2,,train
0547005_as-0082687.jpg,1,0,1,0,2,,train
0547006_as-0082687.jpg,0,0,1,0,1,,val
0547007_as-0082687.jpg,1,0,0,0,1,,val
0547008_as-0082687.jpg,2,0,0,0,2,,test
0547009_as-0082687.jpg,0,0,2,0,2,,train
0547010_as-0082687.jpg,1,0,2,0,3,,train
0547011_as-0082687.jpg,1,0,0,0,1,,train
0547012_as-0082687.jpg,0,1,1,0,2,,train
0547013_as-0082687.jpg,3,0,0,0,3,,train
0547014_as-0043807.jpg,0,1,0,0,1,,train
0547015_as-0043807.jpg,0,0,1,0,1,,train
0547016_as-0043807.jpg,0,0,1,0,1,,val
0547018_sc-210776.jpg,1,0,0,0,1,,val
0547019_sc-210776.jpg,0,0,0,1,1,,test
0547020_sc-210776.jpg,0,0,3,0,3,,train
0547021_sc-210776.jpg,4,0,1,0,5,,train
0547022_sc-210776.jpg,1,1,0,0,2,,train
0547023_sc-210776.jpg,1,0,0,0,1,,train
0547024_sc-210776.jpg,5,2,1,0,8,,train
0547025_sc-210776.jpg,3,3,1,0,7,,train
0547026_as-0047182.jpg,1,0,0,0,1,,train
0547027_as-0047182.jpg,1,0,0,0,1,,val
0547028_as-0047182.jpg,1,0,0,0,1,,val
0547030_as-0087773.jpg,0,1,1,1,3,,test
0547031_as-0087773.jpg,0,2,2,1,5,,train
0547033_as-0087773.jpg,2,1,0,0,3,,train
0547035_as-0087773.jpg,1,1,1,2,5,,train
0547036_sc-154980.jpg,1,1,0,0,2,,train
0547037_as-0006651.jpg,1,0,0,0,1,,train
0547038_as-0006651.jpg,3,0,0,0,3,,train
0547039_as-0006651.jpg,4,1,0,0,5,,train
0547040_as-0006651.jpg,2,1,0,0,3,,val
0547042_as-2990400.jpg,1,1,0,0,2,,val
0547043_as-3364232.jpg,1,0,0,0,1,,test
0547044_sc-123742.jpg,2,0,1,1,4,,train
0547047_as-0050587.jpg,3,0,0,0,3,,train
0547048_as-0050587.jpg,4,0,1,1,6,,train
0547050_as-0050587.jpg,2,0,0,0,2,,train
0547051_as-0050587.jpg,3,0,1,0,4,,train
0547052_as-0050587.jpg,7,0,1,0,8,,train
0547053_as-0050587.jpg,2,0,1,0,3,,train
0547056_as-0017786.jpg,3,1,0,0,4,,val
0547059_as-0017786.jpg,1,0,0,0,1,,val
0547061_as-0017786.jpg,1,0,0,0,1,,test
0547062_as-0017786.jpg,1,0,0,0,1,,train
0547063_as-0017786.jpg,1,0,0,0,1,,train
0547068_sc-186514.jpg,7,0,0,0,7,,train
0547069_sc-186514.jpg,0,0,0,1,1,,train
0547070_sc-186514.jpg,12,0,0,0,12,,train
0547071_sc-154383.jpg,2,0,1,0,3,,train
0547072_sc-154383.jpg,2,2,1,0,5,,train
0547073_sc-154383.jpg,2,1,1,0,4,,val
0547074_sc-154383.jpg,3,1,0,0,4,,val
0547075_sc-154383.jpg,4,2,1,0,7,,test
0547076_sc-154383.jpg,3,2,1,0,6,,train
0547078_sc-154383.jpg,2,2,1,0,5,,train
0547081_as-0042497.jpg,2,0,0,0,2,,train
0547085_as-0062730.jpg,1,0,0,0,1,,train
0547086_as-0014591.jpg,1,0,0,0,1,,train
0547087_as-0014591.jpg,1,0,0,0,1,,train
0547088_as-0014591.jpg,1,0,0,0,1,,train
0547089_sc-220416.jpg,6,0,3,3,12,,val
0547090_sc-220416.jpg,3,0,0,0,3,,val
0547091_sc-220416.jpg,7,6,0,0,13,,test
0547092_sc-220416.jpg,7,1,3,2,13,,train
0547093_as-2859318.jpg,1,2,4,1,8,,train
0547094_as-0024907.jpg,1,0,0,0,1,,train
0547095_as-0024907.jpg,2,0,0,0,2,,train
0547097_sc-122742.jpg,0,0,2,0,2,,train
0547098_sc-122742.jpg,3,1,1,0,5,,train
0547099_sc-122742.jpg,0,0,1,0,1,,train
0547101_sc-122742.jpg,3,0,2,0,5,,val
0547102_sc-122742.jpg,3,0,2,0,5,,val
0547103_as-0016696.jpg,3,0,0,0,3,,test
0547104_as-3075868.jpg,1,0,0,0,1,,train
0547105_sc-182717.jpg,1,0,0,1,2,,train
0547106_sc-182717.jpg,1,0,1,1,3,,train
0547110_as-0092414.jpg,2,1,0,0,3,,train
0547111_as-0092414.jpg,2,1,0,0,3,,train
0547112_as-0092414.jpg,2,1,0,0,3,,train
0547113_as-0092414.jpg,2,1,0,0,3,,train
0547114_as-3011986.jpg,1,0,0,0,1,,val
0547115_as-0034701.jpg,1,0,0,1,2,,val
0547116_as-0034701.jpg,2,0,0,1,3,,test
0547117_as-0034701.jpg,2,2,0,1,5,,train
0547119_as-0078348.jpg,1,0,0,0,1,,train
0547120_as-0078348.jpg,1,0,0,0,1,,train
0547121_sc-224995.jpg,1,0,1,0,2,,train
0547122_sc-224995.jpg,3,0,2,0,5,,train
0547123_sc-224995.jpg,2,1,2,0,5,,train
0547125_as-0052929.jpg,1,0,0,0,1,,train
0547126_as-0052929.jpg,1,0,1,0,2,,val
0547127_as-0052929.jpg,3,0,1,0,4,,val
0547131_as-0052929.jpg,4,0,1,3,8,,test
0547132_as-0052929.jpg,4,1,0,0,5,,train
0547133_as-0052929.jpg,4,0,1,4,9,,train
0547134_as-0052929.jpg,2,0,2,4,8,,train
0547135_sc-200469.jpg,1,0,0,0,1,,train
0547136_sc-171996.jpg,4,0,0,0,4,,train
0547137_sc-171996.jpg,6,0,0,0,6,,train
0547138_sc-171996.jpg,3,0,0,0,3,,train
0547140_as-0024869.jpg,1,0,0,0,1,,val
0547142_sc-207232.jpg,4,0,1,0,5,,val
0547143_sc-207232.jpg,6,0,0,1,7,,test
0547144_sc-207232.jpg,2,0,0,1,3,,train
0547145_sc-207232.jpg,5,0,1,0,6,,train
0547146_sc-207232.jpg,2,0,0,0,2,,train
0547147_sc-207232.jpg,1,0,0,0,1,,train
0547148_sc-207232.jpg,4,0,0,1,5,,train
0547149_as-0037333.jpg,0,1,0,0,1,,train
0547150_as-0037333.jpg,0,1,0,0,1,,train
0547151_as-0037333.jpg,0,1,0,0,1,,val
0547153_sc-191160.jpg,1,0,1,0,2,,val
0547154_sc-191160.jpg,2,1,1,0,4,,test
0547155_sc-191160.jpg,1,0,0,0,1,,train
0547156_sc-191160.jpg,2,1,0,0,3,,train
0547157_sc-191160.jpg,1,1,1,0,3,,train
0547159_sc-191160.jpg,1,0,0,0,1,,train
0547160_sc-1030012.jpg,0,0,1,0,1,,train
0547161_sc-1030012.jpg,1,0,0,0,1,,train
0547162_sc-1030012.jpg,2,0,0,0,2,,train
0547163_sc-1030012.jpg,3,0,0,1,4,,val
0547164_sc-218696.jpg,1,0,0,0,1,,val
0547165_sc-218696.jpg,0,1,0,0,1,,test
0547166_sc-218696.jpg,1,1,0,0,2,,train
0547167_sc-218696.jpg,1,0,0,0,1,,train
0547168_sc-222843.jpg,3,0,0,0,3,,train
0547169_sc-222843.jpg,4,0,1,0,5,,train
0547170_sc-222843.jpg,3,0,1,0,4,,train
0547171_as-2714595.jpg,0,1,1,0,2,,train
0547172_as-7078421.jpg,1,0,0,0,1,,train
0547173_as-7814452.jpg,1,0,0,0,1,,val
0547175_sc-195947.jpg,4,2,5,2,13,,val
0547177_sc-195947.jpg,2,3,4,2,11,,test
0547178_as-0087124.jpg,1,1,1,0,3,,train
0547179_sc-201713.jpg,1,0,1,1,3,,train
0547184_sc-201713.jpg,3,1,0,1,5,,train
0547185_sc-201713.jpg,2,2,1,0,5,,train
0547186_sc-201713.jpg,2,1,1,1,5,,train
0547187_as-0024988.jpg,0,0,0,1,1,,train
0547188_sc-1005542.jpg,1,1,0,0,2,,train
0547190_as-3148746.jpg,0,2,1,2,5,,val
0547192_as-0039949.jpg,3,0,1,0,4,,val
0547193_as-0039949.jpg,3,0,2,5,10,,test
0547194_as-0039949.jpg,3,0,3,2,8,,train
0547195_as-0039949.jpg,5,0,2,2,9,,train
0547197_sc-148871.jpg,1,0,1,0,2,,train
0547198_sc-148871.jpg,4,0,0,0,4,,train
0547199_sc-148871.jpg,2,0,0,0,2,,train
0547201_sc-148871.jpg,3,1,1,0,5,,train
0547202_sc-148871.jpg,3,0,0,0,3,,train
0547203_sc-136296.jpg,1,0,0,0,1,,val
0547205_sc-136296.jpg,1,0,0,0,1,,val
0547207_sc-136296.jpg,1,0,0,0,1,,test
0547208_sc-136296.jpg,1,0,0,0,1,,train
0547213_sc-156584.jpg,1,0,1,1,3,,train
0547218_as-0064568.jpg,0,0,1,0,1,,train
0547219_as-0064568.jpg,1,0,0,0,1,,train
0547221_as-0064568.jpg,0,0,0,1,1,,train
0547222_as-0064568.jpg,1,0,0,0,1,,train
0547223_as-0064568.jpg,0,0,1,0,1,,train
0547224_as-0064568.jpg,0,0,1,1,2,,val
0547225_as-0064568.jpg,2,0,1,0,3,,val
0547227_as-0064568.jpg,0,0,0,1,1,,test
0547228_as-0064568.jpg,1,0,1,1,3,,train
0547230_as-7124950.jpg,2,1,2,1,6,,train
0547232_as-9068989.jpg,4,1,1,0,6,,train
0547233_sc-1034716.jpg,3,0,0,2,5,,train
0547234_sc-1034716.jpg,4,0,0,0,4,,train
0547235_sc-1034716.jpg,1,0,0,0,1,,train
0547236_sc-1034716.jpg,7,0,0,0,7,,train
0547237_sc-1034716.jpg,1,0,0,0,1,,val
0547238_sc-1034716.jpg,3,0,0,2,5,,val
0547239_sc-1034716.jpg,2,0,0,0,2,,test
0547241_sc-1034716.jpg,4,0,0,1,5,,train
0547242_as-0024523.jpg,0,0,0,1,1,,train
0547243_as-0024523.jpg,1,0,0,0,1,,train
0547244_as-7160536.jpg,2,0,0,0,2,,train
0547248_sc-115700.jpg,3,1,1,1,6,,train
0547250_sc-1021404.jpg,1,0,1,0,2,,train
0547251_sc-1021404.jpg,1,0,0,0,1,,train
0547252_as-0047295.jpg,3,1,0,0,4,,val
0547253_as-0047295.jpg,3,0,2,1,6,,val
0547254_as-0047295.jpg,1,0,1,0,2,,test
0547255_as-0047295.jpg,4,0,2,1,7,,train
0547256_as-0047295.jpg,1,0,1,0,2,,train
0547257_as-0047295.jpg,1,0,0,0,1,,train
0547258_as-0047295.jpg,2,0,0,0,2,,train
0547259_as-0047295.jpg,1,0,1,1,3,,train
0547260_as-0047295.jpg,4,0,1,0,5,,train
0547261_as-2534961.jpg,1,1,0,0,2,,train
0547262_as-7244039.jpg,2,0,0,1,3,,val
0547263_as-3398150.jpg,1,0,1,1,3,,val
0547264_sc-222509.jpg,0,1,0,0,1,,test
0547265_sc-125855.jpg,2,0,1,0,3,,train
0547267_sc-125855.jpg,1,0,0,0,1,,train
0547268_as-3277677.jpg,1,0,0,0,1,,train
0547269_sc-155055.jpg,7,0,1,0,8,,train
0547270_sc-155055.jpg,5,0,0,0,5,,train
0547271_sc-220396.jpg,5,0,1,0,6,,train
0547272_sc-220396.jpg,3,0,1,0,4,,train
0547273_sc-220396.jpg,6,0,1,0,7,,val
0547274_as-2965042.jpg,3,0,1,1,5,,val
0547275_sc-208025.jpg,2,1,0,0,3,,test
0547276_sc-152627.jpg,1,0,0,0,1,,train
0547277_sc-219374.jpg,1,1,0,0,2,,train
0547278_sc-219374.jpg,0,1,0,0,1,,train
0547279_sc-217311.jpg,1,0,0,0,1,,train
0547280_sc-217311.jpg,2,0,0,0,2,,train
0547281_sc-217311.jpg,2,0,0,0,2,,train
0547282_sc-217311.jpg,1,0,0,0,1,,train
0547283_sc-217311.jpg,1,0,0,0,1,,val
0547284_sc-217311.jpg,1,0,0,0,1,,val
0547285_as-0003613.jpg,1,0,0,0,1,,test
0547286_as-0096465.jpg,1,0,0,0,1,,train
0547287_as-0096465.jpg,1,0,0,0,1,,train
0547288_as-0096465.jpg,2,0,1,0,3,,train
0547289_as-0096465.jpg,2,0,1,0,3,,train
0547290_as-0096465.jpg,1,0,1,0,2,,train
0547292_as-3189891.jpg,1,0,1,1,3,,train
0547293_sc-129454.jpg,0,0,0,1,1,,train
0547294_sc-137633.jpg,1,0,0,0,1,,val
0547295_sc-137633.jpg,8,1,1,0,10,,val
0547296_sc-137633.jpg,9,1,1,0,11,,test
0547297_sc-137633.jpg,1,0,0,0,1,,train
0547298_as-3165568.jpg,1,0,0,0,1,,train
0547300_as-2984429.jpg,2,0,0,0,2,,train
0547301_sc-150624.jpg,0,1,0,0,1,,train
0547302_sc-150624.jpg,0,1,0,0,1,,train
0547303_sc-150624.jpg,0,1,0,0,1,,train
0547304_as-3391590.jpg,2,0,0,1,3,,train
0547306_as-0059441.jpg,1,0,0,0,1,,val
0547307_as-0059441.jpg,1,0,0,0,1,,val
0547308_as-0059441.jpg,2,0,0,0,2,,test
0547309_sc-1010988.jpg,3,0,0,2,5,,train
0547310_sc-1010988.jpg,1,0,0,1,2,,train
0547311_sc-1010988.jpg,3,0,0,2,5,,train
0547312_as-0022831.jpg,2,0,0,0,2,,train
0547313_sc-205798.jpg,1,1,1,0,3,,train
0547314_as-9031001.jpg,2,0,0,0,2,,train
0547318_sc-160150.jpg,1,0,0,1,2,,train
0547319_sc-160150.jpg,1,0,0,1,2,,val
0547320_sc-1014728.jpg,8,0,0,0,8,,val
0547321_sc-1014728.jpg,6,0,0,0,6,,test
0547322_sc-1014728.jpg,1,0,0,0,1,,train
0547323_sc-1014728.jpg,0,0,1,0,1,,train
0547324_sc-218898.jpg,3,0,0,0,3,,train
0547325_sc-218898.jpg,1,0,1,0,2,,train
0547326_sc-218898.jpg,1,0,1,0,2,,train
0547327_as-2554242.jpg,7,0,0,0,7,,train
0547328_as-7821798.jpg,4,2,1,0,7,,train
0547329_sc-213153.jpg,1,0,1,0,2,,val
0547330_as-2858150.jpg,1,0,0,0,1,,val
0547331_sc-143727.jpg,4,1,1,0,6,,test
0547332_sc-143727.jpg,3,1,1,0,5,,train
0547333_sc-143727.jpg,2,1,1,0,4,,train
0547334_sc-143727.jpg,1,0,0,0,1,,train
0547335_sc-143727.jpg,0,0,1,0,1,,train
0547336_sc-143727.jpg,2,1,0,0,3,,train
0547337_sc-143727.jpg,2,1,0,0,3,,train
0547338_sc-143727.jpg,1,1,0,0,2,,train
0547339_sc-143727.jpg,1,0,0,0,1,,val
0547341_sc-130228.jpg,4,0,0,0,4,,val
0547342_sc-130228.jpg,2,0,0,0,2,,test
0547344_as-3227168.jpg,1,1,0,0,2,,train
0547346_sc-114992.jpg,0,1,1,0,2,,train
0547347_sc-103913.jpg,1,1,0,0,2,,train
0547348_sc-103913.jpg,1,0,0,0,1,,train
0547352_as-0079967.jpg,1,0,0,1,2,,train
0547353_as-0079967.jpg,0,0,0,1,1,,train
0547354_as-0096039.jpg,3,0,0,0,3,,train
0547356_sc-1015451.jpg,1,0,0,0,1,,val
0547358_sc-1038935.jpg,5,0,0,0,5,,val
0547359_sc-1038935.jpg,5,0,0,0,5,,test
0547361_sc-1038935.jpg,7,0,0,0,7,,train
0547362_sc-1038935.jpg,2,0,0,0,2,,train
0547363_sc-1038935.jpg,5,0,0,0,5,,train
0547366_sc-1006854.jpg,0,0,3,0,3,,train
0547367_sc-1006854.jpg,0,0,2,0,2,,train
0547370_sc-1006854.jpg,3,1,2,0,6,,train
0547371_sc-1006854.jpg,0,1,1,0,2,,train
0547372_sc-1006854.jpg,1,1,0,0,2,,val
0547373_as-2562815.jpg,1,0,0,0,1,,val
0547375_as-0026102.jpg,2,0,0,0,2,,test
0547376_as-0026102.jpg,2,0,0,0,2,,train
0547377_as-0026102.jpg,1,0,0,0,1,,train
0547378_as-0026102.jpg,1,0,0,0,1,,train
0547380_sc-137040.jpg,2,0,0,0,2,,train
0547381_sc-137040.jpg,2,0,0,0,2,,train
0547382_sc-137040.jpg,2,0,0,0,2,,train
0547383_sc-137040.jpg,2,0,0,0,2,,train
0547384_sc-137040.jpg,2,0,0,0,2,,val
0547385_as-0034570.jpg,1,1,0,0,2,,val
0547386_as-0034570.jpg,1,0,0,0,1,,test
0547389_sc-172903.jpg,2,0,1,1,4,,train
0547390_sc-172903.jpg,3,0,1,1,5,,train
0547391_sc-172903.jpg,1,0,1,1,3,,train
0547392_sc-172903.jpg,2,0,0,0,2,,train
0547393_sc-172903.jpg,1,0,0,0,1,,train
0547395_sc-155975.jpg,3,0,0,0,3,,train
0547396_sc-115219.jpg,1,0,0,1,2,,train
0547397_sc-115219.jpg,3,0,0,0,3,,val
0547399_sc-115219.jpg,3,0,0,0,3,,val
0547401_sc-115219.jpg,1,0,0,1,2,,test
0547405_as-0082574.jpg,2,0,0,0,2,,train
0547406_sc-195114.jpg,6,0,0,1,7,,train
0547407_sc-195114.jpg,3,0,0,0,3,,train
0547408_sc-195114.jpg,0,0,1,0,1,,train
0547409_sc-195114.jpg,1,0,1,0,2,,train
0547410_sc-195114.jpg,2,0,0,0,2,,train
0547411_sc-195114.jpg,3,0,0,0,3,,train
0547412_sc-195114.jpg,8,0,0,0,8,,val
0547415_sc-1003922.jpg,1,0,0,0,1,,val
0547416_sc-1003922.jpg,5,0,0,0,5,,test
0547417_as-0018893.jpg,1,1,0,0,2,,train
0547418_as-0018893.jpg,1,1,0,0,2,,train
0547419_as-0018893.jpg,1,0,0,0,1,,train
0547420_as-0018893.jpg,1,1,0,0,2,,train
0547422_sc-226924.jpg,2,0,0,0,2,,train
0547423_sc-226924.jpg,2,0,0,0,2,,train
0547424_as-2528571.jpg,1,1,0,0,2,,train
0547425_as-2701877.jpg,1,0,0,0,1,,val
0547426_sc-126843.jpg,2,0,1,2,5,,val
0547427_sc-126843.jpg,2,0,1,2,5,,test
0547428_as-0013788.jpg,1,0,0,0,1,,train
0547429_as-0013788.jpg,4,0,0,0,4,,train
0547430_as-0013788.jpg,3,0,0,0,3,,train
0547431_as-0013788.jpg,3,0,0,0,3,,train
0547432_as-7875226.jpg,2,0,0,0,2,,train
0547433_as-0064041.jpg,1,0,0,1,2,,train
0547437_as-3039971.jpg,1,0,0,0,1,,train
0547438_sc-1002640.jpg,2,0,1,0,3,,val
0547439_sc-1002640.jpg,4,0,1,1,6,,val
0547440_sc-1002640.jpg,1,0,0,0,1,,test
0547441_sc-1002640.jpg,2,0,1,1,4,,train
0547442_sc-1002640.jpg,1,0,0,0,1,,train
0547444_sc-175411.jpg,2,0,1,1,4,,train
0547445_sc-175411.jpg,3,0,0,0,3,,train
0547446_sc-175411.jpg,2,0,0,0,2,,train
0547447_as-7031787.jpg,2,0,0,0,2,,train
0547448_as-0091642.jpg,1,0,0,0,1,,train
0547450_as-0091642.jpg,1,0,0,0,1,,val
0547451_as-3293846.jpg,1,0,0,1,2,,val
0547453_as-0081211.jpg,2,0,1,0,3,,test
0547454_as-0081211.jpg,2,0,1,0,3,,train
0547455_sc-190239.jpg,0,1,0,0,1,,train
0547456_sc-190239.jpg,0,1,0,0,1,,train
0547457_sc-190239.jpg,0,1,0,0,1,,train
0547458_sc-180748.jpg,3,0,0,0,3,,train
0547459_sc-180748.jpg,2,0,0,0,2,,train
0547460_as-3139924.jpg,2,1,1,1,5,,train
0547461_sc-191772.jpg,1,1,0,0,2,,val
0547462_sc-191772.jpg,2,1,1,0,4,,val
0547463_sc-191772.jpg,2,0,0,0,2,,test
0547465_sc-191772.jpg,2,0,0,0,2,,train
0547466_as-3161936.jpg,0,0,1,0,1,,train
0547467_as-0035241.jpg,0,0,1,0,1,,train
0547468_as-0035241.jpg,0,0,1,0,1,,train
0547469_as-3446989.jpg,2,0,0,1,3,,train
0547470_as-7680143.jpg,1,0,1,0,2,,train
0547471_as-7783092.jpg,1,0,0,0,1,,train
0547472_as-2689226.jpg,1,0,0,0,1,,val
0547473_sc-120027.jpg,4,0,1,1,6,,val
0547475_as-5183543.jpg,2,0,2,1,5,,test
0547477_as-0049729.jpg,2,2,0,0,4,,train
0547478_as-0049729.jpg,1,1,0,0,2,,train
0547479_as-0049729.jpg,1,2,0,0,3,,train
0547480_as-0049729.jpg,1,1,0,0,2,,train
0547481_as-0049729.jpg,1,2,0,0,3,,train
0547482_as-0049729.jpg,1,0,0,0,1,,train
0547483_as-0049729.jpg,2,0,0,0,2,,train
0547485_as-0049729.jpg,2,0,0,0,2,,val
0547486_as-0049729.jpg,1,0,0,0,1,,val
0547487_as-0049729.jpg,5,0,0,0,5,,test
0547488_as-0049729.jpg,1,2,0,0,3,,train
0547489_as-0049729.jpg,1,2,0,0,3,,train
0547490_as-0049729.jpg,1,0,0,0,1,,train
0547491_as-0049729.jpg,1,0,0,1,2,,train
0547492_as-0049729.jpg,2,2,0,0,4,,train
0547493_as-0049729.jpg,1,2,0,0,3,,train
0547494_as-0049729.jpg,1,1,0,0,2,,train
0547495_sc-117207.jpg,2,0,0,0,2,,val
0547496_sc-117207.jpg,1,0,0,0,1,,val
0547498_sc-117207.jpg,1,0,0,0,1,,test
0547499_sc-117207.jpg,1,0,0,0,1,,train
0547502_as-3174294.jpg,3,0,2,1,6,,train
0547504_sc-124656.jpg,3,0,1,0,4,,train
0547505_sc-124656.jpg,1,0,0,0,1,,train
0547506_sc-124656.jpg,3,0,1,0,4,,train
0547509_sc-1011350.jpg,1,0,0,0,1,,train
0547510_sc-1011350.jpg,1,0,0,0,1,,train
0547511_sc-1011350.jpg,1,0,0,0,1,,val
0547512_sc-1011350.jpg,1,0,0,0,1,,val
0547513_sc-1011350.jpg,3,0,0,0,3,,test
0547514_sc-1011350.jpg,3,0,0,0,3,,train
0547515_as-3018273.jpg,1,0,1,0,2,,train
0547517_as-0094358.jpg,1,0,0,0,1,,train
0547518_sc-169620.jpg,1,0,0,0,1,,train
0547520_as-0054441.jpg,1,0,2,0,3,,train
0547521_as-0054441.jpg,2,0,0,0,2,,train
0547522_as-0054441.jpg,2,0,0,0,2,,train
0547524_as-2698223.jpg,0,1,0,1,2,,val
0547525_sc-134920.jpg,2,0,0,0,2,,val
0547527_sc-134920.jpg,3,0,0,0,3,,test
0547528_as-0071196.jpg,2,0,0,0,2,,train
0547529_as-0071196.jpg,3,0,0,0,3,,train
0547530_as-0071196.jpg,4,0,0,0,4,,train
0547531_as-0071196.jpg,5,0,0,0,5,,train
0547532_as-0071196.jpg,6,0,0,0,6,,train
0547533_as-0071196.jpg,3,0,0,0,3,,train
0547534_sc-1018168.jpg,2,0,0,0,2,,train
0547535_sc-1018168.jpg,3,0,0,0,3,,val
0547536_sc-1018168.jpg,3,0,0,0,3,,val
0547537_sc-180042.jpg,4,0,0,2,6,,test
0547538_sc-180042.jpg,4,0,1,1,6,,train
0547539_sc-180042.jpg,4,0,1,2,7,,train
0547540_sc-180042.jpg,3,0,1,1,5,,train
0547542_as-0035008.jpg,2,0,0,0,2,,train
0547543_as-0035008.jpg,2,0,0,0,2,,train
0547544_as-0035008.jpg,2,0,0,0,2,,train
0547545_as-0035008.jpg,4,0,0,0,4,,train
0547546_as-3255572.jpg,1,0,0,0,1,,val
0547547_as-3407683.jpg,1,0,0,0,1,,val
0547548_as-0046962.jpg,6,0,0,0,6,,test
0547549_as-0046962.jpg,3,0,0,0,3,,train
0547551_as-0046962.jpg,2,1,0,0,3,,train
0547552_as-0046962.jpg,2,1,0,0,3,,train
0547553_as-0046962.jpg,1,0,0,0,1,,train
0547554_as-0046962.jpg,1,2,0,0,3,,train
0547555_as-0046962.jpg,2,2,0,0,4,,train
0547556_as-0046962.jpg,1,1,0,0,2,,train
0547557_as-0046962.jpg,4,1,0,0,5,,val
0547558_as-0046962.jpg,3,0,0,0,3,,val
0547559_as-0046962.jpg,1,0,0,0,1,,test
0547560_as-0046962.jpg,1,0,0,0,1,,train
0547561_as-0046962.jpg,2,0,0,0,2,,train
0547562_as-0046962.jpg,1,0,0,0,1,,train
0547563_as-0087654.jpg,1,0,0,0,1,,train
0547564_as-0087654.jpg,2,0,0,0,2,,train
0547565_as-0087654.jpg,2,0,0,0,2,,train
0547566_as-0087654.jpg,2,0,0,0,2,,train
0547567_as-0087654.jpg,1,0,0,0,1,,val
0547568_sc-1010318.jpg,3,0,2,0,5,,val
0547569_sc-1010318.jpg,1,0,1,0,2,,test
0547570_as-2992968.jpg,0,0,0,1,1,,train
0547573_as-0061034.jpg,4,0,0,0,4,,train
0547574_as-0061034.jpg,6,0,0,0,6,,train
0547575_sc-200712.jpg,2,0,2,1,5,,train
0547576_sc-200712.jpg,1,0,1,1,3,,train
0547577_sc-200712.jpg,1,0,1,1,3,,train
0547578_as-0004872.jpg,2,0,1,2,5,,train
0547579_as-0004872.jpg,3,0,1,1,5,,val
0547580_as-0004872.jpg,1,0,0,1,2,,val
0547581_as-0089296.jpg,6,0,0,0,6,,test
0547583_as-0052070.jpg,0,1,0,0,1,,train
0547584_as-0052070.jpg,5,0,1,0,6,,train
0547586_as-0030796.jpg,3,0,3,3,9,,train
0547587_as-0030796.jpg,2,0,0,1,3,,train
0547588_sc-150180.jpg,2,0,0,0,2,,train
0547589_sc-150180.jpg,6,0,0,0,6,,train
0547590_sc-150180.jpg,7,0,0,2,9,,train
0547591_sc-150180.jpg,3,0,0,1,4,,val
0547592_sc-160480.jpg,1,0,1,1,3,,val
0547595_sc-199435.jpg,3,0,2,0,5,,test
0547596_sc-199435.jpg,0,0,2,0,2,,train
0547598_as-0027033.jpg,5,2,2,1,10,,train
0547599_as-0027033.jpg,3,2,1,1,7,,train
0547600_as-7737622.jpg,0,0,2,0,2,,train
0547601_sc-205242.jpg,2,0,0,0,2,,train
0547606_as-0092797.jpg,1,1,0,1,3,,train
0547608_as-0092797.jpg,1,0,1,1,3,,train
0547609_as-0092797.jpg,1,0,0,1,2,,val
0547610_as-0092797.jpg,1,0,0,1,2,,val
0547611_as-0092797.jpg,1,0,0,1,2,,test
0547612_as-0092797.jpg,1,0,0,1,2,,train
0547613_as-0092797.jpg,1,0,0,1,2,,train
0547614_as-0092797.jpg,1,1,1,0,3,,train
0547616_sc-146193.jpg,1,0,0,0,1,,train
0547617_as-3221877.jpg,4,0,0,0,4,,train
0547618_as-0050932.jpg,2,1,0,0,3,,train
0547619_as-0050932.jpg,2,1,0,0,3,,train
0547621_sc-202352.jpg,4,0,2,0,6,,val
0547622_sc-202352.jpg,4,0,2,0,6,,val
0547623_sc-202352.jpg,0,0,0,1,1,,test
0547624_sc-202352.jpg,0,0,0,1,1,,train
0547625_sc-202352.jpg,2,0,0,0,2,,train
0547626_sc-202352.jpg,4,0,1,0,5,,train
0547627_sc-202352.jpg,1,0,1,0,2,,train
0547628_sc-202352.jpg,1,0,1,0,2,,train
0547629_sc-202352.jpg,0,0,1,0,1,,train
0547630_sc-202352.jpg,1,0,1,0,2,,train
0547631_sc-202352.jpg,0,1,1,0,2,,val
0547632_sc-1005659.jpg,4,1,0,0,5,,val
0547633_sc-1005659.jpg,3,1,0,0,4,,test
0547634_as-0023939.jpg,1,0,0,0,1,,train
0547635_as-0023939.jpg,2,0,0,0,2,,train
0547636_sc-203916.jpg,3,0,0,0,3,,train
0547637_sc-203916.jpg,3,0,0,0,3,,train
0547640_sc-120032.jpg,1,0,2,2,5,,train
0547641_sc-120032.jpg,1,0,2,2,5,,train
0547642_sc-120032.jpg,1,0,2,1,4,,train
0547643_as-0085218.jpg,1,0,0,1,2,,val
0547644_as-0085218.jpg,2,0,0,0,2,,val
0547645_as-0085218.jpg,1,0,0,1,2,,test
0547646_sc-1029865.jpg,2,0,0,0,2,,train
0547647_sc-1029865.jpg,1,0,1,0,2,,train
0547648_sc-1029865.jpg,3,0,0,0,3,,train
0547650_sc-1029865.jpg,1,0,0,0,1,,train
0547651_as-0080702.jpg,1,0,1,0,2,,train
0547653_as-0080702.jpg,1,1,1,0,3,,train
0547654_as-0080702.jpg,1,0,0,1,2,,train
0547655_as-0080702.jpg,1,0,0,0,1,,val
0547656_as-0080702.jpg,1,0,0,0,1,,val
0547658_as-0045992.jpg,7,0,1,0,8,,test
0547659_as-0045992.jpg,2,0,1,0,3,,train
0547660_sc-214697.jpg,2,0,0,0,2,,train
0547661_sc-214697.jpg,6,1,1,0,8,,train
0547662_sc-214697.jpg,3,0,0,0,3,,train
0547663_as-2573333.jpg,1,0,0,1,2,,train
0547664_as-3050833.jpg,1,0,0,0,1,,train
0547665_sc-150845.jpg,4,1,1,0,6,,train
0547666_sc-150845.jpg,4,2,3,0,9,,val
0547667_sc-150845.jpg,5,4,3,1,13,,val
0547668_sc-150845.jpg,5,3,4,0,12,,test
0547669_sc-150845.jpg,4,0,0,0,4,,train
0547670_sc-150845.jpg,3,1,1,1,6,,train
0547671_sc-105785.jpg,9,3,0,0,12,,train
0547672_sc-105785.jpg,3,0,0,0,3,,train
0547673_sc-105785.jpg,2,0,0,0,2,,train
0547674_sc-105785.jpg,2,0,1,0,3,,train
0547675_sc-105785.jpg,1,0,1,1,3,,train
0547676_sc-105785.jpg,0,0,1,0,1,,val
0547677_sc-105785.jpg,3,0,0,0,3,,val
0547678_sc-105785.jpg,1,1,0,0,2,,test
0547679_sc-105785.jpg,7,2,0,0,9,,train
0547680_sc-105785.jpg,0,2,2,0,4,,train
0547681_sc-105785.jpg,4,2,1,0,7,,train
0547682_sc-105785.jpg,3,0,0,1,4,,train
0547683_as-7859744.jpg,4,0,0,0,4,,train
0547685_sc-218278.jpg,3,3,2,1,9,,train
0547686_sc-218278.jpg,4,2,1,1,8,,train
0547687_sc-218278.jpg,2,0,1,1,4,,val
0547690_as-0021580.jpg,4,0,0,0,4,,val
0547691_as-0021580.jpg,6,0,0,0,6,,test
0547692_as-0021580.jpg,2,0,0,0,2,,train
0547693_as-0021580.jpg,1,0,0,0,1,,train
0547694_as-0021580.jpg,5,0,0,0,5,,train
0547695_as-0021580.jpg,1,0,0,0,1,,train
0547696_as-0021580.jpg,8,0,0,0,8,,train
0547700_as-0021423.jpg,3,1,1,1,6,,train
0547701_as-0021423.jpg,1,0,0,0,1,,train
0547702_sc-107599.jpg,0,1,0,0,1,,val
0547703_as-0032929.jpg,1,1,1,2,5,,val
0547704_as-0032929.jpg,2,0,0,0,2,,test
0547705_as-0032929.jpg,1,0,0,0,1,,train
0547707_as-0002605.jpg,1,0,0,0,1,,train
0547708_as-0002605.jpg,1,1,0,0,2,,train
0547711_sc-151058.jpg,1,1,1,1,4,,train
0547712_sc-151058.jpg,3,1,2,1,7,,train
0547713_sc-151058.jpg,2,1,2,1,6,,train
0547715_sc-151058.jpg,2,1,2,1,6,,train
0547716_sc-151058.jpg,1,1,2,1,5,,val
0547717_sc-151058.jpg,1,1,2,1,5,,val
0547719_sc-151058.jpg,1,1,1,1,4,,test
0547720_sc-151058.jpg,2,1,2,1,6,,train
0547721_sc-151058.jpg,2,1,2,1,6,,train
0547722_as-3113837.jpg,4,0,0,0,4,,train
0547723_as-3312021.jpg,1,0,0,0,1,,train
0547724_sc-1020169.jpg,3,0,0,1,4,,train
0547725_sc-1020169.jpg,2,0,1,1,4,,train
0547726_sc-1020169.jpg,3,0,0,1,4,,train
0547727_sc-1020169.jpg,1,0,1,1,3,,val
0547728_sc-128448.jpg,1,0,0,0,1,,val
0547729_as-0078930.jpg,21,0,2,0,23,,test
0547730_as-0078930.jpg,3,0,1,0,4,,train
0547731_as-0078930.jpg,6,0,3,0,9,,train
0547732_as-7502223.jpg,1,0,0,0,1,,train
0547733_sc-135708.jpg,0,1,0,0,1,,train
0547734_as-2570065.jpg,4,0,0,0,4,,train
0547735_as-0062322.jpg,1,0,0,1,2,,train
0547737_as-0062322.jpg,2,0,0,1,3,,train
0547738_as-0062322.jpg,1,0,1,1,3,,val
0547739_as-0062322.jpg,1,0,1,1,3,,val
0547740_as-0062322.jpg,2,0,0,0,2,,test
0547741_sc-1001604.jpg,2,0,1,0,3,,train
0547742_sc-1001604.jpg,2,0,0,0,2,,train
0547743_as-3300633.jpg,1,0,0,0,1,,train
0547744_sc-192919.jpg,3,2,5,2,12,,train
0547745_sc-192919.jpg,3,2,5,2,12,,train
0547746_sc-192919.jpg,3,2,2,2,9,,train
0547747_sc-192919.jpg,2,0,1,0,3,,train
0547748_sc-192919.jpg,0,1,1,1,3,,val
0547749_sc-192919.jpg,1,2,2,1,6,,val
0547750_sc-192919.jpg,0,0,1,0,1,,test
0547753_as-3174042.jpg,4,0,0,0,4,,train
0547754_sc-1001842.jpg,3,0,0,0,3,,train
0547755_sc-1001842.jpg,7,2,2,0,11,,train
0547756_sc-1001842.jpg,3,0,1,0,4,,train
0547757_sc-1001842.jpg,0,0,1,0,1,,train
0547758_sc-1001842.jpg,9,1,2,0,12,,train
0547759_sc-1001842.jpg,11,1,2,0,14,,train
0547760_as-3112445.jpg,2,0,1,1,4,,val
0547761_as-3148257.jpg,1,0,0,0,1,,val
0547762_as-2851544.jpg,0,0,1,1,2,,test
0547763_as-3123570.jpg,3,0,1,0,4,,train
0547764_as-2527579.jpg,1,0,0,0,1,,train
0547766_sc-1010076.jpg,3,0,0,1,4,,train
0547767_sc-220120.jpg,3,0,2,0,5,,train
0547768_sc-220120.jpg,2,0,0,0,2,,train
0547769_sc-220120.jpg,1,0,1,1,3,,train
0547770_sc-220120.jpg,0,1,3,0,4,,train
0547771_as-2834462.jpg,0,0,0,1,1,,val
0547773_as-0071754.jpg,0,1,0,0,1,,val
0547774_as-0071754.jpg,0,1,0,0,1,,test
0547775_as-0071754.jpg,0,1,0,0,1,,train
0547776_as-0071754.jpg,0,0,1,0,1,,train
0547777_as-0071754.jpg,0,2,0,0,2,,train
0547778_as-0071758.jpg,2,0,1,0,3,,train
0547779_as-0071758.jpg,5,0,1,0,6,,train
0547780_as-0071758.jpg,5,0,1,0,6,,train
0547782_sc-163127.jpg,3,0,1,0,4,,train
0547783_sc-163127.jpg,8,2,1,0,11,,val
0547784_sc-163127.jpg,5,1,2,0,8,,val
0547785_sc-163127.jpg,4,1,0,0,5,,test
0547789_as-0039249.jpg,1,0,0,0,1,,train
0547791_as-0039249.jpg,1,0,0,0,1,,train
0547792_as-0039249.jpg,1,0,1,0,2,,train
0547793_as-0039249.jpg,1,0,0,0,1,,train
0547795_as-0021174.jpg,1,0,0,0,1,,train
0547796_as-0021174.jpg,1,0,0,0,1,,train
0547798_sc-215421.jpg,1,0,0,0,1,,train
0547801_sc-215421.jpg,1,0,0,0,1,,val
0547802_sc-215421.jpg,1,0,0,0,1,,val
0547804_sc-215421.jpg,2,1,0,0,3,,test
0547805_sc-215421.jpg,1,0,0,2,3,,train
0547806_as-0034832.jpg,1,0,0,0,1,,train
0547807_as-0034832.jpg,1,0,0,0,1,,train
0547808_as-0034832.jpg,0,0,1,0,1,,train
0547809_sc-1031196.jpg,3,0,0,1,4,,train
0547810_sc-206281.jpg,1,1,1,0,3,,train
0547811_sc-206281.jpg,0,1,0,0,1,,train
0547812_as-0040754.jpg,2,0,1,0,3,,val
0547813_as-0040754.jpg,2,0,0,1,3,,val
0547814_as-0040754.jpg,1,0,0,1,2,,test
0547815_as-0040754.jpg,1,0,0,1,2,,train
0547816_as-0040754.jpg,2,1,0,1,4,,train
0547817_as-0040754.jpg,1,0,0,0,1,,train
0547818_as-0051946.jpg,5,0,0,0,5,,train
0547820_as-0032962.jpg,3,0,1,2,6,,train
0547821_as-0032962.jpg,1,1,1,0,3,,train
0547822_as-0069379.jpg,8,0,0,1,9,,train
0547824_as-2914072.jpg,1,0,0,0,1,,val
0547825_as-9098967.jpg,1,0,0,0,1,,val
0547826_as-0057021.jpg,1,0,0,1,2,,test
0547827_as-0057021.jpg,1,0,0,1,2,,train
0547828_as-0057021.jpg,1,0,0,1,2,,train
0547829_as-0057021.jpg,1,0,0,0,1,,train
0547830_as-0057021.jpg,1,0,0,1,2,,train
0547831_as-3171128.jpg,1,0,2,0,3,,train
0547832_as-0080255.jpg,1,0,0,1,2,,train
0547833_as-0080255.jpg,1,0,0,1,2,,train
0547834_as-0080255.jpg,1,0,0,1,2,,val
0547835_as-0080255.jpg,1,0,0,1,2,,val
0547836_as-0080255.jpg,1,0,0,1,2,,test
0547837_as-0080255.jpg,2,0,0,0,2,,train
0547839_as-7140054.jpg,1,0,1,0,2,,train
0547840_as-3088518.jpg,0,0,1,0,1,,train
0547841_sc-189265.jpg,0,0,1,0,1,,train
0547845_sc-189265.jpg,2,1,1,1,5,,train
0547846_sc-189265.jpg,2,1,1,0,4,,train
0547847_sc-189265.jpg,0,1,1,0,2,,train
0547848_sc-1027043.jpg,1,0,0,0,1,,val
0547849_sc-1027043.jpg,2,0,0,0,2,,val
0547850_sc-179345.jpg,1,0,0,1,2,,test
0547851_sc-179345.jpg,2,0,0,1,3,,train
0547852_sc-179345.jpg,1,0,0,1,2,,train
0547853_sc-179345.jpg,2,0,0,1,3,,train
0547854_sc-179345.jpg,1,0,0,1,2,,train
0547855_sc-179345.jpg,1,0,0,0,1,,train
0547856_sc-179345.jpg,1,0,0,0,1,,train
0547857_sc-179345.jpg,1,0,0,0,1,,train
0547858_sc-179345.jpg,1,0,0,0,1,,val
0547859_as-2895196.jpg,1,0,0,0,1,,val
0547860_sc-142813.jpg,5,1,1,0,7,,test
0547861_sc-142813.jpg,1,1,1,0,3,,train
0547862_sc-221663.jpg,0,0,1,0,1,,train
0547863_sc-221663.jpg,3,1,0,0,4,,train
0547864_sc-221663.jpg,0,1,0,0,1,,train
0547865_sc-221663.jpg,3,0,1,0,4,,train
0547866_sc-221663.jpg,1,0,1,0,2,,train
0547867_sc-221663.jpg,0,1,1,0,2,,train
0547868_sc-221663.jpg,0,1,1,0,2,,val
0547869_sc-221663.jpg,0,0,1,0,1,,val
0547870_sc-123303.jpg,4,0,0,1,5,,test
0547871_sc-123303.jpg,3,0,0,1,4,,train
0547872_sc-123303.jpg,1,0,0,1,2,,train
0547873_sc-195196.jpg,4,0,0,1,5,,train
0547874_sc-213167.jpg,1,0,0,0,1,,train
0547875_sc-213167.jpg,1,0,0,0,1,,train
0547876_sc-213167.jpg,1,0,0,0,1,,train
0547877_sc-213167.jpg,1,0,1,1,3,,train
0547878_sc-213167.jpg,2,0,1,1,4,,val
0547879_sc-1028965.jpg,4,0,0,0,4,,val
0547880_sc-1028965.jpg,1,0,1,1,3,,test
0547881_sc-1028965.jpg,4,0,0,0,4,,train
0547882_sc-1007605.jpg,2,1,1,0,4,,train
0547883_sc-1007605.jpg,2,1,2,1,6,,train
0547884_sc-1007605.jpg,4,0,0,0,4,,train
0547886_sc-188124.jpg,2,0,2,0,4,,train
0547887_sc-188124.jpg,2,0,1,0,3,,train
0547888_sc-188124.jpg,1,1,0,0,2,,train
0547892_as-0041964.jpg,2,1,2,0,5,,val
0547893_as-0041964.jpg,0,0,2,0,2,,val
0547898_sc-152115.jpg,2,0,0,0,2,,test
0547899_sc-207290.jpg,2,0,3,1,6,,train
0547900_sc-207290.jpg,2,0,2,1,5,,train
0547901_sc-209706.jpg,1,0,1,0,2,,train
0547902_sc-209706.jpg,1,0,0,0,1,,train
0547903_as-0074675.jpg,2,1,1,0,4,,train
0547904_as-0074675.jpg,1,0,0,0,1,,train
0547905_as-0074675.jpg,0,1,0,0,1,,train
0547906_as-0074675.jpg,0,1,1,0,2,,val
0547910_as-0004463.jpg,1,0,0,0,1,,val
0547911_as-7495306.jpg,1,0,1,0,2,,test
0547912_sc-165646.jpg,1,0,0,0,1,,train
0547913_sc-165646.jpg,5,0,0,2,7,,train
0547914_sc-165646.jpg,7,0,0,2,9,,train
0547915_sc-165646.jpg,4,0,0,1,5,,train
0547916_sc-212832.jpg,1,0,0,0,1,,train
0547918_as-2836265.jpg,1,0,0,0,1,,train
0547919_sc-115176.jpg,4,0,1,1,6,,train
0547921_as-2554833.jpg,1,1,0,0,2,,val
0547926_as-0057837.jpg,3,1,1,2,7,,val
0547927_as-0057837.jpg,4,3,3,2,12,,test
0547928_as-0057837.jpg,1,0,2,2,5,,train
0547929_as-0057837.jpg,5,0,1,1,7,,train
0547930_as-0057837.jpg,0,0,2,1,3,,train
0547931_as-0057837.jpg,1,1,3,1,6,,train
0547932_sc-167166.jpg,1,0,0,0,1,,train
0547933_sc-167166.jpg,1,0,0,0,1,,train
0547934_as-0037294.jpg,2,0,0,0,2,,train
0547935_as-0037294.jpg,4,0,0,0,4,,val
0547936_sc-182347.jpg,1,0,1,0,2,,val
0547937_sc-182347.jpg,1,0,1,0,2,,test
0547939_as-3268838.jpg,1,0,1,0,2,,train
0547940_as-2966979.jpg,2,0,0,0,2,,train
0547941_sc-1023108.jpg,1,0,0,0,1,,train
0547942_sc-1023108.jpg,1,0,0,0,1,,train
0547943_sc-201278.jpg,3,0,0,0,3,,train
0547944_sc-201278.jpg,2,0,2,2,6,,train
0547945_sc-201278.jpg,2,0,0,0,2,,train
0547946_as-7978664.jpg,2,0,1,0,3,,val
0547948_as-0091322.jpg,4,0,1,0,5,,val
0547949_as-0091322.jpg,0,0,2,0,2,,test
0547950_sc-109680.jpg,3,2,1,0,6,,train
0547951_sc-109680.jpg,4,1,0,0,5,,train
0547952_as-7914725.jpg,0,1,0,1,2,,train
0547953_as-3422065.jpg,0,3,2,0,5,,train
0547954_sc-1001055.jpg,1,0,0,0,1,,train
0547956_sc-132749.jpg,1,0,1,1,3,,train
0547957_sc-132749.jpg,2,0,1,1,4,,train
0547959_sc-213912.jpg,24,0,2,0,26,,val
0547961_as-0061927.jpg,2,0,0,0,2,,val
0547962_as-0061927.jpg,3,0,0,0,3,,test
0547963_as-0061927.jpg,3,0,0,0,3,,train
0547964_as-0061927.jpg,2,0,0,0,2,,train
0547966_sc-179744.jpg,2,0,0,0,2,,train
0547968_sc-179744.jpg,2,0,0,0,2,,train
0547970_as-3170957.jpg,2,0,1,0,3,,train
0547971_sc-224492.jpg,1,1,0,1,3,,train
0547972_sc-224492.jpg,4,0,1,1,6,,train
0547973_sc-224492.jpg,3,0,0,0,3,,val
0547974_sc-224492.jpg,2,0,0,0,2,,val
0547975_sc-224492.jpg,1,0,0,0,1,,test
0547976_as-0088220.jpg,2,0,0,1,3,,train
0547978_as-0088220.jpg,2,0,1,0,3,,train
0547979_as-0088220.jpg,5,1,0,1,7,,train
0547980_as-0088220.jpg,1,1,1,0,3,,train
0547981_as-0088220.jpg,1,1,1,0,3,,train
0547984_as-0088220.jpg,2,0,0,0,2,,train
0547986_sc-213165.jpg,4,0,1,0,5,,train
0547987_sc-213165.jpg,3,0,1,0,4,,val
0547988_sc-213165.jpg,3,0,0,0,3,,val
0547989_as-5462924.jpg,1,1,1,0,3,,test
0547990_as-5260290.jpg,2,0,2,1,5,,train
0547993_as-0034698.jpg,5,0,1,0,6,,train
0547994_as-0034698.jpg,2,0,1,0,3,,train
0547995_as-0034698.jpg,2,0,0,0,2,,train
0547996_as-0034698.jpg,2,0,0,0,2,,train
0547997_as-0034698.jpg,3,0,0,0,3,,train
0547998_sc-160912.jpg,2,0,0,0,2,,train
0547999_sc-160912.jpg,1,0,1,0,2,,val
0548000_sc-160912.jpg,1,0,1,1,3,,val
0548001_sc-160912.jpg,1,0,1,0,2,,test
0548002_sc-160912.jpg,1,0,2,1,4,,train
0548003_sc-160912.jpg,2,0,0,2,4,,train
0548004_sc-160912.jpg,2,0,3,1,6,,train
0548005_as-0090854.jpg,2,0,0,1,3,,train
0548006_sc-143450.jpg,1,0,0,0,1,,train
0548007_sc-143450.jpg,5,0,1,0,6,,train
0548008_sc-114423.jpg,1,1,0,0,2,,train
0548010_as-3271308.jpg,0,0,2,0,2,,val
0548011_sc-112573.jpg,1,0,0,0,1,,val
0548014_sc-138890.jpg,1,0,1,0,2,,test
0548019_as-0014736.jpg,1,1,1,0,3,,train
0548020_as-0014736.jpg,1,1,2,0,4,,train
0548021_as-0014736.jpg,1,0,1,0,2,,train
0548022_as-0014736.jpg,4,1,0,0,5,,train
0548023_sc-124473.jpg,1,0,1,0,2,,train
0548025_sc-124473.jpg,0,1,0,0,1,,train
0548026_sc-124473.jpg,1,1,1,0,3,,train
0548027_sc-124473.jpg,1,1,2,2,6,,val
0548028_sc-124473.jpg,0,1,2,0,3,,val
0548029_sc-124473.jpg,0,1,0,0,1,,test
0548030_sc-124473.jpg,1,0,1,1,3,,train
0548031_sc-124473.jpg,1,0,1,1,3,,train
0548032_sc-124473.jpg,0,0,1,1,2,,train
0548033_sc-124473.jpg,0,0,1,1,2,,train
0548035_sc-203711.jpg,0,1,0,0,1,,train
0548036_sc-203711.jpg,1,1,0,0,2,,train
0548037_sc-203711.jpg,1,1,1,0,3,,train
0548038_sc-203711.jpg,3,1,1,0,5,,val
0548039_sc-203711.jpg,1,0,0,0,1,,val
0548040_sc-203711.jpg,2,1,0,0,3,,test
0548041_sc-203711.jpg,1,1,0,0,2,,train
0548042_sc-203711.jpg,1,0,0,0,1,,train
0548043_sc-203711.jpg,2,0,0,0,2,,train
0548044_sc-203711.jpg,5,0,1,0,6,,train
0548045_sc-203711.jpg,0,0,1,0,1,,train
0548046_sc-203711.jpg,1,0,0,0,1,,train
0548047_sc-203711.jpg,3,0,1,0,4,,train
0548048_sc-203711.jpg,2,0,1,0,3,,val
0548049_sc-228862.jpg,8,0,0,0,8,,val
0548050_as-2780621.jpg,1,0,0,0,1,,test
0548051_as-0021686.jpg,2,0,0,0,2,,train
0548052_as-0021686.jpg,3,0,0,0,3,,train
0548053_sc-218448.jpg,1,0,0,0,1,,train
0548054_sc-1028438.jpg,4,0,0,0,4,,train
0548055_as-0045317.jpg,4,0,1,1,6,,train
0548056_as-2701148.jpg,1,0,2,0,3,,train
0548057_sc-186042.jpg,1,0,0,0,1,,train
0548060_sc-1005064.jpg,1,0,0,0,1,,val
0548061_sc-1005064.jpg,1,0,0,0,1,,val
0548062_sc-1005064.jpg,9,0,0,0,9,,test
0548064_as-2573159.jpg,1,0,1,0,2,,train
0548067_as-0048951.jpg,2,0,0,0,2,,train
0548068_as-0048951.jpg,1,0,0,0,1,,train
0548069_as-0048951.jpg,1,0,0,0,1,,train
0548070_sc-112758.jpg,15,0,0,0,15,,train
0548071_sc-112758.jpg,7,0,1,0,8,,train
0548072_sc-112758.jpg,11,0,0,0,11,,train
0548073_sc-112758.jpg,6,0,0,0,6,,val
0548074_sc-189981.jpg,1,0,1,1,3,,val
0548075_sc-189981.jpg,3,0,1,1,5,,test
0548076_sc-189981.jpg,1,0,1,1,3,,train
0548077_sc-189981.jpg,2,0,1,1,4,,train
0548078_sc-189981.jpg,2,0,1,1,4,,train
0548079_as-0001457.jpg,0,1,1,0,2,,train
0548080_as-0001457.jpg,3,0,1,0,4,,train
0548081_as-3046757.jpg,2,0,0,0,2,,train
0548082_sc-1026794.jpg,0,0,1,0,1,,train
0548084_sc-1026794.jpg,1,0,1,0,2,,val
0548085_sc-1026794.jpg,1,0,2,0,3,,val
0548086_sc-1026794.jpg,1,0,2,0,3,,test
0548087_sc-1026794.jpg,2,0,3,1,6,,train
0548088_sc-1026794.jpg,1,0,0,1,2,,train
0548089_sc-1026794.jpg,2,0,3,1,6,,train
0548090_sc-1026794.jpg,2,0,2,1,5,,train
0548091_as-0089011.jpg,1,0,0,0,1,,train
0548092_as-0089011.jpg,1,0,0,0,1,,train
0548093_as-0089011.jpg,0,1,0,0,1,,train
0548094_sc-114260.jpg,4,0,0,0,4,,val
0548095_sc-114260.jpg,6,0,0,0,6,,val
0548096_sc-114260.jpg,1,0,0,0,1,,test
0548100_as-0086729.jpg,2,0,0,0,2,,train
0548103_as-0012303.jpg,1,2,2,2,7,,train
0548104_as-0012303.jpg,0,1,2,0,3,,train
0548105_as-0012303.jpg,0,0,2,0,2,,train
0548106_as-0012303.jpg,0,0,1,0,1,,train
0548107_as-2648589.jpg,1,0,0,0,1,,train
0548108_as-0094115.jpg,2,0,1,1,4,,train
0548109_as-0094115.jpg,2,0,1,1,4,,val
0548110_as-0094115.jpg,1,0,0,2,3,,val
0548111_as-0094115.jpg,1,2,1,0,4,,test
0548112_as-0094115.jpg,2,0,1,0,3,,train
0548113_as-7931186.jpg,5,2,2,2,11,,train
0548114_as-2988460.jpg,1,0,0,0,1,,train
0548116_as-0049269.jpg,1,0,0,0,1,,train
0548117_as-0049269.jpg,2,0,0,0,2,,train
0548118_as-0049269.jpg,2,1,0,0,3,,train
0548120_as-0049269.jpg,1,0,1,0,2,,train
0548121_as-0049269.jpg,1,0,1,0,2,,val
0548122_as-0049269.jpg,1,0,1,0,2,,val
0548124_as-0049269.jpg,0,1,0,0,1,,test
0548125_as-0049269.jpg,2,0,1,0,3,,train
0548126_sc-191116.jpg,3,0,0,0,3,,train
0548127_sc-191116.jpg,7,0,0,0,7,,train
0548128_sc-184668.jpg,1,0,0,1,2,,train
0548129_sc-184668.jpg,1,0,0,1,2,,train
0548130_sc-184668.jpg,1,0,1,1,3,,train
0548131_sc-184668.jpg,2,0,0,0,2,,train
0548132_as-7654676.jpg,1,0,1,0,2,,val
0548133_sc-208398.jpg,2,0,1,0,3,,val
0548134_sc-208398.jpg,1,0,0,0,1,,test
0548135_sc-208398.jpg,2,0,1,0,3,,train
0548136_sc-208398.jpg,2,0,1,0,3,,train
0548137_sc-208398.jpg,2,0,1,0,3,,train
0548138_sc-143006.jpg,3,0,0,1,4,,train
0548142_sc-223589.jpg,1,0,0,1,2,,train
0548143_sc-223589.jpg,1,0,0,0,1,,train
0548144_sc-223589.jpg,1,0,0,0,1,,train
0548145_sc-223589.jpg,1,0,0,1,2,,val
0548146_sc-1015798.jpg,1,0,0,1,2,,val
0548147_sc-1015798.jpg,2,1,1,0,4,,test
0548148_sc-1015798.jpg,2,0,1,0,3,,train
0548149_sc-1015798.jpg,1,0,0,0,1,,train
0548150_sc-1015798.jpg,4,1,1,1,7,,train
0548151_sc-1015798.jpg,1,2,1,1,5,,train
0548152_sc-1015798.jpg,4,1,1,1,7,,train
0548153_sc-1015798.jpg,1,0,0,0,1,,train
0548157_sc-1022464.jpg,5,0,1,0,6,,train
0548158_sc-225962.jpg,2,0,0,1,3,,val
0548159_sc-225962.jpg,3,0,1,1,5,,val
0548160_sc-225962.jpg,1,0,0,0,1,,test
0548161_sc-225962.jpg,1,0,0,0,1,,train
0548162_sc-225962.jpg,1,0,0,0,1,,train
0548163_sc-225962.jpg,4,0,1,1,6,,train
0548164_sc-225962.jpg,4,0,0,1,5,,train
0548165_sc-225962.jpg,1,0,1,0,2,,train
0548166_sc-225962.jpg,2,0,1,1,4,,train
0548167_sc-225962.jpg,3,0,0,1,4,,train
0548168_sc-225962.jpg,1,1,0,0,2,,val
0548169_sc-225962.jpg,2,0,0,0,2,,val
0548170_sc-225962.jpg,3,1,1,0,5,,test
0548171_sc-225962.jpg,2,0,1,0,3,,train
0548172_sc-225962.jpg,2,0,1,0,3,,train
0548173_sc-225962.jpg,4,0,1,2,7,,train
0548174_sc-225962.jpg,1,0,0,1,2,,train
0548175_sc-225962.jpg,2,0,0,0,2,,train
0548176_sc-225962.jpg,4,0,0,0,4,,train
0548177_sc-225962.jpg,1,1,0,0,2,,train
0548178_sc-225962.jpg,2,0,0,0,2,,val
0548179_sc-225962.jpg,2,0,0,0,2,,val
0548180_sc-225962.jpg,1,0,0,0,1,,test
0548181_sc-225962.jpg,0,0,1,0,1,,train
0548182_sc-225962.jpg,2,0,0,0,2,,train
0548183_sc-225962.jpg,1,0,0,0,1,,train
0548184_sc-225962.jpg,1,1,0,0,2,,train
0548185_as-0037336.jpg,1,0,0,0,1,,train
0548186_as-0037336.jpg,1,0,1,0,2,,train
0548188_sc-198291.jpg,0,1,1,0,2,,train
0548189_sc-198291.jpg,0,1,1,0,2,,val
0548190_sc-198291.jpg,1,0,0,0,1,,val
0548191_sc-198291.jpg,1,0,0,0,1,,test
0548193_sc-198291.jpg,1,1,1,0,3,,train
0548195_as-7035851.jpg,2,0,0,0,2,,train
0548197_as-2593936.jpg,5,1,1,0,7,,train
0548198_as-0035539.jpg,1,0,0,0,1,,train
0548199_as-0035539.jpg,3,0,0,0,3,,train
0548200_as-0035539.jpg,1,0,0,0,1,,train
0548202_as-0035539.jpg,1,0,0,0,1,,train
0548203_as-0035539.jpg,1,0,0,0,1,,val
0548204_as-0035539.jpg,1,0,0,0,1,,val
0548205_as-0035539.jpg,1,0,0,0,1,,test
0548207_sc-216192.jpg,2,0,0,1,3,,train
0548208_sc-216192.jpg,3,0,0,0,3,,train
0548209_sc-216192.jpg,3,0,0,0,3,,train
0548210_sc-216192.jpg,1,0,0,0,1,,train
0548211_sc-216192.jpg,1,0,0,0,1,,train
0548212_sc-216192.jpg,1,0,0,0,1,,train
0548213_sc-216192.jpg,1,0,0,1,2,,train
0548214_sc-216192.jpg,1,0,0,1,2,,val
0548215_sc-216192.jpg,1,0,0,1,2,,val
0548216_sc-216192.jpg,1,0,0,0,1,,test
0548217_as-0029118.jpg,1,0,0,1,2,,train
0548218_as-0029118.jpg,1,0,0,1,2,,train
0548219_as-0029118.jpg,1,0,0,1,2,,train
0548220_as-0024506.jpg,2,0,0,0,2,,train
0548222_sc-189393.jpg,1,1,0,0,2,,train
0548223_sc-189393.jpg,1,1,0,0,2,,train
0548224_sc-189393.jpg,1,0,0,0,1,,train
0548226_sc-189393.jpg,6,0,0,0,6,,val
0548227_sc-189393.jpg,6,0,0,0,6,,val
0548228_sc-189393.jpg,2,0,0,0,2,,test
0548229_sc-189393.jpg,3,0,0,0,3,,train
0548230_sc-189393.jpg,3,0,0,0,3,,train
0548231_as-3390658.jpg,3,0,0,0,3,,train
0548234_as-0074198.jpg,0,1,0,1,2,,train
0548235_as-0074198.jpg,3,0,0,0,3,,train
0548236_as-0074198.jpg,5,3,1,2,11,,train
0548237_as-0074198.jpg,5,3,1,2,11,,train
0548238_as-0074198.jpg,4,3,1,2,10,,val
0548239_as-0074198.jpg,4,3,1,2,10,,val
0548240_as-0074198.jpg,0,0,1,0,1,,test
0548242_sc-220083.jpg,3,0,0,0,3,,train
0548243_sc-220083.jpg,3,0,0,0,3,,train
0548244_sc-220083.jpg,3,0,0,0,3,,train
0548245_as-2767592.jpg,7,0,0,0,7,,train
0548246_sc-199464.jpg,1,0,0,0,1,,train
0548249_sc-199464.jpg,1,0,0,0,1,,train
0548251_as-0007001.jpg,3,0,0,0,3,,train
0548252_as-0007001.jpg,3,0,0,0,3,,val
0548253_as-0008524.jpg,1,1,0,0,2,,val
0548254_as-0008524.jpg,3,0,0,0,3,,test
0548255_as-0008524.jpg,1,0,0,0,1,,train
0548256_as-0008524.jpg,1,0,0,0,1,,train
0548257_as-0008524.jpg,1,0,0,0,1,,train
0548260_as-0059999.jpg,1,0,0,0,1,,train
0548261_as-0059999.jpg,4,0,0,0,4,,train
0548263_as-0059999.jpg,2,0,0,0,2,,train
0548264_as-0059999.jpg,0,0,1,0,1,,train
0548265_as-0098466.jpg,3,0,0,0,3,,val
0548266_as-2727334.jpg,1,0,1,1,3,,val
0548267_sc-192626.jpg,3,0,0,0,3,,test
0548268_sc-192626.jpg,4,0,1,0,5,,train
0548269_sc-192626.jpg,4,0,1,0,5,,train
0548270_sc-192626.jpg,8,1,0,0,9,,train
0548272_sc-227198.jpg,1,0,0,0,1,,train
0548273_sc-227198.jpg,1,0,0,0,1,,train
0548274_as-0076407.jpg,3,2,0,0,5,,train
0548275_as-0076407.jpg,6,2,0,0,8,,train
0548276_as-0076407.jpg,1,0,1,0,2,,val
0548279_sc-209741.jpg,3,1,0,0,4,,val
0548280_sc-209741.jpg,1,1,1,0,3,,test
0548281_sc-209741.jpg,1,0,1,0,2,,train
0548282_sc-209741.jpg,1,1,0,0,2,,train
0548284_as-0027356.jpg,4,0,2,0,6,,train
0548285_as-0027356.jpg,2,0,1,0,3,,train
0548286_as-0027356.jpg,2,0,3,1,6,,train
0548287_as-0027356.jpg,3,0,0,0,3,,train
0548288_sc-1040433.jpg,12,1,0,0,13,,train
0548289_sc-1040433.jpg,2,0,2,1,5,,val
0548290_sc-1040433.jpg,13,2,1,1,17,,val
0548291_sc-1040433.jpg,2,2,2,1,7,,test
0548292_sc-1040433.jpg,12,0,0,0,12,,train
0548293_sc-1040433.jpg,5,1,2,1,9,,train
0548295_sc-1040433.jpg,4,2,1,1,8,,train
0548296_as-7561039.jpg,1,0,0,1,2,,train
0548297_sc-1027110.jpg,1,0,0,0,1,,train
0548298_as-0039279.jpg,1,0,0,1,2,,train
0548299_as-0039279.jpg,1,0,0,0,1,,train
0548300_as-0039279.jpg,1,0,0,1,2,,val
0548301_as-9011623.jpg,2,0,0,0,2,,val
0548303_as-3108982.jpg,1,1,1,1,4,,test
0548304_sc-144231.jpg,2,0,1,0,3,,train
0548306_as-0055084.jpg,1,0,1,1,3,,train
0548307_as-0055084.jpg,1,0,1,1,3,,train
0548308_as-0055084.jpg,1,0,0,0,1,,train
0548310_as-0055084.jpg,2,0,0,0,2,,train
0548311_as-0004887.jpg,1,0,0,0,1,,train
0548312_as-0004887.jpg,0,0,1,0,1,,train
0548314_as-0098283.jpg,6,0,0,0,6,,val
0548315_as-0098283.jpg,3,0,0,0,3,,val
0548316_as-0098283.jpg,5,0,0,0,5,,test
0548317_as-0098283.jpg,3,0,0,0,3,,train
0548318_as-0098283.jpg,3,0,0,0,3,,train
0548320_sc-125805.jpg,5,0,0,0,5,,train
0548321_sc-125805.jpg,3,0,0,0,3,,train
0548322_sc-218291.jpg,1,1,0,1,3,,train
0548323_sc-218291.jpg,1,1,0,1,3,,train
0548324_sc-218291.jpg,1,2,1,1,5,,train
0548325_sc-201943.jpg,5,2,0,0,7,,val
0548326_sc-201943.jpg,1,0,0,0,1,,val
0548327_sc-201943.jpg,1,0,0,0,1,,test
0548328_sc-223111.jpg,0,1,0,0,1,,train
0548329_sc-223111.jpg,2,1,1,0,4,,train
0548330_sc-151349.jpg,15,2,1,1,19,,train
0548332_sc-131210.jpg,1,0,0,0,1,,train
0548333_sc-131210.jpg,1,0,0,1,2,,train
0548335_sc-168865.jpg,2,0,1,1,4,,train
0548337_sc-168865.jpg,3,0,1,0,4,,train
0548340_sc-168865.jpg,1,0,0,1,2,,val
0548341_sc-168865.jpg,1,0,0,1,2,,val
0548344_sc-168865.jpg,1,0,0,1,2,,test
0548345_sc-168865.jpg,1,0,0,1,2,,train
0548346_sc-168865.jpg,2,0,1,1,4,,train
0548347_sc-168865.jpg,2,0,0,1,3,,train
0548348_sc-168865.jpg,1,0,0,1,2,,train
0548349_sc-168865.jpg,1,0,1,1,3,,train
0548350_as-2639677.jpg,1,0,0,0,1,,train
0548351_as-3088823.jpg,1,0,0,0,1,,train
0548352_as-0044798.jpg,1,0,0,0,1,,val
0548353_sc-164069.jpg,1,0,0,0,1,,val
0548355_sc-164069.jpg,1,0,0,0,1,,test
0548356_sc-164069.jpg,2,0,0,0,2,,train
0548357_as-3173179.jpg,1,0,0,0,1,,train
0548358_as-2778811.jpg,0,0,1,0,1,,train
0548360_as-0063662.jpg,0,1,0,0,1,,train
0548361_as-2968298.jpg,1,0,0,0,1,,train
0548362_as-9054244.jpg,1,0,0,1,2,,train
0548363_as-3048977.jpg,5,0,0,0,5,,train
0548364_as-0068790.jpg,8,0,0,0,8,,val
0548365_as-0068790.jpg,17,0,0,0,17,,val
0548366_as-0068790.jpg,1,0,0,0,1,,test
0548367_sc-173533.jpg,0,1,0,0,1,,train
0548368_sc-173533.jpg,0,1,0,0,1,,train
0548369_as-3031365.jpg,2,0,1,2,5,,train
0548370_sc-210512.jpg,6,0,0,0,6,,train
0548371_sc-210512.jpg,5,0,0,0,5,,train
0548372_sc-210512.jpg,3,0,0,0,3,,train
0548373_sc-210512.jpg,1,0,0,0,1,,train
0548374_sc-210512.jpg,3,0,0,0,3,,val
0548376_as-0037303.jpg,7,1,1,0,9,,val
0548377_as-0037303.jpg,2,0,1,0,3,,test
0548378_as-0037303.jpg,2,0,0,0,2,,train
0548379_as-0037303.jpg,2,0,0,0,2,,train
0548380_as-0037303.jpg,4,2,1,0,7,,train
0548381_as-3180988.jpg,1,0,1,0,2,,train
0548382_as-2711567.jpg,1,0,0,0,1,,train
0548383_sc-1015416.jpg,1,0,1,0,2,,train
0548384_sc-219941.jpg,2,0,0,0,2,,train
0548385_sc-219941.jpg,3,0,0,0,3,,val
0548386_sc-219941.jpg,1,0,0,0,1,,val
0548388_sc-1020905.jpg,4,0,0,0,4,,test
0548389_sc-178424.jpg,0,0,0,1,1,,train
0548390_sc-178424.jpg,2,0,0,2,4,,train
0548391_as-0084389.jpg,1,0,0,0,1,,train
0548395_sc-189761.jpg,3,1,0,0,4,,train
0548396_sc-189761.jpg,1,1,0,0,2,,train
0548398_sc-114428.jpg,0,0,0,1,1,,train
0548399_sc-220921.jpg,5,0,0,1,6,,train
0548400_sc-220921.jpg,5,0,0,1,6,,val
0548401_sc-220921.jpg,6,0,0,1,7,,val
0548402_sc-220921.jpg,2,0,0,0,2,,test
0548403_sc-220921.jpg,3,0,0,0,3,,train
0548404_sc-220921.jpg,4,0,0,0,4,,train
0548405_sc-220921.jpg,1,0,0,0,1,,train
0548406_sc-220921.jpg,1,0,0,0,1,,train
0548407_sc-220921.jpg,4,0,0,1,5,,train
0548408_sc-128881.jpg,3,1,0,1,5,,train
0548410_sc-128881.jpg,4,1,0,0,5,,train
0548412_as-0076127.jpg,1,0,0,1,2,,val
0548413_sc-185748.jpg,2,1,1,1,5,,val
0548414_sc-185748.jpg,0,1,1,0,2,,test
0548415_sc-104511.jpg,1,0,0,1,2,,train
0548416_sc-104511.jpg,1,0,0,1,2,,train
0548417_sc-104511.jpg,1,0,0,1,2,,train
0548418_sc-104511.jpg,1,0,0,1,2,,train
0548419_sc-104511.jpg,1,0,0,1,2,,train
0548421_sc-206912.jpg,2,0,0,0,2,,train
0548422_sc-206912.jpg,1,0,0,0,1,,train
0548423_sc-206912.jpg,1,0,0,0,1,,val
0548424_sc-206912.jpg,1,0,0,0,1,,val
0548425_sc-1030370.jpg,1,0,0,0,1,,test
0548427_as-0069732.jpg,1,0,0,0,1,,train
0548428_as-0069732.jpg,3,0,0,0,3,,train
0548429_as-0069732.jpg,7,0,2,1,10,,train
0548430_as-0069732.jpg,4,0,1,0,5,,train
0548431_as-0069732.jpg,3,0,1,1,5,,train
0548432_as-0069732.jpg,0,0,1,1,2,,train
0548433_as-0069732.jpg,0,0,1,0,1,,train
0548434_as-3086963.jpg,5,0,0,0,5,,val
0548435_sc-125343.jpg,4,0,0,1,5,,val
0548436_sc-125343.jpg,4,0,0,1,5,,test
0548437_sc-125343.jpg,1,0,0,0,1,,train
0548438_sc-125343.jpg,3,0,0,1,4,,train
0548439_sc-125343.jpg,1,0,0,0,1,,train
0548440_sc-125343.jpg,3,0,0,0,3,,train
0548441_sc-212110.jpg,1,0,1,0,2,,train
0548442_sc-212110.jpg,1,0,1,0,2,,train
0548443_sc-212110.jpg,1,0,0,0,1,,train
0548444_sc-212110.jpg,1,0,0,0,1,,val
0548445_sc-212110.jpg,1,0,1,0,2,,val
0548446_as-0055281.jpg,4,0,0,0,4,,test
0548447_as-0055281.jpg,1,0,0,0,1,,train
0548448_as-0055281.jpg,2,0,0,0,2,,train
0548449_as-0055281.jpg,2,0,0,0,2,,train
0548450_sc-175135.jpg,0,1,0,0,1,,train
0548451_sc-224381.jpg,5,1,0,1,7,,train
0548452_sc-224381.jpg,0,1,0,0,1,,train
0548453_sc-151279.jpg,2,1,0,0,3,,train
0548455_as-0091685.jpg,3,0,0,1,4,,val
0548456_as-0091685.jpg,1,0,0,1,2,,val
0548457_as-0091685.jpg,4,0,0,0,4,,test
0548459_as-9025774.jpg,1,0,0,0,1,,train
0548467_as-0072707.jpg,8,0,1,2,11,,train
0548468_as-0072707.jpg,2,0,1,1,4,,train
0548469_as-0072707.jpg,2,0,2,1,5,,train
0548470_as-0072707.jpg,5,2,2,0,9,,train
0548471_sc-202383.jpg,1,0,0,0,1,,train
0548472_sc-202383.jpg,1,0,0,0,1,,train
0548474_as-0084752.jpg,1,0,2,0,3,,val
0548475_as-0084752.jpg,1,0,2,0,3,,val
0548476_as-0084752.jpg,1,0,0,0,1,,test
0548478_as-0084752.jpg,0,1,0,0,1,,train
0548479_as-0084752.jpg,2,0,0,0,2,,train
0548480_as-0084752.jpg,1,0,0,1,2,,train
0548481_as-0084752.jpg,1,0,1,0,2,,train
0548482_as-0084752.jpg,1,1,2,0,4,,train
0548484_sc-149321.jpg,1,0,0,0,1,,train
0548485_as-7754885.jpg,2,0,0,0,2,,train
0548488_as-2794701.jpg,1,0,0,1,2,,val
0548489_sc-224424.jpg,1,0,0,0,1,,val
0548490_as-0020062.jpg,1,1,0,0,2,,test
0548491_as-0020062.jpg,1,0,0,0,1,,train
0548493_as-0020062.jpg,2,0,0,0,2,,train
0548494_as-0020062.jpg,1,0,0,0,1,,train
0548496_as-0078519.jpg,1,0,0,1,2,,train
0548497_as-0078519.jpg,1,0,0,0,1,,train
0548498_as-0078519.jpg,2,0,0,1,3,,train
0548499_as-0078519.jpg,1,0,0,0,1,,train
0548500_as-0078519.jpg,2,0,0,0,2,,val
0548501_sc-1040452.jpg,0,1,0,1,2,,val
0548503_sc-1040452.jpg,0,1,0,1,2,,test
0548504_sc-1030137.jpg,7,0,1,1,9,,train
0548505_sc-1030137.jpg,11,0,1,2,14,,train
0548506_sc-1030137.jpg,12,1,3,2,18,,train
0548507_sc-1030137.jpg,10,0,2,0,12,,train
0548508_sc-1030137.jpg,5,1,3,1,10,,train
0548510_sc-1030137.jpg,6,0,1,0,7,,train
0548511_as-0064634.jpg,3,0,1,0,4,,train
0548514_as-0064634.jpg,1,0,0,0,1,,val
0548515_as-0064634.jpg,2,0,1,0,3,,val
0548516_as-0064634.jpg,1,0,0,0,1,,test
0548517_as-0064634.jpg,1,0,1,0,2,,train
0548518_as-0064634.jpg,0,1,0,0,1,,train
0548519_as-0064634.jpg,1,0,1,0,2,,train
0548520_sc-136001.jpg,1,0,0,0,1,,train
0548521_sc-136001.jpg,1,0,0,0,1,,train
0548522_sc-136001.jpg,2,0,0,0,2,,train
0548523_as-2600117.jpg,3,0,0,0,3,,train
0548525_as-0028313.jpg,0,0,3,0,3,,val
0548526_as-0028313.jpg,1,0,1,0,2,,val
0548527_as-0036734.jpg,1,0,0,1,2,,test
0548528_as-0036734.jpg,1,0,0,0,1,,train
0548529_as-0036734.jpg,1,0,0,0,1,,train
0548531_as-3363303.jpg,0,0,1,0,1,,train
0548532_as-0082212.jpg,1,0,0,0,1,,train
0548533_as-0082212.jpg,3,1,1,1,6,,train
0548534_as-0082212.jpg,1,1,0,1,3,,train
0548535_as-0082212.jpg,0,1,0,0,1,,train
0548536_as-0082212.jpg,2,1,0,0,3,,val
0548537_sc-1037812.jpg,1,0,0,1,2,,val
0548538_sc-1037812.jpg,1,0,0,1,2,,test
0548539_sc-1037812.jpg,1,0,0,1,2,,train
0548540_sc-140559.jpg,3,2,3,1,9,,train
0548541_sc-140559.jpg,2,0,0,0,2,,train
0548542_sc-140559.jpg,2,1,2,0,5,,train
0548543_sc-140559.jpg,1,1,1,1,4,,train
0548547_sc-1015194.jpg,3,0,1,0,4,,train
0548548_sc-1015194.jpg,1,0,0,0,1,,train
0548549_sc-1015194.jpg,0,0,1,0,1,,val
0548550_sc-1015194.jpg,0,0,1,0,1,,val
0548551_sc-1015194.jpg,3,0,1,1,5,,test
0548552_sc-1015194.jpg,2,0,1,1,4,,train
0548553_sc-1015194.jpg,3,0,1,1,5,,train
0548554_sc-1015194.jpg,0,0,1,0,1,,train
0548556_sc-148427.jpg,1,1,0,0,2,,train
0548557_sc-148427.jpg,0,1,0,0,1,,train
0548558_sc-148427.jpg,1,1,0,0,2,,train
0548559_sc-148427.jpg,1,0,0,0,1,,train
0548560_as-0091099.jpg,1,0,0,1,2,,val
0548562_as-0091099.jpg,1,0,0,1,2,,val
0548564_as-0004363.jpg,2,1,2,0,5,,test
0548565_as-0004363.jpg,1,0,2,0,3,,train
0548566_as-0004363.jpg,3,1,0,0,4,,train
0548567_as-0004363.jpg,2,0,1,0,3,,train
0548568_as-0004363.jpg,1,0,1,0,2,,train
0548569_as-0004363.jpg,3,1,0,0,4,,train
0548570_sc-118341.jpg,1,0,0,0,1,,train
0548571_sc-118341.jpg,1,0,1,0,2,,train
0548572_sc-118341.jpg,2,0,1,0,3,,val
0548573_sc-118341.jpg,3,0,1,0,4,,val
0548574_sc-118341.jpg,3,0,1,0,4,,test
0548576_sc-118341.jpg,2,0,1,0,3,,train
0548577_sc-118341.jpg,2,0,1,0,3,,train
0548578_sc-118341.jpg,1,0,1,0,2,,train
0548579_sc-118341.jpg,2,0,1,0,3,,train
0548580_sc-148376.jpg,3,0,0,0,3,,train
0548581_sc-148376.jpg,3,0,1,0,4,,train
0548583_sc-148376.jpg,3,0,0,0,3,,train
0548585_as-0000767.jpg,1,0,0,0,1,,val
0548586_sc-227511.jpg,1,1,0,0,2,,val
0548587_sc-227511.jpg,1,2,0,0,3,,test
0548588_as-3421028.jpg,1,0,0,0,1,,train
0548589_sc-109571.jpg,1,0,0,0,1,,train
0548590_as-2977378.jpg,4,0,0,0,4,,train
0548594_as-2812359.jpg,0,0,1,0,1,,train
0548595_as-0002895.jpg,2,1,0,0,3,,train
0548596_as-0002895.jpg,1,0,0,0,1,,train
0548597_as-0002895.jpg,3,0,0,0,3,,train
0548598_sc-123840.jpg,0,1,0,0,1,,val
0548599_sc-123840.jpg,2,1,1,0,4,,val
0548602_as-3240157.jpg,0,0,1,0,1,,test
0548603_as-3383544.jpg,1,0,0,0,1,,train
0548604_as-0026670.jpg,2,0,0,0,2,,train
0548605_as-0026670.jpg,1,0,0,0,1,,train
0548606_as-0033013.jpg,2,0,0,0,2,,train
0548607_sc-1028613.jpg,1,0,0,0,1,,train
0548608_sc-1028613.jpg,1,0,0,0,1,,train
0548611_as-0009769.jpg,0,0,1,0,1,,train
0548612_sc-224990.jpg,1,0,1,0,2,,val
0548613_sc-224990.jpg,0,1,3,0,4,,val
0548614_sc-224990.jpg,1,0,2,0,3,,test
0548615_sc-224990.jpg,1,0,0,0,1,,train
0548616_sc-224990.jpg,1,0,0,0,1,,train
0548617_sc-224990.jpg,0,1,2,0,3,,train
0548618_sc-138951.jpg,2,0,0,0,2,,train
0548619_sc-140002.jpg,3,0,0,1,4,,train
0548620_sc-140002.jpg,3,0,0,1,4,,train
0548621_sc-140002.jpg,1,0,0,1,2,,train
0548622_sc-140002.jpg,2,0,0,1,3,,val
0548624_sc-164936.jpg,3,0,1,1,5,,val
0548626_sc-164936.jpg,3,1,1,0,5,,test
0548627_sc-164936.jpg,4,2,1,0,7,,train
0548628_sc-164936.jpg,3,0,1,1,5,,train
0548629_sc-164936.jpg,4,3,1,0,8,,train
0548630_sc-164936.jpg,4,1,1,0,6,,train
0548634_as-0060523.jpg,1,0,0,0,1,,train
0548635_as-0060523.jpg,4,0,0,0,4,,train
0548636_as-0060523.jpg,4,0,0,0,4,,train
0548637_as-0060523.jpg,3,0,0,0,3,,val
0548639_sc-1033927.jpg,0,0,1,0,1,,val
0548640_sc-1033927.jpg,2,0,0,0,2,,test
0548641_sc-1033927.jpg,2,0,1,0,3,,train
0548642_as-3359439.jpg,8,2,2,0,12,,train
0548643_sc-1021164.jpg,1,1,1,0,3,,train
0548645_sc-218505.jpg,1,0,0,0,1,,train
0548646_sc-218505.jpg,3,0,0,0,3,,train
0548647_as-0041446.jpg,4,1,0,1,6,,train
0548652_as-0041446.jpg,2,1,1,0,4,,train
0548653_as-0041446.jpg,1,1,0,0,2,,val
0548654_as-0041446.jpg,3,3,0,0,6,,val
0548655_as-0041446.jpg,2,2,0,0,4,,test
0548656_as-0041446.jpg,1,0,1,0,2,,train
0548657_as-3089903.jpg,2,0,0,0,2,,train
0548658_as-5119287.jpg,1,0,1,1,3,,train
0548659_sc-124021.jpg,1,0,0,0,1,,train
0548661_sc-124021.jpg,1,0,0,0,1,,train
0548663_sc-1038585.jpg,1,0,0,0,1,,train
0548664_sc-1038585.jpg,7,0,1,0,8,,train
0548666_sc-1038585.jpg,2,0,1,0,3,,val
0548667_sc-1038585.jpg,1,0,1,1,3,,val
0548668_sc-1038585.jpg,1,0,0,0,1,,test
0548669_sc-1038585.jpg,2,0,0,0,2,,train
0548670_as-7057370.jpg,5,0,0,0,5,,train
0548671_as-0023424.jpg,1,0,0,1,2,,train
0548672_as-0023424.jpg,1,0,0,1,2,,train
0548673_as-0023424.jpg,0,0,2,1,3,,train
0548674_as-0023424.jpg,1,0,0,1,2,,train
0548675_as-2954348.jpg,8,0,0,1,9,,train
0548676_as-2954348.jpg,1,0,0,0,1,,val
0548677_as-0057389.jpg,1,0,0,0,1,,val
0548678_as-0057389.jpg,1,0,0,0,1,,test
0548680_sc-192350.jpg,1,0,0,0,1,,train
0548681_sc-192350.jpg,1,0,0,0,1,,train
0548682_sc-192350.jpg,1,0,0,0,1,,train
0548683_sc-192350.jpg,3,0,0,0,3,,train
0548684_sc-192350.jpg,2,0,0,0,2,,train
0548685_sc-192350.jpg,1,0,0,0,1,,train
0548686_sc-192350.jpg,1,0,0,0,1,,train
0548687_sc-200445.jpg,1,0,0,0,1,,val
0548688_sc-200445.jpg,1,0,1,0,2,,val
0548689_sc-200445.jpg,3,0,0,0,3,,test
0548690_sc-200445.jpg,2,0,0,0,2,,train
0548691_sc-200445.jpg,1,0,0,0,1,,train
0548692_sc-200445.jpg,1,0,0,0,1,,train
0548693_sc-200445.jpg,2,1,0,0,3,,train
0548694_sc-200445.jpg,2,1,1,0,4,,train
0548696_sc-152789.jpg,3,0,0,1,4,,train
0548697_sc-152789.jpg,1,0,1,0,2,,train
0548699_sc-142772.jpg,3,1,0,1,5,,val
0548700_sc-142772.jpg,3,1,0,1,5,,val
0548702_sc-1034131.jpg,1,0,0,0,1,,test
0548703_sc-1034131.jpg,2,0,0,0,2,,train
0548706_as-0041791.jpg,3,0,0,1,4,,train
0548708_as-0041791.jpg,7,0,0,1,8,,train
0548709_as-0041791.jpg,1,0,0,0,1,,train
0548710_as-0041791.jpg,3,0,0,0,3,,train
0548711_as-0041791.jpg,2,0,0,0,2,,train
0548712_as-0041791.jpg,3,0,0,0,3,,train
0548713_as-0041791.jpg,0,0,1,0,1,,val
0548714_sc-160488.jpg,0,0,1,0,1,,val
0548715_sc-160488.jpg,3,0,0,0,3,,test
0548716_sc-160488.jpg,4,0,0,0,4,,train
0548718_as-0033092.jpg,2,0,0,0,2,,train
0548719_sc-211147.jpg,2,0,0,0,2,,train
0548722_sc-1037093.jpg,0,0,2,0,2,,train
0548726_as-0065423.jpg,1,0,0,0,1,,train
0548727_as-0065423.jpg,0,0,1,0,1,,train
0548728_as-0065423.jpg,1,0,0,0,1,,train
0548729_as-0065423.jpg,1,0,0,0,1,,val
0548731_as-0017639.jpg,1,0,0,0,1,,val
0548732_as-2678530.jpg,2,1,2,1,6,,test
0548733_as-3053089.jpg,2,0,0,0,2,,train
0548734_sc-162671.jpg,0,0,1,0,1,,train
0548735_sc-162671.jpg,0,1,1,0,2,,train
0548736_as-2968311.jpg,2,0,0,0,2,,train
0548737_as-2534281.jpg,0,1,1,0,2,,train
0548741_as-0091014.jpg,3,0,1,1,5,,train
0548742_as-0091014.jpg,3,0,1,0,4,,train
0548743_as-0091014.jpg,4,0,0,0,4,,val
0548744_as-0091014.jpg,1,0,0,0,1,,val
0548750_as-0080185.jpg,1,0,1,0,2,,test
0548751_as-0080185.jpg,3,0,0,0,3,,train
0548752_sc-203631.jpg,1,1,0,0,2,,train
0548753_sc-203631.jpg,0,1,1,0,2,,train
0548754_sc-203631.jpg,1,1,0,0,2,,train
0548755_sc-203631.jpg,1,0,0,0,1,,train
0548756_sc-203631.jpg,1,0,1,0,2,,train
0548757_as-0032386.jpg,3,0,0,0,3,,train
0548758_as-0032386.jpg,1,1,0,0,2,,val
0548759_as-0032386.jpg,1,1,0,0,2,,val
0548760_as-2598384.jpg,1,0,1,0,2,,test
0548761_as-2588902.jpg,0,0,1,0,1,,train
0548762_as-3353383.jpg,4,0,0,0,4,,train
0548763_sc-221579.jpg,1,0,1,0,2,,train
0548764_sc-221579.jpg,0,0,1,0,1,,train
0548765_as-2690112.jpg,4,0,3,0,7,,train
0548766_as-0051346.jpg,1,0,0,1,2,,train
0548767_as-0051346.jpg,1,0,1,1,3,,train
0548768_as-0051346.jpg,1,0,0,0,1,,val
0548769_as-7150622.jpg,1,0,0,0,1,,val
0548770_as-0032720.jpg,3,0,0,0,3,,test
0548771_as-0032720.jpg,4,0,0,0,4,,train
0548772_as-0032720.jpg,2,0,0,0,2,,train
0548773_as-0032720.jpg,3,0,0,0,3,,train
0548775_as-0032720.jpg,4,0,0,0,4,,train
0548776_as-0032720.jpg,4,0,0,1,5,,train
0548777_as-0032720.jpg,2,0,0,0,2,,train
0548778_as-0032720.jpg,2,0,0,1,3,,train
0548779_as-0032720.jpg,1,0,0,0,1,,val
0548781_sc-143105.jpg,2,0,0,0,2,,val
0548782_sc-122971.jpg,5,0,0,0,5,,test
0548783_sc-122971.jpg,3,0,0,0,3,,train
0548784_sc-1027587.jpg,1,0,0,1,2,,train
0548786_sc-1027587.jpg,4,0,0,1,5,,train
0548787_as-3036130.jpg,2,0,0,0,2,,train
0548788_sc-129480.jpg,1,1,0,0,2,,train
0548789_sc-146037.jpg,3,1,1,0,5,,train
0548790_sc-146037.jpg,1,0,0,0,1,,train
0548791_sc-146037.jpg,1,1,1,0,3,,val
0548793_as-7855721.jpg,1,0,0,0,1,,val
0548795_as-0035099.jpg,2,0,1,1,4,,test
0548796_as-0035099.jpg,1,0,0,0,1,,train
0548797_as-0035099.jpg,1,0,1,0,2,,train
0548798_as-0035099.jpg,3,1,1,1,6,,train
0548801_as-0071354.jpg,1,0,1,0,2,,train
0548802_as-0071354.jpg,1,0,1,0,2,,train
0548803_as-0071354.jpg,8,1,1,1,11,,train
0548804_as-0071354.jpg,4,1,1,0,6,,train
0548805_as-0071354.jpg,6,1,2,1,10,,val
0548806_as-0071354.jpg,7,1,1,0,9,,val
0548808_as-7630688.jpg,2,0,0,1,3,,test
0548810_as-0078868.jpg,2,0,0,1,3,,train
0548812_as-0078868.jpg,16,0,1,0,17,,train
0548813_as-0078868.jpg,3,2,3,1,9,,train
0548814_as-0078868.jpg,11,5,3,2,21,,train
0548815_as-0078868.jpg,11,2,1,0,14,,train
0548816_as-0078868.jpg,6,2,1,2,11,,train
0548818_sc-195296.jpg,1,0,1,0,2,,train
0548819_as-0068653.jpg,2,1,0,0,3,,val
0548822_as-2801199.jpg,1,0,1,0,2,,val
0548823_sc-185912.jpg,3,0,0,0,3,,test
0548824_sc-185912.jpg,2,0,0,0,2,,train
0548825_sc-185912.jpg,2,0,0,0,2,,train
0548826_sc-185912.jpg,1,0,0,0,1,,train
0548827_as-3082271.jpg,0,0,1,2,3,,train
0548828_sc-202254.jpg,3,0,0,0,3,,train
0548829_sc-202254.jpg,1,0,0,2,3,,train
0548830_sc-202254.jpg,1,0,0,1,2,,train
0548831_sc-202254.jpg,0,0,0,1,1,,val
0548832_sc-202254.jpg,2,0,0,1,3,,val
0548833_sc-202254.jpg,1,0,0,0,1,,test
0548834_as-3487498.jpg,1,1,1,1,4,,train
0548835_sc-1008130.jpg,2,0,0,0,2,,train
0548837_sc-140987.jpg,5,0,1,0,6,,train
0548838_sc-140987.jpg,3,0,0,0,3,,train
0548839_as-7501882.jpg,2,0,0,0,2,,train
0548840_sc-140990.jpg,1,0,0,0,1,,train
0548841_sc-140990.jpg,1,0,0,0,1,,train
0548842_sc-136704.jpg,4,0,0,0,4,,val
0548843_sc-136704.jpg,1,0,0,0,1,,val
0548844_sc-171403.jpg,1,0,0,0,1,,test
0548845_sc-171403.jpg,1,0,0,0,1,,train
0548846_sc-171403.jpg,1,0,0,0,1,,train
0548847_sc-176303.jpg,1,0,1,1,3,,train
0548848_as-3158610.jpg,3,1,1,0,5,,train
0548849_sc-1031378.jpg,3,0,0,0,3,,train
0548850_as-3478678.jpg,2,0,0,0,2,,train
0548851_sc-1038808.jpg,0,1,0,0,1,,train
0548852_as-0090043.jpg,3,0,1,0,4,,val
0548853_as-0090043.jpg,1,0,1,0,2,,val
0548854_as-0090043.jpg,0,0,1,0,1,,test
0548855_sc-201660.jpg,2,0,1,0,3,,train
0548856_sc-201660.jpg,2,0,0,0,2,,train
0548857_as-0057049.jpg,1,0,0,0,1,,train
0548858_as-0057049.jpg,0,1,0,0,1,,train
0548859_as-3169165.jpg,3,0,1,0,4,,train
0548860_sc-1010846.jpg,1,0,0,0,1,,train
0548861_sc-1010846.jpg,1,0,0,0,1,,train
0548862_sc-1010846.jpg,2,0,0,0,2,,val
0548864_sc-127956.jpg,1,0,0,0,1,,val
0548865_sc-127956.jpg,1,0,1,1,3,,test
0548866_sc-127956.jpg,0,0,0,1,1,,train
0548867_sc-127956.jpg,1,0,0,1,2,,train
0548868_sc-127956.jpg,1,0,0,1,2,,train
0548869_as-3339548.jpg,0,0,2,1,3,,train
0548872_as-3012514.jpg,2,0,0,0,2,,train
0548873_as-0085213.jpg,1,0,2,1,4,,train
0548874_as-0085213.jpg,2,0,0,0,2,,train
0548875_as-0085213.jpg,1,0,1,1,3,,val
0548876_as-0085213.jpg,1,1,0,3,5,,val
0548877_as-0085213.jpg,1,1,1,2,5,,test
0548880_as-0095188.jpg,0,1,2,2,5,,train
0548881_as-0095188.jpg,0,1,0,1,2,,train
0548882_as-0095188.jpg,1,0,0,1,2,,train
0548883_as-0095188.jpg,1,5,2,1,9,,train
0548884_sc-185678.jpg,3,0,2,0,5,,train
0548886_sc-185678.jpg,1,0,2,0,3,,train
0548887_sc-185678.jpg,2,0,2,0,4,,train
0548889_sc-129491.jpg,7,0,0,0,7,,val
0548890_sc-129491.jpg,3,0,0,0,3,,val
0548891_sc-129491.jpg,4,0,0,0,4,,test
0548893_sc-150334.jpg,9,0,1,0,10,,train
0548894_sc-150334.jpg,5,0,0,0,5,,train
0548895_as-7000341.jpg,2,0,0,0,2,,train
0548896_as-7343116.jpg,2,0,0,1,3,,train
0548898_as-0019565.jpg,1,0,1,0,2,,train
0548899_as-0019565.jpg,1,0,0,0,1,,train
0548900_sc-126850.jpg,3,1,1,0,5,,train
0548901_as-2918610.jpg,1,0,0,0,1,,val
0548902_as-9083139.jpg,1,0,1,0,2,,val
0548903_sc-130550.jpg,1,1,0,0,2,,test
0548904_sc-130550.jpg,1,2,0,0,3,,train
0548905_sc-130550.jpg,2,2,0,1,5,,train
0548906_sc-130550.jpg,2,2,0,1,5,,train
0548909_sc-141600.jpg,2,0,0,0,2,,train
0548911_sc-109068.jpg,2,0,0,0,2,,train
0548915_as-0055838.jpg,1,0,1,1,3,,train
0548916_sc-228402.jpg,0,0,0,1,1,,train
0548917_sc-228402.jpg,2,0,0,1,3,,val
0548918_sc-228402.jpg,2,0,0,1,3,,val
0548919_as-2793940.jpg,4,1,3,1,9,,test
0548920_as-7577662.jpg,6,1,0,1,8,,train
0548921_sc-145088.jpg,3,0,1,1,5,,train
0548922_sc-145088.jpg,2,0,1,2,5,,train
0548923_sc-222102.jpg,2,0,0,0,2,,train
0548924_sc-222102.jpg,0,1,0,0,1,,train
0548925_sc-222102.jpg,0,1,0,0,1,,train
0548926_sc-1020600.jpg,1,0,0,1,2,,train
0548927_as-0055807.jpg,1,0,0,0,1,,val
0548928_as-0055807.jpg,2,0,0,0,2,,val
0548929_sc-181349.jpg,5,0,0,0,5,,test
0548930_sc-217666.jpg,10,0,0,0,10,,train
0548931_sc-217666.jpg,2,0,0,1,3,,train
0548937_as-0056398.jpg,4,1,0,0,5,,train
0548939_as-0056398.jpg,6,0,0,0,6,,train
0548940_as-0056398.jpg,2,0,1,0,3,,train
0548941_sc-194535.jpg,2,0,0,0,2,,train
0548942_sc-194535.jpg,1,0,0,0,1,,train
0548943_sc-194535.jpg,1,0,0,0,1,,val
0548944_sc-194535.jpg,1,0,0,1,2,,val
0548945_sc-194535.jpg,2,0,0,0,2,,test
0548946_as-0055769.jpg,1,0,0,0,1,,train
0548947_as-0055769.jpg,1,0,0,0,1,,train
0548949_sc-178949.jpg,1,0,0,0,1,,train
0548951_as-3302997.jpg,5,0,0,0,5,,train
0548952_as-0024598.jpg,2,1,1,0,4,,train
0548953_sc-147387.jpg,4,2,3,0,9,,train
0548955_sc-147387.jpg,4,2,3,0,9,,train
0548956_sc-147387.jpg,5,2,3,0,10,,val
0548957_sc-147387.jpg,7,1,3,0,11,,val
0548958_as-3266750.jpg,1,0,1,0,2,,test
0548959_as-3400124.jpg,1,0,1,0,2,,train
0548960_sc-214267.jpg,1,1,1,0,3,,train
0548961_sc-225710.jpg,1,0,1,0,2,,train
0548962_sc-225710.jpg,3,0,2,0,5,,train
0548963_sc-225710.jpg,4,0,1,1,6,,train
0548965_as-0065778.jpg,0,1,1,0,2,,train
0548966_as-0065778.jpg,1,4,1,1,7,,train
0548967_as-0065778.jpg,2,0,0,0,2,,val
0548970_as-0065778.jpg,0,0,3,0,3,,val
0548971_as-3341966.jpg,1,0,0,0,1,,test
0548972_sc-204182.jpg,3,1,1,0,5,,train
0548973_sc-204182.jpg,1,0,0,0,1,,train
0548974_sc-204182.jpg,3,1,1,0,5,,train
0548975_sc-204182.jpg,3,1,1,0,5,,train
0548976_sc-204182.jpg,3,0,0,0,3,,train
0548977_sc-204182.jpg,0,0,1,0,1,,train
0548978_as-3334563.jpg,2,0,0,0,2,,train
0548979_sc-169747.jpg,0,0,1,0,1,,val
0548980_sc-163526.jpg,1,0,0,0,1,,val
0548981_sc-163526.jpg,1,0,0,0,1,,test
0548983_sc-161861.jpg,2,1,0,0,3,,train
0548984_as-3393629.jpg,2,0,0,0,2,,train
0548985_sc-115068.jpg,1,0,0,0,1,,train
0548986_sc-115068.jpg,1,0,0,1,2,,train
0548987_sc-115068.jpg,1,0,0,0,1,,train
0548989_sc-169335.jpg,3,0,0,0,3,,train
0548990_sc-169335.jpg,3,0,0,0,3,,train
0548991_sc-169335.jpg,2,0,0,0,2,,val
0548992_as-2922225.jpg,1,0,0,0,1,,val
0548993_sc-173775.jpg,1,1,0,0,2,,test
0548994_sc-173775.jpg,1,2,0,0,3,,train
0548996_sc-173775.jpg,1,0,0,1,2,,train
0548997_sc-173775.jpg,1,0,0,0,1,,train
0548998_sc-173775.jpg,1,2,0,0,3,,train
0549000_sc-173775.jpg,1,2,0,1,4,,train
0549001_sc-173775.jpg,0,2,0,0,2,,train
0549002_sc-173775.jpg,0,2,0,0,2,,train
0549003_sc-173775.jpg,1,1,0,0,2,,val
0549004_sc-173775.jpg,1,1,0,0,2,,val
0549005_sc-173775.jpg,1,0,0,0,1,,test
0549009_as-0080929.jpg,1,0,0,0,1,,train
0549010_sc-109258.jpg,1,0,0,0,1,,train
0549011_as-0094577.jpg,4,0,1,0,5,,train
0549012_as-0094577.jpg,1,0,0,0,1,,train
0549014_sc-109745.jpg,1,0,0,0,1,,train
0549017_as-0079654.jpg,1,0,0,1,2,,train
0549018_as-0079654.jpg,1,0,0,1,2,,train
0549020_sc-218770.jpg,2,0,0,4,6,,val
0549021_sc-218770.jpg,1,0,0,2,3,,val
0549022_sc-218770.jpg,1,0,0,0,1,,test
0549024_as-0009171.jpg,1,0,0,0,1,,train
0549026_as-0009171.jpg,1,0,1,1,3,,train
0549027_as-0009171.jpg,1,0,1,1,3,,train
0549028_as-0009171.jpg,1,0,1,1,3,,train
0549029_as-0009171.jpg,1,0,1,1,3,,train
0549030_as-0009171.jpg,1,0,0,1,2,,train
0549031_sc-1022442.jpg,1,0,0,0,1,,train
0549032_sc-1022442.jpg,1,0,0,0,1,,val
0549033_sc-1022442.jpg,1,0,0,0,1,,val
0549034_sc-1022442.jpg,1,0,0,0,1,,test
0549035_sc-1022442.jpg,1,0,0,0,1,,train
0549037_sc-1014145.jpg,3,0,0,0,3,,train
0549039_sc-1014145.jpg,4,0,0,0,4,,train
0549040_as-2590951.jpg,4,0,0,0,4,,train
0549043_as-0017666.jpg,1,2,2,1,6,,train
0549045_as-0017666.jpg,2,0,1,2,5,,train
0549046_as-0017666.jpg,1,0,0,0,1,,train
0549048_as-0017666.jpg,1,0,2,1,4,,val
0549049_as-0017666.jpg,2,1,2,1,6,,val
0549050_as-0017666.jpg,3,2,1,1,7,,test
0549051_as-0065799.jpg,1,0,1,0,2,,train
0549052_as-0065799.jpg,1,0,1,0,2,,train
0549053_as-0065799.jpg,0,0,2,0,2,,train
0549054_as-0087481.jpg,1,1,0,0,2,,train
0549055_as-0087481.jpg,1,0,0,0,1,,train
0549056_as-0087481.jpg,1,0,0,0,1,,train
0549057_as-0087481.jpg,1,0,0,0,1,,train
0549060_as-0050562.jpg,4,1,1,1,7,,val
0549062_as-0050562.jpg,4,1,1,1,7,,val
0549064_sc-134765.jpg,10,1,0,0,11,,test
0549065_sc-134765.jpg,2,0,0,0,2,,train
0549066_sc-134765.jpg,4,0,0,0,4,,train
0549067_sc-134765.jpg,2,0,0,0,2,,train
0549068_sc-134765.jpg,1,0,0,0,1,,train
0549069_sc-216652.jpg,1,0,0,0,1,,train
0549070_sc-216652.jpg,4,0,0,0,4,,train
0549071_sc-216652.jpg,3,0,0,0,3,,train
0549072_sc-216652.jpg,1,0,0,0,1,,val
0549073_as-7598895.jpg,2,0,0,0,2,,val
0549075_sc-148630.jpg,2,0,1,0,3,,test
0549076_sc-148630.jpg,2,0,0,1,3,,train
0549077_as-0055643.jpg,4,0,0,0,4,,train
0549078_as-0055643.jpg,6,0,0,0,6,,train
0549079_as-0055643.jpg,2,0,0,0,2,,train
0549080_sc-221812.jpg,2,0,1,2,5,,train
0549082_sc-221812.jpg,1,0,1,2,4,,train
0549083_sc-221812.jpg,1,0,1,2,4,,train
0549085_sc-221812.jpg,1,0,0,2,3,,val
0549086_sc-221812.jpg,1,0,0,1,2,,val
0549087_as-7161681.jpg,1,0,1,1,3,,test
0549088_as-7864196.jpg,1,1,1,1,4,,train
0549089_as-0068152.jpg,0,2,0,0,2,,train
0549090_as-2889219.jpg,1,0,0,0,1,,train
0549091_as-0023418.jpg,1,0,0,0,1,,train
0549092_as-0023418.jpg,1,0,0,0,1,,train
0549093_sc-1040303.jpg,2,0,1,0,3,,train
0549095_sc-1040303.jpg,1,0,1,0,2,,train
0549096_sc-1040303.jpg,3,0,1,0,4,,val
0549097_sc-1008439.jpg,1,0,0,0,1,,val
0549098_sc-1008439.jpg,1,0,0,0,1,,test
0549099_sc-1008439.jpg,1,0,0,1,2,,train
0549100_as-2504014.jpg,2,0,3,1,6,,train
0549101_as-2677648.jpg,0,1,2,0,3,,train
0549102_as-3055060.jpg,1,1,1,1,4,,train
0549103_sc-200595.jpg,1,0,0,0,1,,train
0549104_sc-200595.jpg,1,0,0,0,1,,train
0549105_sc-200595.jpg,1,0,0,0,1,,train
0549106_sc-1018797.jpg,1,0,0,0,1,,val
0549107_as-2512975.jpg,1,0,0,0,1,,val
0549109_as-0071117.jpg,1,0,1,1,3,,test
0549110_as-0071117.jpg,1,0,1,1,3,,train
0549111_as-0071117.jpg,1,0,0,0,1,,train
0549112_as-0071117.jpg,1,0,0,0,1,,train
0549113_as-0071117.jpg,2,0,0,0,2,,train
0549114_sc-1035924.jpg,1,0,0,0,1,,train
0549115_as-3215030.jpg,2,0,0,0,2,,train
0549117_as-0032005.jpg,0,1,0,0,1,,train
0549118_as-0032005.jpg,1,0,0,0,1,,val
0549119_as-7979686.jpg,2,0,0,0,2,,val
0549120_sc-194757.jpg,1,0,0,0,1,,test
0549121_sc-194757.jpg,3,0,0,0,3,,train
0549122_sc-194757.jpg,2,0,0,1,3,,train
0549123_sc-194757.jpg,1,0,0,0,1,,train
0549124_as-2687672.jpg,1,0,0,0,1,,train
0549126_sc-108031.jpg,1,0,0,0,1,,train
0549128_sc-158207.jpg,2,0,0,1,3,,train
0549129_sc-158207.jpg,1,0,2,1,4,,train
0549130_sc-158207.jpg,1,0,1,1,3,,val
0549132_sc-158207.jpg,4,0,1,0,5,,val
0549134_sc-158207.jpg,1,0,0,0,1,,test
0549136_sc-158207.jpg,1,0,1,0,2,,train
0549137_sc-158207.jpg,1,0,0,0,1,,train
0549138_sc-158207.jpg,2,0,1,0,3,,train
0549140_sc-158207.jpg,2,0,0,0,2,,train
0549141_sc-158207.jpg,3,0,0,0,3,,train
0549144_as-3107609.jpg,1,0,0,0,1,,train
0549148_as-0077086.jpg,10,2,0,1,13,,train
0549149_as-0077086.jpg,4,1,0,1,6,,val
0549150_as-0077086.jpg,0,0,0,1,1,,val
0549152_sc-134943.jpg,2,1,1,0,4,,test
0549153_sc-134943.jpg,0,1,0,0,1,,train
0549154_sc-134943.jpg,0,1,1,0,2,,train
0549155_sc-183140.jpg,1,0,1,1,3,,train
0549156_sc-183140.jpg,1,0,3,1,5,,train
0549157_sc-183140.jpg,1,0,0,0,1,,train
0549158_sc-183140.jpg,1,0,0,1,2,,train
0549159_sc-172908.jpg,5,0,0,1,6,,train
0549160_sc-172908.jpg,2,0,0,1,3,,val
0549161_sc-172908.jpg,5,0,0,0,5,,val
0549162_sc-172908.jpg,3,0,0,1,4,,test
0549163_sc-172908.jpg,2,0,1,1,4,,train
0549164_as-0019608.jpg,1,3,0,0,4,,train
0549165_as-0019608.jpg,1,0,0,0,1,,train
0549166_as-7815566.jpg,2,0,0,0,2,,train
0549167_sc-174984.jpg,1,1,0,0,2,,train
0549168_sc-1030357.jpg,2,0,0,1,3,,train
0549169_sc-180765.jpg,2,0,0,0,2,,train
0549172_sc-180765.jpg,1,0,0,0,1,,val
0549173_sc-180765.jpg,1,1,0,0,2,,val
0549175_sc-180765.jpg,1,0,0,0,1,,test
0549176_sc-147021.jpg,1,0,2,0,3,,train
0549178_as-9057213.jpg,0,2,0,2,4,,train
0549179_as-0038060.jpg,0,0,0,1,1,,train
0549180_as-0038060.jpg,1,0,0,0,1,,train
0549181_as-0038060.jpg,0,0,0,1,1,,train
0549182_as-0038060.jpg,1,0,0,0,1,,train
0549187_as-7794715.jpg,2,0,1,0,3,,train
0549190_as-0084394.jpg,4,1,1,1,7,,val
0549192_as-3134020.jpg,2,0,0,0,2,,val
0549193_sc-127282.jpg,0,0,1,0,1,,test
0549194_as-0016519.jpg,5,0,0,0,5,,train
0549195_as-0016519.jpg,2,0,0,0,2,,train
0549196_as-0016519.jpg,1,0,0,0,1,,train
0549197_as-0016519.jpg,1,0,0,0,1,,train
0549199_sc-1033656.jpg,5,0,0,0,5,,train
0549200_sc-1033656.jpg,8,0,0,0,8,,train
0549201_sc-1033656.jpg,8,0,0,0,8,,train
0549202_sc-1033656.jpg,5,1,0,0,6,,val
0549204_as-0004487.jpg,1,0,0,0,1,,val
0549205_as-0035707.jpg,1,0,0,0,1,,test
0549206_as-0035707.jpg,1,0,0,0,1,,train
0549207_as-0035707.jpg,1,0,0,0,1,,train
0549208_as-0035707.jpg,1,0,0,0,1,,train
0549209_as-0035707.jpg,1,0,0,0,1,,train
0549210_sc-170070.jpg,2,0,0,1,3,,train
0549213_sc-170070.jpg,0,2,1,0,3,,train
0549214_sc-170070.jpg,1,0,0,1,2,,train
0549215_sc-170070.jpg,2,0,0,1,3,,val
0549216_as-2827030.jpg,1,0,1,0,2,,val
0549217_sc-154520.jpg,1,0,0,0,1,,test
0549219_sc-154520.jpg,1,0,0,0,1,,train
0549221_as-0022288.jpg,1,0,0,0,1,,train
0549222_as-0022288.jpg,1,0,1,0,2,,train
0549223_as-0022288.jpg,1,0,0,0,1,,train
0549224_as-0022288.jpg,1,0,0,0,1,,train
0549225_as-0022288.jpg,1,0,0,0,1,,train
0549228_as-0093112.jpg,4,0,0,0,4,,train
0549229_as-0093112.jpg,3,0,0,0,3,,val
0549231_as-3043130.jpg,1,0,0,0,1,,val
0549232_sc-201632.jpg,2,0,0,0,2,,test
0549234_sc-201632.jpg,1,0,0,0,1,,train
0549235_sc-201632.jpg,1,0,0,0,1,,train
0549237_sc-201632.jpg,4,0,0,0,4,,train
0549239_sc-201632.jpg,1,1,0,0,2,,train
0549240_sc-201632.jpg,3,1,0,0,4,,train
0549241_as-0049092.jpg,2,0,0,1,3,,train
0549242_as-0049092.jpg,1,0,2,0,3,,train
0549243_as-0049092.jpg,2,0,0,1,3,,val
0549244_as-0049092.jpg,1,0,0,1,2,,val
0549245_as-0049092.jpg,1,0,1,1,3,,test
0549246_as-0049092.jpg,0,1,0,1,2,,train
0549247_as-0049092.jpg,1,1,0,0,2,,train
0549248_as-0049092.jpg,0,0,0,1,1,,train
0549249_as-0049092.jpg,0,2,0,1,3,,train
0549250_as-0049092.jpg,0,1,0,0,1,,train
0549251_as-0049092.jpg,0,1,0,1,2,,train
0549252_as-2545962.jpg,1,0,0,0,1,,train
0549253_sc-228851.jpg,6,0,0,0,6,,val
0549254_sc-228851.jpg,1,0,0,0,1,,val
0549255_sc-228851.jpg,1,0,0,0,1,,test
0549257_as-0027509.jpg,4,0,1,1,6,,train
0549258_as-0027509.jpg,4,0,1,1,6,,train
0549259_sc-200813.jpg,2,0,0,0,2,,train
0549260_sc-200813.jpg,1,0,1,0,2,,train
0549261_sc-200813.jpg,0,0,1,0,1,,train
0549262_as-3173190.jpg,1,0,1,1,3,,train
0549263_as-0021386.jpg,1,0,0,0,1,,train
0549264_as-0021386.jpg,1,0,0,0,1,,val
0549265_as-0021386.jpg,4,0,1,0,5,,val
0549266_as-0021386.jpg,5,0,1,0,6,,test
0549267_sc-140546.jpg,1,0,0,0,1,,train
0549268_sc-113368.jpg,1,0,0,0,1,,train
0549270_as-0034312.jpg,2,1,0,0,3,,train
0549271_as-0034312.jpg,2,2,0,0,4,,train
0549272_as-0034312.jpg,0,0,1,0,1,,train
0549277_as-0014278.jpg,0,0,0,1,1,,train
0549278_as-0014278.jpg,0,0,0,1,1,,train
0549279_as-0014278.jpg,1,0,1,1,3,,val
0549280_as-0014278.jpg,1,0,1,1,3,,val
0549281_as-7657382.jpg,1,0,0,0,1,,test
0549283_sc-195525.jpg,1,0,1,0,2,,train
0549284_sc-195525.jpg,0,0,1,0,1,,train
0549285_sc-195525.jpg,1,0,1,0,2,,train
0549286_sc-195525.jpg,1,0,1,0,2,,train
0549287_sc-210424.jpg,2,0,0,0,2,,train
0549288_sc-210424.jpg,3,0,0,0,3,,train
0549289_sc-210424.jpg,3,0,0,0,3,,train
0549290_sc-210424.jpg,1,0,0,0,1,,val
0549291_sc-1018850.jpg,5,0,1,1,7,,val
0549292_sc-1018850.jpg,2,0,3,2,7,,test
0549294_sc-1018850.jpg,2,1,1,1,5,,train
0549295_sc-186997.jpg,1,0,0,1,2,,train
0549296_sc-186997.jpg,1,0,1,1,3,,train
0549298_as-0042665.jpg,1,0,1,0,2,,train
0549299_as-0051989.jpg,0,1,0,0,1,,train
0549300_as-0051989.jpg,2,1,0,0,3,,train
0549301_as-0051989.jpg,4,1,0,1,6,,train
0549302_sc-163466.jpg,1,0,0,0,1,,val
0549303_as-0003063.jpg,7,0,0,1,8,,val
0549304_as-0003063.jpg,2,0,0,0,2,,test
0549305_as-0003063.jpg,5,0,0,0,5,,train
0549306_sc-173986.jpg,1,0,0,0,1,,train
0549307_sc-173986.jpg,1,0,1,0,2,,train
0549308_sc-173986.jpg,1,0,0,0,1,,train
0549309_as-7511810.jpg,1,1,0,0,2,,train
0549312_as-3069627.jpg,1,0,1,1,3,,train
0549313_as-3413587.jpg,0,1,1,0,2,,train
0549315_as-0036344.jpg,3,0,0,0,3,,val
0549316_as-0036344.jpg,3,0,0,0,3,,val
0549317_as-0036344.jpg,1,0,0,0,1,,test
0549318_as-0036344.jpg,2,0,1,0,3,,train
0549319_as-0036344.jpg,2,0,0,0,2,,train
0549320_as-0036344.jpg,1,0,0,0,1,,train
0549321_as-0036344.jpg,1,0,1,1,3,,train
0549323_as-0036344.jpg,2,0,0,0,2,,train
0549324_as-0036344.jpg,6,0,0,0,6,,train
0549325_as-0032718.jpg,2,1,0,0,3,,train
0549327_sc-134521.jpg,4,1,1,1,7,,val
0549328_sc-168659.jpg,3,1,0,0,4,,val
0549330_sc-208862.jpg,5,0,0,0,5,,test
0549331_sc-208862.jpg,1,0,0,0,1,,train
0549335_as-0086924.jpg,1,2,0,0,3,,train
0549336_as-0086924.jpg,1,0,0,0,1,,train
0549337_sc-211492.jpg,1,1,0,0,2,,train
0549338_sc-211492.jpg,1,1,0,0,2,,train
0549340_sc-1003794.jpg,2,0,0,1,3,,train
0549341_sc-1003794.jpg,3,1,1,1,6,,train
0549342_sc-1003794.jpg,3,1,1,1,6,,val
0549343_sc-1003794.jpg,1,2,0,1,4,,val
0549345_sc-1003794.jpg,1,2,1,0,4,,test
0549346_sc-1003794.jpg,2,1,1,0,4,,train
0549347_sc-170349.jpg,1,0,1,0,2,,train
0549348_sc-170349.jpg,2,0,2,1,5,,train
0549349_sc-170349.jpg,1,0,0,1,2,,train
0549350_sc-170349.jpg,1,0,3,0,4,,train
0549351_sc-170349.jpg,0,0,2,0,2,,train
0549352_sc-170349.jpg,1,0,3,0,4,,train
0549354_sc-158975.jpg,1,0,1,2,4,,val
0549355_as-0033742.jpg,1,0,0,0,1,,val
0549356_as-0033742.jpg,0,0,1,0,1,,test
0549357_as-0033742.jpg,0,0,1,0,1,,train
0549358_as-0033742.jpg,0,0,0,1,1,,train
0549359_as-0033742.jpg,3,0,1,0,4,,train
0549360_as-0033742.jpg,0,0,0,1,1,,train
0549361_as-0033742.jpg,0,0,0,1,1,,train
0549362_sc-121283.jpg,1,0,0,0,1,,train
0549363_sc-121283.jpg,1,0,0,0,1,,train
0549364_sc-198184.jpg,1,0,1,0,2,,val
0549365_sc-198184.jpg,1,0,0,0,1,,val
0549366_sc-198184.jpg,1,1,0,0,2,,test
0549367_sc-198184.jpg,2,0,0,0,2,,train
0549368_as-7135784.jpg,4,0,0,0,4,,train
0549369_sc-1007239.jpg,2,0,0,0,2,,train
0549370_sc-178420.jpg,0,1,0,0,1,,train
0549372_as-0025859.jpg,3,0,0,0,3,,train
0549373_as-0025859.jpg,0,0,0,1,1,,train
0549374_as-0025859.jpg,0,0,0,1,1,,train
0549378_as-0050593.jpg,1,0,1,1,3,,val
0549379_as-0050593.jpg,1,0,1,1,3,,val
0549380_as-0050593.jpg,2,0,1,1,4,,test
0549381_as-0050593.jpg,2,0,1,0,3,,train
0549382_as-0050593.jpg,1,0,1,1,3,,train
0549383_as-0050593.jpg,1,0,0,1,2,,train
0549384_as-0050593.jpg,1,0,1,1,3,,train
0549385_as-0050593.jpg,2,0,0,0,2,,train
0549386_as-0050593.jpg,1,0,1,1,3,,train
0549387_sc-108452.jpg,2,0,0,0,2,,train
0549388_sc-108452.jpg,2,0,0,0,2,,val
0549389_sc-108452.jpg,2,0,1,0,3,,val
0549390_sc-108452.jpg,1,0,1,0,2,,test
0549391_sc-108452.jpg,1,0,1,0,2,,train
0549392_sc-108452.jpg,1,0,1,0,2,,train
0549393_sc-108452.jpg,1,0,1,0,2,,train
0549394_as-0076354.jpg,1,0,0,0,1,,train
0549395_as-0076354.jpg,1,1,0,0,2,,train
0549396_as-0076354.jpg,1,0,0,0,1,,train
0549397_as-3143403.jpg,0,1,1,0,2,,train
0549398_sc-145859.jpg,2,0,1,0,3,,val
0549399_sc-145859.jpg,1,0,0,0,1,,val
0549400_sc-145859.jpg,1,0,0,0,1,,test
0549401_as-0031611.jpg,2,0,1,0,3,,train
0549402_as-0031611.jpg,1,0,0,0,1,,train
0549403_as-0031611.jpg,3,0,1,0,4,,train
0549404_sc-169740.jpg,1,0,0,0,1,,train
0549405_sc-169740.jpg,2,0,0,0,2,,train
0549406_sc-169740.jpg,1,0,0,0,1,,train
0549407_sc-1003016.jpg,1,0,2,2,5,,train
0549408_sc-1003016.jpg,1,0,2,2,5,,val
0549410_sc-153108.jpg,1,0,0,0,1,,val
0549411_sc-212047.jpg,2,0,0,0,2,,test
0549412_sc-207357.jpg,1,1,0,0,2,,train
0549413_sc-107699.jpg,0,0,1,0,1,,train
0549414_as-3483119.jpg,1,0,0,0,1,,train
0549415_as-0036763.jpg,1,1,0,1,3,,train
0549416_as-0036763.jpg,1,1,0,0,2,,train
0549417_as-0036763.jpg,1,1,0,0,2,,train
0549419_as-3139243.jpg,1,0,0,0,1,,train
0549420_sc-172765.jpg,3,0,0,0,3,,val
0549421_sc-1012326.jpg,5,0,0,0,5,,val
0549422_as-3243450.jpg,4,1,2,3,10,,test
0549423_sc-175081.jpg,1,0,1,0,2,,train
0549424_as-9060306.jpg,3,0,0,0,3,,train
0549427_as-0063423.jpg,1,0,0,0,1,,train
0549428_as-0063423.jpg,1,0,0,0,1,,train
0549429_as-0063423.jpg,1,0,0,0,1,,train
0549430_as-0063423.jpg,1,0,0,2,3,,train
0549431_as-0063423.jpg,1,0,0,2,3,,train
0549432_as-0063423.jpg,2,0,0,1,3,,val
0549433_as-0063423.jpg,1,0,0,2,3,,val
0549434_as-0063423.jpg,1,0,0,2,3,,test
0549435_as-0034672.jpg,2,0,0,0,2,,train
0549436_as-0034672.jpg,1,0,1,0,2,,train
0549437_as-0013072.jpg,1,0,0,0,1,,train
0549439_as-0013072.jpg,3,0,0,0,3,,train
0549440_as-0013072.jpg,3,0,0,0,3,,train
0549441_as-0013072.jpg,2,0,0,0,2,,train
0549442_as-0013072.jpg,3,0,0,0,3,,train
0549443_as-0013072.jpg,4,0,0,0,4,,val
0549444_as-0013072.jpg,2,0,1,0,3,,val
0549445_as-0013072.jpg,2,0,0,0,2,,test
0549446_as-0013072.jpg,1,0,0,0,1,,train
0549447_as-0013072.jpg,1,0,0,0,1,,train
0549448_as-0013072.jpg,1,0,0,0,1,,train
0549449_as-0013072.jpg,1,0,0,0,1,,train
0549450_as-0013072.jpg,1,0,0,0,1,,train
0549451_as-0013072.jpg,0,1,0,0,1,,train
0549452_sc-137476.jpg,1,1,1,0,3,,train
0549454_sc-137476.jpg,1,0,0,0,1,,val
0549455_sc-174428.jpg,1,0,0,2,3,,val
0549456_sc-1022646.jpg,1,1,1,1,4,,test
0549458_sc-1022646.jpg,1,1,1,1,4,,train
0549462_sc-116935.jpg,1,0,2,0,3,,train
0549464_sc-116935.jpg,0,0,2,0,2,,train
0549465_as-0070310.jpg,1,0,0,1,2,,train
0549466_as-0070310.jpg,2,0,0,1,3,,train
0549467_as-0070310.jpg,1,0,1,1,3,,train
0549468_as-0070310.jpg,1,0,1,1,3,,train
0549469_sc-184681.jpg,0,0,1,0,1,,val
0549470_sc-184681.jpg,1,0,1,0,2,,val
0549471_sc-184681.jpg,5,0,0,0,5,,test
0549472_sc-184681.jpg,1,0,0,1,2,,train
0549473_as-3480755.jpg,0,1,1,0,2,,train
0549474_sc-141478.jpg,4,0,1,0,5,,train
0549475_sc-141478.jpg,3,0,0,0,3,,train
0549476_sc-141478.jpg,1,0,1,0,2,,train
0549477_sc-141478.jpg,3,0,1,0,4,,train
0549478_sc-128208.jpg,5,0,1,1,7,,train
0549479_as-2826282.jpg,2,0,1,0,3,,val
0549480_sc-1037668.jpg,0,0,0,1,1,,val
0549481_sc-1037668.jpg,1,0,0,1,2,,test
0549482_sc-1037668.jpg,1,0,0,1,2,,train
0549483_sc-140909.jpg,1,0,0,0,1,,train
0549484_sc-140909.jpg,1,0,0,0,1,,train
0549485_sc-140909.jpg,4,0,0,0,4,,train
0549487_sc-140909.jpg,1,0,0,0,1,,train
0549488_sc-129905.jpg,2,1,0,0,3,,train
0549489_sc-129905.jpg,1,1,1,0,3,,train
0549492_sc-201971.jpg,2,0,0,0,2,,val
0549493_sc-201971.jpg,1,0,0,0,1,,val
0549494_sc-201971.jpg,3,1,0,0,4,,test
0549495_sc-201971.jpg,1,0,0,0,1,,train
0549496_sc-201971.jpg,5,1,0,0,6,,train
0549497_sc-201971.jpg,1,1,0,0,2,,train
0549500_as-0093963.jpg,1,1,0,0,2,,train
0549501_as-0093963.jpg,3,1,0,0,4,,train
0549502_sc-1008057.jpg,3,0,1,0,4,,train
0549504_sc-1035635.jpg,0,1,1,0,2,,train
0549506_as-4891653.jpg,0,0,0,2,2,,val
0549508_as-0028247.jpg,1,0,1,1,3,,val
0549510_as-2511832.jpg,1,0,0,0,1,,test
0549511_as-3118777.jpg,0,0,1,0,1,,train
0549514_as-2606448.jpg,1,0,0,1,2,,train
0549515_as-0008219.jpg,4,0,1,0,5,,train
0549516_as-0008219.jpg,2,0,0,0,2,,train
0549517_as-0008219.jpg,3,0,0,0,3,,train
0549518_as-0008219.jpg,2,0,0,1,3,,train
0549520_as-0008219.jpg,1,0,0,0,1,,train
0549521_as-0008219.jpg,1,0,0,0,1,,val
0549524_as-0008219.jpg,3,0,0,0,3,,val
0549525_as-0008219.jpg,3,0,0,0,3,,test
0549526_as-0008219.jpg,1,0,0,0,1,,train
0549527_as-0008219.jpg,1,0,0,0,1,,train
0549528_as-0008219.jpg,1,0,0,0,1,,train
0549529_as-7028635.jpg,5,0,1,2,8,,train
0549530_sc-1040282.jpg,3,0,0,0,3,,train
0549534_as-0088993.jpg,1,0,0,0,1,,train
0549535_as-0088993.jpg,1,0,0,0,1,,train
0549536_as-0088993.jpg,2,0,0,0,2,,val
0549537_as-0088993.jpg,0,1,0,0,1,,val
0549538_as-0088993.jpg,3,0,1,0,4,,test
0549539_as-0088993.jpg,1,0,0,0,1,,train
0549540_as-0088993.jpg,2,0,1,0,3,,train
0549541_as-0088993.jpg,1,0,0,0,1,,train
0549542_as-0088993.jpg,1,1,0,0,2,,train
0549543_as-0088993.jpg,1,1,0,0,2,,train
0549544_as-0088993.jpg,1,2,0,0,3,,train
0549545_as-2665053.jpg,1,0,0,0,1,,train
0549546_as-2692951.jpg,0,1,0,0,1,,val
0549549_as-0096681.jpg,2,0,0,0,2,,val
0549550_as-0096681.jpg,2,0,0,0,2,,test
0549553_as-7150140.jpg,0,0,0,1,1,,train
0549554_as-0007313.jpg,1,0,0,1,2,,train
0549557_as-0045591.jpg,1,0,0,1,2,,train
0549558_as-0045591.jpg,1,0,0,0,1,,train
0549559_as-0045591.jpg,0,0,1,0,1,,train
0549560_as-0045591.jpg,3,0,1,0,4,,train
0549561_as-0045591.jpg,1,1,0,0,2,,train
0549562_as-2941564.jpg,2,0,0,0,2,,val
0549563_as-3173570.jpg,1,0,0,1,2,,val
0549564_as-0061118.jpg,3,0,1,0,4,,test
0549565_as-0061118.jpg,1,0,3,0,4,,train
0549566_as-0061118.jpg,1,0,1,1,3,,train
0549567_as-0061118.jpg,2,2,3,1,8,,train
0549568_sc-221625.jpg,1,0,0,0,1,,train
0549569_as-0040641.jpg,3,0,1,0,4,,train
0549570_as-0040641.jpg,4,0,1,1,6,,train
0549571_as-0040641.jpg,5,0,0,1,6,,train
0549572_as-0040641.jpg,3,0,1,0,4,,val
0549573_as-0040641.jpg,0,1,1,0,2,,val
0549575_as-0040641.jpg,1,0,2,0,3,,test
0549576_as-0040641.jpg,3,0,1,0,4,,train
0549577_as-7545604.jpg,1,0,1,0,2,,train
0549578_as-0066654.jpg,2,1,0,0,3,,train
0549579_as-0066654.jpg,2,1,0,0,3,,train
0549580_sc-108600.jpg,1,0,1,1,3,,train
0549581_sc-108600.jpg,1,0,1,1,3,,train
0549582_sc-174541.jpg,1,1,1,0,3,,train
0549583_sc-174541.jpg,1,1,1,0,3,,val
0549584_sc-168564.jpg,1,0,0,1,2,,val
0549585_as-0083289.jpg,1,2,0,0,3,,test
0549586_as-0083289.jpg,2,0,0,0,2,,train
0549587_as-2603520.jpg,1,1,0,1,3,,train
0549588_sc-119399.jpg,0,0,1,0,1,,train
0549589_sc-119399.jpg,0,0,1,0,1,,train
0549590_sc-119399.jpg,0,0,1,0,1,,train
0549591_sc-119399.jpg,1,0,0,0,1,,train
0549592_sc-119399.jpg,1,0,0,0,1,,train
0549593_as-2667282.jpg,1,1,0,0,2,,val
0549594_as-3270225.jpg,1,0,0,0,1,,val
0549598_as-0078906.jpg,3,0,2,0,5,,test
0549599_as-0078906.jpg,2,1,1,0,4,,train
0549600_as-0078906.jpg,0,0,1,0,1,,train
0549601_as-0078906.jpg,0,0,1,0,1,,train
0549603_as-0078906.jpg,4,1,3,0,8,,train
0549604_as-7408883.jpg,2,0,0,1,3,,train
0549605_as-7570060.jpg,0,0,1,1,2,,train
0549606_as-3159916.jpg,11,3,1,2,17,,train
0549608_as-0045621.jpg,1,1,1,0,3,,val
0549609_as-0045621.jpg,1,0,1,0,2,,val
0549610_as-0045621.jpg,2,0,1,1,4,,test
0549611_sc-151224.jpg,1,0,0,1,2,,train
0549612_sc-151224.jpg,2,0,0,0,2,,train
0549613_sc-151224.jpg,2,0,0,0,2,,train
0549614_sc-151224.jpg,1,0,0,0,1,,train
0549616_sc-151224.jpg,1,0,0,1,2,,train
0549617_sc-176475.jpg,2,0,0,0,2,,train
0549618_sc-176475.jpg,6,0,0,0,6,,train
0549619_sc-176475.jpg,2,0,0,0,2,,val
0549621_sc-176475.jpg,2,0,0,0,2,,val
0549622_sc-162458.jpg,2,0,0,0,2,,test
0549623_sc-162458.jpg,2,0,0,0,2,,train
0549624_as-2973060.jpg,5,0,0,0,5,,train
0549625_as-0005713.jpg,1,1,1,1,4,,train
0549630_sc-1029139.jpg,4,0,0,0,4,,train
0549631_sc-1029139.jpg,4,0,0,0,4,,train
0549632_sc-1029139.jpg,3,0,0,0,3,,train
0549634_sc-1035002.jpg,2,0,0,0,2,,train
0549635_sc-1035002.jpg,3,0,1,0,4,,val
0549636_sc-1035002.jpg,0,0,1,0,1,,val
0549637_sc-1035002.jpg,3,0,1,0,4,,test
0549638_sc-1035002.jpg,3,0,0,0,3,,train
0549639_sc-1035002.jpg,3,0,1,1,5,,train
0549640_sc-1035002.jpg,2,0,1,0,3,,train
0549642_sc-1018741.jpg,2,0,1,0,3,,train
0549643_sc-1018741.jpg,0,1,0,0,1,,train
0549644_sc-1018741.jpg,1,0,0,0,1,,train
0549645_sc-1018741.jpg,1,0,0,0,1,,train
0549646_sc-1018741.jpg,2,0,0,0,2,,val
0549647_sc-1018741.jpg,3,0,0,0,3,,val
0549648_sc-165244.jpg,1,2,0,0,3,,test
0549649_as-0030111.jpg,4,0,0,0,4,,train
0549650_as-0067923.jpg,0,1,0,0,1,,train
0549651_as-0067923.jpg,1,0,0,0,1,,train
0549652_sc-207355.jpg,1,0,0,0,1,,train
0549653_sc-207355.jpg,2,0,0,0,2,,train
0549654_as-2604327.jpg,2,0,0,1,3,,train
0549655_sc-164664.jpg,8,0,0,0,8,,train
0549656_sc-164664.jpg,9,0,2,0,11,,val
0549657_sc-195964.jpg,1,0,0,1,2,,val
0549658_sc-195964.jpg,1,0,0,1,2,,test
0549659_sc-195964.jpg,1,0,0,1,2,,train
0549662_as-0058883.jpg,17,4,1,0,22,,train
0549663_as-0058883.jpg,17,3,0,0,20,,train
0549664_as-2875169.jpg,1,0,0,0,1,,train
0549665_as-3377112.jpg,1,0,0,0,1,,train
0549666_sc-148011.jpg,0,0,1,0,1,,train
0549667_sc-148011.jpg,0,0,1,0,1,,train
0549668_sc-148011.jpg,1,0,0,0,1,,val
0549669_sc-148011.jpg,2,0,0,0,2,,val
0549670_sc-148011.jpg,1,0,0,0,1,,test
0549671_sc-148011.jpg,1,0,0,0,1,,train
0549672_as-2870059.jpg,2,0,0,0,2,,train
0549673_as-0045240.jpg,0,0,1,0,1,,train
0549674_as-0045240.jpg,1,0,1,0,2,,train
0549675_as-0045240.jpg,2,0,1,0,3,,train
0549676_as-0045240.jpg,2,0,1,0,3,,train
0549677_as-0045240.jpg,2,0,0,0,2,,train
0549678_as-0045240.jpg,1,0,1,0,2,,val
0549679_as-0045240.jpg,1,0,2,1,4,,val
0549680_as-0045240.jpg,2,0,1,2,5,,test
0549681_as-0045240.jpg,2,1,0,0,3,,train
0549682_as-3182271.jpg,1,0,0,0,1,,train
0549683_sc-196616.jpg,3,0,0,0,3,,train
0549684_sc-196616.jpg,0,0,1,0,1,,train
0549685_sc-196616.jpg,1,0,0,0,1,,train
0549686_sc-196616.jpg,1,0,0,0,1,,train
0549687_sc-196616.jpg,1,0,0,0,1,,train
0549688_sc-196616.jpg,1,0,0,0,1,,val
0549691_sc-1009596.jpg,2,1,2,0,5,,val
0549693_sc-130566.jpg,3,0,0,0,3,,test
0549694_sc-1012660.jpg,1,0,1,1,3,,train
0549695_sc-1012660.jpg,1,0,1,1,3,,train
0549696_as-2523558.jpg,1,0,0,0,1,,train
0549697_as-0061894.jpg,1,1,0,0,2,,train
0549698_as-0061894.jpg,1,1,0,0,2,,train
0549699_as-0061894.jpg,2,0,0,1,3,,train
0549700_as-0061894.jpg,1,0,0,0,1,,train
0549701_as-0061894.jpg,2,0,0,0,2,,val
0549702_as-0045685.jpg,1,1,1,0,3,,val
0549703_as-0045685.jpg,1,1,1,0,3,,test
0549704_sc-159121.jpg,1,0,0,0,1,,train
0549705_sc-202905.jpg,5,1,1,0,7,,train
0549706_sc-202905.jpg,2,0,1,0,3,,train
0549707_sc-202905.jpg,1,0,1,0,2,,train
0549709_as-0012036.jpg,1,0,0,0,1,,train
0549710_as-0012036.jpg,0,0,1,0,1,,train
0549711_sc-194654.jpg,2,0,2,0,4,,train
0549712_sc-194654.jpg,3,0,1,0,4,,val
0549713_sc-194654.jpg,3,0,1,0,4,,val
0549714_sc-194654.jpg,1,0,0,0,1,,test
0549715_sc-194654.jpg,2,0,2,1,5,,train
0549716_sc-194654.jpg,3,0,0,0,3,,train
0549717_sc-194654.jpg,2,0,0,0,2,,train
0549718_sc-194654.jpg,3,0,0,0,3,,train
0549719_sc-194654.jpg,5,0,0,0,5,,train
0549721_sc-194654.jpg,3,0,1,1,5,,train
0549722_sc-194654.jpg,1,0,1,1,3,,train
0549723_sc-194654.jpg,1,0,1,0,2,,val
0549724_sc-194654.jpg,2,0,0,0,2,,val
0549725_sc-194654.jpg,1,0,0,0,1,,test
0549726_sc-194654.jpg,2,0,0,0,2,,train
0549727_sc-194654.jpg,1,1,0,0,2,,train
0549728_sc-194654.jpg,2,0,1,0,3,,train
0549729_sc-194654.jpg,1,0,1,0,2,,train
0549730_sc-194654.jpg,3,0,0,0,3,,train
0549731_sc-194654.jpg,2,0,0,0,2,,train
0549732_sc-194654.jpg,3,0,0,0,3,,train
0549733_sc-194654.jpg,3,0,0,0,3,,val
0549734_sc-194654.jpg,3,0,0,0,3,,val
0549735_sc-227997.jpg,5,0,1,1,7,,test
0549737_as-2632196.jpg,0,0,1,0,1,,train
0549739_sc-149276.jpg,3,0,0,0,3,,train
0549740_sc-149276.jpg,3,0,0,0,3,,train
0549742_sc-202880.jpg,0,1,0,0,1,,train
0549743_as-3145882.jpg,0,0,1,0,1,,train
0549745_as-0078635.jpg,1,0,0,0,1,,train
0549746_sc-220997.jpg,8,0,2,0,10,,train
0549747_sc-220997.jpg,3,1,1,0,5,,val
0549748_sc-220997.jpg,7,0,2,0,9,,val
0549749_sc-220997.jpg,5,0,2,0,7,,test
0549750_sc-220997.jpg,1,0,0,0,1,,train
0549751_sc-220997.jpg,0,1,0,0,1,,train
0549752_sc-220997.jpg,0,1,1,1,3,,train
0549753_sc-220997.jpg,0,0,1,0,1,,train
0549758_as-0058237.jpg,0,0,1,0,1,,train
0549760_as-0078562.jpg,2,1,3,2,8,,train
0549763_as-0078562.jpg,3,0,1,0,4,,train
0549764_as-0078562.jpg,4,2,3,0,9,,val
0549765_as-0018367.jpg,1,0,1,0,2,,val
0549766_as-0018367.jpg,1,0,1,0,2,,test
0549767_as-0018367.jpg,1,0,1,0,2,,train
0549769_as-0069495.jpg,1,0,1,0,2,,train
0549770_as-0069495.jpg,2,0,0,0,2,,train
0549771_as-0069495.jpg,2,0,0,0,2,,train
0549772_as-0069495.jpg,2,0,0,0,2,,train
0549773_as-0069495.jpg,7,0,0,0,7,,train
0549774_as-3490092.jpg,3,0,0,1,4,,train
0549775_sc-203147.jpg,2,0,0,0,2,,val
0549776_as-0087001.jpg,3,0,0,0,3,,val
0549777_as-0087001.jpg,1,0,0,0,1,,test
0549778_as-0087001.jpg,1,0,0,0,1,,train
0549779_as-0087001.jpg,1,0,0,0,1,,train
0549780_as-0087001.jpg,1,0,0,0,1,,train
0549781_as-0087001.jpg,1,0,2,0,3,,train
0549782_sc-119351.jpg,1,0,0,0,1,,train
0549783_sc-119351.jpg,1,0,0,0,1,,train
0549785_sc-119351.jpg,1,0,0,0,1,,train
0549786_sc-143614.jpg,3,0,1,1,5,,val
0549787_sc-143614.jpg,1,0,2,0,3,,val
0549788_sc-143614.jpg,1,0,1,1,3,,test
0549789_sc-143614.jpg,1,0,1,1,3,,train
0549790_sc-143614.jpg,1,0,1,1,3,,train
0549793_as-3318211.jpg,2,0,1,0,3,,train
0549795_sc-1020412.jpg,3,4,0,0,7,,train
0549796_sc-1020412.jpg,0,1,1,0,2,,train
0549797_sc-1020412.jpg,2,1,0,1,4,,train
0549798_sc-1015521.jpg,0,0,1,1,2,,train
0549799_sc-1015521.jpg,2,2,0,1,5,,val
0549800_sc-1015521.jpg,2,0,0,0,2,,val
0549801_sc-1015521.jpg,1,2,0,0,3,,test
0549802_sc-1015521.jpg,6,0,1,0,7,,train
0549803_sc-1015521.jpg,2,1,1,0,4,,train
0549804_sc-1015521.jpg,0,0,1,0,1,,train
0549805_as-3207367.jpg,1,0,1,0,2,,train
0549806_sc-1018499.jpg,1,0,0,0,1,,train
0549807_sc-1018499.jpg,1,0,0,0,1,,train
0549808_sc-1018499.jpg,1,0,0,0,1,,train
0549809_sc-214102.jpg,2,0,0,0,2,,val
0549810_as-0085756.jpg,1,0,0,0,1,,val
0549811_as-3310061.jpg,3,1,0,0,4,,test
0549813_sc-137836.jpg,1,0,1,0,2,,train
0549815_sc-137836.jpg,1,0,1,0,2,,train
0549816_sc-137836.jpg,1,0,0,0,1,,train
0549817_sc-137836.jpg,1,1,0,0,2,,train
0549818_sc-199297.jpg,7,0,1,2,10,,train
0549819_sc-199297.jpg,1,0,1,1,3,,train
0549820_sc-199297.jpg,5,0,0,1,6,,train
0549821_sc-199297.jpg,2,0,1,1,4,,val
0549822_sc-199297.jpg,2,1,1,1,5,,val
0549823_sc-199297.jpg,1,1,0,1,3,,test
0549824_as-3484422.jpg,3,0,1,0,4,,train
0549825_sc-165544.jpg,0,1,0,0,1,,train
0549827_sc-161335.jpg,0,0,0,1,1,,train
0549828_sc-161335.jpg,0,0,0,1,1,,train
0549829_sc-161335.jpg,0,0,0,1,1,,train
0549830_sc-161335.jpg,0,0,0,1,1,,train
0549833_as-0081270.jpg,7,1,3,1,12,,train
0549835_as-0059122.jpg,1,0,0,0,1,,val
0549836_as-0059122.jpg,4,0,0,0,4,,val
0549837_as-0059122.jpg,2,0,0,1,3,,test
0549838_as-0059122.jpg,3,0,0,0,3,,train
0549839_as-0059122.jpg,3,0,0,0,3,,train
0549840_as-0059122.jpg,2,0,0,0,2,,train
0549841_as-0059122.jpg,2,0,0,0,2,,train
0549843_as-0059122.jpg,1,0,0,0,1,,train
0549844_as-0059122.jpg,0,3,0,0,3,,train
0549845_sc-1015312.jpg,3,0,0,0,3,,train
0549846_sc-1015312.jpg,0,0,1,0,1,,val
0549847_sc-1015312.jpg,2,1,1,0,4,,val
0549848_sc-208662.jpg,1,0,0,0,1,,test
0549849_sc-208662.jpg,4,0,1,1,6,,train
0549850_sc-208662.jpg,1,0,1,1,3,,train
0549851_sc-208662.jpg,1,0,0,0,1,,train
0549852_sc-208662.jpg,1,0,0,0,1,,train
0549853_sc-164880.jpg,3,0,0,0,3,,train
0549854_sc-164880.jpg,1,0,0,0,1,,train
0549855_sc-164880.jpg,3,0,0,0,3,,train
0549856_sc-164880.jpg,1,1,0,0,2,,val
0549857_sc-164880.jpg,1,0,0,0,1,,val
0549858_sc-164880.jpg,1,0,0,0,1,,test
0549859_as-2605559.jpg,2,0,0,0,2,,train
0549860_sc-221087.jpg,1,1,2,1,5,,train
0549861_sc-223238.jpg,1,1,0,1,3,,train
0549862_sc-223238.jpg,1,0,0,1,2,,train
0549863_sc-223238.jpg,1,0,0,1,2,,train
0549864_sc-1040093.jpg,2,0,0,0,2,,train
0549865_sc-184948.jpg,1,0,0,0,1,,train
0549866_sc-141468.jpg,3,0,0,0,3,,val
0549867_sc-141468.jpg,5,0,1,0,6,,val
0549868_sc-141468.jpg,3,0,2,0,5,,test
0549869_sc-141468.jpg,2,0,1,0,3,,train
0549870_sc-141468.jpg,1,0,1,1,3,,train
0549871_sc-141468.jpg,3,0,0,0,3,,train
0549872_sc-141468.jpg,3,0,0,0,3,,train
0549875_as-0072745.jpg,0,1,2,2,5,,train
0549876_as-0072745.jpg,0,1,0,0,1,,train
0549877_as-0072745.jpg,0,1,0,1,2,,train
0549878_as-0072745.jpg,1,1,1,2,5,,val
0549879_as-0072745.jpg,0,1,0,0,1,,val
0549880_as-0072745.jpg,2,2,0,1,5,,test
0549881_sc-1002127.jpg,1,0,0,0,1,,train
0549883_sc-152307.jpg,7,1,0,0,8,,train
0549884_sc-152307.jpg,12,0,0,0,12,,train
0549885_sc-152307.jpg,10,0,0,0,10,,train
0549886_sc-152307.jpg,6,0,0,0,6,,train
0549888_as-0094752.jpg,3,0,1,0,4,,train
0549889_as-0094752.jpg,3,0,0,0,3,,train
0549890_as-0094752.jpg,3,0,1,0,4,,val
0549891_as-0094752.jpg,1,0,1,0,2,,val
0549892_as-0094752.jpg,1,0,1,0,2,,test
0549893_as-0094752.jpg,1,0,1,0,2,,train
0549895_as-2611754.jpg,0,0,1,0,1,,train
0549896_sc-134169.jpg,1,0,0,1,2,,train
0549897_sc-134169.jpg,2,0,0,1,3,,train
0549898_sc-134169.jpg,1,0,0,1,2,,train
0549899_as-2774925.jpg,3,0,0,0,3,,train
0549900_as-2673206.jpg,3,1,0,0,4,,train
0549901_as-3280787.jpg,1,0,1,0,2,,val
0549902_as-0002373.jpg,2,1,0,0,3,,val
0549903_as-0002373.jpg,2,0,0,0,2,,test
0549904_as-0096646.jpg,4,0,0,0,4,,train
0549905_as-0096646.jpg,1,0,0,0,1,,train
0549906_as-0096646.jpg,3,0,1,0,4,,train
0549908_as-0070321.jpg,1,0,2,1,4,,train
0549910_as-0070321.jpg,0,0,1,0,1,,train
0549911_as-0070321.jpg,1,0,1,1,3,,train
0549912_as-0070321.jpg,3,0,1,0,4,,train
0549913_sc-159348.jpg,1,0,0,0,1,,val
0549914_sc-159348.jpg,3,0,0,0,3,,val
0549915_sc-159348.jpg,2,0,0,0,2,,test
0549916_sc-159348.jpg,2,0,0,0,2,,train
0549917_sc-159348.jpg,2,0,0,0,2,,train
0549918_sc-225960.jpg,2,1,0,0,3,,train
0549919_as-2521892.jpg,1,1,0,0,2,,train
0549920_sc-223205.jpg,1,1,2,0,4,,train
0549921_sc-223205.jpg,1,0,1,0,2,,train
0549922_sc-223205.jpg,1,0,1,0,2,,train
0549923_sc-192599.jpg,0,1,0,0,1,,val
0549926_as-0071846.jpg,1,0,1,0,2,,val
0549927_as-0071846.jpg,1,0,1,1,3,,test
0549928_as-0071846.jpg,1,0,2,1,4,,train
0549930_sc-186935.jpg,1,0,0,1,2,,train
0549931_sc-186935.jpg,1,0,0,1,2,,train
0549932_sc-186935.jpg,1,0,1,1,3,,train
0549933_sc-186935.jpg,1,0,1,1,3,,train
0549934_sc-186935.jpg,2,0,0,0,2,,train
0549935_sc-186935.jpg,2,0,0,0,2,,train
0549936_sc-186935.jpg,1,0,0,0,1,,val
0549937_sc-186935.jpg,1,0,1,1,3,,val
0549940_as-0041349.jpg,2,0,0,0,2,,test
0549941_as-0041349.jpg,2,0,0,1,3,,train
0549942_as-0041349.jpg,3,0,0,0,3,,train
0549943_as-0041349.jpg,1,0,0,0,1,,train
0549945_as-0046434.jpg,4,0,0,0,4,,train
0549946_as-0046434.jpg,7,0,0,1,8,,train
0549947_as-0046434.jpg,5,0,0,0,5,,train
0549948_as-0046434.jpg,0,0,0,12,12,,train
0549949_as-0046434.jpg,4,0,0,0,4,,val
0549950_as-0046434.jpg,3,0,0,0,3,,val
0549951_as-0046434.jpg,1,0,0,0,1,,test
0549952_as-0046434.jpg,1,0,0,0,1,,train
0549953_as-0046434.jpg,1,0,0,0,1,,train
0549954_as-3311187.jpg,2,0,0,0,2,,train
0549958_as-0058320.jpg,1,0,1,1,3,,train
0549959_as-0014036.jpg,1,0,0,0,1,,train
0549960_as-0014036.jpg,1,0,0,0,1,,train
0549962_sc-131690.jpg,1,1,0,0,2,,train
0549963_sc-131690.jpg,2,0,0,0,2,,val
0549965_sc-1041691.jpg,0,2,0,0,2,,val
0549966_sc-1041691.jpg,2,1,2,0,5,,test
0549967_sc-1041691.jpg,1,1,2,0,4,,train
0549968_sc-142464.jpg,1,0,0,0,1,,train
0549970_sc-142464.jpg,1,0,0,0,1,,train
0549972_sc-142464.jpg,1,0,0,0,1,,train
0549973_sc-142464.jpg,2,0,0,0,2,,train
0549974_sc-142464.jpg,3,0,0,0,3,,train
0549975_sc-142464.jpg,3,0,0,0,3,,train
0549976_sc-142464.jpg,2,0,0,0,2,,val
0549977_sc-142464.jpg,4,0,0,0,4,,val
0549978_sc-142464.jpg,5,0,0,0,5,,test
0549979_sc-142464.jpg,4,0,0,0,4,,train
0549980_sc-142464.jpg,2,0,0,0,2,,train
0549981_sc-142464.jpg,2,0,0,0,2,,train
0549983_as-3298794.jpg,3,0,0,0,3,,train
0549984_as-3282242.jpg,0,0,2,2,4,,train
0549985_as-0037257.jpg,0,0,0,1,1,,train
0549986_as-0037257.jpg,0,0,0,1,1,,train
0549987_as-0037257.jpg,0,0,1,0,1,,val
0549988_as-0086262.jpg,8,0,0,0,8,,val
0549989_as-0086262.jpg,9,0,0,0,9,,test
0549990_as-0086262.jpg,7,0,0,0,7,,train
0549991_as-0086262.jpg,2,0,1,0,3,,train
0549993_as-2532446.jpg,0,1,1,0,2,,train
0549994_as-0079884.jpg,4,1,2,3,10,,train
0549995_as-2812612.jpg,0,2,0,1,3,,train
0549996_as-3337150.jpg,1,0,0,0,1,,train
0549997_as-3179260.jpg,4,0,1,1,6,,train
0549998_as-2675425.jpg,2,0,1,1,4,,val
0549999_as-7958614.jpg,2,0,1,0,3,,val
0550000_as-0094424.jpg,1,0,0,0,1,,test
0550001_as-0094424.jpg,0,0,1,0,1,,train
0550002_as-0094424.jpg,1,0,0,0,1,,train
0550003_as-0094424.jpg,1,0,0,0,1,,train
0550004_as-0094424.jpg,0,0,1,0,1,,train
0550006_sc-1001585.jpg,2,0,1,0,3,,train
0550008_sc-1001585.jpg,2,0,0,0,2,,train
0550009_sc-140999.jpg,1,0,1,0,2,,train
0550010_sc-140999.jpg,3,1,1,0,5,,val
0550011_sc-140999.jpg,4,3,1,1,9,,val
0550013_sc-140999.jpg,1,0,1,1,3,,test
0550014_sc-140999.jpg,4,1,0,0,5,,train
0550015_sc-140999.jpg,2,3,1,1,7,,train
0550016_sc-140999.jpg,1,0,1,1,3,,train
0550018_sc-140999.jpg,1,0,0,0,1,,train
0550020_sc-140999.jpg,1,0,0,0,1,,train
0550021_sc-116352.jpg,1,0,0,0,1,,train
0550022_sc-116352.jpg,6,0,0,0,6,,train
0550023_sc-116352.jpg,5,0,0,0,5,,val
0550024_sc-212067.jpg,4,0,0,1,5,,val
0550026_sc-1006111.jpg,1,0,0,0,1,,test
0550027_sc-1006111.jpg,1,1,0,1,3,,train
0550028_sc-1006111.jpg,1,1,0,1,3,,train
0550029_sc-1006111.jpg,2,0,0,0,2,,train
0550030_sc-1006111.jpg,1,1,0,1,3,,train
0550031_sc-1006111.jpg,1,0,0,0,1,,train
0550032_sc-1006111.jpg,1,0,0,0,1,,train
0550036_as-0064293.jpg,1,1,1,0,3,,train
0550037_as-0064293.jpg,2,1,1,0,4,,val
0550038_as-0064293.jpg,3,1,1,0,5,,val
0550039_sc-122841.jpg,1,0,0,1,2,,test
0550040_sc-122841.jpg,3,0,0,0,3,,train
0550041_sc-122841.jpg,2,0,0,0,2,,train
0550044_as-2597911.jpg,2,0,1,1,4,,train
0550045_sc-162771.jpg,3,0,1,1,5,,train
0550046_sc-162771.jpg,3,0,3,0,6,,train
0550047_sc-162771.jpg,5,0,0,0,5,,train
0550048_sc-162771.jpg,1,0,0,0,1,,train
0550049_as-0028109.jpg,1,0,0,0,1,,val
0550050_as-0028109.jpg,2,0,0,0,2,,val
0550051_as-0028109.jpg,2,0,0,0,2,,test
0550052_as-2798193.jpg,2,0,2,1,5,,train
0550053_sc-1039830.jpg,1,0,1,1,3,,train
0550054_sc-1039830.jpg,0,0,2,2,4,,train
0550057_as-3010927.jpg,1,0,0,0,1,,train
0550058_sc-203424.jpg,2,1,1,0,4,,train
0550059_sc-203424.jpg,0,0,1,0,1,,train
0550061_sc-152946.jpg,2,0,0,1,3,,train
0550062_sc-130897.jpg,3,0,0,0,3,,val
0550063_sc-130897.jpg,4,0,0,0,4,,val
0550064_as-3289529.jpg,1,2,1,3,7,,test
0550065_as-0081874.jpg,1,0,0,0,1,,train
0550066_as-0081874.jpg,1,0,0,0,1,,train
0550067_as-0081874.jpg,2,0,0,0,2,,train
0550068_sc-201967.jpg,2,1,2,0,5,,train
0550069_sc-201967.jpg,1,1,2,0,4,,train
0550070_sc-201967.jpg,1,0,0,0,1,,train
0550071_sc-208373.jpg,3,0,0,0,3,,train
0550072_sc-208373.jpg,2,0,0,0,2,,val
0550073_as-2643077.jpg,1,0,1,0,2,,val
0550074_sc-123061.jpg,2,0,0,1,3,,test
0550076_sc-123061.jpg,5,0,0,1,6,,train
0550077_sc-123061.jpg,3,0,0,1,4,,train
0550078_as-0004075.jpg,1,0,0,0,1,,train
0550079_as-2945310.jpg,1,0,0,1,2,,train
0550080_as-3324344.jpg,2,0,0,0,2,,train
0550081_as-0037435.jpg,1,0,0,0,1,,train
0550082_as-0037435.jpg,1,0,0,0,1,,train
0550083_as-0037435.jpg,1,0,0,0,1,,val
0550086_as-3479918.jpg,1,0,0,0,1,,val
0550087_sc-1030732.jpg,4,0,4,0,8,,test
0550088_sc-1030732.jpg,2,0,1,1,4,,train
0550089_sc-1030732.jpg,5,0,2,0,7,,train
0550090_sc-1030732.jpg,3,0,1,0,4,,train
0550092_sc-112248.jpg,1,0,0,1,2,,train
0550093_sc-112248.jpg,2,0,0,0,2,,train
0550094_sc-112248.jpg,2,0,1,0,3,,train
0550095_sc-112248.jpg,2,0,0,0,2,,train
0550096_sc-112248.jpg,3,0,1,0,4,,val
0550097_as-2758633.jpg,1,0,0,0,1,,val
0550099_as-3128749.jpg,2,1,1,2,6,,test
0550100_as-0035708.jpg,4,0,2,1,7,,train
0550101_as-0035708.jpg,2,0,2,2,6,,train
0550104_as-0026403.jpg,1,1,0,0,2,,train
0550105_as-0028265.jpg,0,2,2,0,4,,train
0550106_as-0028265.jpg,0,1,0,1,2,,train
0550107_as-0028265.jpg,0,1,0,0,1,,train
0550108_as-0028265.jpg,1,0,0,0,1,,train
0550110_as-0075930.jpg,4,0,1,0,5,,val
0550111_as-0075930.jpg,1,0,1,0,2,,val
0550112_as-0075930.jpg,1,1,1,0,3,,test
0550114_as-2673150.jpg,1,0,1,1,3,,train
0550115_as-7260045.jpg,5,0,0,0,5,,train
0550116_as-7003710.jpg,2,0,0,0,2,,train
0550117_sc-1022859.jpg,1,0,0,1,2,,train
0550118_sc-1022859.jpg,1,0,0,1,2,,train
0550119_sc-1022859.jpg,2,0,0,1,3,,train
0550120_as-7973324.jpg,4,1,1,0,6,,train
0550122_as-0018872.jpg,1,0,0,0,1,,val
0550123_as-0018872.jpg,2,0,1,1,4,,val
0550126_as-7488330.jpg,2,0,1,1,4,,test
0550128_as-0074450.jpg,1,0,1,0,2,,train
0550129_as-0074450.jpg,1,0,0,0,1,,train
0550130_as-0074450.jpg,1,0,0,0,1,,train
0550131_as-0074450.jpg,2,0,0,0,2,,train
0550132_as-0074450.jpg,1,1,1,1,4,,train
0550133_as-0074450.jpg,0,4,1,1,6,,train
0550134_as-0074450.jpg,1,0,0,0,1,,train
0550135_as-0074450.jpg,1,0,0,0,1,,val
0550136_as-0074450.jpg,1,0,0,0,1,,val
0550137_as-0074450.jpg,1,0,0,0,1,,test
0550138_as-3418446.jpg,2,3,2,2,9,,train
0550139_sc-185334.jpg,2,0,0,1,3,,train
0550140_sc-185334.jpg,2,0,0,1,3,,train
0550141_sc-185334.jpg,1,0,0,0,1,,train
0550142_sc-185334.jpg,1,0,0,1,2,,train
0550143_sc-185334.jpg,2,0,0,1,3,,train
0550144_sc-185334.jpg,2,0,0,1,3,,train
0550145_sc-185334.jpg,1,0,0,0,1,,val
0550147_sc-228387.jpg,11,0,0,0,11,,val
0550148_sc-228387.jpg,17,0,0,0,17,,test
0550149_sc-228387.jpg,20,0,0,0,20,,train
0550155_as-0017847.jpg,2,1,0,0,3,,train
0550156_as-0017847.jpg,1,3,0,0,4,,train
0550157_as-0017847.jpg,1,0,1,1,3,,train
0550158_as-0017847.jpg,0,1,1,0,2,,train
0550159_as-0017847.jpg,0,1,1,0,2,,train
0550160_as-0017847.jpg,0,3,1,0,4,,train
0550161_as-0017847.jpg,1,0,0,0,1,,val
0550162_as-0010769.jpg,0,0,2,1,3,,val
0550163_sc-1034479.jpg,6,1,0,1,8,,test
0550164_sc-1034479.jpg,11,0,0,1,12,,train
0550166_sc-1034479.jpg,11,1,0,0,12,,train
0550167_sc-1034479.jpg,10,1,0,1,12,,train
0550169_sc-1009269.jpg,0,0,1,0,1,,train
0550170_sc-1009269.jpg,0,0,1,0,1,,train
0550172_sc-198656.jpg,2,2,0,0,4,,train
0550173_sc-212927.jpg,6,0,0,1,7,,train
0550174_sc-212927.jpg,6,0,0,1,7,,val
0550175_sc-212927.jpg,9,0,2,0,11,,val
0550177_as-0013031.jpg,2,0,0,0,2,,test
0550178_as-0076818.jpg,0,2,0,0,2,,train
0550179_as-0076818.jpg,0,1,0,0,1,,train
0550180_sc-133095.jpg,1,1,0,0,2,,train
0550181_sc-133095.jpg,3,0,0,0,3,,train
0550182_sc-133095.jpg,1,0,0,0,1,,train
0550183_as-3405586.jpg,3,1,0,0,4,,train
0550184_as-2754697.jpg,1,0,0,0,1,,train
0550185_as-3293442.jpg,6,0,1,1,8,,val
0550186_sc-174500.jpg,0,2,0,0,2,,val
0550187_sc-221615.jpg,2,0,0,0,2,,test
0550188_as-3002861.jpg,2,0,0,0,2,,train
0550189_as-0054409.jpg,1,0,0,0,1,,train
0550191_sc-154821.jpg,2,0,0,1,3,,train
0550192_sc-154821.jpg,2,0,0,1,3,,train
0550193_sc-154821.jpg,1,0,0,1,2,,train
0550194_sc-154821.jpg,2,0,1,1,4,,train
0550196_sc-154821.jpg,3,0,0,1,4,,train
0550197_sc-154821.jpg,1,0,0,1,2,,val
0550198_sc-154821.jpg,1,0,0,1,2,,val
0550199_sc-154821.jpg,3,1,0,0,4,,test
0550200_as-3329501.jpg,2,0,0,0,2,,train
0550201_as-2515150.jpg,3,0,1,2,6,,train
0550202_sc-225261.jpg,2,0,0,0,2,,train
0550203_as-7702489.jpg,6,0,0,0,6,,train
0550204_sc-1011314.jpg,7,0,1,1,9,,train
0550205_as-3451791.jpg,0,0,1,0,1,,train
0550208_sc-214115.jpg,1,0,0,0,1,,train
0550209_sc-214115.jpg,2,0,1,0,3,,val
0550210_sc-214115.jpg,1,0,1,0,2,,val
0550211_sc-214115.jpg,3,0,0,0,3,,test
0550212_sc-214115.jpg,1,0,0,0,1,,train
0550213_sc-214115.jpg,0,0,1,0,1,,train
0550214_sc-214115.jpg,1,0,1,0,2,,train
0550215_sc-214115.jpg,0,0,1,0,1,,train
0550216_sc-214115.jpg,1,0,0,0,1,,train
0550217_sc-214115.jpg,1,0,1,0,2,,train
0550218_sc-214115.jpg,1,0,1,0,2,,train
0550219_sc-214115.jpg,1,0,1,0,2,,val
0550220_as-0093032.jpg,3,0,0,0,3,,val
0550221_as-0093032.jpg,1,0,0,0,1,,test
0550222_as-2566327.jpg,0,0,0,1,1,,train
0550223_as-0063561.jpg,1,0,0,0,1,,train
0550224_as-0063561.jpg,1,0,0,0,1,,train
0550225_as-3251177.jpg,1,0,0,0,1,,train
0550226_as-7946318.jpg,0,2,1,1,4,,train
0550227_sc-223913.jpg,3,0,0,0,3,,train
0550228_sc-223913.jpg,3,0,0,0,3,,train
0550229_sc-223913.jpg,2,0,1,1,4,,val
0550230_sc-223913.jpg,2,0,0,0,2,,val
0550231_sc-223913.jpg,1,0,0,0,1,,test
0550232_sc-223913.jpg,1,0,0,0,1,,train
0550233_sc-223913.jpg,1,0,1,1,3,,train
0550234_as-0028543.jpg,1,0,0,0,1,,train
0550235_as-0028543.jpg,1,0,0,0,1,,train
0550236_as-0028543.jpg,1,0,0,0,1,,train
0550237_as-0028543.jpg,0,1,0,0,1,,train
0550238_as-0028543.jpg,1,1,1,0,3,,train
0550240_as-0028543.jpg,2,1,0,0,3,,val
0550243_sc-197097.jpg,2,0,1,1,4,,val
0550244_sc-197097.jpg,7,1,1,2,11,,test
0550245_sc-197097.jpg,3,0,1,2,6,,train
0550246_sc-197097.jpg,1,0,0,1,2,,train
0550247_sc-197097.jpg,4,0,1,2,7,,train
0550248_sc-190158.jpg,1,1,1,0,3,,train
0550249_sc-190158.jpg,0,1,1,1,3,,train
0550251_as-7336837.jpg,5,0,1,0,6,,train
0550252_as-2799197.jpg,2,0,1,0,3,,train
0550253_sc-229186.jpg,2,3,1,0,6,,val
0550254_sc-229186.jpg,2,3,1,0,6,,val
0550255_sc-229186.jpg,2,4,1,0,7,,test
0550256_sc-130989.jpg,2,0,0,0,2,,train
0550257_sc-130989.jpg,2,0,0,0,2,,train
0550258_as-0033199.jpg,1,0,0,0,1,,train
0550259_as-0033199.jpg,2,0,0,0,2,,train
0550260_as-0033199.jpg,1,0,0,0,1,,train
0550261_as-0033199.jpg,1,0,0,0,1,,train
0550262_sc-206139.jpg,4,0,3,2,9,,train
0550263_sc-206139.jpg,5,1,2,0,8,,val
0550264_sc-218645.jpg,0,1,0,0,1,,val
0550265_sc-218645.jpg,0,1,0,0,1,,test
0550266_sc-1013217.jpg,1,0,0,0,1,,train
0550267_sc-1013217.jpg,1,0,0,0,1,,train
0550269_as-3396604.jpg,4,0,2,1,7,,train
0550271_sc-179282.jpg,1,0,1,1,3,,train
0550272_sc-179282.jpg,1,0,1,1,3,,train
0550273_sc-179282.jpg,1,0,1,1,3,,train
0550274_sc-179282.jpg,1,0,1,1,3,,train
0550275_sc-179282.jpg,1,0,1,1,3,,val
0550276_sc-179282.jpg,1,0,1,1,3,,val
0550277_sc-198965.jpg,1,0,0,0,1,,test
0550279_sc-198965.jpg,1,0,0,0,1,,train
0550280_sc-198965.jpg,2,0,0,0,2,,train
0550281_sc-198965.jpg,2,0,0,0,2,,train
0550282_sc-198965.jpg,1,0,1,0,2,,train
0550283_as-2922323.jpg,1,0,2,1,4,,train
0550284_sc-187372.jpg,0,1,0,0,1,,train
0550285_as-2520897.jpg,1,0,0,1,2,,train
0550286_as-0023441.jpg,1,2,0,0,3,,val
0550287_as-2797628.jpg,1,0,0,0,1,,val
0550288_as-0095308.jpg,1,0,2,1,4,,test
0550289_as-0095308.jpg,1,0,0,0,1,,train
0550290_as-0095308.jpg,1,0,1,1,3,,train
0550291_sc-157591.jpg,0,2,0,0,2,,train
0550293_sc-1041505.jpg,2,0,2,1,5,,train
0550294_sc-1041505.jpg,4,0,2,1,7,,train
0550295_sc-1041505.jpg,4,0,1,1,6,,train
0550296_as-2547371.jpg,1,0,0,0,1,,train
0550297_as-2942997.jpg,3,1,1,0,5,,val
0550298_as-7904847.jpg,1,0,1,0,2,,val
0550299_sc-225014.jpg,2,0,1,0,3,,test
0550300_sc-225014.jpg,4,0,1,0,5,,train
0550301_sc-225014.jpg,1,0,1,0,2,,train
0550302_sc-225014.jpg,3,0,0,0,3,,train
0550303_sc-225014.jpg,3,0,0,0,3,,train
0550304_as-0080983.jpg,2,1,0,0,3,,train
0550305_as-0080983.jpg,3,1,0,0,4,,train
0550306_as-7759423.jpg,2,0,0,0,2,,train
0550308_as-0036781.jpg,1,2,3,0,6,,val
0550309_as-0036781.jpg,2,1,0,0,3,,val
0550310_as-0036781.jpg,3,0,2,0,5,,test
0550311_as-0036781.jpg,1,1,1,0,3,,train
0550312_sc-112726.jpg,2,1,1,1,5,,train
0550313_sc-112726.jpg,1,1,0,1,3,,train
0550315_sc-112726.jpg,1,1,1,1,4,,train
0550316_as-0071368.jpg,2,0,0,0,2,,train
0550317_as-0071368.jpg,4,1,0,0,5,,train
0550318_as-0071368.jpg,4,0,0,0,4,,train
0550319_as-0071368.jpg,5,0,0,0,5,,val
0550320_as-0046525.jpg,1,0,0,0,1,,val
0550324_as-0039364.jpg,0,0,1,0,1,,test
0550325_as-0039364.jpg,0,0,1,0,1,,train
0550326_as-0039364.jpg,0,1,1,1,3,,train
0550327_as-0065474.jpg,1,0,0,1,2,,train
0550328_as-0065474.jpg,1,1,0,1,3,,train
0550329_as-0065474.jpg,1,0,0,1,2,,train
0550330_as-0065474.jpg,1,0,0,0,1,,train
0550331_as-0065474.jpg,1,0,0,0,1,,train
0550332_as-0065474.jpg,1,0,0,0,1,,val
0550333_as-0065474.jpg,1,0,0,0,1,,val
0550334_sc-211191.jpg,1,1,2,1,5,,test
0550335_sc-211191.jpg,0,0,1,1,2,,train
0550336_sc-211191.jpg,1,1,1,0,3,,train
0550337_sc-211191.jpg,2,1,1,0,4,,train
0550338_sc-211191.jpg,1,1,1,0,3,,train
0550339_sc-211191.jpg,0,0,1,0,1,,train
0550340_sc-211191.jpg,0,0,1,0,1,,train
0550341_sc-211191.jpg,0,0,1,0,1,,train
0550342_sc-211191.jpg,0,0,1,0,1,,val
0550343_sc-211191.jpg,0,0,2,0,2,,val
0550344_sc-211191.jpg,0,0,1,0,1,,test
0550345_sc-211191.jpg,0,0,1,0,1,,train
0550346_as-0046960.jpg,1,0,0,0,1,,train
0550347_as-0046960.jpg,0,0,1,1,2,,train
0550348_as-0046960.jpg,1,0,1,2,4,,train
0550349_as-0046960.jpg,1,0,1,2,4,,train
0550350_as-0046960.jpg,3,0,0,0,3,,train
0550351_as-0046960.jpg,2,3,0,0,5,,train
0550352_as-0046960.jpg,0,3,0,0,3,,val
0550353_as-0046960.jpg,0,4,0,0,4,,val
0550357_as-0049768.jpg,8,0,2,1,11,,test
0550358_as-0049768.jpg,3,0,1,1,5,,train
0550359_as-0049768.jpg,4,1,1,0,6,,train
0550360_as-0079115.jpg,1,0,1,0,2,,train
0550361_as-0079115.jpg,1,0,1,1,3,,train
0550362_sc-181891.jpg,2,0,0,0,2,,train
0550363_sc-209348.jpg,4,0,0,0,4,,train
0550364_sc-209348.jpg,5,0,1,0,6,,train
0550366_sc-209348.jpg,1,0,1,0,2,,val
0550367_sc-209348.jpg,2,0,0,0,2,,val
0550368_sc-209348.jpg,3,0,0,0,3,,test
0550369_sc-1036394.jpg,2,0,1,0,3,,train
0550370_sc-132200.jpg,3,0,0,0,3,,train
0550371_sc-132200.jpg,8,0,0,0,8,,train
0550372_sc-132200.jpg,6,0,0,0,6,,train
0550373_sc-132200.jpg,6,0,0,0,6,,train
0550374_sc-217942.jpg,1,0,0,0,1,,train
0550375_sc-1029992.jpg,12,0,0,0,12,,train
0550376_sc-1029992.jpg,7,1,2,0,10,,val
0550377_sc-1029992.jpg,5,1,2,0,8,,val
0550379_as-0035498.jpg,3,0,0,0,3,,test
0550380_as-0035498.jpg,4,0,0,0,4,,train
0550381_as-0035498.jpg,4,0,0,0,4,,train
0550384_sc-200515.jpg,1,0,1,1,3,,train
0550385_sc-200515.jpg,1,0,1,1,3,,train
0550386_sc-200515.jpg,2,0,0,1,3,,train
0550387_sc-178383.jpg,1,0,1,0,2,,train
0550388_sc-178383.jpg,1,2,1,0,4,,train
0550389_sc-178383.jpg,2,0,1,0,3,,val
0550390_sc-178383.jpg,0,0,1,0,1,,val
0550391_sc-178383.jpg,1,0,1,0,2,,test
0550392_as-3021976.jpg,0,2,1,0,3,,train
0550393_as-0030347.jpg,1,0,0,0,1,,train
0550394_as-3042179.jpg,2,0,0,1,3,,train
0550396_as-0027754.jpg,1,0,0,1,2,,train
0550397_as-0027754.jpg,1,0,0,0,1,,train
0550398_sc-204256.jpg,1,0,0,0,1,,train
0550399_sc-204256.jpg,1,0,0,0,1,,train
0550400_sc-204256.jpg,1,0,1,0,2,,val
0550401_sc-204256.jpg,1,0,1,0,2,,val
0550402_sc-204256.jpg,3,0,0,0,3,,test
0550403_sc-204256.jpg,2,0,0,0,2,,train
0550404_sc-195902.jpg,1,1,0,0,2,,train
0550405_sc-195902.jpg,1,1,0,0,2,,train
0550406_sc-195902.jpg,2,1,0,0,3,,train
0550407_sc-195902.jpg,2,1,0,0,3,,train
0550408_sc-195902.jpg,1,0,0,0,1,,train
0550409_sc-115128.jpg,2,0,0,0,2,,train
0550410_as-3003182.jpg,2,1,0,0,3,,val
0550411_as-0044816.jpg,1,0,0,0,1,,val
0550412_as-2545635.jpg,4,1,1,3,9,,test
0550413_as-0082197.jpg,1,0,0,0,1,,train
0550417_as-0082197.jpg,2,0,0,0,2,,train
0550420_sc-181103.jpg,3,0,0,0,3,,train
0550422_sc-1024549.jpg,2,0,0,0,2,,train
0550423_sc-1024549.jpg,4,0,0,0,4,,train
0550424_sc-1024549.jpg,2,0,0,1,3,,train
0550425_sc-127643.jpg,0,1,0,2,3,,train
0550426_sc-1009858.jpg,1,2,3,0,6,,val
0550427_sc-1003148.jpg,1,0,0,0,1,,val
0550428_sc-1003148.jpg,0,1,0,0,1,,test
0550429_sc-1003148.jpg,1,1,0,0,2,,train
0550430_sc-1003148.jpg,2,1,0,0,3,,train
0550431_sc-1003148.jpg,4,0,0,0,4,,train
0550432_sc-1003148.jpg,4,0,0,0,4,,train
0550433_as-0070666.jpg,2,0,0,0,2,,train
0550434_sc-176772.jpg,0,0,4,0,4,,train
0550435_sc-176772.jpg,4,3,5,1,13,,train
0550437_sc-176772.jpg,0,0,3,0,3,,val
0550438_as-3044661.jpg,13,0,0,1,14,,val
0550439_as-7858153.jpg,1,2,1,0,4,,test
0550440_sc-144519.jpg,1,1,0,1,3,,train
0550442_as-0069416.jpg,2,0,1,0,3,,train
0550443_as-0046739.jpg,7,2,2,2,13,,train
0550445_as-0018532.jpg,3,1,1,0,5,,train
0550446_as-0018532.jpg,1,1,0,0,2,,train
0550447_as-0040726.jpg,2,0,0,0,2,,train
0550448_as-0040726.jpg,0,0,0,1,1,,train
0550449_as-0040726.jpg,3,0,1,2,6,,val
0550450_as-0040726.jpg,3,0,1,0,4,,val
0550451_as-0040726.jpg,4,0,1,0,5,,test
0550452_as-0040726.jpg,2,0,0,0,2,,train
0550453_as-2767931.jpg,5,2,4,0,11,,train
0550454_as-3464126.jpg,1,1,0,1,3,,train
0550455_as-2863287.jpg,2,0,1,2,5,,train
0550456_sc-219141.jpg,3,1,1,1,6,,train
0550458_as-0081063.jpg,2,0,5,1,8,,train
0550459_as-0081063.jpg,3,2,2,0,7,,train
0550460_sc-1011518.jpg,1,0,1,0,2,,val
0550461_sc-1011518.jpg,1,0,1,0,2,,val
0550462_sc-1011518.jpg,3,0,1,0,4,,test
0550463_sc-1011518.jpg,2,0,1,0,3,,train
0550464_sc-1011518.jpg,2,0,1,0,3,,train
0550465_as-9001242.jpg,1,0,0,0,1,,train
0550466_as-0033434.jpg,0,0,1,1,2,,train
0550467_as-0033434.jpg,1,0,1,0,2,,train
0550468_as-0033434.jpg,0,1,0,0,1,,train
0550469_as-0033434.jpg,0,1,0,0,1,,train
0550470_as-0081449.jpg,2,0,0,0,2,,val
0550471_sc-218896.jpg,1,0,0,2,3,,val
0550472_sc-107702.jpg,3,1,2,0,6,,test
0550473_sc-107702.jpg,3,2,1,0,6,,train
0550474_sc-107702.jpg,2,1,0,0,3,,train
0550476_sc-107702.jpg,4,1,0,0,5,,train
0550477_as-2871707.jpg,1,2,1,0,4,,train
0550478_sc-131062.jpg,1,0,1,1,3,,train
0550479_sc-131062.jpg,1,0,1,1,3,,train
0550480_sc-131062.jpg,1,0,1,1,3,,train
0550481_sc-131062.jpg,1,0,1,1,3,,val
0550483_sc-160223.jpg,1,1,0,0,2,,val
0550484_sc-160223.jpg,3,0,0,0,3,,test
0550487_sc-138663.jpg,1,0,0,0,1,,train
0550489_sc-138663.jpg,1,1,0,0,2,,train
0550491_sc-138663.jpg,5,1,0,0,6,,train
0550492_sc-138663.jpg,1,0,0,0,1,,train
0550493_sc-138663.jpg,1,0,0,0,1,,train
0550494_as-0069196.jpg,2,1,0,0,3,,train
0550495_sc-135720.jpg,3,1,1,0,5,,train
0550496_sc-135720.jpg,2,1,1,0,4,,val
0550497_sc-135720.jpg,2,1,1,1,5,,val
0550498_as-0032202.jpg,1,1,0,1,3,,test
0550499_as-0032202.jpg,2,1,0,1,4,,train
0550500_as-0032202.jpg,1,1,0,1,3,,train
0550501_as-0032202.jpg,2,1,0,1,4,,train
0550502_as-0032202.jpg,2,0,0,0,2,,train
0550504_sc-103441.jpg,2,0,0,0,2,,train
0550505_sc-103441.jpg,2,0,0,1,3,,train
0550507_as-2931156.jpg,1,0,0,0,1,,train
0550510_as-0041070.jpg,3,0,0,1,4,,val
0550511_as-0041070.jpg,2,0,0,1,3,,val
0550512_as-0041070.jpg,2,0,0,1,3,,test
0550513_as-3144783.jpg,1,0,1,1,3,,train
0550514_sc-213099.jpg,0,0,1,0,1,,train
0550515_sc-1034970.jpg,1,0,0,1,2,,train
0550516_sc-1034970.jpg,1,0,0,0,1,,train
0550517_sc-1034970.jpg,1,0,0,1,2,,train
0550518_sc-1034970.jpg,1,0,0,1,2,,train
0550519_sc-1034970.jpg,3,0,0,0,3,,train
0550521_as-0036025.jpg,2,0,0,0,2,,val
0550522_as-0036025.jpg,4,0,1,1,6,,val
0550523_as-0036025.jpg,7,0,1,0,8,,test
0550524_as-0036025.jpg,1,0,1,0,2,,train
0550525_as-0036025.jpg,1,0,0,0,1,,train
0550527_sc-203609.jpg,2,1,0,0,3,,train
0550528_sc-203609.jpg,4,0,0,0,4,,train
0550529_sc-203609.jpg,6,0,0,0,6,,train
0550530_sc-203609.jpg,2,0,0,0,2,,train
0550531_as-3039824.jpg,0,1,0,0,1,,train
0550532_as-0077993.jpg,4,3,0,0,7,,val
0550533_as-0077993.jpg,0,0,0,1,1,,val
0550534_as-0077993.jpg,2,0,0,0,2,,test
0550536_sc-148439.jpg,11,0,0,0,11,,train
0550537_sc-148439.jpg,7,0,0,0,7,,train
0550538_sc-148439.jpg,6,0,0,0,6,,train
0550539_as-0043251.jpg,3,0,0,0,3,,train
0550540_as-0067623.jpg,1,0,0,0,1,,train
0550541_as-0067623.jpg,1,0,0,0,1,,train
0550542_sc-181596.jpg,2,0,0,0,2,,train
0550544_as-7470377.jpg,2,0,0,0,2,,val
0550547_as-0072739.jpg,1,1,1,0,3,,val
0550550_as-0072739.jpg,1,1,2,1,5,,test
0550551_as-0072739.jpg,0,0,1,1,2,,train
0550552_as-0072739.jpg,0,1,2,0,3,,train
0550553_as-0072739.jpg,4,0,1,0,5,,train
0550554_as-0072739.jpg,1,2,0,0,3,,train
0550557_sc-155539.jpg,3,0,0,1,4,,train
0550558_sc-155539.jpg,2,1,0,1,4,,train
0550559_sc-155539.jpg,2,0,0,1,3,,train
0550561_sc-126206.jpg,0,1,0,0,1,,val
0550562_sc-126206.jpg,0,1,0,0,1,,val
0550563_sc-126206.jpg,0,1,0,0,1,,test
0550564_sc-178603.jpg,2,0,1,0,3,,train
0550565_sc-178603.jpg,1,0,0,0,1,,train
0550566_sc-1030462.jpg,1,0,1,0,2,,train
0550568_sc-1030462.jpg,6,1,1,1,9,,train
0550569_sc-1030462.jpg,1,0,0,1,2,,train
0550570_sc-1030462.jpg,6,0,0,0,6,,train
0550571_sc-1030462.jpg,4,0,1,1,6,,train
0550572_sc-1030462.jpg,4,1,2,1,8,,val
0550573_sc-1030462.jpg,3,0,0,0,3,,val
0550577_as-0064479.jpg,1,0,0,0,1,,test
0550578_as-0064479.jpg,1,0,0,0,1,,train
0550580_as-0064479.jpg,1,0,0,0,1,,train
0550581_as-0064479.jpg,2,0,0,0,2,,train
0550583_as-0064479.jpg,2,0,0,1,3,,train
0550584_as-0064479.jpg,1,1,0,1,3,,train
0550585_sc-154148.jpg,2,0,0,0,2,,train
0550586_as-0071420.jpg,1,0,0,0,1,,train
0550587_as-0071420.jpg,1,0,0,0,1,,val
0550588_as-0071420.jpg,1,0,0,0,1,,val
0550590_as-0057230.jpg,0,1,0,0,1,,test
0550591_as-0080022.jpg,0,0,0,1,1,,train
0550593_as-0086280.jpg,1,0,1,0,2,,train
0550594_as-0086280.jpg,0,0,1,1,2,,train
0550595_as-0086280.jpg,0,0,1,1,2,,train
0550596_as-7327546.jpg,1,0,0,0,1,,train
0550597_as-0006742.jpg,1,0,1,0,2,,train
0550598_as-2688353.jpg,1,0,1,0,2,,train
0550600_sc-161930.jpg,3,0,0,0,3,,val
0550604_as-0064084.jpg,2,1,0,0,3,,val
0550605_as-0064084.jpg,1,0,0,0,1,,test
0550607_as-0064084.jpg,2,1,0,0,3,,train
0550608_as-0064084.jpg,0,1,1,0,2,,train
0550609_as-0064084.jpg,2,1,0,0,3,,train
0550611_sc-171517.jpg,2,1,1,0,4,,train
0550612_as-3349673.jpg,0,0,0,1,1,,train
0550614_as-0058378.jpg,1,0,0,0,1,,train
0550615_as-0058378.jpg,1,0,1,0,2,,train
0550616_as-0058378.jpg,2,0,0,0,2,,val
0550619_as-0072465.jpg,2,0,0,0,2,,val
0550620_as-0072465.jpg,5,0,0,0,5,,test
0550621_as-3326601.jpg,6,1,3,4,14,,train
0550622_sc-1033751.jpg,4,0,0,0,4,,train
0550623_sc-1033751.jpg,4,0,0,0,4,,train
0550626_as-0012944.jpg,1,0,0,0,1,,train
0550627_as-0012944.jpg,2,0,1,0,3,,train
0550628_as-0012944.jpg,3,0,1,0,4,,train
0550629_as-0012944.jpg,2,0,1,0,3,,train
0550630_as-0058668.jpg,2,0,1,0,3,,val
0550631_sc-141330.jpg,5,1,0,0,6,,val
0550632_sc-141330.jpg,1,0,0,1,2,,test
0550633_sc-141330.jpg,1,0,0,0,1,,train
0550635_sc-141330.jpg,4,1,0,0,5,,train
0550638_sc-228909.jpg,1,0,0,0,1,,train
0550639_as-3179442.jpg,1,0,0,0,1,,train
0550640_as-3096479.jpg,11,0,0,0,11,,train
0550641_sc-1025021.jpg,2,0,0,0,2,,train
0550642_sc-112256.jpg,1,0,0,0,1,,train
0550644_sc-112256.jpg,1,0,0,0,1,,val
0550645_sc-112256.jpg,2,0,0,0,2,,val
0550648_sc-135311.jpg,1,0,1,0,2,,test
0550650_as-7979921.jpg,4,0,1,1,6,,train
0550651_as-0001317.jpg,1,0,0,0,1,,train
0550652_as-0001317.jpg,2,0,0,1,3,,train
0550653_as-0086715.jpg,3,0,0,0,3,,train
0550654_sc-183797.jpg,1,0,0,1,2,,train
0550655_sc-183797.jpg,1,0,0,1,2,,train
0550657_as-0018188.jpg,0,0,1,0,1,,train
0550658_as-0018188.jpg,0,0,1,0,1,,val
0550659_as-0018188.jpg,2,2,0,0,4,,val
0550660_as-0018188.jpg,0,2,0,0,2,,test
0550663_sc-163753.jpg,1,0,0,0,1,,train
0550664_sc-163753.jpg,1,0,0,0,1,,train
0550665_sc-163753.jpg,1,0,0,0,1,,train
0550666_as-7857278.jpg,2,0,1,0,3,,train
0550668_sc-201353.jpg,1,0,0,0,1,,train
0550669_sc-201353.jpg,1,0,0,0,1,,train
0550670_sc-1031858.jpg,2,0,0,0,2,,train
0550672_as-0060773.jpg,3,0,1,0,4,,val
0550673_as-0060773.jpg,0,2,1,0,3,,val
0550674_as-0060773.jpg,2,0,1,0,3,,test
0550676_as-0033676.jpg,0,0,2,0,2,,train
0550677_as-0033676.jpg,5,1,2,2,10,,train
0550678_as-0033676.jpg,1,0,1,1,3,,train
0550679_as-0033676.jpg,4,1,0,1,6,,train
0550681_sc-1019208.jpg,1,0,0,0,1,,train
0550682_sc-1019208.jpg,2,0,0,0,2,,train
0550683_sc-1019208.jpg,3,1,0,0,4,,train
0550684_sc-1019208.jpg,0,1,1,1,3,,val
0550685_sc-1019208.jpg,1,1,0,0,2,,val
0550686_as-2777907.jpg,3,0,1,0,4,,test
0550687_as-7953705.jpg,4,2,0,0,6,,train
0550688_sc-213580.jpg,1,0,0,0,1,,train
0550689_as-0082018.jpg,2,0,0,0,2,,train
0550691_sc-113315.jpg,1,0,0,0,1,,train
0550692_sc-127249.jpg,4,3,2,3,12,,train
0550695_sc-127249.jpg,2,2,4,1,9,,train
0550697_sc-127249.jpg,5,3,3,1,12,,train
0550698_sc-127434.jpg,1,0,0,0,1,,val
0550700_sc-127434.jpg,3,0,1,0,4,,val
0550701_sc-127434.jpg,2,0,1,1,4,,test
0550702_sc-127434.jpg,1,0,1,1,3,,train
0550703_as-0039972.jpg,1,0,0,0,1,,train
0550704_as-0039972.jpg,3,0,0,0,3,,train
0550705_as-0039972.jpg,3,0,1,0,4,,train
0550707_sc-133932.jpg,6,0,0,0,6,,train
0550708_sc-124156.jpg,5,0,0,0,5,,train
0550709_sc-197625.jpg,3,0,0,1,4,,train
0550710_as-2751501.jpg,8,1,0,1,10,,val
0550712_sc-178418.jpg,2,0,1,0,3,,val
0550713_sc-178418.jpg,4,0,1,0,5,,test
0550714_sc-178418.jpg,3,0,0,0,3,,train
0550715_sc-178418.jpg,0,1,1,0,2,,train
0550716_sc-178418.jpg,2,2,1,0,5,,train
0550717_sc-178418.jpg,4,0,0,1,5,,train
0550718_sc-178418.jpg,4,0,0,1,5,,train
0550719_sc-178418.jpg,4,0,0,1,5,,train
0550720_sc-178418.jpg,3,0,0,1,4,,train
0550722_sc-178418.jpg,2,0,0,0,2,,val
0550723_sc-211461.jpg,1,0,0,0,1,,val
0550724_sc-211461.jpg,1,0,0,0,1,,test
0550725_sc-211461.jpg,3,0,0,0,3,,train
0550726_sc-211461.jpg,1,0,0,0,1,,train
0550728_as-0032041.jpg,3,0,2,1,6,,train
0550729_as-0032041.jpg,1,0,0,0,1,,train
0550730_as-9077722.jpg,3,0,2,0,5,,train
0550732_as-9019564.jpg,1,0,1,0,2,,train
0550733_as-2524365.jpg,3,0,0,0,3,,train
0550734_sc-125408.jpg,2,1,0,1,4,,val
0550736_sc-125408.jpg,1,2,0,0,3,,val
0550737_sc-125408.jpg,1,1,0,0,2,,test
0550738_sc-125408.jpg,2,0,0,0,2,,train
0550739_sc-195494.jpg,3,0,0,0,3,,train
0550740_sc-195494.jpg,4,1,0,0,5,,train
0550741_as-0041435.jpg,3,4,0,0,7,,train
0550742_as-0041435.jpg,1,1,2,1,5,,train
0550744_as-0041435.jpg,1,2,0,0,3,,train
0550745_as-0041435.jpg,1,1,0,0,2,,train
0550746_as-3475175.jpg,2,0,0,0,2,,val
0550750_sc-218686.jpg,2,0,1,0,3,,val
0550751_sc-1022415.jpg,5,0,1,1,7,,test
0550752_sc-1022415.jpg,4,0,1,1,6,,train
0550753_sc-1022415.jpg,3,0,1,1,5,,train
0550755_sc-1022415.jpg,4,1,0,0,5,,train
0550756_as-9075451.jpg,3,0,0,0,3,,train
0550757_as-2925045.jpg,1,0,0,0,1,,train
0550758_as-2925045.jpg,3,0,1,2,6,,train
0550761_as-0084142.jpg,5,1,2,0,8,,train
0550762_as-0084142.jpg,2,0,0,0,2,,val
0550763_as-0084142.jpg,0,0,1,0,1,,val
0550764_sc-155538.jpg,0,0,2,0,2,,test
0550765_sc-155538.jpg,1,1,3,0,5,,train
0550766_sc-155538.jpg,4,0,2,0,6,,train
0550767_sc-155538.jpg,2,0,2,0,4,,train
0550768_sc-1033474.jpg,1,0,0,0,1,,train
0550769_sc-1033474.jpg,4,0,1,1,6,,train
0550770_as-2664131.jpg,3,0,0,0,3,,train
0550771_sc-1016070.jpg,2,1,2,0,5,,train
0550772_as-3421660.jpg,3,0,0,1,4,,val
0550775_as-0082581.jpg,1,0,0,0,1,,val
0550776_as-0082581.jpg,3,1,0,1,5,,test
0550777_sc-1005001.jpg,4,1,0,0,5,,train
0550778_sc-1005001.jpg,5,0,0,0,5,,train
0550779_sc-1005001.jpg,3,1,0,0,4,,train
0550782_as-0061708.jpg,3,0,0,0,3,,train
0550783_as-0061708.jpg,4,0,0,1,5,,train
0550784_as-0061708.jpg,4,0,0,1,5,,train
0550785_as-0061708.jpg,1,0,1,0,2,,train
0550787_sc-154564.jpg,7,0,0,1,8,,val
0550789_sc-154564.jpg,2,0,0,0,2,,val
0550790_as-0042489.jpg,2,1,0,0,3,,test
0550791_as-0042489.jpg,2,1,1,0,4,,train
0550792_as-0042489.jpg,2,0,1,0,3,,train
0550793_as-0042489.jpg,1,1,1,0,3,,train
0550794_sc-200385.jpg,2,0,0,0,2,,train
0550795_sc-200385.jpg,2,0,0,0,2,,train
0550796_sc-200385.jpg,3,0,0,0,3,,train
0550797_sc-200385.jpg,1,0,0,0,1,,train
0550798_sc-147396.jpg,2,0,1,0,3,,val
0550799_sc-147396.jpg,2,0,1,0,3,,val
0550800_as-3499345.jpg,1,0,1,1,3,,test
0550801_sc-167264.jpg,2,0,0,0,2,,train
0550804_as-0065479.jpg,1,0,0,1,2,,train
0550805_as-0065479.jpg,1,0,0,1,2,,train
0550806_as-0065479.jpg,2,0,0,0,2,,train
0550807_as-0065479.jpg,2,0,0,1,3,,train
0550811_as-0065479.jpg,2,0,1,0,3,,train
0550812_as-0065479.jpg,2,0,1,0,3,,train
0550814_as-0065479.jpg,2,0,1,0,3,,val
0550815_as-0065479.jpg,2,0,0,0,2,,val
0550816_as-0065479.jpg,2,0,0,0,2,,test
0550819_as-0038630.jpg,5,0,2,0,7,,train
0550820_as-0038630.jpg,3,0,2,0,5,,train
0550821_as-0038630.jpg,3,0,2,0,5,,train
0550822_as-0036463.jpg,1,0,0,1,2,,train
0550823_as-0036463.jpg,1,0,0,1,2,,train
0550824_sc-132329.jpg,2,0,1,2,5,,train
0550825_as-7211735.jpg,4,0,0,0,4,,train
0550826_as-2846105.jpg,0,1,0,0,1,,val
0550827_sc-114372.jpg,1,0,0,0,1,,val
0550828_as-3243088.jpg,1,0,0,1,2,,test
0550830_sc-1011126.jpg,2,0,0,0,2,,train
0550831_sc-1011126.jpg,3,0,0,0,3,,train
0550832_sc-1011126.jpg,6,1,0,0,7,,train
0550833_as-0063587.jpg,1,0,0,0,1,,train
0550834_as-0063587.jpg,1,0,0,0,1,,train
0550837_as-7783317.jpg,2,0,0,1,3,,train
0550839_sc-1031863.jpg,4,0,1,0,5,,train
0550840_sc-1031863.jpg,4,0,0,0,4,,val
0550841_sc-161525.jpg,6,2,0,0,8,,val
0550842_sc-161525.jpg,6,1,0,0,7,,test
0550843_sc-161525.jpg,2,0,0,0,2,,train
0550844_sc-161525.jpg,2,0,0,0,2,,train
0550845_sc-161525.jpg,7,0,0,1,8,,train
0550846_sc-161525.jpg,5,0,0,1,6,,train
0550847_sc-161525.jpg,6,0,0,1,7,,train
0550848_sc-161525.jpg,1,0,0,0,1,,train
0550849_sc-161525.jpg,3,0,0,0,3,,train
0550850_sc-161525.jpg,1,0,0,0,1,,val
0550851_sc-161525.jpg,7,0,1,0,8,,val
0550852_sc-161525.jpg,8,0,0,0,8,,test
0550853_sc-161525.jpg,3,2,1,1,7,,train
0550854_as-7491782.jpg,3,0,0,0,3,,train
0550855_as-2620456.jpg,3,0,1,0,4,,train
0550857_sc-161626.jpg,3,0,0,0,3,,train
0550858_sc-161626.jpg,1,0,0,0,1,,train
0550859_sc-161626.jpg,1,0,0,0,1,,train
0550860_as-2677287.jpg,1,0,1,0,2,,train
0550861_sc-135029.jpg,3,0,0,0,3,,val
0550862_sc-135029.jpg,3,0,0,0,3,,val
0550863_sc-135029.jpg,2,0,0,0,2,,test
0550864_as-2773384.jpg,1,1,0,1,3,,train
0550866_sc-1005823.jpg,5,2,1,1,9,,train
0550867_sc-1005823.jpg,8,1,1,0,10,,train
0550868_as-0098922.jpg,3,0,0,0,3,,train
0550869_as-0098922.jpg,1,0,1,0,2,,train
0550870_as-0098922.jpg,1,0,0,0,1,,train
0550871_as-3135250.jpg,0,1,0,0,1,,train
0550872_sc-203105.jpg,2,1,0,1,4,,val
0550873_sc-203105.jpg,2,0,1,1,4,,val
0550875_as-0061062.jpg,4,0,0,0,4,,test
0550876_as-0061062.jpg,1,0,0,0,1,,train
0550877_as-0061062.jpg,4,0,0,0,4,,train
0550879_sc-209926.jpg,11,1,0,1,13,,train
0550882_sc-209926.jpg,10,1,0,1,12,,train
0550883_sc-209926.jpg,3,1,0,0,4,,train
0550884_sc-209926.jpg,7,0,0,1,8,,train
0550885_sc-209926.jpg,2,0,0,1,3,,train
0550886_sc-209926.jpg,9,1,0,0,10,,val
0550887_sc-209926.jpg,4,0,0,1,5,,val
0550891_sc-126875.jpg,1,2,1,2,6,,test
0550892_sc-126875.jpg,1,2,0,0,3,,train
0550894_sc-126875.jpg,2,0,0,1,3,,train
0550895_sc-126875.jpg,2,0,0,1,3,,train
0550896_sc-126875.jpg,1,0,0,1,2,,train
0550899_sc-1033384.jpg,0,1,0,2,3,,train
0550900_sc-1033384.jpg,2,1,2,0,5,,train
0550903_as-2806624.jpg,1,0,1,1,3,,train
0550904_sc-1024414.jpg,3,0,0,0,3,,val
0550905_sc-205161.jpg,6,1,1,0,8,,val
0550906_sc-205161.jpg,3,1,0,0,4,,test
0550907_sc-205161.jpg,11,3,0,0,14,,train
0550908_as-7541236.jpg,2,2,0,0,4,,train
0550909_sc-1003017.jpg,1,1,0,0,2,,train
0550911_as-9002985.jpg,1,0,0,0,1,,train
0550913_sc-220581.jpg,1,0,0,0,1,,train
0550914_sc-220581.jpg,1,0,0,0,1,,train
0550915_as-0087587.jpg,1,0,0,0,1,,train
0550916_as-0087587.jpg,1,0,0,0,1,,val
0550917_as-0087587.jpg,1,0,0,0,1,,val
0550918_as-0087587.jpg,1,0,0,0,1,,test
0550919_as-0087587.jpg,1,0,0,0,1,,train
0550920_as-0087587.jpg,1,0,0,0,1,,train
0550921_as-3441908.jpg,1,0,0,0,1,,train
0550922_sc-128601.jpg,2,0,0,0,2,,train
0550923_sc-1029384.jpg,2,0,1,0,3,,train
0550924_sc-1029384.jpg,2,0,1,0,3,,train
0550925_sc-1029384.jpg,1,0,0,0,1,,train
0550926_sc-1029384.jpg,2,0,1,0,3,,val
0550927_as-2844164.jpg,1,0,0,0,1,,val
0550928_as-0062466.jpg,1,0,0,0,1,,test
0550930_as-0062466.jpg,1,0,0,1,2,,train
0550931_as-0062466.jpg,1,0,1,0,2,,train
0550932_as-0062466.jpg,3,0,1,1,5,,train
0550933_as-0062466.jpg,1,0,0,1,2,,train
0550935_as-0062466.jpg,0,1,1,0,2,,train
0550937_sc-197466.jpg,4,0,1,0,5,,train
0550938_as-2761855.jpg,11,0,3,0,14,,train
0550940_sc-1001943.jpg,2,0,0,0,2,,val
0550941_sc-1001943.jpg,3,0,1,1,5,,val
0550942_sc-1001943.jpg,1,0,0,1,2,,test
0550944_sc-1001943.jpg,2,0,0,0,2,,train
0550945_sc-1037984.jpg,2,0,0,0,2,,train
0550946_sc-1037984.jpg,3,0,0,0,3,,train
0550947_sc-1037984.jpg,4,0,0,0,4,,train
0550948_as-2811736.jpg,0,1,0,0,1,,train
0550949_as-0099745.jpg,5,0,0,0,5,,train
0550950_as-0099745.jpg,1,0,1,0,2,,train
0550951_as-0099745.jpg,3,0,1,1,5,,val
0550952_as-0099745.jpg,4,0,1,1,6,,val
0550953_as-3220658.jpg,2,0,0,0,2,,test
0550954_as-0032699.jpg,0,1,0,0,1,,train
0550955_as-0032699.jpg,0,1,0,0,1,,train
0550956_as-7177009.jpg,0,0,1,0,1,,train
0550957_as-7177009.jpg,1,1,0,0,2,,train
0550958_sc-1009107.jpg,1,0,0,0,1,,train
0550959_sc-1009107.jpg,2,0,0,1,3,,train
0550960_sc-1009107.jpg,2,0,0,0,2,,train
0550961_sc-1009107.jpg,7,0,0,0,7,,val
0550962_sc-1009107.jpg,5,0,0,0,5,,val
0550963_sc-1009107.jpg,1,0,0,0,1,,test
0550964_sc-1009107.jpg,3,0,0,0,3,,train
0550965_as-2878630.jpg,1,0,0,0,1,,train
0550966_as-0097607.jpg,2,0,0,0,2,,train
0550967_as-0097607.jpg,3,0,1,0,4,,train
0550968_as-0097607.jpg,2,0,1,0,3,,train
0550969_as-0097607.jpg,3,0,1,0,4,,train
0550970_sc-170500.jpg,1,0,0,0,1,,train
0550971_sc-208544.jpg,1,0,0,0,1,,val
0550972_sc-208544.jpg,4,0,0,1,5,,val
0550973_sc-208544.jpg,3,0,1,1,5,,test
0550974_sc-208544.jpg,2,0,0,0,2,,train
0550975_sc-228911.jpg,0,1,0,0,1,,train
0550976_sc-228911.jpg,1,0,0,1,2,,train
0550977_sc-228911.jpg,0,1,0,0,1,,train
0550978_sc-228911.jpg,0,1,2,0,3,,train
0550979_sc-228911.jpg,1,2,1,1,5,,train
0550980_as-0030274.jpg,2,0,0,0,2,,train
0550981_as-0030274.jpg,0,1,0,0,1,,val
0550982_as-0030274.jpg,1,0,1,0,2,,val
0550983_as-0030274.jpg,3,0,0,0,3,,test
0550984_as-0030274.jpg,1,0,1,0,2,,train
0550985_as-0030274.jpg,1,1,0,0,2,,train
0550986_as-0030274.jpg,0,1,1,0,2,,train
0550987_sc-227971.jpg,1,0,0,0,1,,train
0550988_sc-227971.jpg,1,0,0,0,1,,train
0550989_sc-227971.jpg,1,0,0,0,1,,train
0550990_sc-227971.jpg,1,0,0,0,1,,train
0550991_sc-227971.jpg,1,0,0,1,2,,val
0550992_sc-227971.jpg,1,0,0,1,2,,val
0550993_sc-227971.jpg,0,1,0,1,2,,test
0550994_sc-227971.jpg,1,0,0,0,1,,train
0550995_sc-227971.jpg,1,0,0,0,1,,train
0550996_sc-196277.jpg,9,0,3,1,13,,train
0550997_sc-196277.jpg,3,0,2,0,5,,train
0550998_sc-196277.jpg,2,0,0,0,2,,train
0550999_as-2637632.jpg,4,0,0,0,4,,train
0551003_sc-144917.jpg,3,0,0,1,4,,train
0551006_sc-1027803.jpg,1,0,1,1,3,,val
0551007_sc-222914.jpg,1,0,0,0,1,,val
0551008_sc-222914.jpg,1,0,0,0,1,,test
0551011_as-0005246.jpg,0,0,1,1,2,,train
0551015_sc-1009156.jpg,1,0,0,0,1,,train
0551016_sc-1009156.jpg,1,0,0,0,1,,train
0551017_sc-1016473.jpg,4,0,0,0,4,,train
0551018_sc-1016473.jpg,2,0,0,0,2,,train
0551019_sc-1016473.jpg,4,0,0,1,5,,train
0551020_sc-1016473.jpg,3,0,0,1,4,,train
0551021_sc-113146.jpg,0,0,0,1,1,,val
0551022_sc-113146.jpg,1,0,0,1,2,,val
0551023_sc-162802.jpg,2,0,2,0,4,,test
0551024_sc-162802.jpg,4,0,0,0,4,,train
0551026_sc-1033438.jpg,2,0,1,1,4,,train
0551027_sc-1033438.jpg,1,0,1,1,3,,train
0551028_sc-169391.jpg,0,1,0,0,1,,train
0551030_sc-212492.jpg,1,0,0,0,1,,train
0551031_as-2716338.jpg,5,0,0,0,5,,train
0551033_sc-136090.jpg,2,0,0,1,3,,train
0551034_sc-136090.jpg,1,0,0,0,1,,val
0551035_sc-136090.jpg,1,0,0,1,2,,val
0551036_sc-136090.jpg,1,0,0,1,2,,test
0551037_sc-136090.jpg,1,0,0,1,2,,train
0551038_sc-159114.jpg,2,0,1,1,4,,train
0551039_sc-159114.jpg,3,0,1,1,5,,train
0551042_sc-217525.jpg,1,0,0,0,1,,train
0551043_sc-217525.jpg,1,0,0,0,1,,train
0551044_sc-217525.jpg,1,0,0,0,1,,train
0551045_sc-138676.jpg,5,0,0,0,5,,train
0551046_sc-138676.jpg,1,0,0,0,1,,val
0551047_sc-138676.jpg,4,0,0,0,4,,val
0551048_sc-138676.jpg,5,0,0,0,5,,test
0551050_sc-118291.jpg,4,0,2,0,6,,train
0551051_sc-186239.jpg,1,0,0,1,2,,train
0551052_sc-186239.jpg,0,0,0,1,1,,train
0551053_as-0095454.jpg,0,0,1,0,1,,train
0551054_as-0095454.jpg,1,0,1,0,2,,train
0551055_as-0095454.jpg,1,0,2,1,4,,train
0551056_sc-148258.jpg,2,0,0,0,2,,train
0551057_as-0082077.jpg,2,0,0,0,2,,val
0551059_as-0082077.jpg,2,0,0,0,2,,val
0551061_as-0082077.jpg,2,0,0,0,2,,test
0551062_as-0082077.jpg,2,0,0,0,2,,train
0551063_as-0060617.jpg,1,0,0,0,1,,train
0551064_as-0060617.jpg,0,1,0,0,1,,train
0551065_as-0060617.jpg,1,0,0,0,1,,train
0551067_sc-203727.jpg,3,0,0,0,3,,train
0551068_sc-203727.jpg,1,0,0,0,1,,train
0551069_as-0000137.jpg,2,0,1,1,4,,train
0551070_as-0000137.jpg,3,0,1,1,5,,val
0551071_as-0000137.jpg,2,0,1,1,4,,val
0551072_as-0000137.jpg,2,0,1,1,4,,test
0551073_as-0000137.jpg,3,0,1,0,4,,train
0551074_as-0000137.jpg,1,0,1,1,3,,train
0551075_as-3273107.jpg,4,2,0,0,6,,train
0551077_as-0033592.jpg,2,1,1,0,4,,train
0551078_sc-175426.jpg,5,0,1,0,6,,train
0551079_sc-175426.jpg,1,0,0,1,2,,train
0551080_sc-175426.jpg,1,0,0,1,2,,train
0551081_sc-133993.jpg,2,1,1,1,5,,val
0551082_sc-133993.jpg,2,1,1,1,5,,val
0551083_sc-133993.jpg,4,1,2,1,8,,test
0551084_sc-133993.jpg,1,1,2,1,5,,train
0551085_sc-133993.jpg,4,1,2,1,8,,train
0551086_sc-133993.jpg,5,1,2,1,9,,train
0551087_sc-133993.jpg,4,1,2,1,8,,train
0551088_sc-1028079.jpg,2,0,0,1,3,,train
0551089_sc-1028079.jpg,2,0,0,1,3,,train
0551090_sc-1028079.jpg,1,0,0,0,1,,train
0551091_sc-1028079.jpg,1,0,0,0,1,,val
0551092_sc-1028079.jpg,1,1,1,0,3,,val
0551093_sc-1028079.jpg,2,0,0,0,2,,test
0551094_as-3262414.jpg,1,0,1,2,4,,train
0551102_sc-104865.jpg,2,1,0,0,3,,train
0551103_sc-1018444.jpg,1,0,0,0,1,,train
0551104_sc-105256.jpg,4,0,0,0,4,,train
0551105_sc-105256.jpg,1,0,0,0,1,,train
0551107_sc-1024807.jpg,1,0,1,0,2,,train
0551108_sc-1024807.jpg,1,0,0,0,1,,train
0551109_sc-1024807.jpg,4,0,1,1,6,,val
0551110_as-2730169.jpg,2,0,0,0,2,,val
0551111_as-0033628.jpg,1,0,0,2,3,,test
0551113_sc-1027407.jpg,1,0,1,2,4,,train
0551114_sc-1027407.jpg,1,0,1,1,3,,train
0551115_sc-1027407.jpg,1,0,0,0,1,,train
0551116_sc-1027407.jpg,1,0,0,0,1,,train
0551117_sc-1027407.jpg,1,0,0,0,1,,train
0551118_sc-1027407.jpg,1,0,1,2,4,,train
0551119_as-3189567.jpg,0,0,1,0,1,,train
0551120_as-0008623.jpg,3,0,0,0,3,,val
0551121_as-0008623.jpg,2,0,0,0,2,,val
0551122_as-0008623.jpg,2,0,0,0,2,,test
0551126_sc-226437.jpg,2,0,1,1,4,,train
0551127_sc-226437.jpg,2,0,1,1,4,,train
0551128_sc-226437.jpg,3,0,1,1,5,,train
0551129_sc-226437.jpg,2,0,0,1,3,,train
0551130_sc-113473.jpg,2,0,1,0,3,,train
0551132_sc-136183.jpg,2,1,0,0,3,,train
0551133_as-0011429.jpg,3,0,0,0,3,,train
0551137_as-3328906.jpg,0,0,1,0,1,,val
0551138_as-2616995.jpg,4,1,0,0,5,,val
0551139_sc-217827.jpg,1,0,1,0,2,,test
0551140_sc-217827.jpg,1,0,1,0,2,,train
0551141_sc-217827.jpg,2,0,1,0,3,,train
0551142_sc-217827.jpg,2,0,1,0,3,,train
0551143_sc-217827.jpg,3,0,1,0,4,,train
0551144_sc-217827.jpg,0,0,1,0,1,,train
0551145_sc-217827.jpg,3,1,0,0,4,,train
0551146_sc-217827.jpg,1,0,0,0,1,,train
0551147_sc-217827.jpg,1,0,1,0,2,,val
0551148_sc-217827.jpg,1,0,1,0,2,,val
0551151_sc-141129.jpg,1,0,1,1,3,,test
0551153_sc-141129.jpg,2,1,1,1,5,,train
0551154_sc-141129.jpg,2,1,2,1,6,,train
0551155_sc-141129.jpg,0,0,1,1,2,,train
0551156_sc-141129.jpg,1,0,0,1,2,,train
0551157_sc-141129.jpg,1,0,0,1,2,,train
0551158_sc-112928.jpg,1,1,0,0,2,,train
0551159_sc-117698.jpg,4,0,0,4,8,,train
0551160_sc-117698.jpg,4,0,0,2,6,,val
0551162_sc-117698.jpg,4,0,0,0,4,,val
0551164_as-0049480.jpg,1,0,0,0,1,,test
0551165_as-0049480.jpg,1,0,0,0,1,,train
0551167_as-0049480.jpg,1,0,0,0,1,,train
0551168_as-0049480.jpg,1,0,0,0,1,,train
0551169_as-0049480.jpg,1,0,0,0,1,,train
0551170_as-0049480.jpg,1,0,0,0,1,,train
0551171_sc-1040018.jpg,2,1,1,1,5,,train
0551172_sc-1040018.jpg,1,0,2,1,4,,train
0551173_sc-1040018.jpg,1,0,1,0,2,,val
0551174_sc-1004747.jpg,2,0,2,1,5,,val
0551177_as-0013053.jpg,3,0,0,0,3,,test
0551178_as-0013053.jpg,2,0,0,0,2,,train
0551179_as-0013053.jpg,2,0,0,0,2,,train
0551180_as-0013053.jpg,1,0,0,0,1,,train
0551181_as-0013053.jpg,1,0,0,0,1,,train
0551182_as-0013053.jpg,1,0,0,0,1,,train
0551183_sc-200411.jpg,4,1,0,0,5,,train
0551184_sc-197889.jpg,1,0,0,1,2,,train
0551185_sc-197889.jpg,1,0,0,1,2,,val
0551186_sc-156162.jpg,1,0,0,0,1,,val
0551187_sc-156162.jpg,1,0,0,0,1,,test
0551188_sc-156162.jpg,8,0,0,0,8,,train
0551189_sc-156162.jpg,2,0,0,0,2,,train
0551190_sc-156162.jpg,3,0,0,0,3,,train
0551193_sc-156162.jpg,4,0,1,0,5,,train
0551194_sc-156162.jpg,1,0,3,0,4,,train
0551195_sc-156162.jpg,2,0,0,1,3,,train
0551197_as-3190597.jpg,4,1,0,0,5,,train
0551198_sc-1012768.jpg,1,0,2,1,4,,val
0551199_sc-1012768.jpg,2,0,2,1,5,,val
0551200_sc-1012768.jpg,2,0,3,1,6,,test
0551202_sc-1012768.jpg,4,1,1,0,6,,train
0551204_as-2935549.jpg,0,0,0,1,1,,train
0551205_as-7875215.jpg,1,0,0,0,1,,train
0551209_as-0059056.jpg,4,0,1,0,5,,train
0551210_as-0059056.jpg,0,1,1,0,2,,train
0551211_sc-1009515.jpg,3,0,0,0,3,,train
0551212_sc-1009515.jpg,7,0,0,0,7,,train
0551213_sc-1009515.jpg,2,0,0,0,2,,val
0551214_sc-1009515.jpg,3,0,0,0,3,,val
0551215_sc-1009515.jpg,1,0,0,0,1,,test
0551216_sc-1009515.jpg,4,0,1,0,5,,train
0551217_sc-1029756.jpg,3,1,0,0,4,,train
0551218_sc-1029756.jpg,0,0,2,0,2,,train
0551219_sc-1029756.jpg,4,0,2,1,7,,train
0551220_sc-1029756.jpg,2,0,2,0,4,,train
0551221_sc-1029756.jpg,3,0,2,1,6,,train
0551222_sc-1029756.jpg,3,0,2,0,5,,train
0551223_sc-1029756.jpg,5,0,2,0,7,,val
0551224_sc-1029756.jpg,1,0,3,0,4,,val
0551225_sc-1029756.jpg,2,0,1,1,4,,test
0551226_sc-1029756.jpg,2,0,0,0,2,,train
0551227_sc-1029756.jpg,2,0,0,0,2,,train
0551228_sc-1029756.jpg,2,0,0,0,2,,train
0551229_sc-1029756.jpg,2,0,0,0,2,,train
0551230_as-3266795.jpg,5,0,0,0,5,,train
0551231_as-2626711.jpg,1,1,0,1,3,,train
0551232_as-0045988.jpg,1,0,0,0,1,,train
0551234_as-0045988.jpg,1,1,1,1,4,,val
0551235_as-0045988.jpg,1,1,0,0,2,,val
0551236_as-0045988.jpg,1,1,1,0,3,,test
0551237_as-0045988.jpg,1,0,1,0,2,,train
0551238_as-0045988.jpg,1,1,1,0,3,,train
0551239_sc-204609.jpg,10,2,0,3,15,,train
0551240_sc-204598.jpg,1,0,0,0,1,,train
0551241_sc-153685.jpg,0,0,1,0,1,,train
0551242_sc-153685.jpg,1,0,0,0,1,,train
0551243_sc-153685.jpg,0,0,1,0,1,,train
0551245_as-0000959.jpg,1,0,0,1,2,,val
0551247_as-2572140.jpg,1,0,1,1,3,,val
0551248_as-2572140.jpg,0,0,0,1,1,,test
0551249_as-9035010.jpg,2,0,0,1,3,,train
0551250_sc-182103.jpg,0,1,1,0,2,,train
0551251_sc-182103.jpg,3,0,1,0,4,,train
0551252_sc-182103.jpg,3,0,1,0,4,,train
0551253_sc-182103.jpg,1,0,0,0,1,,train
0551254_sc-182103.jpg,2,0,1,0,3,,train
0551255_sc-1037676.jpg,1,0,0,0,1,,train
0551256_sc-1037676.jpg,1,0,1,0,2,,val
0551257_sc-1037676.jpg,1,0,0,0,1,,val
0551258_sc-1035877.jpg,1,0,0,0,1,,test
0551259_sc-1035877.jpg,1,0,1,0,2,,train
0551260_sc-1035877.jpg,1,0,0,0,1,,train
0551262_as-7737647.jpg,1,0,0,0,1,,train
0551263_as-0083829.jpg,1,0,0,0,1,,train
0551264_as-0083829.jpg,1,0,0,0,1,,train
0551266_as-0002184.jpg,0,0,1,0,1,,train
0551267_as-0002184.jpg,0,0,1,0,1,,train
0551268_as-2789729.jpg,5,1,0,0,6,,val
0551269_sc-1023002.jpg,1,0,0,0,1,,val
0551270_sc-1023002.jpg,1,1,0,1,3,,test
0551271_sc-1023002.jpg,1,0,0,0,1,,train
0551272_sc-1023002.jpg,1,0,0,1,2,,train
0551273_as-7683318.jpg,0,0,2,1,3,,train
0551274_sc-133837.jpg,2,0,1,0,3,,train
0551277_sc-1022120.jpg,4,0,1,0,5,,train
0551278_sc-1022120.jpg,1,3,1,0,5,,train
0551279_sc-1022120.jpg,1,0,1,0,2,,train
0551280_sc-1022120.jpg,5,0,0,0,5,,val
0551281_sc-1022120.jpg,3,0,1,0,4,,val
0551282_sc-1022120.jpg,4,0,1,0,5,,test
0551283_sc-1022120.jpg,3,0,0,0,3,,train
0551285_as-0078213.jpg,2,0,0,0,2,,train
0551286_as-0078213.jpg,5,0,0,0,5,,train
0551287_as-0078213.jpg,2,0,0,0,2,,train
0551288_as-0078213.jpg,3,0,0,0,3,,train
0551290_as-3231151.jpg,2,0,0,0,2,,train
0551291_sc-149086.jpg,4,0,0,0,4,,train
0551292_sc-200026.jpg,3,0,0,0,3,,val
0551293_sc-200026.jpg,1,0,0,0,1,,val
0551294_sc-212718.jpg,1,0,0,1,2,,test
0551295_sc-212718.jpg,0,0,1,1,2,,train
0551296_sc-212718.jpg,2,0,1,1,4,,train
0551297_sc-212718.jpg,1,0,0,0,1,,train
0551298_sc-212718.jpg,1,0,0,0,1,,train
0551299_sc-212718.jpg,3,0,0,0,3,,train
0551300_sc-212718.jpg,1,0,0,0,1,,train
0551301_sc-212718.jpg,2,0,0,0,2,,train
0551302_sc-212718.jpg,1,0,0,0,1,,val
0551303_as-2740810.jpg,2,1,1,1,5,,val
0551304_sc-206633.jpg,3,0,1,2,6,,test
0551305_sc-206633.jpg,1,0,1,1,3,,train
0551306_sc-1018495.jpg,2,0,1,0,3,,train
0551307_sc-1018495.jpg,3,1,1,0,5,,train
0551309_sc-1018495.jpg,3,1,1,0,5,,train
0551310_sc-1018495.jpg,4,1,1,0,6,,train
0551313_as-0064310.jpg,1,0,0,0,1,,train
0551315_sc-1025485.jpg,2,0,0,1,3,,train
0551316_sc-142574.jpg,1,0,0,1,2,,val
0551317_as-3238357.jpg,1,0,1,0,2,,val
0551320_as-0017678.jpg,1,0,0,0,1,,test
0551321_as-0017678.jpg,2,0,0,0,2,,train
0551322_as-0017678.jpg,2,0,0,0,2,,train
0551323_as-0017678.jpg,3,0,1,0,4,,train
0551324_as-0017678.jpg,3,0,0,0,3,,train
0551325_as-0017678.jpg,5,0,0,0,5,,train
0551326_as-0017678.jpg,3,0,0,0,3,,train
0551327_as-0017678.jpg,3,0,0,0,3,,train
0551328_as-0017678.jpg,7,0,0,0,7,,val
0551329_as-7472536.jpg,0,0,0,2,2,,val
0551330_as-7297847.jpg,1,0,0,0,1,,test
0551332_sc-218409.jpg,3,1,1,0,5,,train
0551333_sc-218409.jpg,6,0,4,1,11,,train
0551334_as-0062502.jpg,1,0,0,0,1,,train
0551341_as-0062502.jpg,1,0,0,0,1,,train
0551342_sc-212373.jpg,5,0,0,0,5,,train
0551343_sc-212373.jpg,10,0,0,0,10,,train
0551344_sc-212373.jpg,5,0,0,0,5,,train
0551345_sc-212373.jpg,5,0,1,0,6,,val
0551346_sc-212373.jpg,6,0,1,0,7,,val
0551347_sc-212373.jpg,4,1,1,0,6,,test
0551348_sc-212373.jpg,8,0,0,0,8,,train
0551349_sc-212373.jpg,9,0,0,0,9,,train
0551350_sc-212373.jpg,8,0,1,0,9,,train
0551351_sc-212373.jpg,1,0,1,0,2,,train
0551352_as-3040018.jpg,1,0,0,0,1,,train
0551356_sc-133211.jpg,2,0,0,0,2,,train
0551359_sc-133211.jpg,1,1,0,1,3,,train
0551361_sc-1024938.jpg,0,0,1,1,2,,val
0551362_sc-1024938.jpg,1,0,1,1,3,,val
0551363_as-0021387.jpg,2,1,1,1,5,,test
0551364_sc-224076.jpg,0,1,0,0,1,,train
0551365_sc-224076.jpg,1,0,2,0,3,,train
0551366_sc-224076.jpg,1,0,1,0,2,,train
0551368_as-0033662.jpg,1,1,0,0,2,,train
0551369_as-0033662.jpg,0,1,0,0,1,,train
0551372_sc-190973.jpg,1,0,1,0,2,,train
0551373_sc-190973.jpg,1,0,0,0,1,,train
0551374_sc-190973.jpg,1,0,0,0,1,,val
0551376_sc-162356.jpg,1,1,1,0,3,,val
0551379_as-0042357.jpg,3,0,0,0,3,,test
0551380_sc-118897.jpg,0,0,0,1,1,,train
0551381_sc-118897.jpg,3,0,0,1,4,,train
0551382_sc-118897.jpg,0,0,0,1,1,,train
0551383_sc-118897.jpg,2,0,0,1,3,,train
0551384_as-3376810.jpg,2,0,1,1,4,,train
0551385_sc-149496.jpg,2,2,2,0,6,,train
0551386_sc-149496.jpg,2,0,1,0,3,,train
0551387_sc-149496.jpg,1,0,0,0,1,,val
0551388_sc-113796.jpg,7,0,0,0,7,,val
0551389_sc-113796.jpg,6,0,0,0,6,,test
0551390_sc-113796.jpg,5,0,0,0,5,,train
0551391_sc-113796.jpg,3,0,0,0,3,,train
0551392_sc-113796.jpg,2,0,0,0,2,,train
0551393_sc-113796.jpg,3,0,0,0,3,,train
0551394_sc-113796.jpg,2,0,0,0,2,,train
0551403_as-0096851.jpg,1,1,1,1,4,,train
0551406_sc-134626.jpg,3,0,0,2,5,,train
0551407_sc-124464.jpg,6,0,0,0,6,,val
0551408_sc-124464.jpg,14,0,0,0,14,,val
0551410_sc-124464.jpg,13,0,0,0,13,,test
0551411_sc-124464.jpg,2,0,1,0,3,,train
0551412_as-3367883.jpg,1,0,0,0,1,,train
0551413_sc-128077.jpg,3,0,0,1,4,,train
0551414_sc-128077.jpg,2,0,0,1,3,,train
0551415_sc-128077.jpg,1,0,0,1,2,,train
0551416_as-3296103.jpg,0,1,0,0,1,,train
0551417_as-3386481.jpg,1,0,0,0,1,,train
0551418_as-0075195.jpg,3,0,0,0,3,,val
0551419_as-0075195.jpg,1,0,0,0,1,,val
0551420_as-0075195.jpg,1,0,0,0,1,,test
0551421_sc-225662.jpg,3,0,1,0,4,,train
0551422_as-7309814.jpg,1,0,0,0,1,,train
0551424_as-0061242.jpg,2,1,1,0,4,,train
0551426_as-3285569.jpg,0,1,0,0,1,,train
0551428_as-7558369.jpg,2,0,1,0,3,,train
0551429_sc-1006018.jpg,2,0,0,0,2,,train
0551430_as-7690302.jpg,1,0,2,0,3,,train
0551431_sc-148401.jpg,6,0,2,1,9,,val
0551432_sc-148401.jpg,5,2,3,3,13,,val
0551433_sc-148401.jpg,14,3,1,2,20,,test
0551434_sc-148401.jpg,1,0,0,0,1,,train
0551435_sc-148401.jpg,2,0,0,0,2,,train
0551436_sc-148401.jpg,2,1,2,1,6,,train
0551437_sc-148401.jpg,4,2,0,0,6,,train
0551440_sc-151774.jpg,3,0,0,0,3,,train
0551441_sc-151774.jpg,2,0,1,0,3,,train
0551443_sc-151774.jpg,2,0,0,0,2,,train
0551444_sc-151774.jpg,3,0,0,0,3,,val
0551445_sc-151774.jpg,6,0,0,0,6,,val
0551446_sc-151774.jpg,5,0,0,0,5,,test
0551447_sc-151774.jpg,4,0,0,0,4,,train
0551448_sc-151774.jpg,4,0,0,0,4,,train
0551449_sc-151774.jpg,4,0,0,1,5,,train
0551450_sc-151774.jpg,4,0,0,1,5,,train
0551451_sc-151774.jpg,2,0,0,0,2,,train
0551453_sc-107432.jpg,1,1,0,0,2,,train
0551454_sc-190339.jpg,1,0,0,0,1,,train
0551456_sc-190339.jpg,1,0,0,0,1,,val
0551457_sc-148228.jpg,2,0,0,0,2,,val
0551458_as-0012919.jpg,0,0,1,1,2,,test
0551459_as-0012919.jpg,0,0,1,1,2,,train
0551460_as-0012919.jpg,0,0,1,1,2,,train
0551461_as-0012919.jpg,0,0,0,1,1,,train
0551462_as-0012919.jpg,0,0,0,1,1,,train
0551463_as-0012919.jpg,1,0,0,0,1,,train
0551464_as-0012919.jpg,1,0,0,0,1,,train
0551465_sc-207382.jpg,3,0,0,0,3,,train
0551466_sc-207382.jpg,1,0,0,0,1,,val
0551467_sc-207382.jpg,3,0,0,0,3,,val
0551468_sc-207382.jpg,2,0,0,0,2,,test
0551469_sc-207382.jpg,1,0,0,0,1,,train
0551470_sc-207382.jpg,4,0,0,0,4,,train
0551471_as-2918127.jpg,3,0,1,1,5,,train
0551472_sc-225648.jpg,1,0,0,0,1,,train
0551474_sc-225648.jpg,0,2,0,1,3,,train
0551475_as-0048162.jpg,0,0,1,0,1,,train
0551476_sc-1033822.jpg,3,1,1,1,6,,train
0551477_sc-1033822.jpg,3,2,1,1,7,,val
0551478_sc-1033822.jpg,2,1,1,1,5,,val
0551479_as-0091922.jpg,1,0,1,1,3,,test
0551485_as-0091922.jpg,2,0,1,0,3,,train
0551486_as-0091922.jpg,3,0,1,1,5,,train
0551487_as-0091922.jpg,4,0,1,1,6,,train
0551488_as-0091922.jpg,2,0,0,1,3,,train
0551489_as-0091922.jpg,4,0,1,1,6,,train
0551490_as-0091922.jpg,5,0,1,0,6,,train
0551491_as-0001960.jpg,3,0,0,2,5,,train
0551492_as-0001960.jpg,2,0,0,0,2,,val
0551494_as-0077207.jpg,4,0,0,1,5,,val
0551495_as-0077207.jpg,1,0,1,1,3,,test
0551496_as-0077207.jpg,1,0,1,1,3,,train
0551497_as-0077207.jpg,2,0,0,0,2,,train
0551498_as-0077207.jpg,1,1,0,0,2,,train
0551499_as-0077207.jpg,1,1,0,0,2,,train
0551501_as-2660962.jpg,6,0,0,0,6,,train
0551502_as-0035943.jpg,1,0,1,0,2,,train
0551504_sc-176469.jpg,1,0,0,1,2,,train
0551505_sc-176469.jpg,1,0,0,1,2,,val
0551506_sc-190191.jpg,2,2,0,0,4,,val
0551507_as-4932740.jpg,0,0,2,0,2,,test
0551508_as-3321290.jpg,1,0,0,1,2,,train
0551509_as-0084936.jpg,0,0,1,0,1,,train
0551510_as-0084936.jpg,1,0,1,0,2,,train
0551512_as-0052221.jpg,6,0,0,0,6,,train
0551513_as-3371285.jpg,1,0,0,0,1,,train
0551514_as-2630512.jpg,0,0,1,0,1,,train
0551517_as-0052838.jpg,0,1,0,0,1,,train
0551518_as-0052838.jpg,0,1,0,0,1,,val
0551519_as-0052838.jpg,0,1,0,0,1,,val
0551520_as-0052838.jpg,0,1,0,0,1,,test
0551521_as-0052838.jpg,0,1,0,0,1,,train
0551522_as-3095343.jpg,1,0,0,0,1,,train
0551523_sc-124325.jpg,1,1,1,0,3,,train
0551527_sc-124325.jpg,0,1,0,0,1,,train
0551528_as-2558211.jpg,1,0,0,0,1,,train
0551529_sc-205527.jpg,2,0,0,0,2,,train
0551530_sc-205527.jpg,1,0,0,0,1,,train
0551531_sc-205527.jpg,2,0,0,0,2,,val
0551532_as-0013682.jpg,2,0,0,0,2,,val
0551533_as-0013682.jpg,2,0,0,0,2,,test
0551534_as-3021223.jpg,2,0,0,0,2,,train
0551536_as-0082318.jpg,1,0,0,1,2,,train
0551537_as-0082318.jpg,1,0,0,2,3,,train
0551538_as-0082318.jpg,2,0,1,1,4,,train
0551539_as-0082318.jpg,2,1,1,0,4,,train
0551540_as-0082318.jpg,1,0,1,0,2,,train
0551541_as-0082318.jpg,3,1,1,0,5,,train
0551542_as-0082318.jpg,1,0,0,0,1,,val
0551544_as-0082318.jpg,1,0,0,0,1,,val
0551546_as-0082318.jpg,1,0,0,0,1,,test
0551547_as-0082318.jpg,2,0,0,0,2,,train
0551548_as-0082318.jpg,1,0,0,0,1,,train
0551549_as-0082318.jpg,2,0,1,0,3,,train
0551550_as-0082318.jpg,1,0,0,0,1,,train
0551551_as-0082318.jpg,1,0,0,0,1,,train
0551553_as-3147010.jpg,0,2,1,0,3,,train
0551556_as-0082066.jpg,1,1,1,0,3,,train
0551558_as-0082066.jpg,0,0,1,0,1,,val
0551559_as-0082066.jpg,0,0,1,0,1,,val
0551560_sc-176249.jpg,1,1,1,0,3,,test
0551561_sc-176249.jpg,0,1,1,0,2,,train
0551562_sc-176249.jpg,1,0,0,0,1,,train
0551564_as-0025286.jpg,1,0,1,0,2,,train
0551565_as-0025286.jpg,7,0,1,0,8,,train
0551566_as-3060604.jpg,6,0,0,0,6,,train
0551567_as-0056706.jpg,4,2,1,2,9,,train
0551568_as-0056706.jpg,1,0,1,0,2,,train
0551569_as-0056706.jpg,4,1,1,0,6,,val
0551570_as-0056706.jpg,0,1,0,0,1,,val
0551571_as-0056706.jpg,1,0,0,0,1,,test
0551572_as-0056706.jpg,2,0,0,0,2,,train
0551573_sc-223751.jpg,0,0,1,0,1,,train
0551574_sc-223751.jpg,1,0,0,0,1,,train
0551575_sc-223751.jpg,1,0,0,0,1,,train
0551576_as-0083544.jpg,1,0,0,0,1,,train
0551577_as-0083544.jpg,3,0,0,0,3,,train
0551579_as-0083544.jpg,1,0,0,0,1,,train
0551583_as-7962462.jpg,0,0,2,0,2,,val
0551584_sc-222078.jpg,3,0,0,0,3,,val
0551585_sc-222078.jpg,3,0,0,0,3,,test
0551586_sc-222078.jpg,7,0,0,2,9,,train
0551587_sc-222078.jpg,4,0,0,2,6,,train
0551588_sc-222078.jpg,6,0,0,2,8,,train
0551589_as-0028793.jpg,1,0,0,0,1,,train
0551590_as-0028793.jpg,2,0,0,0,2,,train
0551591_as-3011519.jpg,2,0,2,0,4,,train
0551592_sc-146308.jpg,4,1,0,1,6,,train
0551594_as-3210175.jpg,2,1,2,1,6,,val
0551595_as-0051731.jpg,1,0,1,0,2,,val
0551596_as-0065415.jpg,6,0,0,0,6,,test
0551597_as-0065415.jpg,2,0,0,0,2,,train
0551598_as-0065415.jpg,4,0,0,0,4,,train
0551599_as-0065415.jpg,3,0,0,0,3,,train
0551600_as-0065415.jpg,3,0,0,0,3,,train
0551602_as-0065415.jpg,5,0,0,0,5,,train
0551603_as-0065415.jpg,2,0,0,0,2,,train
0551608_as-0095916.jpg,2,0,0,0,2,,train
0551609_as-0095916.jpg,2,0,0,0,2,,val
0551610_sc-196867.jpg,2,1,0,1,4,,val
0551611_sc-196867.jpg,2,0,1,1,4,,test
0551612_as-7531990.jpg,1,0,0,0,1,,train
0551613_as-0090418.jpg,1,0,0,0,1,,train
0551614_as-0090418.jpg,1,0,0,0,1,,train
0551616_sc-131209.jpg,1,0,0,1,2,,train
0551617_as-0056175.jpg,1,2,0,0,3,,train
0551618_as-0056175.jpg,0,1,0,0,1,,train
0551619_as-0056175.jpg,1,1,0,0,2,,train
0551620_as-0056175.jpg,0,1,0,0,1,,val
0551626_as-0074158.jpg,1,1,1,0,3,,val
0551627_as-0074158.jpg,1,0,0,0,1,,test
0551628_as-0074158.jpg,1,0,0,0,1,,train
0551629_as-0074158.jpg,1,0,1,0,2,,train
0551631_as-0074158.jpg,0,0,1,0,1,,train
0551632_sc-177238.jpg,5,1,1,0,7,,train
0551633_sc-177238.jpg,2,0,0,0,2,,train
0551634_sc-177238.jpg,5,0,0,0,5,,train
0551635_sc-177238.jpg,6,0,0,0,6,,train
0551636_as-0018871.jpg,1,0,0,1,2,,val
0551640_sc-1021673.jpg,4,0,0,0,4,,val
0551641_sc-1021673.jpg,1,0,1,0,2,,test
0551642_sc-226953.jpg,5,0,1,1,7,,train
0551643_sc-226953.jpg,4,0,1,1,6,,train
0551644_sc-216552.jpg,1,0,0,0,1,,train
0551645_sc-216552.jpg,1,0,0,0,1,,train
0551646_sc-216552.jpg,1,0,0,0,1,,train
0551647_sc-184128.jpg,2,0,0,0,2,,train
0551648_sc-138113.jpg,2,0,0,0,2,,train
0551649_sc-138113.jpg,1,0,0,0,1,,val
0551651_as-0076658.jpg,1,1,0,0,2,,val
0551652_as-0076658.jpg,3,1,0,0,4,,test
0551653_as-3080337.jpg,2,2,1,1,6,,train
0551654_sc-1017542.jpg,2,0,0,1,3,,train
0551655_sc-1017542.jpg,1,0,0,0,1,,train
0551656_sc-1017542.jpg,6,0,0,0,6,,train
0551657_sc-1017542.jpg,3,0,0,1,4,,train
0551658_as-0016794.jpg,1,1,0,1,3,,train
0551659_as-0016794.jpg,1,1,1,0,3,,train
0551660_as-0016794.jpg,1,0,0,0,1,,val
0551661_sc-209905.jpg,1,0,0,0,1,,val
0551662_sc-209905.jpg,1,0,0,0,1,,test
0551663_sc-209905.jpg,1,0,0,0,1,,train
0551664_as-7591710.jpg,2,0,0,0,2,,train
0551665_sc-180783.jpg,4,0,0,0,4,,train
0551666_sc-180783.jpg,1,0,0,0,1,,train
0551667_sc-180783.jpg,1,0,0,0,1,,train
0551668_sc-180783.jpg,2,0,0,0,2,,train
0551669_sc-1017438.jpg,7,0,2,1,10,,train
0551671_sc-1017438.jpg,6,0,0,2,8,,val
0551672_sc-129258.jpg,4,1,1,1,7,,val
0551673_sc-103411.jpg,1,0,0,0,1,,test
0551674_sc-103411.jpg,1,0,0,0,1,,train
0551676_sc-155675.jpg,5,0,0,0,5,,train
0551677_sc-155675.jpg,5,0,0,0,5,,train
0551678_sc-155675.jpg,4,0,0,0,4,,train
0551681_sc-221440.jpg,0,0,0,1,1,,train
0551682_sc-221440.jpg,2,2,1,0,5,,train
0551683_sc-221440.jpg,0,0,0,2,2,,train
0551684_sc-221440.jpg,0,0,0,2,2,,val
0551685_sc-221440.jpg,5,0,0,0,5,,val
0551686_sc-221440.jpg,3,0,0,2,5,,test
0551687_sc-221440.jpg,6,0,1,2,9,,train
0551688_as-7907841.jpg,2,0,0,0,2,,train
0551689_as-0035552.jpg,2,1,1,0,4,,train
0551690_sc-189705.jpg,2,0,1,0,3,,train
0551691_sc-189705.jpg,2,0,0,0,2,,train
0551692_sc-189705.jpg,7,0,0,0,7,,train
0551693_sc-189705.jpg,2,0,0,0,2,,train
0551695_sc-190532.jpg,2,0,0,0,2,,val
0551696_sc-190532.jpg,6,2,0,0,8,,val
0551697_as-3013548.jpg,2,0,1,0,3,,test
0551698_sc-185635.jpg,2,0,1,2,5,,train
0551699_sc-185635.jpg,2,0,0,2,4,,train
0551700_sc-185635.jpg,2,0,1,2,5,,train
0551701_sc-185635.jpg,1,0,1,2,4,,train
0551702_sc-185635.jpg,2,0,1,2,5,,train
0551703_sc-185635.jpg,2,0,0,1,3,,train
0551705_as-0026208.jpg,3,0,0,1,4,,train
0551706_as-0026208.jpg,3,0,1,0,4,,val
0551708_as-0026208.jpg,2,0,1,1,4,,val
0551709_as-0026208.jpg,1,1,0,0,2,,test
0551710_as-0026208.jpg,1,1,0,0,2,,train
0551711_as-3023727.jpg,0,0,1,0,1,,train
0551712_as-0050503.jpg,4,4,3,2,13,,train
0551713_as-0050503.jpg,0,1,2,0,3,,train
0551715_as-7743946.jpg,3,1,1,0,5,,train
0551716_as-0091764.jpg,1,0,0,0,1,,train
0551718_as-0091764.jpg,1,0,0,0,1,,train
0551719_as-0091764.jpg,1,0,0,1,2,,val
0551720_as-0091764.jpg,1,0,0,1,2,,val
0551721_as-0091764.jpg,1,0,0,1,2,,test
0551722_as-0091764.jpg,1,0,0,0,1,,train
0551723_as-0091764.jpg,1,0,0,1,2,,train
0551724_as-0091764.jpg,1,0,0,1,2,,train
0551725_as-2595670.jpg,1,0,0,0,1,,train
0551727_as-0029691.jpg,2,1,1,0,4,,train
0551729_as-0029691.jpg,0,1,2,0,3,,train
0551730_as-0029691.jpg,1,0,0,0,1,,train
0551733_as-7775035.jpg,5,1,0,0,6,,val
0551735_sc-150637.jpg,1,0,1,1,3,,val
0551736_sc-150637.jpg,1,0,2,0,3,,test
0551737_sc-150637.jpg,1,0,1,1,3,,train
0551738_as-2971613.jpg,6,0,1,1,8,,train
0551739_as-2705318.jpg,1,0,0,0,1,,train
0551740_sc-111914.jpg,2,0,1,0,3,,train
0551742_as-0011727.jpg,2,1,1,1,5,,train
0551743_as-0011727.jpg,2,1,1,1,5,,train
0551744_as-0011727.jpg,0,0,2,0,2,,train
0551746_as-0018902.jpg,2,1,0,0,3,,val
0551747_as-0018902.jpg,1,0,1,0,2,,val
0551748_as-0018902.jpg,1,0,0,0,1,,test
0551749_as-0018902.jpg,1,2,0,0,3,,train
0551750_as-0018902.jpg,0,1,0,0,1,,train
0551751_as-0018902.jpg,0,1,1,0,2,,train
0551752_as-0018902.jpg,0,1,1,0,2,,train
0551753_as-7042397.jpg,0,1,0,0,1,,train
0551754_as-9030652.jpg,1,0,1,2,4,,train
0551756_as-0017606.jpg,1,0,1,1,3,,train
0551757_as-0017606.jpg,1,0,0,0,1,,val
0551758_as-0036636.jpg,1,0,0,1,2,,val
0551759_as-0036636.jpg,1,1,1,1,4,,test
0551760_as-0036636.jpg,2,0,0,1,3,,train
0551761_as-0036636.jpg,3,0,0,0,3,,train
0551762_as-0014647.jpg,2,2,1,0,5,,train
0551763_as-0014647.jpg,1,0,0,0,1,,train
0551764_as-0014647.jpg,2,0,1,0,3,,train
0551765_as-0014647.jpg,2,0,1,0,3,,train
0551766_as-0014647.jpg,2,0,1,0,3,,train
0551767_sc-1015442.jpg,1,1,0,0,2,,val
0551768_sc-1015442.jpg,1,1,0,0,2,,val
0551769_sc-1015442.jpg,3,0,0,0,3,,test
0551771_as-2514008.jpg,2,0,1,1,4,,train
0551773_sc-188365.jpg,2,0,0,2,4,,train
0551775_sc-188365.jpg,0,0,1,0,1,,train
0551776_sc-188365.jpg,0,0,1,0,1,,train
0551777_sc-188365.jpg,3,1,2,0,6,,train
0551778_sc-188365.jpg,2,1,3,0,6,,train
0551780_sc-188365.jpg,0,0,1,0,1,,train
0551781_sc-188365.jpg,0,1,4,1,6,,val
0551782_sc-188365.jpg,2,0,0,1,3,,val
0551783_sc-188365.jpg,1,0,0,0,1,,test
0551784_sc-188365.jpg,2,0,0,1,3,,train
0551785_sc-188365.jpg,2,0,0,1,3,,train
0551786_sc-188365.jpg,2,1,0,1,4,,train
0551787_sc-188365.jpg,3,1,1,1,6,,train
0551788_sc-188365.jpg,3,0,1,1,5,,train
0551791_as-0066801.jpg,1,1,0,0,2,,train
0551792_as-2726648.jpg,1,0,0,1,2,,train
0551793_sc-133974.jpg,1,0,0,2,3,,val
0551794_sc-133974.jpg,2,0,0,0,2,,val
0551795_sc-133974.jpg,2,0,0,1,3,,test
0551797_sc-131302.jpg,1,1,1,0,3,,train
0551798_sc-131302.jpg,0,1,0,0,1,,train
0551799_sc-209451.jpg,3,0,0,0,3,,train
0551800_sc-209451.jpg,3,0,0,0,3,,train
0551801_sc-209451.jpg,3,1,1,0,5,,train
0551802_sc-209451.jpg,1,0,0,0,1,,train
0551803_sc-209451.jpg,1,0,0,0,1,,train
0551804_as-7295090.jpg,2,0,0,0,2,,val
0551805_sc-173624.jpg,0,2,0,0,2,,val
0551806_sc-173624.jpg,0,1,0,0,1,,test
0551807_sc-157027.jpg,1,0,2,1,4,,train
0551808_sc-157027.jpg,1,0,2,2,5,,train
0551809_sc-157027.jpg,1,1,2,2,6,,train
0551810_sc-157027.jpg,1,0,1,1,3,,train
0551811_sc-157027.jpg,2,0,2,1,5,,train
0551812_sc-157027.jpg,1,0,2,2,5,,train
0551813_sc-178444.jpg,1,0,3,0,4,,train
0551814_sc-1017155.jpg,1,1,0,0,2,,val
0551815_sc-1017155.jpg,1,1,0,0,2,,val
0551818_sc-1017155.jpg,1,1,0,0,2,,test
0551819_sc-1017155.jpg,2,0,0,0,2,,train
0551820_as-0036945.jpg,1,0,0,0,1,,train
0551821_as-0036945.jpg,0,1,0,0,1,,train
0551822_as-0036945.jpg,0,1,1,1,3,,train
0551823_as-0036945.jpg,0,1,0,0,1,,train
0551826_as-0036945.jpg,0,0,1,0,1,,train
0551828_as-0036945.jpg,0,1,1,0,2,,train
0551829_as-0036945.jpg,1,3,0,0,4,,val
0551830_as-0036945.jpg,1,2,0,0,3,,val
0551832_as-2573882.jpg,0,0,0,1,1,,test
0551833_as-0093913.jpg,3,0,0,0,3,,train
0551834_as-7939702.jpg,0,0,1,1,2,,train
0551835_sc-188500.jpg,1,1,1,1,4,,train
0551836_sc-188500.jpg,1,0,0,0,1,,train
0551837_sc-188500.jpg,1,0,1,1,3,,train
0551838_sc-188500.jpg,1,0,0,1,2,,train
0551840_as-0094744.jpg,1,0,0,0,1,,train
0551841_as-0094744.jpg,1,0,0,0,1,,val
0551842_as-0094744.jpg,1,0,0,0,1,,val
0551843_as-0094744.jpg,1,0,0,0,1,,test
0551844_as-2534984.jpg,1,0,0,0,1,,train
0551845_as-2768328.jpg,1,0,1,0,2,,train
0551846_as-9023363.jpg,1,0,2,0,3,,train
0551847_as-2549163.jpg,0,0,1,0,1,,train
0551850_as-0059289.jpg,6,0,0,0,6,,train
0551851_as-0059289.jpg,6,0,0,0,6,,train
0551853_as-0059289.jpg,2,0,0,0,2,,train
0551854_as-0059289.jpg,1,0,0,0,1,,val
0551855_as-0059289.jpg,3,0,0,0,3,,val
0551856_as-0059289.jpg,2,0,0,0,2,,test
0551858_as-0059289.jpg,4,0,0,0,4,,train
0551860_sc-118800.jpg,1,1,1,1,4,,train
0551861_sc-118800.jpg,1,1,0,1,3,,train
0551862_sc-118800.jpg,2,1,1,1,5,,train
0551863_as-7374197.jpg,0,0,1,0,1,,train
0551864_sc-216013.jpg,0,1,0,0,1,,train
0551865_as-7654296.jpg,0,1,0,0,1,,train
0551866_as-2613988.jpg,2,1,0,0,3,,val
0551869_as-7836460.jpg,2,0,0,0,2,,val
0551870_sc-107541.jpg,1,0,0,0,1,,test
0551871_sc-220789.jpg,3,0,0,0,3,,train
0551872_sc-220789.jpg,1,0,0,0,1,,train
0551873_sc-220789.jpg,1,0,0,0,1,,train
0551874_as-7099213.jpg,3,0,1,0,4,,train
0551875_sc-214671.jpg,3,0,1,1,5,,train
0551876_sc-214671.jpg,3,2,0,0,5,,train
0551877_sc-214671.jpg,7,1,0,0,8,,train
0551878_sc-214671.jpg,1,1,1,0,3,,val
0551879_sc-214671.jpg,2,1,1,1,5,,val
0551880_sc-1028953.jpg,6,0,0,0,6,,test
0551884_as-0065873.jpg,4,1,0,0,5,,train
0551886_as-0065873.jpg,5,1,0,0,6,,train
0551888_sc-1028017.jpg,8,0,0,0,8,,train
0551891_as-0036241.jpg,0,0,1,0,1,,train
0551892_as-0036241.jpg,1,0,0,1,2,,train
0551893_as-0036241.jpg,0,0,1,0,1,,train
0551894_as-0036241.jpg,0,0,1,0,1,,train
0551896_as-0036241.jpg,2,0,0,1,3,,val
0551897_as-0090533.jpg,2,0,0,0,2,,val
0551898_sc-111783.jpg,1,0,0,0,1,,test
0551899_sc-111783.jpg,2,0,0,0,2,,train
0551900_sc-111783.jpg,6,0,0,0,6,,train
0551901_sc-111783.jpg,3,0,0,0,3,,train
0551902_sc-111783.jpg,2,0,0,0,2,,train
0551904_sc-124964.jpg,4,0,0,0,4,,train
0551905_sc-124964.jpg,3,0,0,0,3,,train
0551906_sc-224257.jpg,0,0,2,0,2,,train
0551907_sc-224257.jpg,0,0,4,0,4,,val
0551908_sc-224257.jpg,0,0,3,0,3,,val
0551909_sc-225879.jpg,1,1,0,0,2,,test
0551910_as-3135986.jpg,1,1,0,0,2,,train
0551911_as-2542330.jpg,1,0,0,0,1,,train
0551912_as-2596303.jpg,2,0,0,1,3,,train
0551913_sc-198370.jpg,2,0,2,0,4,,train
0551915_as-0006206.jpg,0,1,2,1,4,,train
0551916_as-0006206.jpg,0,1,2,1,4,,train
0551917_as-0006206.jpg,1,1,1,0,3,,train
0551918_as-0006206.jpg,3,0,0,0,3,,val
0551919_as-0006206.jpg,1,1,0,0,2,,val
0551920_as-0006206.jpg,0,1,0,0,1,,test
0551921_as-0006206.jpg,0,2,0,0,2,,train
0551922_as-2907006.jpg,4,0,1,0,5,,train
0551923_sc-114180.jpg,1,1,0,0,2,,train
0551924_sc-114180.jpg,1,1,0,0,2,,train
0551925_sc-114180.jpg,1,1,1,0,3,,train
0551926_sc-198846.jpg,1,0,0,1,2,,train
0551927_sc-198846.jpg,3,0,0,1,4,,train
0551928_sc-198846.jpg,1,0,0,1,2,,val
0551930_as-0072777.jpg,1,0,1,1,3,,val
0551932_sc-135260.jpg,1,0,0,1,2,,test
0551933_sc-135260.jpg,3,0,0,1,4,,train
0551934_sc-135260.jpg,3,0,0,0,3,,train
0551935_sc-135260.jpg,0,0,0,1,1,,train
0551936_as-0053804.jpg,1,0,0,0,1,,train
0551937_as-0053804.jpg,1,0,0,0,1,,train
0551938_as-0053804.jpg,1,0,0,0,1,,train
0551939_as-0053804.jpg,2,0,0,0,2,,train
0551940_sc-107314.jpg,3,1,0,0,4,,val
0551941_sc-107314.jpg,4,1,0,0,5,,val
0551942_sc-107314.jpg,3,0,0,0,3,,test
0551943_sc-107314.jpg,2,1,0,0,3,,train
0551944_sc-195516.jpg,0,0,2,0,2,,train
0551945_sc-195516.jpg,5,0,0,1,6,,train
0551946_sc-195516.jpg,2,0,0,1,3,,train
0551947_as-0048429.jpg,3,0,1,0,4,,train
0551949_as-0033595.jpg,1,1,0,0,2,,train
0551950_as-0041916.jpg,2,2,1,1,6,,train
0551951_as-0041916.jpg,1,0,0,0,1,,val
0551952_as-0041916.jpg,4,0,0,0,4,,val
0551953_as-3401506.jpg,2,0,0,0,2,,test
0551955_as-3025692.jpg,3,0,1,0,4,,train
0551956_sc-124728.jpg,4,0,0,0,4,,train
0551958_sc-124728.jpg,1,0,0,0,1,,train
0551959_sc-124728.jpg,3,0,0,0,3,,train
0551960_sc-124728.jpg,4,0,0,0,4,,train
0551961_sc-222363.jpg,4,0,0,0,4,,train
0551962_sc-222363.jpg,2,0,0,0,2,,train
0551963_sc-222363.jpg,3,0,0,0,3,,val
0551964_sc-222363.jpg,2,0,1,1,4,,val
0551965_sc-120321.jpg,4,0,0,0,4,,test
0551966_sc-120321.jpg,4,0,0,0,4,,train
0551967_sc-120321.jpg,1,0,0,0,1,,train
0551969_as-3336622.jpg,2,0,0,0,2,,train
0551970_as-2557476.jpg,1,0,1,1,3,,train
0551971_as-2984582.jpg,3,0,0,0,3,,train
0551972_as-0028107.jpg,1,0,0,2,3,,train
0551973_as-0028107.jpg,1,0,0,1,2,,train
0551974_as-0028107.jpg,1,0,0,1,2,,val
0551975_as-0028107.jpg,0,0,0,2,2,,val
0551978_sc-225207.jpg,0,1,0,0,1,,test
0551979_as-0011283.jpg,1,0,0,0,1,,train
0551981_sc-205254.jpg,0,0,1,0,1,,train
0551982_sc-205254.jpg,2,0,2,1,5,,train
0551983_sc-205254.jpg,3,1,1,0,5,,train
0551984_sc-205254.jpg,1,0,0,0,1,,train
0551985_sc-131707.jpg,1,0,0,0,1,,train
0551986_as-3056427.jpg,1,0,0,0,1,,train
0551987_sc-165858.jpg,2,1,0,0,3,,val
0551988_sc-165858.jpg,2,1,0,0,3,,val
0551989_sc-1030869.jpg,1,0,0,0,1,,test
0551990_sc-1030869.jpg,1,0,0,0,1,,train
0551991_sc-1030869.jpg,1,0,0,0,1,,train
0551992_sc-1030869.jpg,1,0,0,0,1,,train
0551994_as-7171818.jpg,6,0,0,0,6,,train
0551995_as-0031212.jpg,1,0,0,0,1,,train
0551996_as-0059390.jpg,2,2,1,2,7,,train
0551998_as-7193676.jpg,2,0,0,1,3,,train
0551999_sc-1008254.jpg,1,0,0,1,2,,val
0552000_sc-1008254.jpg,1,0,0,1,2,,val
0552001_sc-1008254.jpg,2,0,0,0,2,,test
0552002_sc-1008254.jpg,4,0,0,0,4,,train
0552003_as-3046454.jpg,1,0,0,1,2,,train
0552004_as-0092383.jpg,2,0,0,1,3,,train
0552005_as-0030064.jpg,9,0,1,0,10,,train
0552006_as-0030064.jpg,3,0,0,0,3,,train
0552007_as-0030064.jpg,8,0,0,0,8,,train
0552008_sc-216529.jpg,1,0,0,0,1,,train
0552009_sc-216529.jpg,1,0,0,0,1,,val
0552010_sc-216529.jpg,1,0,0,0,1,,val
0552011_sc-216529.jpg,1,0,0,0,1,,test
0552012_sc-216529.jpg,2,0,0,0,2,,train
0552013_sc-216529.jpg,1,0,0,0,1,,train
0552014_sc-216529.jpg,2,0,0,0,2,,train
0552015_sc-216529.jpg,0,0,1,0,1,,train
0552016_sc-216529.jpg,0,1,0,0,1,,train
0552017_as-0045819.jpg,1,0,0,0,1,,train
0552018_as-0045819.jpg,3,0,0,0,3,,train
0552019_as-0049175.jpg,2,2,2,1,7,,val
0552020_as-0049175.jpg,1,2,3,1,7,,val
0552021_as-0049175.jpg,3,0,0,1,4,,test
0552022_as-0049175.jpg,1,2,2,3,8,,train
0552023_as-0049487.jpg,0,0,1,0,1,,train
0552024_as-0049487.jpg,0,0,1,0,1,,train
0552025_as-0049487.jpg,0,1,0,0,1,,train
0552026_as-0049487.jpg,1,0,1,0,2,,train
0552027_sc-220169.jpg,3,0,0,0,3,,train
0552028_sc-220169.jpg,2,0,0,0,2,,train
0552029_sc-220169.jpg,4,0,0,0,4,,val
0552030_sc-220169.jpg,2,0,0,0,2,,val
0552031_sc-1032429.jpg,2,0,0,0,2,,test
0552032_as-2671890.jpg,3,2,0,0,5,,train
0552033_sc-151164.jpg,1,1,0,0,2,,train
0552035_sc-148494.jpg,2,0,0,0,2,,train
0552036_sc-113891.jpg,1,0,0,0,1,,train
0552037_sc-113891.jpg,1,0,0,1,2,,train
0552038_sc-113891.jpg,1,0,0,1,2,,train
0552041_as-0038927.jpg,1,1,0,0,2,,train
0552042_sc-187158.jpg,3,0,0,0,3,,val
0552043_sc-187158.jpg,6,0,0,1,7,,val
0552044_sc-193816.jpg,5,0,0,0,5,,test
0552045_sc-193816.jpg,7,0,0,0,7,,train
0552046_sc-193816.jpg,4,0,0,0,4,,train
0552047_sc-193816.jpg,3,0,0,0,3,,train
0552048_sc-211976.jpg,2,0,1,0,3,,train
0552049_sc-211976.jpg,4,0,0,0,4,,train
0552050_sc-111162.jpg,0,1,1,0,2,,train
0552052_sc-148047.jpg,1,0,0,0,1,,train
0552053_sc-148047.jpg,1,0,0,0,1,,val
0552054_sc-148047.jpg,1,0,0,0,1,,val
0552055_sc-148047.jpg,1,0,0,0,1,,test
0552056_as-2595869.jpg,2,1,1,0,4,,train
0552057_as-2936188.jpg,1,0,0,0,1,,train
0552058_as-3061277.jpg,1,0,0,0,1,,train
0552059_sc-131693.jpg,4,0,0,0,4,,train
0552060_sc-131693.jpg,9,0,0,0,9,,train
0552061_sc-131693.jpg,4,0,0,0,4,,train
0552062_sc-131693.jpg,2,0,0,1,3,,train
0552063_sc-131693.jpg,1,0,0,1,2,,val
0552065_as-3080369.jpg,4,0,0,0,4,,val
0552066_as-0082384.jpg,1,0,1,0,2,,test
0552067_as-0082384.jpg,1,0,0,0,1,,train
0552068_as-0082384.jpg,1,0,0,0,1,,train
0552069_as-0082384.jpg,1,0,0,0,1,,train
0552070_as-0082384.jpg,3,0,0,0,3,,train
0552071_as-0082384.jpg,0,0,0,1,1,,train
0552072_as-0082384.jpg,4,0,0,0,4,,train
0552073_as-0082384.jpg,3,0,0,1,4,,train
0552074_as-0082384.jpg,0,0,0,1,1,,val
0552075_as-0082384.jpg,1,0,0,0,1,,val
0552076_as-0082384.jpg,1,0,0,0,1,,test
0552077_as-0082384.jpg,1,0,0,0,1,,train
0552078_sc-219226.jpg,1,0,1,0,2,,train
0552079_sc-219226.jpg,1,0,0,0,1,,train
0552080_sc-219226.jpg,2,1,0,0,3,,train
0552081_sc-162923.jpg,7,1,0,0,8,,train
0552082_sc-162923.jpg,10,1,0,0,11,,train
0552084_sc-162923.jpg,3,1,0,0,4,,train
0552085_as-2501230.jpg,0,0,1,0,1,,val
0552086_as-7222003.jpg,5,0,1,0,6,,val
0552088_sc-159159.jpg,1,0,0,0,1,,test
0552089_as-3267599.jpg,2,0,0,1,3,,train
0552090_as-2877712.jpg,0,1,0,0,1,,train
0552091_as-7296456.jpg,0,1,0,0,1,,train
0552092_as-2644187.jpg,0,0,1,0,1,,train
0552094_sc-152105.jpg,2,0,1,0,3,,train
0552095_sc-105781.jpg,1,0,0,0,1,,train
0552097_as-0080159.jpg,4,0,0,0,4,,train
0552098_as-0080159.jpg,5,0,0,0,5,,val
0552099_as-0080159.jpg,4,0,0,0,4,,val
0552101_sc-1022509.jpg,2,0,0,0,2,,test
0552102_sc-1022509.jpg,2,0,0,1,3,,train
0552106_sc-123824.jpg,3,0,0,0,3,,train
0552107_sc-1015044.jpg,0,0,1,0,1,,train
0552108_sc-1015044.jpg,1,0,0,0,1,,train
0552109_sc-1015044.jpg,1,0,0,0,1,,train
0552110_sc-1015044.jpg,1,0,1,0,2,,train
0552111_sc-1015044.jpg,0,0,1,0,1,,train
0552112_sc-1011954.jpg,0,1,1,0,2,,val
0552113_as-0026020.jpg,2,0,0,0,2,,val
0552114_as-0026020.jpg,2,0,0,0,2,,test
0552115_as-0026020.jpg,2,0,0,0,2,,train
0552116_as-7494129.jpg,1,0,1,0,2,,train
0552118_as-2688190.jpg,0,0,0,1,1,,train
0552119_as-2920343.jpg,4,0,0,0,4,,train
0552121_as-0027113.jpg,1,0,0,0,1,,train
0552122_as-0027113.jpg,1,1,1,0,3,,train
0552124_as-0027113.jpg,1,0,1,0,2,,train
0552125_as-0027113.jpg,0,0,1,0,1,,val
0552126_as-2500129.jpg,0,0,1,1,2,,val
0552127_sc-188079.jpg,1,0,0,1,2,,test
0552130_sc-188079.jpg,0,0,1,0,1,,train
0552131_as-3080202.jpg,2,0,0,0,2,,train
0552132_as-0097827.jpg,2,0,0,0,2,,train
0552133_as-0097827.jpg,2,0,0,0,2,,train
0552134_sc-141029.jpg,4,0,0,1,5,,train
0552135_sc-141029.jpg,3,0,0,2,5,,train
0552136_sc-141029.jpg,3,0,0,1,4,,train
0552137_sc-141029.jpg,3,0,0,1,4,,val
0552138_sc-1034374.jpg,5,1,0,0,6,,val
0552139_as-0017176.jpg,1,0,0,0,1,,test
0552141_as-0017176.jpg,3,0,1,1,5,,train
0552142_as-0017176.jpg,2,0,1,1,4,,train
0552143_as-0017176.jpg,3,0,1,1,5,,train
0552144_sc-1013377.jpg,1,0,1,1,3,,train
0552145_sc-167871.jpg,6,0,0,1,7,,train
0552146_sc-167871.jpg,8,0,0,2,10,,train
0552148_sc-167871.jpg,1,0,0,0,1,,train
0552149_sc-167871.jpg,1,0,0,0,1,,val
0552150_sc-167871.jpg,7,0,0,0,7,,val
0552151_sc-167871.jpg,8,0,0,1,9,,test
0552152_sc-167871.jpg,8,0,0,1,9,,train
0552153_sc-167871.jpg,6,0,0,0,6,,train
0552154_sc-167871.jpg,14,0,0,1,15,,train
0552155_sc-167871.jpg,8,0,0,1,9,,train
0552156_sc-180169.jpg,0,2,0,0,2,,train
0552157_as-2633139.jpg,2,0,0,0,2,,train
0552158_sc-202385.jpg,1,1,0,0,2,,train
0552161_as-0007182.jpg,6,0,0,0,6,,val
0552162_sc-1001361.jpg,2,1,0,0,3,,val
0552163_sc-1001361.jpg,1,1,0,0,2,,test
0552164_sc-1001361.jpg,2,1,0,0,3,,train
0552166_sc-119365.jpg,1,0,1,1,3,,train
0552168_as-0060925.jpg,1,0,0,1,2,,train
0552170_as-0060925.jpg,1,0,0,1,2,,train
0552171_as-0060925.jpg,1,0,0,0,1,,train
0552172_as-0060925.jpg,1,0,1,1,3,,train
0552173_as-0060925.jpg,2,0,0,1,3,,train
0552174_as-0060925.jpg,1,0,0,0,1,,val
0552176_sc-1019034.jpg,1,0,1,0,2,,val
0552177_as-4880444.jpg,1,0,0,0,1,,test
0552178_as-2746786.jpg,3,0,1,0,4,,train
0552179_sc-223077.jpg,1,1,0,0,2,,train
0552180_as-3280306.jpg,1,0,1,1,3,,train
0552181_as-2721293.jpg,1,0,0,0,1,,train
0552182_sc-1035723.jpg,1,0,0,0,1,,train
0552183_as-2869064.jpg,2,0,0,0,2,,train
0552184_sc-208213.jpg,2,1,0,0,3,,train
0552185_sc-208213.jpg,2,1,0,0,3,,val
0552186_sc-228763.jpg,1,0,0,1,2,,val
0552188_sc-1028417.jpg,3,0,0,0,3,,test
0552189_sc-1028417.jpg,4,0,0,0,4,,train
0552190_as-0092077.jpg,2,0,3,2,7,,train
0552191_as-0092077.jpg,1,0,2,1,4,,train
0552192_as-0092077.jpg,1,0,1,1,3,,train
0552196_as-0092077.jpg,3,0,0,3,6,,train
0552197_as-0092077.jpg,2,0,0,2,4,,train
0552198_as-0092077.jpg,2,0,0,2,4,,train
0552199_as-0092077.jpg,3,0,1,4,8,,val
0552200_as-0092077.jpg,1,0,1,2,4,,val
0552201_as-0092077.jpg,1,1,0,0,2,,test
0552202_as-0092077.jpg,1,0,0,0,1,,train
0552205_as-0092077.jpg,2,1,0,0,3,,train
0552206_sc-1030301.jpg,2,0,0,0,2,,train
0552207_sc-1030301.jpg,6,0,1,1,8,,train
0552208_sc-1030301.jpg,8,0,0,0,8,,train
0552209_sc-1030301.jpg,5,0,0,0,5,,train
0552211_sc-1030301.jpg,6,0,1,1,8,,train
0552213_as-0083425.jpg,1,0,1,1,3,,val
0552214_as-0047122.jpg,1,0,0,0,1,,val
0552215_as-0047122.jpg,1,1,1,1,4,,test
0552216_sc-197872.jpg,2,0,1,1,4,,train
0552217_as-2882760.jpg,1,0,0,1,2,,train
0552219_as-0083712.jpg,1,0,1,0,2,,train
0552220_as-0083712.jpg,1,0,1,1,3,,train
0552221_as-0083712.jpg,1,0,0,2,3,,train
0552222_as-0083712.jpg,1,0,0,1,2,,train
0552223_as-0083712.jpg,0,0,0,1,1,,train
0552224_as-3173628.jpg,1,0,2,0,3,,val
0552226_as-0044251.jpg,1,1,0,0,2,,val
0552228_as-0021391.jpg,6,0,1,0,7,,test
0552229_sc-126517.jpg,2,0,0,0,2,,train
0552230_sc-126517.jpg,3,0,1,0,4,,train
0552233_as-3273910.jpg,2,0,0,0,2,,train
0552234_as-3240781.jpg,7,0,2,0,9,,train
0552239_as-0058085.jpg,0,2,0,0,2,,train
0552240_as-0058085.jpg,6,0,0,0,6,,train
0552241_sc-1037387.jpg,2,0,0,1,3,,train
0552243_sc-1037387.jpg,2,0,0,0,2,,val
0552244_as-0052099.jpg,1,1,0,1,3,,val
0552245_sc-181449.jpg,1,0,0,0,1,,test
0552246_sc-181449.jpg,2,0,1,0,3,,train
0552247_sc-181449.jpg,1,0,1,0,2,,train
0552248_sc-181449.jpg,1,0,1,0,2,,train
0552249_sc-222526.jpg,1,0,0,0,1,,train
0552250_sc-222526.jpg,1,0,1,0,2,,train
0552251_sc-222526.jpg,3,0,2,0,5,,train
0552252_sc-222526.jpg,0,0,2,0,2,,train
0552253_sc-222526.jpg,4,0,0,0,4,,val
0552254_sc-222526.jpg,3,0,0,0,3,,val
0552255_sc-222526.jpg,4,0,0,0,4,,test
0552257_as-0027998.jpg,2,0,0,0,2,,train
0552258_as-0027998.jpg,3,0,0,0,3,,train
0552259_sc-132293.jpg,3,0,0,1,4,,train
0552260_sc-132293.jpg,3,0,0,1,4,,train
0552262_sc-132293.jpg,2,0,0,1,3,,train
0552263_sc-219393.jpg,1,0,0,0,1,,train
0552264_sc-219393.jpg,1,0,0,0,1,,train
0552265_sc-219393.jpg,2,0,0,0,2,,val
0552266_as-0047774.jpg,7,0,0,0,7,,val
0552267_as-2995872.jpg,2,0,1,0,3,,test
0552268_as-0036788.jpg,1,0,0,0,1,,train
0552269_as-0036788.jpg,1,0,0,0,1,,train
0552270_as-0036788.jpg,5,2,1,1,9,,train
0552271_as-0036788.jpg,3,2,1,0,6,,train
0552274_as-0022777.jpg,0,1,0,0,1,,train
0552275_sc-173055.jpg,4,0,0,0,4,,train
0552276_sc-173055.jpg,3,0,0,0,3,,train
0552277_as-3178767.jpg,2,0,0,0,2,,val
0552280_as-0080724.jpg,1,0,0,1,2,,val
0552281_as-0080724.jpg,1,0,0,1,2,,test
0552284_as-0048118.jpg,0,1,0,0,1,,train
0552285_as-0048118.jpg,2,0,0,0,2,,train
0552286_as-0048118.jpg,1,1,1,0,3,,train
0552287_as-0048118.jpg,1,0,0,1,2,,train
0552288_as-0048118.jpg,1,0,0,1,2,,train
0552289_as-0048118.jpg,1,0,0,1,2,,train
0552290_as-0048118.jpg,1,0,0,1,2,,train
0552291_as-0054105.jpg,1,0,0,0,1,,val
0552292_as-0054105.jpg,2,0,0,0,2,,val
0552294_sc-133892.jpg,2,0,1,1,4,,test
0552296_sc-133892.jpg,3,0,1,1,5,,train
0552297_sc-133892.jpg,3,0,1,1,5,,train
0552298_sc-133892.jpg,4,0,3,1,8,,train
0552301_sc-133892.jpg,2,0,1,1,4,,train
0552302_sc-133892.jpg,1,0,1,1,3,,train
0552303_sc-133892.jpg,2,0,1,1,4,,train
0552305_sc-133892.jpg,3,0,2,1,6,,train
0552306_as-0039424.jpg,2,0,0,0,2,,val
0552307_as-0039424.jpg,3,0,0,1,4,,val
0552308_as-0039424.jpg,2,0,0,0,2,,test
0552309_as-0039424.jpg,3,0,0,1,4,,train
0552310_as-0039424.jpg,1,0,0,1,2,,train
0552311_as-0039424.jpg,2,0,0,0,2,,train
0552316_as-0006865.jpg,4,1,1,0,6,,train
0552317_as-0006865.jpg,3,2,1,0,6,,train
0552318_sc-105697.jpg,1,0,0,0,1,,train
0552319_as-3026929.jpg,1,0,0,1,2,,train
0552322_as-0041693.jpg,1,0,0,0,1,,val
0552323_as-0041693.jpg,1,0,0,0,1,,val
0552324_as-0041693.jpg,1,0,0,0,1,,test
0552328_as-0016107.jpg,3,0,0,0,3,,train
0552329_sc-123680.jpg,0,0,1,0,1,,train
0552332_sc-212421.jpg,1,2,0,0,3,,train
0552333_sc-212421.jpg,2,5,0,0,7,,train
0552335_sc-212421.jpg,3,0,0,1,4,,train
0552336_sc-212421.jpg,1,4,0,0,5,,train
0552337_sc-212421.jpg,1,0,0,0,1,,train
0552338_sc-212421.jpg,4,4,0,0,8,,val
0552339_sc-212421.jpg,1,0,0,0,1,,val
0552340_sc-212421.jpg,4,0,0,0,4,,test
0552342_sc-212421.jpg,3,0,0,0,3,,train
0552343_sc-212421.jpg,0,0,0,2,2,,train
0552344_as-7686600.jpg,0,0,1,0,1,,train
0552345_sc-212926.jpg,3,1,0,1,5,,train
0552347_sc-212926.jpg,2,2,1,0,5,,train
0552349_sc-212926.jpg,3,3,0,1,7,,train
0552350_sc-212926.jpg,4,2,0,1,7,,train
0552352_sc-212926.jpg,2,1,0,1,4,,val
0552353_sc-212926.jpg,2,1,0,0,3,,val
0552356_as-0083494.jpg,2,0,0,0,2,,test
0552358_as-0083494.jpg,3,0,0,1,4,,train
0552359_as-0083494.jpg,2,0,0,1,3,,train
0552360_sc-213713.jpg,3,1,2,1,7,,train
0552361_as-2677833.jpg,0,0,0,1,1,,train
0552363_as-0072230.jpg,0,1,0,0,1,,train
0552364_as-0072230.jpg,0,0,1,0,1,,train
0552368_as-0072230.jpg,1,2,1,0,4,,train
0552369_as-0072230.jpg,0,0,1,0,1,,val
0552370_sc-194342.jpg,1,0,0,0,1,,val
0552371_sc-194342.jpg,2,0,1,1,4,,test
0552372_sc-194342.jpg,3,0,1,3,7,,train
0552373_sc-194342.jpg,4,0,1,3,8,,train
0552374_sc-194342.jpg,3,0,1,3,7,,train
0552375_sc-194342.jpg,2,0,1,2,5,,train
0552376_sc-160696.jpg,0,1,0,0,1,,train
0552379_as-2524204.jpg,2,0,0,0,2,,train
0552380_as-3358565.jpg,1,2,2,5,10,,train
0552381_sc-225008.jpg,2,1,0,0,3,,val
0552382_as-0053578.jpg,1,0,0,0,1,,val
0552383_sc-218239.jpg,1,0,0,1,2,,test
0552384_sc-218239.jpg,1,0,0,0,1,,train
0552385_sc-218239.jpg,1,0,0,0,1,,train
0552386_sc-218239.jpg,2,0,0,1,3,,train
0552388_as-0033938.jpg,4,1,0,0,5,,train
0552389_as-0033938.jpg,2,0,0,0,2,,train
0552391_sc-220162.jpg,1,0,0,0,1,,train
0552392_sc-220162.jpg,1,0,0,0,1,,train
0552393_sc-215209.jpg,0,2,0,0,2,,val
0552394_sc-215209.jpg,4,1,0,0,5,,val
0552395_sc-215209.jpg,6,1,0,0,7,,test
0552397_sc-1041079.jpg,1,0,0,0,1,,train
0552398_sc-1041079.jpg,1,0,0,0,1,,train
0552400_sc-1041079.jpg,6,0,1,0,7,,train
0552402_sc-137165.jpg,1,0,1,0,2,,train
0552403_sc-137165.jpg,2,0,1,0,3,,train
0552404_sc-137165.jpg,2,0,0,0,2,,train
0552406_sc-137165.jpg,2,0,0,0,2,,train
0552407_as-0024976.jpg,0,0,2,0,2,,val
0552408_as-0024976.jpg,1,0,3,1,5,,val
0552409_as-0024976.jpg,1,0,0,0,1,,test
0552410_as-0024976.jpg,1,0,1,1,3,,train
0552411_sc-173552.jpg,2,0,0,0,2,,train
0552416_as-0050915.jpg,1,0,0,0,1,,train
0552417_sc-198799.jpg,0,0,0,2,2,,train
0552418_sc-198799.jpg,2,0,0,0,2,,train
0552419_sc-198799.jpg,1,0,0,0,1,,train
0552420_sc-208793.jpg,1,0,0,0,1,,train
0552421_sc-208793.jpg,3,0,0,0,3,,val
0552422_sc-208793.jpg,1,0,0,0,1,,val
0552423_sc-208793.jpg,1,0,0,0,1,,test
0552424_as-0049005.jpg,4,0,0,1,5,,train
0552425_as-0049005.jpg,2,0,1,1,4,,train
0552426_as-0049005.jpg,8,1,1,0,10,,train
0552427_as-0049005.jpg,7,0,1,1,9,,train
0552428_as-0049005.jpg,2,0,0,0,2,,train
0552429_as-0049005.jpg,3,0,0,0,3,,train
0552430_as-0049005.jpg,3,0,0,0,3,,train
0552431_as-0049005.jpg,0,1,0,0,1,,val
0552432_as-0049005.jpg,0,1,0,0,1,,val
0552433_as-0049005.jpg,0,1,0,1,2,,test
0552434_sc-104654.jpg,1,0,0,0,1,,train
0552435_sc-104654.jpg,2,0,0,0,2,,train
0552436_sc-151749.jpg,2,1,0,0,3,,train
0552439_as-0022230.jpg,1,1,1,1,4,,train
0552440_as-0022230.jpg,1,0,1,0,2,,train
0552441_as-0022230.jpg,0,0,1,0,1,,train
0552442_as-3146747.jpg,3,1,0,0,4,,train
0552443_sc-193621.jpg,4,2,0,0,6,,val
0552445_sc-193621.jpg,1,0,0,0,1,,val
0552446_sc-193621.jpg,2,1,1,0,4,,test
0552447_sc-193621.jpg,2,1,0,0,3,,train
0552448_sc-113514.jpg,5,0,0,1,6,,train
0552449_sc-113514.jpg,3,0,0,1,4,,train
0552452_as-0053724.jpg,2,0,0,0,2,,train
0552453_as-0053724.jpg,1,0,0,0,1,,train
0552454_as-0053724.jpg,1,0,0,0,1,,train
0552455_as-0053724.jpg,1,0,1,0,2,,train
0552457_sc-230354.jpg,1,2,4,1,8,,val
0552458_sc-230354.jpg,3,1,3,0,7,,val
0552459_sc-230354.jpg,2,1,2,1,6,,test
0552461_sc-230354.jpg,2,1,3,1,7,,train
0552462_sc-230354.jpg,1,3,3,1,8,,train
0552463_sc-230354.jpg,1,1,2,1,5,,train
0552464_sc-230354.jpg,2,1,3,1,7,,train
0552465_sc-230354.jpg,1,1,2,1,5,,train
0552466_sc-230354.jpg,1,2,3,1,7,,train
0552467_as-0019545.jpg,0,0,1,1,2,,train
0552468_as-0019545.jpg,1,0,1,1,3,,val
0552470_sc-199679.jpg,2,0,0,0,2,,val
0552471_sc-199679.jpg,3,0,0,1,4,,test
0552472_sc-199679.jpg,3,0,0,0,3,,train
0552473_as-2654612.jpg,1,0,0,0,1,,train
0552474_sc-113988.jpg,1,0,0,0,1,,train
0552475_sc-113988.jpg,1,0,0,2,3,,train
0552476_sc-113988.jpg,2,0,0,3,5,,train
0552477_sc-113988.jpg,2,0,0,0,2,,train
0552478_as-3193954.jpg,4,0,1,0,5,,train
0552479_sc-1036412.jpg,0,1,1,0,2,,val
0552482_as-0058625.jpg,1,0,0,0,1,,val
0552485_as-0058625.jpg,2,0,1,1,4,,test
0552487_as-2734963.jpg,1,0,1,1,3,,train
0552488_as-3218700.jpg,5,0,0,0,5,,train
0552489_as-0097442.jpg,0,0,1,0,1,,train
0552490_as-0097442.jpg,0,0,1,0,1,,train
0552491_as-0097442.jpg,0,0,1,0,1,,train
0552493_as-0097442.jpg,2,0,0,0,2,,train
0552494_as-0097442.jpg,1,1,2,0,4,,train
0552495_as-0097442.jpg,3,0,0,0,3,,val
0552496_as-0097442.jpg,2,0,0,0,2,,val
0552497_as-0097442.jpg,1,0,1,1,3,,test
0552498_as-0097442.jpg,0,1,1,1,3,,train
0552499_as-0097442.jpg,0,1,1,0,2,,train
0552500_as-0097442.jpg,1,1,1,1,4,,train
0552501_as-0097442.jpg,2,1,2,0,5,,train
0552502_as-2863576.jpg,0,1,1,0,2,,train
0552503_sc-1040435.jpg,1,0,1,0,2,,train
0552504_sc-1040435.jpg,1,0,0,0,1,,train
0552506_sc-1040435.jpg,1,1,2,0,4,,val
0552507_sc-1040435.jpg,2,0,0,0,2,,val
0552508_sc-1040435.jpg,2,0,2,0,4,,test
0552509_sc-1040435.jpg,1,1,0,0,2,,train
0552510_sc-1040435.jpg,1,1,2,0,4,,train
0552511_sc-1040435.jpg,1,0,1,0,2,,train
0552512_as-7940340.jpg,0,0,2,0,2,,train
0552514_as-0050948.jpg,3,2,1,0,6,,train
0552515_as-0050948.jpg,2,0,0,0,2,,train
0552516_sc-215603.jpg,3,0,1,0,4,,train
0552517_sc-215603.jpg,6,0,1,0,7,,val
0552519_sc-155893.jpg,1,0,0,0,1,,val
0552520_sc-1017086.jpg,3,2,1,0,6,,test
0552521_sc-1017086.jpg,1,1,2,0,4,,train
0552522_sc-1017086.jpg,1,0,0,0,1,,train
0552523_sc-1017086.jpg,1,0,0,0,1,,train
0552524_sc-1017086.jpg,1,1,2,0,4,,train
0552525_sc-1017086.jpg,1,0,0,0,1,,train
0552526_sc-1002700.jpg,1,1,1,1,4,,train
0552527_sc-1002700.jpg,1,1,1,1,4,,train
0552528_sc-1002700.jpg,1,0,1,0,2,,val
0552529_sc-1002700.jpg,1,0,1,0,2,,val
0552530_sc-1002700.jpg,1,0,0,0,1,,test
0552531_sc-1002700.jpg,1,1,1,0,3,,train
0552532_sc-228918.jpg,0,2,0,0,2,,train
0552533_sc-228918.jpg,0,1,0,0,1,,train
0552534_as-0016809.jpg,1,0,1,1,3,,train
0552535_as-0016809.jpg,1,0,1,1,3,,train
0552537_as-0016809.jpg,0,0,1,0,1,,train
0552539_as-0016809.jpg,0,1,0,0,1,,train
0552540_as-0016809.jpg,1,1,0,0,2,,val
0552541_as-0016809.jpg,0,0,1,0,1,,val
0552542_as-0016809.jpg,0,2,0,0,2,,test
0552543_as-0016809.jpg,1,0,0,0,1,,train
0552544_as-0016809.jpg,1,0,0,0,1,,train
0552545_as-0016809.jpg,1,0,0,0,1,,train
0552547_sc-177157.jpg,3,0,0,0,3,,train
0552548_sc-177157.jpg,4,0,1,1,6,,train
0552549_sc-177157.jpg,0,0,1,0,1,,train
0552550_sc-177157.jpg,0,0,1,0,1,,train
0552551_sc-177157.jpg,0,0,2,0,2,,val
0552552_as-0009430.jpg,1,0,2,1,4,,val
0552556_sc-155730.jpg,2,1,2,0,5,,test
0552557_sc-150831.jpg,7,0,1,1,9,,train
0552558_sc-150831.jpg,10,0,0,0,10,,train
0552560_as-3247224.jpg,3,0,1,1,5,,train
0552561_as-7181131.jpg,3,0,2,0,5,,train
0552562_as-7430706.jpg,3,0,0,1,4,,train
0552563_sc-1037388.jpg,4,1,0,0,5,,train
0552564_sc-1037388.jpg,3,0,0,0,3,,train
0552565_as-2942593.jpg,3,0,1,2,6,,val
0552566_as-3303390.jpg,1,0,0,0,1,,val
0552569_as-0017015.jpg,4,0,0,0,4,,test
0552570_as-0017015.jpg,1,0,0,0,1,,train
0552572_as-0055060.jpg,1,0,0,0,1,,train
0552573_as-0055060.jpg,2,0,0,0,2,,train
0552574_sc-1028208.jpg,0,0,1,1,2,,train
0552575_sc-1028208.jpg,0,3,2,1,6,,train
0552576_sc-1028208.jpg,0,0,1,0,1,,train
0552579_as-0005032.jpg,2,0,1,0,3,,train
0552580_as-0005032.jpg,1,0,3,0,4,,val
0552581_as-0005032.jpg,2,0,0,0,2,,val
0552582_as-9031407.jpg,0,1,0,1,2,,test
0552584_as-0003139.jpg,1,0,0,0,1,,train
0552586_as-0047990.jpg,1,0,0,0,1,,train
0552589_as-0047990.jpg,3,0,2,0,5,,train
0552590_as-0047990.jpg,1,0,1,0,2,,train
0552591_as-0047990.jpg,1,0,1,0,2,,train
0552592_as-0047990.jpg,1,0,0,0,1,,train
0552593_as-0047990.jpg,1,0,3,0,4,,train
0552594_as-0047990.jpg,1,0,0,0,1,,val
0552595_as-0047990.jpg,4,0,0,0,4,,val
0552596_as-0047990.jpg,5,0,0,0,5,,test
0552597_as-0047990.jpg,1,0,0,0,1,,train
0552598_as-0047990.jpg,3,0,0,0,3,,train
0552599_as-0047990.jpg,1,1,1,0,3,,train
0552600_as-0047990.jpg,2,0,2,0,4,,train
0552601_as-0047990.jpg,1,0,0,0,1,,train
0552602_as-0047990.jpg,0,1,2,0,3,,train
0552603_as-0047990.jpg,0,1,1,0,2,,train
0552604_as-0047990.jpg,2,0,1,0,3,,val
0552605_as-0047990.jpg,0,0,1,0,1,,val
0552606_as-0047990.jpg,1,0,3,0,4,,test
0552608_sc-198587.jpg,5,0,1,0,6,,train
0552612_sc-198587.jpg,1,0,1,0,2,,train
0552613_sc-119284.jpg,4,0,0,0,4,,train
0552614_sc-119284.jpg,3,0,0,0,3,,train
0552615_as-0031952.jpg,3,0,0,0,3,,train
0552617_as-0031952.jpg,0,0,1,0,1,,train
0552618_as-0054716.jpg,0,1,0,1,2,,train
0552619_as-0054716.jpg,0,1,1,1,3,,val
0552620_as-0054716.jpg,1,0,1,1,3,,val
0552623_as-0054716.jpg,0,1,0,1,2,,test
0552624_as-0054716.jpg,1,0,0,0,1,,train
0552625_as-0054716.jpg,0,1,0,0,1,,train
0552626_as-0054716.jpg,0,1,0,0,1,,train
0552627_as-0054716.jpg,0,1,0,0,1,,train
0552628_sc-177568.jpg,3,0,0,0,3,,train
0552629_sc-177568.jpg,5,0,0,0,5,,train
0552630_sc-177568.jpg,2,0,0,0,2,,train
0552631_as-2977014.jpg,4,0,0,1,5,,val
0552632_as-7987268.jpg,3,2,1,0,6,,val
0552633_sc-213211.jpg,0,1,0,0,1,,test
0552634_sc-152697.jpg,0,0,0,1,1,,train
0552635_sc-152697.jpg,0,0,0,1,1,,train
0552636_sc-152697.jpg,0,0,0,1,1,,train
0552637_sc-152697.jpg,0,0,0,1,1,,train
0552639_sc-183224.jpg,4,0,2,1,7,,train
0552641_sc-217815.jpg,11,0,0,1,12,,train
0552642_sc-217815.jpg,10,0,0,0,10,,train
0552644_as-3059951.jpg,3,0,0,0,3,,val
0552645_as-3486821.jpg,2,1,0,0,3,,val
0552646_sc-215091.jpg,1,0,0,1,2,,test
0552647_sc-215091.jpg,2,0,0,2,4,,train
0552648_sc-215091.jpg,4,0,0,1,5,,train
0552649_sc-215091.jpg,1,0,0,1,2,,train
0552650_as-2574288.jpg,1,0,0,0,1,,train
0552651_sc-178660.jpg,1,0,3,0,4,,train
0552652_sc-178660.jpg,1,0,1,0,2,,train
0552653_sc-178660.jpg,1,0,1,0,2,,train
0552654_sc-178660.jpg,1,0,1,0,2,,val
0552657_sc-136112.jpg,2,0,3,1,6,,val
0552658_sc-136112.jpg,2,0,1,1,4,,test
0552659_sc-136112.jpg,2,0,1,1,4,,train
0552660_sc-136112.jpg,2,0,1,1,4,,train
0552661_sc-136112.jpg,5,0,0,0,5,,train
0552663_sc-173470.jpg,4,0,2,0,6,,train
0552664_as-0020580.jpg,1,0,0,0,1,,train
0552665_as-0020580.jpg,2,0,0,0,2,,train
0552666_as-0020580.jpg,3,0,0,0,3,,train
0552668_sc-224959.jpg,1,0,0,0,1,,val
0552669_sc-224959.jpg,1,0,1,0,2,,val
0552672_as-0010500.jpg,1,1,0,1,3,,test
0552673_sc-122254.jpg,3,0,0,0,3,,train
0552678_sc-1017555.jpg,1,0,1,0,2,,train
0552679_as-3128231.jpg,2,1,1,0,4,,train
0552680_sc-1034049.jpg,2,0,1,1,4,,train
0552681_sc-1034049.jpg,2,0,1,0,3,,train
0552682_sc-1034049.jpg,3,0,1,1,5,,train
0552685_as-0031490.jpg,2,0,0,0,2,,train
0552686_as-0031490.jpg,3,0,0,0,3,,val
0552687_as-0031490.jpg,1,0,0,0,1,,val
0552688_as-2897998.jpg,1,0,0,0,1,,test
0552695_as-0092950.jpg,4,1,0,1,6,,train
0552696_as-0092950.jpg,3,0,0,1,4,,train
0552697_as-0092950.jpg,3,0,0,0,3,,train
0552698_as-0092950.jpg,3,2,0,1,6,,train
0552699_as-0092950.jpg,1,1,0,0,2,,train
0552700_as-0092950.jpg,3,0,1,1,5,,train
0552701_as-0092950.jpg,2,0,1,1,4,,train
0552702_as-0092950.jpg,4,0,1,1,6,,val
0552703_as-0092950.jpg,1,0,1,1,3,,val
0552704_as-0092950.jpg,1,0,0,0,1,,test
0552705_as-0092950.jpg,3,0,0,0,3,,train
0552706_as-0092950.jpg,2,0,0,0,2,,train
0552709_as-0092950.jpg,1,0,0,0,1,,train
0552710_as-0092950.jpg,2,0,0,0,2,,train
0552712_as-0092950.jpg,1,0,0,0,1,,train
0552713_as-2756206.jpg,2,0,0,0,2,,train
0552714_as-0073854.jpg,4,0,0,0,4,,train
0552715_as-0073854.jpg,3,0,0,0,3,,val
0552716_sc-1025830.jpg,1,0,0,0,1,,val
0552718_sc-1025830.jpg,3,0,0,0,3,,test
0552719_sc-1025830.jpg,2,0,0,0,2,,train
0552722_sc-1025830.jpg,1,0,0,0,1,,train
0552723_as-2701520.jpg,1,0,0,0,1,,train
0552728_as-0008974.jpg,1,0,0,0,1,,train
0552730_sc-203351.jpg,0,0,2,0,2,,train
0552731_sc-203351.jpg,0,0,1,0,1,,train
0552732_sc-227976.jpg,2,0,0,0,2,,train
0552733_sc-227976.jpg,1,0,0,0,1,,val
0552734_sc-163657.jpg,9,0,0,0,9,,val
0552735_as-0093173.jpg,12,0,0,0,12,,test
0552737_as-0075472.jpg,0,4,0,0,4,,train
0552740_as-0029949.jpg,0,0,2,0,2,,train
0552741_as-0029949.jpg,2,0,0,0,2,,train
0552742_as-0029949.jpg,4,2,2,0,8,,train
0552746_as-0084022.jpg,0,2,1,1,4,,train
0552747_as-0084022.jpg,0,0,1,0,1,,train
0552748_as-0084022.jpg,1,3,2,1,7,,train
0552749_as-0084022.jpg,0,1,1,0,2,,val
0552750_as-0084022.jpg,0,1,1,0,2,,val
0552751_as-0084022.jpg,1,4,0,1,6,,test
0552752_as-0084022.jpg,0,1,1,0,2,,train
0552753_as-0084022.jpg,1,0,1,1,3,,train
0552755_as-0074526.jpg,1,1,0,1,3,,train
0552756_as-0074526.jpg,2,0,1,0,3,,train
0552757_as-0074526.jpg,1,1,1,1,4,,train
0552758_as-0074526.jpg,1,1,1,1,4,,train
0552759_as-0074526.jpg,2,0,0,1,3,,train
0552760_as-0074526.jpg,1,1,1,1,4,,val
0552761_as-0074526.jpg,1,0,0,0,1,,val
0552763_as-0074526.jpg,2,1,0,0,3,,test
0552764_as-0074526.jpg,0,1,0,0,1,,train
0552765_as-3258161.jpg,1,1,2,1,5,,train
0552766_as-0086522.jpg,2,0,0,1,3,,train
0552767_as-0086522.jpg,2,0,0,0,2,,train
0552768_sc-183598.jpg,1,0,0,0,1,,train
0552769_as-0068408.jpg,5,0,0,0,5,,train
0552770_as-7194099.jpg,1,0,0,0,1,,train
0552771_sc-211343.jpg,0,1,0,0,1,,val
0552772_sc-211343.jpg,2,0,0,0,2,,val
0552773_sc-211343.jpg,1,0,0,0,1,,test
0552775_as-0056050.jpg,1,1,2,0,4,,train
0552776_as-0056050.jpg,1,2,1,0,4,,train
0552777_as-0056050.jpg,1,3,2,0,6,,train
0552778_as-0056050.jpg,1,2,1,0,4,,train
0552780_as-0056050.jpg,2,1,0,0,3,,train
0552781_as-0056050.jpg,3,1,1,0,5,,train
0552782_as-0056050.jpg,1,0,0,0,1,,train
0552783_as-0056050.jpg,3,0,0,0,3,,val
0552784_as-0056050.jpg,3,0,0,0,3,,val
0552785_sc-218815.jpg,1,0,0,0,1,,test
0552786_sc-218815.jpg,3,0,0,0,3,,train
0552787_sc-218815.jpg,3,0,0,0,3,,train
0552788_sc-218815.jpg,2,0,0,0,2,,train
0552789_sc-218815.jpg,4,0,0,0,4,,train
0552790_sc-218815.jpg,3,0,0,0,3,,train
0552791_sc-218815.jpg,2,0,0,0,2,,train
0552792_sc-218815.jpg,2,0,0,0,2,,train
0552793_sc-218815.jpg,2,0,0,0,2,,val
0552794_sc-218815.jpg,2,0,0,0,2,,val
0552795_sc-218815.jpg,1,0,0,0,1,,test
0552796_sc-218815.jpg,1,0,0,0,1,,train
0552797_as-9063800.jpg,1,0,0,0,1,,train
0552798_sc-181337.jpg,2,0,0,0,2,,train
0552799_sc-181337.jpg,3,0,0,0,3,,train
0552800_sc-181337.jpg,4,0,0,0,4,,train
0552803_sc-181337.jpg,5,0,0,0,5,,train
0552804_sc-181337.jpg,5,0,0,0,5,,train
0552805_sc-181337.jpg,2,0,0,0,2,,val
0552806_as-7235549.jpg,2,0,0,0,2,,val
0552807_as-3356034.jpg,3,0,0,0,3,,test
0552808_as-0029829.jpg,9,0,0,0,9,,train
0552809_as-0029829.jpg,7,0,0,0,7,,train
0552811_as-0099831.jpg,1,0,0,0,1,,train
0552812_as-0099831.jpg,0,0,1,0,1,,train
0552813_as-0099831.jpg,0,0,1,0,1,,train
0552814_as-0099831.jpg,0,0,1,0,1,,train
0552815_sc-143108.jpg,3,1,0,0,4,,train
0552816_sc-143108.jpg,0,1,0,0,1,,val
0552817_as-0087893.jpg,1,1,0,0,2,,val
0552818_as-0087893.jpg,1,1,0,0,2,,test
0552819_as-0087893.jpg,1,1,0,0,2,,train
0552820_as-0087893.jpg,1,1,0,0,2,,train
0552821_as-0087893.jpg,2,0,0,0,2,,train
0552822_sc-1027424.jpg,2,0,0,1,3,,train
0552823_sc-1027424.jpg,2,0,0,1,3,,train
0552824_sc-1014745.jpg,0,1,0,0,1,,train
0552825_as-0008745.jpg,1,0,0,0,1,,train
0552828_as-3278152.jpg,1,0,0,0,1,,val
0552829_sc-197154.jpg,2,0,0,0,2,,val
0552830_sc-197154.jpg,4,0,0,0,4,,test
0552831_sc-225904.jpg,1,0,0,1,2,,train
0552833_as-0081430.jpg,2,1,0,0,3,,train
0552838_as-0081430.jpg,4,0,0,0,4,,train
0552840_as-0008212.jpg,0,0,1,1,2,,train
0552841_as-0008212.jpg,0,0,1,0,1,,train
0552842_as-0008212.jpg,0,0,1,0,1,,train
0552844_sc-1011833.jpg,3,0,1,2,6,,train
0552846_as-3486886.jpg,1,0,0,0,1,,val
0552847_as-7818235.jpg,1,0,0,1,2,,val
0552848_as-0054588.jpg,1,0,0,1,2,,test
0552849_as-0054588.jpg,1,0,0,0,1,,train
0552850_as-3482675.jpg,1,1,1,0,3,,train
0552851_sc-1012080.jpg,2,1,0,0,3,,train
0552852_sc-1012080.jpg,1,0,1,0,2,,train
0552853_sc-1012080.jpg,1,0,0,0,1,,train
0552854_sc-153555.jpg,7,0,0,0,7,,train
0552855_sc-153555.jpg,2,0,0,0,2,,train
0552856_sc-153555.jpg,2,0,0,0,2,,val
0552857_sc-153555.jpg,2,0,0,0,2,,val
0552858_sc-153555.jpg,1,0,1,0,2,,test
0552860_as-2549554.jpg,1,0,1,0,2,,train
0552861_as-0082352.jpg,4,2,2,0,8,,train
0552862_as-0082352.jpg,3,1,2,1,7,,train
0552863_as-0082352.jpg,1,2,1,0,4,,train
0552864_sc-179236.jpg,3,1,0,0,4,,train
0552865_sc-179236.jpg,4,1,0,0,5,,train
0552866_sc-179236.jpg,2,0,2,0,4,,train
0552867_sc-1032975.jpg,15,0,0,0,15,,val
0552868_sc-1032975.jpg,9,0,0,0,9,,val
0552869_sc-1032975.jpg,11,0,0,0,11,,test
0552870_sc-1025227.jpg,1,0,0,0,1,,train
0552871_sc-1025227.jpg,1,0,0,0,1,,train
0552873_sc-1035337.jpg,5,1,1,0,7,,train
0552875_as-5426304.jpg,2,0,1,1,4,,train
0552879_as-0051102.jpg,2,0,1,1,4,,train
0552880_sc-1037954.jpg,1,0,1,0,2,,train
0552881_sc-1037954.jpg,1,0,1,0,2,,train
0552882_sc-1037954.jpg,1,0,1,0,2,,val
0552885_sc-204086.jpg,2,0,0,0,2,,val
0552886_sc-204086.jpg,3,0,0,0,3,,test
0552887_sc-204086.jpg,1,0,0,1,2,,train
0552888_sc-204086.jpg,1,0,0,0,1,,train
0552889_sc-162195.jpg,3,0,1,0,4,,train
0552890_sc-162195.jpg,1,0,2,0,3,,train
0552891_sc-162195.jpg,2,0,1,0,3,,train
0552892_sc-162195.jpg,3,0,2,1,6,,train
0552893_sc-162195.jpg,2,0,1,1,4,,train
0552894_sc-162195.jpg,3,0,0,1,4,,val
0552895_sc-162195.jpg,5,0,1,0,6,,val
0552896_sc-162195.jpg,6,0,1,0,7,,test
0552899_as-0007188.jpg,2,0,0,0,2,,train
0552900_as-3479357.jpg,1,0,1,0,2,,train
0552901_sc-115906.jpg,1,0,1,0,2,,train
0552902_sc-115906.jpg,1,0,1,0,2,,train
0552903_sc-115906.jpg,1,0,1,0,2,,train
0552904_as-2562907.jpg,4,0,0,0,4,,train
0552905_sc-145160.jpg,1,0,0,0,1,,train
0552906_as-0029227.jpg,1,0,0,0,1,,val
0552907_as-0029227.jpg,1,0,0,0,1,,val
0552908_sc-1005165.jpg,1,1,0,0,2,,test
0552909_sc-1005165.jpg,0,1,0,0,1,,train
0552910_sc-1014411.jpg,1,1,0,0,2,,train
0552912_as-7570995.jpg,1,0,0,0,1,,train
0552913_as-0045750.jpg,2,0,0,0,2,,train
0552914_as-0045750.jpg,1,0,0,0,1,,train
0552915_sc-1008144.jpg,1,0,0,1,2,,train
0552916_sc-1008144.jpg,1,0,0,1,2,,train
0552917_as-0079117.jpg,1,1,0,0,2,,val
0552919_as-2897330.jpg,3,0,1,2,6,,val
0552920_sc-1015743.jpg,1,0,0,2,3,,test
0552921_as-0019949.jpg,2,1,0,0,3,,train
0552922_as-0019949.jpg,5,2,1,0,8,,train
0552923_as-0019949.jpg,4,1,0,0,5,,train
0552924_as-0019949.jpg,3,1,0,0,4,,train
0552925_as-0019949.jpg,3,1,0,0,4,,train
0552927_as-0019949.jpg,4,1,1,1,7,,train
0552928_as-0019949.jpg,3,0,1,0,4,,train
0552929_as-0000087.jpg,2,0,0,0,2,,val
0552930_as-0000087.jpg,1,1,0,0,2,,val
0552931_as-0000087.jpg,2,1,0,0,3,,test
0552933_as-0000087.jpg,3,1,0,0,4,,train
0552934_sc-219505.jpg,14,0,1,1,16,,train
0552935_sc-219505.jpg,4,0,1,1,6,,train
0552936_sc-219505.jpg,9,0,0,1,10,,train
0552937_sc-219505.jpg,2,0,2,1,5,,train
0552938_sc-219505.jpg,2,0,0,1,3,,train
0552939_sc-219505.jpg,2,0,0,0,2,,train
0552940_sc-219505.jpg,2,0,0,0,2,,val
0552941_sc-1011100.jpg,1,0,0,0,1,,val
0552942_sc-1011100.jpg,1,0,0,0,1,,test
0552943_sc-1011100.jpg,2,0,0,0,2,,train
0552946_sc-106724.jpg,1,1,0,0,2,,train
0552948_sc-1024345.jpg,1,0,1,0,2,,train
0552949_sc-1024345.jpg,1,0,1,0,2,,train
0552950_sc-1024345.jpg,1,0,0,0,1,,train
0552951_sc-1024345.jpg,1,0,0,0,1,,train
0552952_sc-1024345.jpg,1,0,1,0,2,,train
0552954_sc-1024345.jpg,2,0,0,0,2,,val
0552955_sc-228217.jpg,5,0,0,0,5,,val
0552956_sc-228217.jpg,3,0,0,0,3,,test
0552957_sc-228217.jpg,5,0,0,0,5,,train
0552958_sc-228217.jpg,4,0,0,0,4,,train
0552959_sc-228217.jpg,12,0,0,0,12,,train
0552960_sc-228217.jpg,1,0,0,0,1,,train
0552961_sc-228217.jpg,7,0,0,0,7,,train
0552962_sc-228217.jpg,3,0,0,1,4,,train
0552963_sc-228217.jpg,5,0,0,1,6,,train
0552964_sc-228217.jpg,2,0,0,0,2,,val
0552965_sc-228217.jpg,4,0,0,0,4,,val
0552966_sc-190277.jpg,4,0,0,0,4,,test
0552967_sc-224998.jpg,2,0,0,0,2,,train
0552968_sc-224998.jpg,1,0,0,0,1,,train
0552969_sc-224998.jpg,0,0,1,0,1,,train
0552970_sc-154386.jpg,1,0,0,0,1,,train
0552971_sc-154386.jpg,1,0,0,0,1,,train
0552972_sc-116105.jpg,2,0,0,1,3,,train
0552973_sc-116105.jpg,2,0,0,0,2,,train
0552974_sc-116105.jpg,1,0,0,0,1,,val
0552975_sc-116105.jpg,3,0,0,2,5,,val
0552976_sc-116105.jpg,4,0,0,2,6,,test
0552977_sc-116105.jpg,2,0,0,0,2,,train
0552979_as-0073804.jpg,1,0,0,0,1,,train
0552980_as-0073804.jpg,3,0,1,1,5,,train
0552981_as-0073804.jpg,1,0,1,1,3,,train
0552982_as-0073804.jpg,3,0,2,0,5,,train
0552983_as-0073804.jpg,2,0,1,0,3,,train
0552984_as-0073804.jpg,2,0,1,0,3,,train
0552985_as-0070383.jpg,5,0,1,0,6,,val
0552986_as-0070383.jpg,3,0,1,0,4,,val
0552987_as-0070383.jpg,3,0,1,0,4,,test
0552988_as-0070383.jpg,4,0,1,0,5,,train
0552989_as-9012089.jpg,1,0,0,0,1,,train
0552990_as-2503036.jpg,1,0,0,0,1,,train
0552991_as-2529183.jpg,1,0,0,0,1,,train
0552992_as-2782177.jpg,2,1,1,0,4,,train
0552995_sc-160564.jpg,3,0,0,0,3,,train
0552996_sc-160564.jpg,2,0,1,0,3,,train
0552998_as-0035456.jpg,1,1,1,0,3,,val
0552999_as-0035456.jpg,4,0,0,0,4,,val
0553000_as-0035456.jpg,5,0,1,0,6,,test
0553001_as-0035456.jpg,4,1,0,1,6,,train
0553002_as-0035456.jpg,2,0,1,1,4,,train
0553005_as-9059273.jpg,1,1,2,1,5,,train
0553006_as-2871521.jpg,10,1,1,1,13,,train
0553007_sc-213685.jpg,2,0,0,1,3,,train
0553008_sc-213685.jpg,8,0,0,1,9,,train
0553010_sc-1041655.jpg,0,0,1,0,1,,train
0553011_sc-1041655.jpg,2,1,1,0,4,,val
0553012_sc-1041655.jpg,1,0,2,0,3,,val
0553013_as-3006165.jpg,2,0,0,0,2,,test
0553014_sc-148329.jpg,3,2,3,1,9,,train
0553017_sc-148329.jpg,3,2,5,1,11,,train
0553020_sc-1019641.jpg,1,0,0,0,1,,train
0553021_sc-1019641.jpg,1,0,0,1,2,,train
0553022_sc-1019641.jpg,2,0,0,0,2,,train
0553023_as-0001522.jpg,2,0,1,2,5,,train
0553024_as-0001522.jpg,3,0,1,1,5,,train
0553025_as-0001522.jpg,4,0,1,2,7,,val
0553027_as-7843435.jpg,3,0,0,0,3,,val
0553028_sc-136701.jpg,1,0,1,0,2,,test
0553029_sc-136701.jpg,1,0,1,0,2,,train
0553030_sc-136701.jpg,1,0,1,0,2,,train
0553031_as-3161378.jpg,2,0,1,0,3,,train
0553032_sc-128536.jpg,0,1,0,0,1,,train
0553033_sc-189893.jpg,0,0,1,0,1,,train
0553034_sc-189893.jpg,1,0,0,0,1,,train
0553035_as-2785653.jpg,1,0,0,0,1,,train
0553036_sc-177848.jpg,13,0,1,0,14,,val
0553037_sc-177848.jpg,4,0,2,0,6,,val
0553038_sc-177848.jpg,4,0,1,0,5,,test
0553039_sc-177848.jpg,4,0,2,0,6,,train
0553040_sc-1012850.jpg,2,0,2,0,4,,train
0553041_sc-1012850.jpg,4,0,1,0,5,,train
0553043_sc-1012850.jpg,5,0,0,0,5,,train
0553044_sc-1012850.jpg,2,0,1,0,3,,train
0553045_as-0082097.jpg,1,1,0,2,4,,train
0553046_as-0082097.jpg,1,1,0,2,4,,train
0553047_as-0082097.jpg,2,1,0,1,4,,val
0553048_as-0031526.jpg,1,0,0,0,1,,val
0553049_as-0031526.jpg,2,0,0,1,3,,test
0553050_as-0031526.jpg,3,0,0,1,4,,train
0553052_sc-193840.jpg,1,0,0,0,1,,train
0553053_sc-215011.jpg,0,1,0,0,1,,train
0553054_sc-179324.jpg,2,1,0,0,3,,train
0553055_sc-179324.jpg,2,1,0,0,3,,train
0553056_sc-179324.jpg,2,0,0,0,2,,train
0553057_sc-179324.jpg,2,1,0,0,3,,train
0553058_sc-179324.jpg,2,1,0,0,3,,val
0553059_sc-179324.jpg,2,1,0,0,3,,val
0553060_sc-179324.jpg,1,0,0,0,1,,test
0553062_as-0059681.jpg,1,0,1,0,2,,train
0553063_sc-1020375.jpg,5,0,0,0,5,,train
0553064_sc-1020375.jpg,7,0,0,0,7,,train
0553065_sc-135212.jpg,0,0,1,0,1,,train
0553066_sc-135212.jpg,0,0,1,0,1,,train
0553067_sc-135212.jpg,1,0,1,0,2,,train
0553070_sc-135212.jpg,1,0,1,0,2,,train
0553071_as-2564682.jpg,1,0,0,0,1,,val
0553072_as-7710426.jpg,1,0,0,0,1,,val
0553073_sc-201083.jpg,3,0,0,2,5,,test
0553074_sc-201083.jpg,2,0,0,2,4,,train
0553075_sc-201083.jpg,5,0,0,2,7,,train
0553076_sc-201083.jpg,2,0,0,0,2,,train
0553077_sc-201083.jpg,3,0,0,1,4,,train
0553078_as-2502481.jpg,1,1,1,0,3,,train
0553079_sc-215833.jpg,1,0,0,0,1,,train
0553081_as-0010455.jpg,1,0,0,0,1,,train
0553082_as-0010455.jpg,1,0,0,0,1,,val
0553083_as-0010455.jpg,2,0,0,0,2,,val
0553087_as-0041305.jpg,1,0,0,0,1,,test
0553088_as-0041305.jpg,1,0,0,0,1,,train
0553089_as-0041305.jpg,2,1,1,1,5,,train
0553091_as-0041305.jpg,1,0,0,0,1,,train
0553092_as-0041305.jpg,1,0,0,0,1,,train
0553093_as-0041305.jpg,1,0,1,0,2,,train
0553094_as-0041305.jpg,0,0,2,0,2,,train
0553096_as-0041305.jpg,1,0,1,1,3,,train
0553097_as-0041305.jpg,1,0,1,1,3,,val
0553098_as-0041305.jpg,1,0,0,0,1,,val
0553099_sc-111470.jpg,3,0,0,0,3,,test
0553100_sc-111470.jpg,1,0,0,0,1,,train
0553101_sc-111470.jpg,2,0,0,0,2,,train
0553102_sc-111470.jpg,4,0,0,0,4,,train
0553103_sc-111470.jpg,1,0,1,0,2,,train
0553104_sc-111470.jpg,1,0,1,0,2,,train
0553105_sc-111470.jpg,2,0,0,0,2,,train
0553106_sc-111470.jpg,1,0,0,0,1,,train
0553107_sc-111470.jpg,1,0,0,1,2,,val
0553110_as-0065225.jpg,4,0,0,0,4,,val
0553112_as-2692628.jpg,1,0,1,0,2,,test
0553113_sc-187667.jpg,2,0,0,0,2,,train
0553114_sc-187667.jpg,2,0,0,0,2,,train
0553115_sc-187667.jpg,2,0,0,0,2,,train
0553116_sc-187667.jpg,3,0,0,0,3,,train
0553117_as-0073514.jpg,2,1,0,1,4,,train
0553118_as-0073514.jpg,3,0,0,0,3,,train
0553120_as-0073514.jpg,0,1,0,0,1,,train
0553122_sc-184751.jpg,2,0,1,0,3,,val
0553124_sc-184751.jpg,2,0,1,0,3,,val
0553125_as-3480382.jpg,0,1,0,0,1,,test
0553127_sc-221902.jpg,2,1,1,0,4,,train
0553128_sc-221902.jpg,2,1,1,0,4,,train
0553129_sc-221902.jpg,2,1,1,0,4,,train
0553130_sc-163805.jpg,0,1,0,0,1,,train
0553131_sc-163805.jpg,4,0,1,0,5,,train
0553132_sc-163805.jpg,4,0,1,0,5,,train
0553133_sc-163805.jpg,4,0,1,0,5,,train
0553134_as-0073136.jpg,2,0,0,0,2,,val
0553135_sc-1013123.jpg,2,0,1,1,4,,val
0553136_sc-1013123.jpg,2,0,1,2,5,,test
0553137_sc-1013123.jpg,2,0,1,2,5,,train
0553139_as-0000549.jpg,3,0,1,0,4,,train
0553140_as-0000549.jpg,3,0,0,0,3,,train
0553141_sc-1028267.jpg,2,0,0,0,2,,train
0553142_sc-1028267.jpg,0,0,1,0,1,,train
0553144_sc-1028267.jpg,0,0,2,0,2,,train
0553145_sc-216872.jpg,3,2,0,0,5,,train
0553146_sc-216872.jpg,1,1,0,0,2,,val
0553147_sc-115483.jpg,2,0,1,0,3,,val
0553148_sc-115483.jpg,2,0,1,0,3,,test
0553149_sc-115483.jpg,0,0,1,0,1,,train
0553150_as-7176893.jpg,1,0,0,0,1,,train
0553151_as-3468371.jpg,2,0,0,0,2,,train
0553152_sc-126352.jpg,1,0,0,0,1,,train
0553153_sc-126352.jpg,1,0,0,0,1,,train
0553154_sc-126352.jpg,1,0,0,0,1,,train
0553155_sc-126352.jpg,1,0,0,1,2,,train
0553156_as-2741230.jpg,0,0,1,0,1,,val
0553158_as-0021956.jpg,1,0,0,0,1,,val
0553159_as-0021956.jpg,2,0,1,0,3,,test
0553160_as-0021956.jpg,3,0,1,0,4,,train
0553161_as-0021956.jpg,2,2,0,0,4,,train
0553162_as-0021956.jpg,1,0,0,0,1,,train
0553163_as-0096309.jpg,0,0,2,0,2,,train
0553166_as-0096309.jpg,2,0,1,0,3,,train
0553169_as-0041395.jpg,1,0,0,0,1,,train
0553170_as-0041395.jpg,3,0,0,0,3,,train
0553171_as-0041395.jpg,3,0,0,0,3,,val
0553172_as-0041395.jpg,3,0,0,0,3,,val
0553173_as-0041395.jpg,3,0,0,0,3,,test
0553175_sc-119101.jpg,2,0,1,0,3,,train
0553176_sc-119101.jpg,3,1,2,0,6,,train
0553177_sc-119101.jpg,2,1,1,0,4,,train
0553179_sc-119101.jpg,1,0,0,0,1,,train
0553180_sc-119101.jpg,5,0,0,0,5,,train
0553181_sc-189252.jpg,1,0,0,0,1,,train
0553182_sc-189252.jpg,2,0,0,0,2,,train
0553184_sc-171413.jpg,2,0,1,1,4,,val
0553185_sc-171413.jpg,3,0,1,1,5,,val
0553186_sc-171413.jpg,4,0,1,1,6,,test
0553189_sc-171413.jpg,3,0,1,1,5,,train
0553190_sc-171413.jpg,1,0,1,1,3,,train
0553192_as-0080354.jpg,1,0,0,0,1,,train
0553193_as-7918050.jpg,0,0,2,0,2,,train
0553196_as-0015911.jpg,2,0,0,1,3,,train
0553198_as-0015911.jpg,2,0,0,1,3,,train
0553199_as-0015911.jpg,4,0,0,0,4,,train
0553202_sc-220228.jpg,0,1,1,0,2,,val
0553203_sc-220228.jpg,1,1,0,0,2,,val
0553204_sc-220228.jpg,1,0,0,0,1,,test
0553206_as-0001212.jpg,15,0,0,0,15,,train
0553207_as-9030383.jpg,1,0,0,0,1,,train
0553208_sc-220998.jpg,4,0,1,1,6,,train
0553209_sc-220998.jpg,4,0,0,0,4,,train
0553210_sc-220998.jpg,1,0,0,0,1,,train
0553211_sc-220998.jpg,1,0,0,0,1,,train
0553212_sc-220998.jpg,1,0,0,1,2,,train
0553213_sc-220998.jpg,2,0,0,0,2,,val
0553214_sc-220998.jpg,1,0,0,1,2,,val
0553215_sc-220998.jpg,1,0,0,1,2,,test
0553216_sc-220998.jpg,3,0,1,0,4,,train
0553217_sc-220998.jpg,2,0,0,0,2,,train
0553218_sc-220998.jpg,2,0,0,0,2,,train
0553219_sc-220998.jpg,1,0,0,1,2,,train
0553220_sc-220998.jpg,2,0,0,1,3,,train
0553221_sc-220998.jpg,2,0,0,1,3,,train
0553222_sc-220998.jpg,1,0,0,1,2,,train
0553223_sc-220998.jpg,2,0,0,1,3,,val
0553224_sc-220998.jpg,3,0,0,0,3,,val
0553225_sc-220998.jpg,2,0,0,0,2,,test
0553226_sc-220998.jpg,1,0,0,0,1,,train
0553227_sc-220998.jpg,2,0,0,1,3,,train
0553228_sc-220998.jpg,1,0,0,0,1,,train
0553229_sc-220998.jpg,1,0,0,0,1,,train
0553230_sc-220998.jpg,2,0,0,0,2,,train
0553231_sc-220998.jpg,1,0,0,0,1,,train
0553232_sc-220998.jpg,1,0,0,0,1,,train
0553233_sc-220998.jpg,1,0,1,0,2,,val
0553234_as-0013803.jpg,3,0,0,0,3,,val
0553235_as-0013803.jpg,1,0,0,0,1,,test
0553236_as-0013803.jpg,1,0,0,0,1,,train
0553237_as-0013803.jpg,3,0,0,0,3,,train
0553238_as-0013803.jpg,2,0,0,2,4,,train
0553240_sc-174703.jpg,2,0,1,1,4,,train
0553241_sc-1011864.jpg,1,0,0,0,1,,train
0553242_sc-1011864.jpg,1,0,0,0,1,,train
0553243_sc-180780.jpg,2,0,0,0,2,,train
0553244_sc-1032851.jpg,2,0,1,1,4,,val
0553245_sc-1032851.jpg,1,0,1,0,2,,val
0553246_sc-1032851.jpg,1,0,0,0,1,,test
0553247_sc-130275.jpg,1,0,0,0,1,,train
0553248_sc-130275.jpg,2,0,1,0,3,,train
0553249_sc-130275.jpg,2,0,1,0,3,,train
0553250_sc-173255.jpg,1,0,0,0,1,,train
0553252_sc-173255.jpg,1,0,0,0,1,,train
0553254_as-0009995.jpg,2,0,2,1,5,,train
0553255_as-0009995.jpg,2,0,2,2,6,,train
0553256_as-0009995.jpg,3,0,3,2,8,,val
0553257_as-0009995.jpg,0,0,1,0,1,,val
0553259_as-0000590.jpg,1,0,0,0,1,,test
0553261_as-0000590.jpg,2,0,0,0,2,,train
0553262_as-0000590.jpg,1,0,0,0,1,,train
0553263_as-0000590.jpg,0,1,0,0,1,,train
0553264_as-0000590.jpg,2,1,0,0,3,,train
0553266_as-3123013.jpg,3,0,0,0,3,,train
0553267_sc-206472.jpg,4,0,0,0,4,,train
0553268_sc-206472.jpg,5,0,1,0,6,,train
0553269_sc-206472.jpg,2,1,0,0,3,,val
0553270_sc-206472.jpg,3,1,0,0,4,,val
0553271_sc-206472.jpg,0,0,1,0,1,,test
0553272_sc-206472.jpg,0,0,1,0,1,,train
0553273_sc-206472.jpg,0,0,1,0,1,,train
0553274_sc-206472.jpg,3,0,0,1,4,,train
0553275_sc-206472.jpg,3,0,0,0,3,,train
0553276_sc-206472.jpg,8,1,0,0,9,,train
0553277_sc-206472.jpg,4,1,1,0,6,,train
0553278_sc-206472.jpg,3,0,1,0,4,,train
0553279_sc-206472.jpg,0,0,1,1,2,,val
0553280_sc-171006.jpg,2,0,1,0,3,,val
0553281_sc-171006.jpg,6,0,1,0,7,,test
0553282_sc-171006.jpg,2,0,2,0,4,,train
0553283_as-3237469.jpg,1,0,0,0,1,,train
0553287_sc-191822.jpg,4,0,0,0,4,,train
0553288_sc-191822.jpg,5,0,0,0,5,,train
0553289_sc-191822.jpg,4,0,0,0,4,,train
0553290_sc-191822.jpg,2,0,0,1,3,,train
0553291_sc-191822.jpg,5,0,0,1,6,,train
0553292_sc-191822.jpg,2,0,0,1,3,,val
0553293_sc-191822.jpg,1,0,0,2,3,,val
0553294_sc-191822.jpg,1,0,0,1,2,,test
0553296_sc-123043.jpg,3,0,0,0,3,,train
0553297_sc-123043.jpg,1,0,0,0,1,,train
0553298_sc-123043.jpg,2,0,0,0,2,,train
0553299_sc-123043.jpg,2,0,0,0,2,,train
0553300_sc-112566.jpg,6,0,0,0,6,,train
0553301_sc-112566.jpg,6,1,0,0,7,,train
0553302_sc-112566.jpg,3,0,0,0,3,,train
0553303_as-2814556.jpg,1,0,0,0,1,,val
0553304_sc-199509.jpg,1,0,0,0,1,,val
0553305_sc-199509.jpg,0,1,0,0,1,,test
0553306_sc-109740.jpg,3,0,0,0,3,,train
0553307_sc-109740.jpg,3,0,0,0,3,,train
0553308_sc-109740.jpg,1,0,0,0,1,,train
0553309_sc-109740.jpg,1,0,0,0,1,,train
0553310_sc-109740.jpg,1,0,0,0,1,,train
0553311_sc-109740.jpg,1,0,0,0,1,,train
0553312_sc-109740.jpg,1,0,0,0,1,,train
0553313_sc-141440.jpg,2,1,1,0,4,,val
0553314_as-0064249.jpg,0,0,0,1,1,,val
0553316_as-0064249.jpg,4,1,2,0,7,,test
0553318_sc-1023626.jpg,6,0,1,1,8,,train
0553319_sc-1023626.jpg,1,1,1,0,3,,train
0553323_sc-165243.jpg,4,1,1,1,7,,train
0553324_sc-165243.jpg,2,1,0,0,3,,train
0553325_sc-165243.jpg,3,0,1,0,4,,train
0553326_sc-217310.jpg,1,0,0,0,1,,train
0553327_sc-217310.jpg,4,0,0,0,4,,train
0553328_sc-217310.jpg,5,0,0,0,5,,val
0553329_as-3159341.jpg,5,0,0,0,5,,val
0553330_as-2775831.jpg,3,0,1,1,5,,test
0553337_as-0059449.jpg,1,0,0,1,2,,train
0553338_as-2501947.jpg,2,1,1,0,4,,train
0553339_sc-178473.jpg,5,0,0,0,5,,train
0553342_as-0072625.jpg,10,3,2,0,15,,train
0553343_as-0072625.jpg,6,0,0,0,6,,train
0553344_as-0072625.jpg,8,3,2,0,13,,train
0553345_as-0072625.jpg,10,1,3,0,14,,train
0553346_sc-1015012.jpg,0,1,1,0,2,,val
0553347_sc-1015012.jpg,1,1,1,1,4,,val
0553348_sc-1015012.jpg,1,0,1,0,2,,test
0553349_as-2738326.jpg,0,1,0,0,1,,train
0553350_sc-196704.jpg,3,2,1,1,7,,train
0553351_sc-196704.jpg,3,2,1,1,7,,train
0553353_sc-196704.jpg,2,1,0,0,3,,train
0553355_sc-223108.jpg,1,0,0,0,1,,train
0553357_sc-223108.jpg,1,0,1,1,3,,train
0553362_sc-131906.jpg,1,0,0,0,1,,train
0553363_sc-131906.jpg,1,0,0,0,1,,val
0553364_sc-131906.jpg,4,0,0,2,6,,val
0553365_sc-131906.jpg,1,0,0,0,1,,test
0553366_sc-131906.jpg,1,0,0,0,1,,train
0553367_sc-131906.jpg,1,0,0,0,1,,train
0553368_sc-222307.jpg,2,0,0,0,2,,train
0553369_sc-222307.jpg,3,0,0,0,3,,train
0553370_sc-222307.jpg,2,0,0,0,2,,train
0553372_sc-203700.jpg,1,0,0,1,2,,train
0553373_sc-203700.jpg,1,0,0,1,2,,train
0553374_sc-203700.jpg,1,0,0,1,2,,val
0553375_as-0037091.jpg,0,1,1,0,2,,val
0553376_as-0037091.jpg,3,1,1,0,5,,test
0553377_as-0037091.jpg,4,1,1,0,6,,train
0553378_sc-142299.jpg,1,0,0,0,1,,train
0553379_sc-203611.jpg,1,1,0,0,2,,train
0553380_sc-203611.jpg,2,0,1,0,3,,train
0553382_sc-192150.jpg,2,0,0,0,2,,train
0553384_sc-192150.jpg,3,1,2,0,6,,train
0553385_sc-192150.jpg,2,0,0,1,3,,train
0553386_sc-192150.jpg,2,1,0,0,3,,val
0553387_sc-192150.jpg,3,2,1,1,7,,val
0553388_sc-192150.jpg,3,0,3,2,8,,test
0553389_sc-192150.jpg,2,0,1,1,4,,train
0553391_sc-192150.jpg,2,1,0,0,3,,train
0553392_sc-192150.jpg,2,0,0,1,3,,train
0553393_sc-192150.jpg,2,0,2,1,5,,train
0553394_as-7583111.jpg,8,1,0,0,9,,train
0553397_as-0019482.jpg,1,0,0,1,2,,train
0553398_as-0019482.jpg,2,0,0,1,3,,train
0553399_as-0019482.jpg,3,0,0,1,4,,val
0553400_as-0019482.jpg,2,0,1,1,4,,val
0553401_as-0019482.jpg,2,0,0,1,3,,test
0553403_as-0019482.jpg,5,0,0,1,6,,train
0553404_as-0019482.jpg,1,0,0,1,2,,train
0553405_as-0019482.jpg,7,0,0,0,7,,train
0553406_sc-1006539.jpg,1,0,1,1,3,,train
0553407_sc-1006539.jpg,1,0,1,1,3,,train
0553409_sc-1006539.jpg,1,0,1,1,3,,train
0553410_as-0030400.jpg,1,1,0,0,2,,train
0553411_as-0030400.jpg,1,1,1,0,3,,val
0553412_as-0030400.jpg,1,0,0,0,1,,val
0553413_as-0030400.jpg,2,1,0,0,3,,test
0553414_as-2872002.jpg,2,2,0,0,4,,train
0553416_sc-114701.jpg,3,0,0,0,3,,train
0553417_sc-114701.jpg,3,0,0,2,5,,train
0553418_sc-114701.jpg,5,0,0,2,7,,train
0553419_sc-114701.jpg,6,1,3,1,11,,train
0553422_sc-114701.jpg,2,0,0,0,2,,train
0553423_sc-114701.jpg,2,0,0,0,2,,train
0553424_sc-114701.jpg,2,0,0,0,2,,val
0553425_sc-114701.jpg,1,1,0,0,2,,val
0553426_as-2980764.jpg,3,0,2,1,6,,test
0553427_as-3013419.jpg,2,0,0,0,2,,train
0553428_as-0044272.jpg,0,1,0,0,1,,train
0553431_as-3034352.jpg,0,1,0,0,1,,train
0553432_as-2744007.jpg,1,0,0,0,1,,train
0553435_as-0027484.jpg,1,0,0,0,1,,train
0553436_as-0027484.jpg,1,0,0,0,1,,train
0553437_as-0027484.jpg,2,0,0,0,2,,train
0553438_as-0027484.jpg,1,0,0,0,1,,val
0553440_sc-212369.jpg,8,1,0,0,9,,val
0553441_sc-212369.jpg,1,1,0,0,2,,test
0553442_sc-212369.jpg,2,0,0,1,3,,train
0553443_sc-212369.jpg,1,0,0,1,2,,train
0553444_sc-212369.jpg,2,0,0,1,3,,train
0553445_sc-212369.jpg,3,0,0,0,3,,train
0553446_sc-212369.jpg,1,0,0,0,1,,train
0553447_sc-212369.jpg,8,0,0,1,9,,train
0553448_as-0075133.jpg,2,0,0,0,2,,train
0553449_as-0075133.jpg,2,0,0,0,2,,val
0553450_as-0075133.jpg,2,0,0,0,2,,val
0553451_as-0075133.jpg,1,0,0,0,1,,test
0553453_as-7311119.jpg,2,0,0,1,3,,train
0553456_as-0063771.jpg,1,0,0,0,1,,train
0553457_as-0063771.jpg,1,0,0,0,1,,train
0553458_as-2867440.jpg,0,2,2,1,5,,train
0553459_sc-129714.jpg,1,0,0,0,1,,train
0553461_sc-129714.jpg,1,0,0,0,1,,train
0553463_sc-179671.jpg,1,1,2,1,5,,train
0553466_as-2895116.jpg,0,1,1,0,2,,val
0553467_sc-138542.jpg,1,1,0,0,2,,val
0553468_sc-138542.jpg,1,1,0,0,2,,test
0553469_sc-138542.jpg,1,1,0,0,2,,train
0553472_as-0019603.jpg,2,0,0,1,3,,train
0553473_as-0019603.jpg,1,0,0,1,2,,train
0553474_as-0019603.jpg,1,0,0,1,2,,train
0553477_sc-132654.jpg,4,0,0,1,5,,train
0553478_as-7075690.jpg,2,0,0,1,3,,train
0553479_as-2977950.jpg,1,0,0,0,1,,train
0553482_as-0056153.jpg,1,0,0,0,1,,val
0553483_as-0056153.jpg,1,0,0,0,1,,val
0553484_as-2797386.jpg,2,0,0,0,2,,test
0553485_sc-1035804.jpg,2,0,0,0,2,,train
0553486_sc-1035804.jpg,2,0,0,0,2,,train
0553487_as-0083393.jpg,5,0,0,0,5,,train
0553488_as-0083393.jpg,6,0,0,0,6,,train
0553489_sc-217956.jpg,2,0,1,0,3,,train
0553490_sc-217956.jpg,2,0,0,0,2,,train
0553491_sc-217956.jpg,2,0,1,0,3,,train
0553492_sc-217956.jpg,1,0,1,0,2,,val
0553493_sc-217956.jpg,3,0,1,0,4,,val
0553494_as-3380063.jpg,1,0,0,1,2,,test
0553495_as-3497339.jpg,3,0,0,0,3,,train
0553496_sc-154038.jpg,4,0,0,0,4,,train
0553499_sc-154038.jpg,3,0,0,0,3,,train
0553500_sc-154038.jpg,4,0,0,1,5,,train
0553501_sc-1028991.jpg,1,0,0,0,1,,train
0553502_sc-1028991.jpg,1,1,0,0,2,,train
0553503_sc-1028991.jpg,4,0,0,0,4,,train
0553504_sc-1007233.jpg,2,1,0,0,3,,val
0553505_sc-1007233.jpg,2,2,0,0,4,,val
0553506_sc-1007233.jpg,0,1,0,0,1,,test
0553507_as-7594053.jpg,1,0,0,1,2,,train
0553508_sc-145851.jpg,2,1,0,5,8,,train
0553510_sc-145851.jpg,3,2,0,7,12,,train
0553511_sc-145851.jpg,3,1,0,1,5,,train
0553512_sc-145851.jpg,3,1,0,3,7,,train
0553513_sc-145851.jpg,4,1,0,1,6,,train
0553514_as-3215889.jpg,3,0,0,1,4,,train
0553515_as-2505086.jpg,1,0,0,0,1,,val
0553516_as-3008068.jpg,1,0,0,0,1,,val
0553517_as-0028439.jpg,0,0,0,1,1,,test
0553518_as-3248474.jpg,1,0,1,1,3,,train
0553519_as-0029960.jpg,2,1,1,1,5,,train
0553523_as-0084488.jpg,5,0,0,1,6,,train
0553524_as-0084488.jpg,5,0,0,1,6,,train
0553525_as-0084488.jpg,1,0,0,1,2,,train
0553526_sc-106106.jpg,1,0,0,0,1,,train
0553527_sc-106106.jpg,1,0,0,0,1,,train
0553529_as-0074731.jpg,2,0,0,0,2,,val
0553530_as-0074731.jpg,2,0,0,2,4,,val
0553531_as-0074731.jpg,2,0,0,0,2,,test
0553532_as-0074731.jpg,2,0,0,0,2,,train
0553533_as-0074731.jpg,2,0,0,0,2,,train
0553534_sc-220839.jpg,2,2,2,2,8,,train
0553535_sc-220839.jpg,4,2,3,1,10,,train
0553536_sc-220839.jpg,2,0,2,1,5,,train
0553537_sc-220839.jpg,0,0,1,0,1,,train
0553538_as-0054267.jpg,0,0,1,0,1,,train
0553539_as-0054267.jpg,1,0,1,0,2,,val
0553540_as-0054267.jpg,0,0,1,0,1,,val
0553541_as-0054267.jpg,1,0,1,0,2,,test
0553542_as-0054267.jpg,1,0,1,0,2,,train
0553544_sc-174413.jpg,2,0,0,1,3,,train
0553546_sc-174413.jpg,1,0,1,1,3,,train
0553547_sc-174413.jpg,2,0,1,1,4,,train
0553550_as-0020498.jpg,3,0,2,1,6,,train
0553552_as-0039155.jpg,4,0,0,1,5,,train
0553553_as-0039155.jpg,1,0,0,0,1,,train
0553554_as-3184106.jpg,0,0,1,0,1,,val
0553555_as-0037418.jpg,4,0,1,1,6,,val
0553556_as-0037418.jpg,2,0,1,0,3,,test
0553557_as-0037418.jpg,3,1,1,0,5,,train
0553558_as-0037418.jpg,3,1,2,0,6,,train
0553559_as-0089892.jpg,0,0,1,0,1,,train
0553560_as-0089892.jpg,0,0,1,0,1,,train
0553561_as-0089892.jpg,0,0,2,0,2,,train
0553562_as-0089892.jpg,0,0,1,1,2,,train
0553563_as-0089892.jpg,0,0,0,1,1,,train
0553564_as-0089892.jpg,6,0,1,1,8,,val
0553565_as-0089892.jpg,1,1,0,0,2,,val
0553566_as-0089892.jpg,5,0,0,0,5,,test
0553567_as-0089892.jpg,6,0,0,0,6,,train
0553568_as-0089892.jpg,5,0,1,0,6,,train
0553569_as-0089892.jpg,1,0,0,0,1,,train
0553570_as-0089892.jpg,1,0,0,0,1,,train
0553571_as-0089892.jpg,1,0,0,0,1,,train
0553572_as-0089892.jpg,1,0,0,0,1,,train
0553573_as-0089892.jpg,1,0,0,0,1,,train
0553575_sc-156777.jpg,1,0,0,0,1,,val
0553576_sc-156777.jpg,1,0,0,0,1,,val
0553579_sc-112039.jpg,3,0,1,0,4,,test
0553580_sc-112039.jpg,2,0,0,0,2,,train
0553581_as-2803221.jpg,5,1,2,1,9,,train
0553582_as-2865975.jpg,3,1,1,1,6,,train
0553583_sc-1029740.jpg,2,1,1,0,4,,train
0553585_as-3099677.jpg,0,1,1,1,3,,train
0553586_as-0065227.jpg,1,0,0,0,1,,train
0553587_as-0065227.jpg,2,0,0,0,2,,train
0553589_as-0065227.jpg,1,0,0,0,1,,val
0553590_sc-217694.jpg,4,0,0,0,4,,val
0553591_sc-217694.jpg,4,0,0,0,4,,test
0553592_sc-217694.jpg,0,0,0,1,1,,train
0553593_sc-217694.jpg,0,0,0,1,1,,train
0553594_sc-217694.jpg,1,0,0,1,2,,train
0553595_sc-217694.jpg,5,0,0,0,5,,train
0553597_sc-171138.jpg,2,1,0,0,3,,train
0553598_sc-215192.jpg,2,0,1,0,3,,train
0553599_sc-215192.jpg,8,0,0,0,8,,train
0553600_sc-215192.jpg,6,0,0,1,7,,val
0553601_sc-215192.jpg,3,0,0,2,5,,val
0553602_sc-153105.jpg,3,0,1,1,5,,test
0553603_sc-153105.jpg,1,0,2,0,3,,train
0553604_sc-153105.jpg,2,0,1,0,3,,train
0553605_sc-153105.jpg,2,1,1,0,4,,train
0553606_sc-153105.jpg,2,0,0,1,3,,train
0553607_as-3206611.jpg,1,0,0,0,1,,train
0553608_as-2593193.jpg,1,0,0,0,1,,train
0553609_as-2593193.jpg,2,0,0,0,2,,train
0553610_as-3308998.jpg,1,0,0,0,1,,val
0553612_as-0053570.jpg,3,1,0,0,4,,val
0553613_as-0053570.jpg,2,0,0,1,3,,test
0553614_as-0053570.jpg,8,0,0,0,8,,train
0553615_as-0053570.jpg,1,0,0,0,1,,train
0553616_as-0053570.jpg,1,0,0,0,1,,train
0553617_as-3287481.jpg,3,0,0,0,3,,train
0553618_as-2818917.jpg,3,0,0,0,3,,train
0553619_as-3038291.jpg,2,0,0,0,2,,train
0553620_sc-1008724.jpg,5,1,1,0,7,,train
0553624_as-0078368.jpg,1,2,0,0,3,,val
0553625_as-0078368.jpg,0,0,1,0,1,,val
0553626_as-0078368.jpg,1,0,1,1,3,,test
0553627_as-0078368.jpg,1,1,1,0,3,,train
0553628_sc-134091.jpg,0,0,1,0,1,,train
0553629_sc-134091.jpg,1,0,0,0,1,,train
0553631_sc-1018328.jpg,2,1,0,1,4,,train
0553632_as-2959928.jpg,2,0,0,0,2,,train
0553633_sc-1001543.jpg,3,0,1,0,4,,train
0553634_sc-1001543.jpg,2,0,1,1,4,,train
0553635_sc-1001543.jpg,2,0,1,2,5,,val
0553636_sc-1001543.jpg,1,0,0,0,1,,val
0553637_sc-1001543.jpg,2,0,0,0,2,,test
0553638_sc-1001543.jpg,3,0,1,1,5,,train
0553639_sc-1001543.jpg,1,0,0,1,2,,train
0553640_as-0054875.jpg,0,1,0,0,1,,train
0553641_as-0054875.jpg,0,2,0,0,2,,train
0553642_as-0054875.jpg,0,2,0,0,2,,train
0553643_as-0054875.jpg,0,2,0,0,2,,train
0553644_as-0054875.jpg,0,2,0,0,2,,train
0553645_sc-171042.jpg,4,0,0,0,4,,val
0553646_sc-171042.jpg,8,0,0,0,8,,val
0553647_sc-171042.jpg,6,0,0,0,6,,test
0553648_sc-171042.jpg,7,0,0,0,7,,train
0553649_sc-189519.jpg,1,0,0,0,1,,train
0553651_sc-120716.jpg,7,0,0,0,7,,train
0553652_sc-120716.jpg,3,0,0,0,3,,train
0553653_sc-120716.jpg,1,0,0,0,1,,train
0553654_sc-120716.jpg,6,0,0,0,6,,train
0553656_sc-120716.jpg,1,0,0,0,1,,train
0553658_as-0012196.jpg,1,0,0,0,1,,val
0553659_as-3220314.jpg,6,0,0,0,6,,val
0553661_as-0071804.jpg,0,0,0,1,1,,test
0553662_as-0071804.jpg,0,0,0,1,1,,train
0553664_sc-1025987.jpg,2,0,0,0,2,,train
0553665_as-3170020.jpg,3,0,1,0,4,,train
0553667_sc-129729.jpg,2,0,0,1,3,,train
0553668_sc-129729.jpg,0,0,0,1,1,,train
0553669_sc-129729.jpg,2,0,0,1,3,,train
0553670_sc-129729.jpg,4,0,0,0,4,,train
0553671_sc-197235.jpg,4,0,0,0,4,,val
0553672_as-9067593.jpg,0,0,1,0,1,,val
0553674_as-0075212.jpg,5,0,1,1,7,,test
0553675_as-0075212.jpg,3,0,1,0,4,,train
0553678_as-0077533.jpg,1,1,0,0,2,,train
0553679_as-2555914.jpg,2,0,0,0,2,,train
0553680_as-2742782.jpg,1,0,2,1,4,,train
0553682_sc-126353.jpg,1,0,0,0,1,,train
0553683_sc-126353.jpg,1,0,0,0,1,,train
0553684_sc-126353.jpg,2,0,0,0,2,,train
0553686_sc-126353.jpg,2,0,0,0,2,,val
0553687_sc-126353.jpg,2,0,0,0,2,,val
0553688_as-0005701.jpg,1,1,1,1,4,,test
0553689_as-0005701.jpg,1,0,0,0,1,,train
0553692_sc-121515.jpg,7,1,0,0,8,,train
0553693_sc-121515.jpg,10,1,0,0,11,,train
0553694_sc-200339.jpg,3,0,2,1,6,,train
0553695_sc-200339.jpg,0,0,2,0,2,,train
0553696_sc-200339.jpg,2,0,2,1,5,,train
0553697_sc-200339.jpg,1,0,0,1,2,,train
0553698_sc-200339.jpg,1,0,0,0,1,,val
0553699_sc-200339.jpg,2,0,0,0,2,,val
0553700_sc-200339.jpg,2,0,0,0,2,,test
0553701_sc-200339.jpg,2,0,0,0,2,,train
0553702_sc-200339.jpg,2,0,2,1,5,,train
0553703_sc-200339.jpg,2,0,0,0,2,,train
0553704_sc-200339.jpg,3,0,0,1,4,,train
0553705_as-2666998.jpg,1,0,0,0,1,,train
0553706_sc-1010155.jpg,1,0,1,1,3,,train
0553707_sc-1010155.jpg,1,0,0,1,2,,train
0553708_sc-1010155.jpg,1,0,0,0,1,,val
0553709_as-2572031.jpg,1,0,1,1,3,,val
0553710_as-0097673.jpg,3,0,1,1,5,,test
0553711_as-0097673.jpg,2,0,0,1,3,,train
0553712_as-0097673.jpg,1,1,0,0,2,,train
0553713_as-0097673.jpg,2,0,0,0,2,,train
0553714_as-0062564.jpg,3,0,0,0,3,,train
0553717_as-0062564.jpg,1,0,0,0,1,,train
0553721_as-0062564.jpg,1,2,0,0,3,,train
0553722_as-0062564.jpg,1,0,0,0,1,,train
0553724_as-0062564.jpg,2,1,0,0,3,,val
0553725_as-0062564.jpg,3,1,0,0,4,,val
0553727_as-7497910.jpg,1,0,0,0,1,,test
0553728_as-0042624.jpg,1,0,1,0,2,,train
0553729_as-0042624.jpg,3,0,1,0,4,,train
0553730_as-0008505.jpg,1,0,0,0,1,,train
0553731_as-0000652.jpg,2,0,1,1,4,,train
0553732_as-0000652.jpg,2,0,2,1,5,,train
0553733_as-0000652.jpg,1,0,0,0,1,,train
0553734_as-0000652.jpg,1,0,1,1,3,,train
0553735_as-7473065.jpg,1,0,1,1,3,,val
0553736_as-3296961.jpg,0,0,1,0,1,,val
0553737_as-7534004.jpg,0,0,0,1,1,,test
0553738_sc-166534.jpg,1,0,1,0,2,,train
0553739_sc-166534.jpg,3,0,0,0,3,,train
0553740_sc-166534.jpg,1,0,1,0,2,,train
0553742_sc-207455.jpg,1,0,0,0,1,,train
0553743_sc-207455.jpg,1,0,0,0,1,,train
0553744_sc-207455.jpg,2,0,0,0,2,,train
0553745_sc-207455.jpg,1,0,0,0,1,,train
0553746_sc-207455.jpg,1,0,0,1,2,,val
0553748_as-2643045.jpg,1,0,0,0,1,,val
0553750_as-0014174.jpg,1,0,0,0,1,,test
0553751_as-0014174.jpg,1,0,0,0,1,,train
0553752_as-0014174.jpg,1,0,0,0,1,,train
0553753_as-0014174.jpg,1,0,0,0,1,,train
0553754_sc-123906.jpg,16,0,2,1,19,,train
0553755_sc-123906.jpg,14,0,1,2,17,,train
0553756_sc-123906.jpg,20,0,1,0,21,,train
0553757_sc-123906.jpg,15,0,1,2,18,,train
0553758_sc-123906.jpg,21,0,1,0,22,,val
0553759_sc-123906.jpg,17,0,1,2,20,,val
0553760_sc-123906.jpg,7,0,1,1,9,,test
0553761_as-3043864.jpg,1,0,0,0,1,,train
0553762_sc-125601.jpg,0,0,0,1,1,,train
0553763_sc-125601.jpg,2,0,0,1,3,,train
0553764_sc-1019307.jpg,1,0,0,0,1,,train
0553765_sc-1019307.jpg,1,0,0,0,1,,train
0553766_as-0054800.jpg,0,0,1,1,2,,train
0553767_as-0054800.jpg,1,0,1,1,3,,train
0553769_as-0054800.jpg,0,0,1,0,1,,val
0553770_as-0054800.jpg,0,0,2,0,2,,val
0553771_as-2952563.jpg,1,0,0,1,2,,test
0553773_as-0075532.jpg,1,0,1,0,2,,train
0553774_as-0075532.jpg,1,0,0,0,1,,train
0553779_as-2915782.jpg,1,0,0,1,2,,train
0553780_as-7385753.jpg,1,0,1,0,2,,train
0553781_as-3481097.jpg,1,0,0,0,1,,train
0553782_sc-196941.jpg,3,0,0,3,6,,train
0553784_sc-196941.jpg,1,0,0,1,2,,train
0553785_sc-196941.jpg,2,0,0,1,3,,val
0553786_sc-196941.jpg,2,0,1,0,3,,val
0553787_sc-196941.jpg,1,0,0,0,1,,test
0553788_sc-196941.jpg,1,0,0,0,1,,train
0553789_sc-196941.jpg,1,0,0,0,1,,train
0553790_sc-196941.jpg,1,0,0,1,2,,train
0553791_sc-196941.jpg,1,0,0,1,2,,train
0553792_sc-196941.jpg,4,0,0,1,5,,train
0553793_sc-196941.jpg,2,0,0,1,3,,train
0553794_sc-196941.jpg,2,0,0,1,3,,train
0553795_sc-195578.jpg,1,0,0,0,1,,val
0553796_as-2587590.jpg,2,0,0,0,2,,val
0553797_as-0029483.jpg,1,0,0,0,1,,test
0553798_as-0029483.jpg,1,0,0,0,1,,train
0553799_as-0029483.jpg,1,0,0,0,1,,train
0553800_as-0029483.jpg,1,0,0,0,1,,train
0553801_as-0028989.jpg,1,0,0,0,1,,train
0553803_as-2902349.jpg,2,0,1,1,4,,train
0553804_sc-228711.jpg,2,0,0,0,2,,train
0553805_sc-228711.jpg,1,1,0,0,2,,train
0553806_sc-210882.jpg,3,0,0,0,3,,val
0553807_sc-210882.jpg,1,0,0,0,1,,val
0553808_sc-210882.jpg,1,0,0,0,1,,test
0553809_sc-210882.jpg,1,1,0,0,2,,train
0553810_sc-229180.jpg,1,0,0,0,1,,train
0553811_sc-229180.jpg,2,0,0,0,2,,train
0553812_sc-229180.jpg,1,2,0,0,3,,train
0553813_sc-229180.jpg,1,1,0,0,2,,train
0553814_sc-229180.jpg,1,0,1,0,2,,train
0553815_sc-229180.jpg,1,0,0,0,1,,train
0553816_sc-229180.jpg,1,0,0,0,1,,val
0553818_sc-112895.jpg,2,0,1,1,4,,val
0553819_sc-112895.jpg,1,0,0,1,2,,test
0553820_sc-1010641.jpg,1,0,0,0,1,,train
0553822_sc-1010641.jpg,1,0,0,0,1,,train
0553823_sc-1010641.jpg,2,0,0,0,2,,train
0553824_sc-1010641.jpg,2,0,0,0,2,,train
0553826_as-0004015.jpg,3,0,0,0,3,,train
0553828_as-0039269.jpg,1,0,0,0,1,,train
0553829_as-3227978.jpg,0,1,2,0,3,,train
0553830_as-3135277.jpg,1,0,0,0,1,,val
0553831_sc-108705.jpg,1,0,1,1,3,,val
0553832_sc-108705.jpg,1,0,0,0,1,,test
0553833_sc-229360.jpg,2,0,1,0,3,,train
0553834_sc-229360.jpg,3,0,4,0,7,,train
0553835_sc-229360.jpg,0,1,0,0,1,,train
0553837_as-0061377.jpg,2,0,0,0,2,,train
0553839_as-0048452.jpg,1,0,0,0,1,,train
0553840_as-0048452.jpg,1,0,0,0,1,,train
0553841_sc-127561.jpg,4,0,0,0,4,,train
0553842_sc-127561.jpg,1,0,0,0,1,,val
0553843_sc-127561.jpg,2,0,0,0,2,,val
0553844_sc-127561.jpg,2,0,0,0,2,,test
0553845_sc-127561.jpg,2,0,0,0,2,,train
0553846_as-9097730.jpg,1,0,1,1,3,,train
0553847_as-9097730.jpg,1,0,1,0,2,,train
0553848_sc-142200.jpg,4,1,0,1,6,,train
0553850_sc-142200.jpg,2,0,0,0,2,,train
0553851_sc-142200.jpg,3,0,0,0,3,,train
0553852_as-3366508.jpg,3,0,0,1,4,,train
0553853_sc-1030719.jpg,8,2,1,3,14,,val
0553855_sc-173973.jpg,3,0,0,0,3,,val
0553856_sc-173973.jpg,2,0,0,0,2,,test
0553857_sc-173973.jpg,2,2,0,0,4,,train
0553858_sc-169538.jpg,4,2,3,0,9,,train
0553860_as-0062176.jpg,1,0,1,0,2,,train
0553862_as-0062176.jpg,3,0,2,0,5,,train
0553863_as-0062176.jpg,1,0,1,0,2,,train
0553864_as-3354565.jpg,2,0,0,1,3,,train
0553865_sc-230091.jpg,5,0,1,1,7,,train
0553866_sc-230091.jpg,2,0,1,0,3,,val
0553867_sc-230091.jpg,5,0,1,1,7,,val
0553868_sc-166297.jpg,3,0,0,0,3,,test
0553870_sc-166297.jpg,4,0,0,0,4,,train
0553871_sc-166297.jpg,2,0,0,0,2,,train
0553872_sc-166297.jpg,3,0,0,0,3,,train
0553873_as-2807205.jpg,7,0,0,0,7,,train
0553874_sc-212696.jpg,1,0,0,0,1,,train
0553875_sc-212696.jpg,1,1,0,0,2,,train
0553876_sc-212696.jpg,0,1,0,0,1,,train
0553880_sc-132505.jpg,1,0,0,0,1,,val
0553881_sc-132505.jpg,1,0,0,0,1,,val
0553882_sc-132505.jpg,1,0,0,0,1,,test
0553883_sc-132505.jpg,2,0,0,0,2,,train
0553884_sc-132505.jpg,1,0,0,0,1,,train
0553886_as-7072063.jpg,7,0,1,0,8,,train
0553887_as-2759328.jpg,12,2,0,0,14,,train
0553888_sc-181332.jpg,1,0,1,0,2,,train
0553889_sc-181332.jpg,1,0,1,0,2,,train
0553890_sc-181332.jpg,1,0,2,0,3,,train
0553891_as-0044504.jpg,0,1,0,0,1,,val
0553892_as-0044504.jpg,1,0,0,0,1,,val
0553893_as-0044504.jpg,1,1,0,0,2,,test
0553894_as-0044504.jpg,0,0,1,0,1,,train
0553895_sc-1001868.jpg,2,0,1,0,3,,train
0553896_sc-1001868.jpg,0,0,1,0,1,,train
0553900_as-0020854.jpg,1,0,0,0,1,,train
0553901_sc-109289.jpg,1,0,1,0,2,,train
0553902_sc-109289.jpg,1,0,1,0,2,,train
0553903_sc-109289.jpg,1,0,1,0,2,,train
0553909_sc-1036887.jpg,1,1,0,0,2,,val
0553910_as-0033598.jpg,1,0,1,0,2,,val
0553911_as-0033598.jpg,3,1,0,0,4,,test
0553912_as-0033598.jpg,0,1,0,0,1,,train
0553914_as-3221770.jpg,1,0,0,0,1,,train
0553916_sc-221998.jpg,1,0,0,2,3,,train
0553917_as-2784661.jpg,1,0,0,0,1,,train
0553918_as-2678001.jpg,4,0,0,0,4,,train
0553919_as-3160465.jpg,1,0,0,0,1,,train
0553921_as-0091661.jpg,1,0,0,0,1,,train
0553922_as-0091661.jpg,1,0,0,0,1,,val
0553923_as-0091661.jpg,1,0,0,0,1,,val
0553924_as-0091661.jpg,1,0,0,0,1,,test
0553925_as-0091661.jpg,1,0,0,0,1,,train
0553926_as-0091661.jpg,1,0,0,0,1,,train
0553927_sc-1011754.jpg,2,0,0,2,4,,train
0553928_sc-1011754.jpg,1,0,0,1,2,,train
0553929_sc-1011754.jpg,2,0,0,1,3,,train
0553930_sc-1011754.jpg,2,0,0,2,4,,train
0553931_sc-193411.jpg,1,0,0,1,2,,train
0553932_sc-193411.jpg,1,0,0,1,2,,val
0553933_sc-193411.jpg,1,0,0,1,2,,val
0553934_sc-193411.jpg,1,0,0,1,2,,test
0553935_sc-193411.jpg,1,0,0,0,1,,train
0553936_sc-193411.jpg,1,0,0,0,1,,train
0553937_sc-193411.jpg,1,0,0,0,1,,train
0553938_sc-193411.jpg,2,0,1,1,4,,train
0553939_sc-193411.jpg,1,0,0,0,1,,train
0553940_sc-193411.jpg,1,0,1,0,2,,train
0553941_as-0037885.jpg,7,0,1,1,9,,train
0553942_sc-212095.jpg,2,1,1,0,4,,val
0553943_as-2502913.jpg,3,0,0,0,3,,val
0553946_as-0041356.jpg,3,0,0,1,4,,test
0553947_as-0041356.jpg,2,0,0,0,2,,train
0553948_as-0041356.jpg,4,0,0,1,5,,train
0553949_sc-1034636.jpg,2,0,0,0,2,,train
0553950_sc-1034636.jpg,1,0,0,0,1,,train
0553951_as-2847373.jpg,0,0,2,0,2,,train
0553954_as-0060281.jpg,3,0,0,0,3,,train
0553956_as-0046203.jpg,3,0,0,0,3,,train
0553957_as-0046203.jpg,3,0,0,0,3,,val
0553958_as-0046203.jpg,3,0,0,0,3,,val
0553959_as-0046203.jpg,3,0,0,0,3,,test
0553960_as-0046203.jpg,3,0,0,0,3,,train
0553961_as-0046203.jpg,3,0,0,0,3,,train
0553962_as-0046203.jpg,2,0,0,0,2,,train
0553963_as-0046203.jpg,0,0,0,1,1,,train
0553964_as-0046203.jpg,0,1,0,0,1,,train
0553965_as-0046203.jpg,0,1,0,0,1,,train
0553966_as-0046203.jpg,2,0,0,0,2,,train
0553967_as-0046203.jpg,1,0,0,0,1,,val
0553968_as-0046203.jpg,3,0,0,0,3,,val
0553969_as-0046203.jpg,1,0,0,0,1,,test
0553971_as-2774533.jpg,1,1,1,0,3,,train
0553973_as-0045484.jpg,1,0,1,0,2,,train
0553974_as-0045484.jpg,2,0,0,1,3,,train
0553975_as-0045484.jpg,1,0,1,0,2,,train
0553976_as-0045484.jpg,1,0,0,0,1,,train
0553977_as-0045484.jpg,1,0,0,0,1,,train
0553978_as-0045484.jpg,1,0,0,0,1,,train
0553979_as-0074443.jpg,5,0,1,1,7,,val
0553981_as-0074443.jpg,2,0,0,1,3,,val
0553982_as-0074443.jpg,1,0,0,1,2,,test
0553983_as-0074443.jpg,4,0,0,1,5,,train
0553984_as-0074443.jpg,4,0,2,1,7,,train
0553985_as-0074443.jpg,4,0,2,0,6,,train
0553986_as-0074443.jpg,1,0,0,1,2,,train
0553987_as-0074443.jpg,1,0,1,1,3,,train
0553988_as-0074443.jpg,0,0,1,0,1,,train
0553989_as-0074443.jpg,3,0,0,0,3,,train
0553990_as-0074443.jpg,3,0,0,0,3,,val
0553991_as-0074443.jpg,2,0,0,1,3,,val
0553992_sc-187936.jpg,4,1,1,0,6,,test
0553993_sc-187936.jpg,9,1,0,0,10,,train
0553994_as-2940636.jpg,1,0,1,1,3,,train
0553995_sc-1000841.jpg,2,1,0,0,3,,train
0553996_sc-1000841.jpg,3,2,0,0,5,,train
0553997_sc-1000841.jpg,2,1,0,0,3,,train
0554000_sc-183664.jpg,2,2,0,0,4,,train
0554001_as-0036502.jpg,1,0,1,0,2,,train
0554002_as-0036502.jpg,1,0,1,0,2,,val
0554003_as-2514990.jpg,1,0,0,0,1,,val
0554004_as-3371027.jpg,2,0,0,0,2,,test
0554005_as-7045676.jpg,1,0,0,0,1,,train
0554009_as-0042548.jpg,0,2,1,1,4,,train
0554010_as-7044522.jpg,1,0,0,0,1,,train
0554012_as-0010322.jpg,0,0,2,0,2,,train
0554013_as-0010322.jpg,4,1,5,1,11,,train
0554014_as-0010322.jpg,1,0,0,0,1,,train
0554015_as-3043583.jpg,0,1,1,0,2,,train
0554017_sc-125884.jpg,1,0,1,0,2,,val
0554018_sc-125884.jpg,1,0,0,0,1,,val
0554019_as-3084145.jpg,0,1,0,0,1,,test
0554020_as-3084145.jpg,5,0,0,0,5,,train
0554022_as-0086237.jpg,1,0,2,1,4,,train
0554023_as-0086237.jpg,1,0,2,2,5,,train
0554024_as-2601913.jpg,3,0,0,0,3,,train
0554025_sc-210657.jpg,5,0,1,1,7,,train
0554026_sc-210657.jpg,4,0,1,1,6,,train
0554027_sc-210657.jpg,2,0,1,1,4,,train
0554028_sc-210657.jpg,2,0,1,1,4,,val
0554029_sc-172915.jpg,2,2,1,0,5,,val
0554030_sc-172915.jpg,1,1,1,0,3,,test
0554032_sc-172915.jpg,5,2,2,0,9,,train
0554033_as-0098585.jpg,2,0,0,0,2,,train
0554034_as-0004427.jpg,0,0,1,0,1,,train
0554036_sc-1009729.jpg,1,0,2,1,4,,train
0554038_sc-1009729.jpg,1,0,1,1,3,,train
0554039_sc-1009729.jpg,1,0,0,0,1,,train
0554041_as-0006779.jpg,0,0,2,1,3,,train
0554042_as-0006779.jpg,0,0,1,1,2,,val
0554043_as-0006779.jpg,1,0,1,0,2,,val
0554044_as-0006779.jpg,1,0,1,0,2,,test
0554045_as-0006779.jpg,2,0,1,0,3,,train
0554046_as-0006779.jpg,1,0,1,0,2,,train
0554047_sc-1027832.jpg,4,1,1,2,8,,train
0554048_as-0018497.jpg,1,0,0,1,2,,train
0554049_as-0018497.jpg,2,0,0,1,3,,train
0554050_as-0018497.jpg,0,1,0,0,1,,train
0554052_as-0018497.jpg,3,1,0,0,4,,train
0554053_as-0018497.jpg,0,2,1,0,3,,val
0554054_as-0018497.jpg,0,1,0,0,1,,val
0554056_as-0018497.jpg,0,0,1,0,1,,test
0554057_as-0018497.jpg,0,0,2,0,2,,train
0554058_as-0018497.jpg,2,0,0,0,2,,train
0554061_as-0018497.jpg,2,0,0,0,2,,train
0554063_as-0018497.jpg,1,0,1,1,3,,train
0554064_as-0018497.jpg,2,0,0,0,2,,train
0554065_as-0018497.jpg,1,0,0,0,1,,train
0554066_as-2654381.jpg,2,0,1,1,4,,train
0554067_sc-134875.jpg,4,0,0,1,5,,val
0554068_sc-134875.jpg,2,0,0,0,2,,val
0554069_sc-212335.jpg,2,0,1,0,3,,test
0554070_sc-212335.jpg,2,0,1,0,3,,train
0554071_sc-212335.jpg,1,0,1,0,2,,train
0554072_as-0026195.jpg,1,0,0,1,2,,train
0554075_sc-1015661.jpg,1,0,0,1,2,,train
0554076_sc-1015661.jpg,1,0,0,1,2,,train
0554079_as-0016827.jpg,1,0,0,0,1,,train
0554080_as-0016827.jpg,1,0,0,0,1,,train
0554081_as-0016827.jpg,1,0,0,1,2,,val
0554085_as-0016827.jpg,2,0,0,0,2,,val
0554087_as-0016827.jpg,3,0,0,0,3,,test
0554088_as-0016827.jpg,8,0,0,0,8,,train
0554089_as-0016827.jpg,8,0,0,0,8,,train
0554093_as-2673340.jpg,1,0,0,0,1,,train
0554094_sc-227472.jpg,2,0,1,1,4,,train
0554095_sc-227472.jpg,2,0,1,1,4,,train
0554096_sc-227472.jpg,5,0,1,1,7,,train
0554097_sc-227472.jpg,6,0,0,1,7,,train
0554098_sc-227472.jpg,3,0,0,1,4,,val
0554099_sc-227472.jpg,5,0,0,1,6,,val
0554100_as-7068429.jpg,1,0,0,0,1,,test
0554101_sc-127576.jpg,1,0,0,2,3,,train
0554102_sc-1025015.jpg,4,0,1,0,5,,train
0554103_sc-1025015.jpg,4,0,0,0,4,,train
0554104_sc-228828.jpg,1,0,0,1,2,,train
0554105_sc-228828.jpg,4,0,0,1,5,,train
0554107_as-2814591.jpg,1,0,0,1,2,,train
0554109_as-0016078.jpg,1,0,1,0,2,,train
0554111_as-0016078.jpg,2,2,1,0,5,,val
0554112_as-0016078.jpg,1,0,0,1,2,,val
0554113_as-0016078.jpg,0,0,1,0,1,,test
0554114_sc-163041.jpg,2,0,0,0,2,,train
0554115_sc-163041.jpg,2,0,0,0,2,,train
0554116_sc-163041.jpg,2,0,0,0,2,,train
0554118_sc-126607.jpg,2,0,0,0,2,,train
0554119_sc-1022026.jpg,3,0,0,0,3,,train
0554123_as-0075579.jpg,1,1,0,0,2,,train
0554126_as-0075579.jpg,1,1,0,1,3,,train
0554127_as-0075579.jpg,1,0,1,0,2,,val
0554128_as-0075579.jpg,1,0,1,1,3,,val
0554129_as-0075579.jpg,1,0,0,1,2,,test
0554130_as-0075579.jpg,1,0,1,1,3,,train
0554131_as-0075579.jpg,1,0,2,1,4,,train
0554132_as-0075579.jpg,2,0,0,0,2,,train
0554133_as-0052365.jpg,2,0,0,2,4,,train
0554134_as-0052365.jpg,2,0,0,2,4,,train
0554135_as-0052365.jpg,2,0,0,2,4,,train
0554137_sc-190039.jpg,2,2,3,0,7,,train
0554138_as-9086186.jpg,1,0,1,0,2,,val
0554139_sc-136669.jpg,2,0,0,1,3,,val
0554141_sc-1032724.jpg,1,0,0,1,2,,test
0554142_sc-1032724.jpg,3,0,0,1,4,,train
0554143_as-0095014.jpg,2,0,0,1,3,,train
0554144_as-0095014.jpg,2,0,0,1,3,,train
0554145_as-0095014.jpg,3,0,1,1,5,,train
0554146_as-3325652.jpg,5,0,0,0,5,,train
0554148_sc-226581.jpg,4,0,0,0,4,,train
0554149_sc-226581.jpg,2,0,0,0,2,,train
0554150_sc-226581.jpg,2,0,0,0,2,,val
0554151_sc-226581.jpg,1,0,1,0,2,,val
0554153_as-0031610.jpg,1,0,0,0,1,,test
0554154_as-0031610.jpg,1,0,0,0,1,,train
0554155_as-0031610.jpg,1,0,0,0,1,,train
0554156_as-0031610.jpg,2,0,1,1,4,,train
0554157_as-0031610.jpg,4,0,1,0,5,,train
0554158_as-0031610.jpg,2,1,1,0,4,,train
0554159_as-0031610.jpg,1,0,0,0,1,,train
0554160_as-2585949.jpg,3,0,0,0,3,,train
0554161_as-2725754.jpg,0,0,1,0,1,,val
0554162_as-3309686.jpg,1,0,1,0,2,,val
0554165_as-0016138.jpg,2,0,1,1,4,,test
0554166_as-0016138.jpg,3,0,0,0,3,,train
0554168_as-0016138.jpg,1,2,1,0,4,,train
0554169_as-0016138.jpg,0,1,1,0,2,,train
0554170_as-0016138.jpg,0,0,1,0,1,,train
0554171_as-0016138.jpg,2,2,1,0,5,,train
0554172_as-7409614.jpg,1,0,2,0,3,,train
0554173_as-3498342.jpg,2,0,0,0,2,,train
0554174_sc-206529.jpg,1,0,0,0,1,,val
0554175_sc-190427.jpg,2,0,0,0,2,,val
0554177_sc-211197.jpg,12,1,1,0,14,,test
0554178_sc-211197.jpg,6,1,0,0,7,,train
0554179_as-7139466.jpg,1,0,0,1,2,,train
0554180_as-7139466.jpg,5,0,1,0,6,,train
0554181_sc-210503.jpg,2,1,1,0,4,,train
0554182_sc-210503.jpg,2,0,0,0,2,,train
0554183_sc-210503.jpg,3,0,0,0,3,,train
0554184_sc-210503.jpg,1,0,0,0,1,,train
0554185_sc-210503.jpg,2,1,1,0,4,,val
0554186_sc-1030340.jpg,4,0,1,0,5,,val
0554187_sc-1030340.jpg,1,0,2,1,4,,test
0554188_sc-1030340.jpg,1,0,0,1,2,,train
0554189_sc-168884.jpg,6,1,1,0,8,,train
0554191_as-3181362.jpg,1,0,0,0,1,,train
0554192_sc-1033696.jpg,0,1,0,0,1,,train
0554194_sc-1033696.jpg,0,0,1,1,2,,train
0554196_sc-1033696.jpg,0,0,1,0,1,,train
0554200_sc-121881.jpg,1,0,0,0,1,,train
0554201_sc-121881.jpg,1,0,0,0,1,,val
0554202_sc-217580.jpg,2,0,0,0,2,,val
0554203_sc-1026765.jpg,1,0,0,0,1,,test
0554204_as-9064141.jpg,1,0,1,0,2,,train
0554209_as-0051787.jpg,1,0,1,1,3,,train
0554210_sc-169900.jpg,3,3,1,1,8,,train
0554211_sc-169900.jpg,3,2,2,2,9,,train
0554214_as-0053622.jpg,2,0,0,0,2,,train
0554215_as-0053622.jpg,1,0,0,0,1,,train
0554216_as-0053622.jpg,2,0,0,0,2,,train
0554217_as-0053622.jpg,2,0,0,0,2,,val
0554219_sc-173076.jpg,0,1,0,0,1,,val
0554221_sc-179518.jpg,5,0,0,1,6,,test
0554222_sc-179518.jpg,6,0,0,1,7,,train
0554223_sc-179518.jpg,1,0,0,1,2,,train
0554224_sc-179518.jpg,2,0,0,1,3,,train
0554225_sc-179518.jpg,1,0,0,1,2,,train
0554226_sc-179518.jpg,3,0,0,1,4,,train
0554227_sc-179518.jpg,1,0,0,1,2,,train
0554229_as-0025365.jpg,1,0,0,0,1,,train
0554230_as-0025365.jpg,1,0,0,0,1,,val
0554231_as-0025365.jpg,1,0,1,0,2,,val
0554232_as-0035097.jpg,3,0,2,1,6,,test
0554233_as-0035097.jpg,2,0,0,2,4,,train
0554234_as-0035097.jpg,3,0,0,2,5,,train
0554235_as-0035097.jpg,3,0,0,0,3,,train
0554236_as-0035097.jpg,3,0,1,0,4,,train
0554237_as-0035097.jpg,3,0,1,1,5,,train
0554238_sc-178964.jpg,2,1,0,0,3,,train
0554240_sc-229230.jpg,1,0,0,1,2,,train
0554241_sc-229230.jpg,3,0,1,0,4,,val
0554242_sc-229230.jpg,4,0,1,1,6,,val
0554244_sc-229230.jpg,4,0,2,0,6,,test
0554245_sc-229230.jpg,1,0,1,0,2,,train
0554247_sc-229230.jpg,2,1,1,0,4,,train
0554248_sc-122303.jpg,6,1,1,1,9,,train
0554249_sc-122303.jpg,6,1,1,1,9,,train
0554250_sc-122303.jpg,4,1,0,1,6,,train
0554251_sc-1017122.jpg,1,0,1,0,2,,train
0554252_sc-1017122.jpg,3,0,0,1,4,,train
0554253_sc-215578.jpg,1,1,0,0,2,,val
0554254_sc-215578.jpg,2,1,0,0,3,,val
0554255_sc-1038234.jpg,1,1,1,0,3,,test
0554256_sc-1038234.jpg,4,0,2,0,6,,train
0554257_sc-1038234.jpg,3,0,1,0,4,,train
0554258_sc-1038234.jpg,2,0,1,0,3,,train
0554260_sc-116892.jpg,3,0,0,0,3,,train
0554261_as-0012823.jpg,1,0,0,0,1,,train
0554262_as-0012823.jpg,0,0,1,0,1,,train
0554263_as-0012823.jpg,0,0,1,0,1,,train
0554264_as-3365058.jpg,1,0,1,1,3,,val
0554265_as-2593555.jpg,1,0,1,1,3,,val
0554266_sc-200044.jpg,0,0,3,0,3,,test
0554267_sc-200044.jpg,0,2,2,1,5,,train
0554268_sc-200044.jpg,1,3,2,0,6,,train
0554269_sc-228220.jpg,0,1,0,0,1,,train
0554270_sc-228220.jpg,0,1,0,0,1,,train
0554271_sc-220665.jpg,1,1,1,1,4,,train
0554272_sc-220665.jpg,1,1,2,1,5,,train
0554274_sc-220665.jpg,1,1,2,1,5,,train
0554275_as-0099807.jpg,1,0,0,0,1,,val
0554276_as-0099807.jpg,1,0,0,0,1,,val
0554278_sc-166377.jpg,1,1,1,0,3,,test
0554279_sc-166377.jpg,1,2,1,1,5,,train
0554282_as-0054242.jpg,1,0,0,0,1,,train
0554283_as-0054242.jpg,1,0,0,0,1,,train
0554284_as-3122583.jpg,2,0,2,0,4,,train
0554285_as-0032922.jpg,1,0,0,0,1,,train
0554286_as-0032922.jpg,3,0,0,0,3,,train
0554288_as-3378425.jpg,1,0,1,1,3,,train
0554290_sc-120931.jpg,0,1,0,0,1,,val
0554293_as-0042816.jpg,1,0,0,0,1,,val
0554295_sc-1028120.jpg,1,0,1,0,2,,test
0554298_as-2779089.jpg,4,0,0,0,4,,train
0554300_as-0095805.jpg,0,1,2,0,3,,train
0554301_as-0095805.jpg,0,0,1,0,1,,train
0554302_as-0095805.jpg,0,0,1,0,1,,train
0554303_as-2503361.jpg,1,0,1,0,2,,train
0554304_as-7505324.jpg,4,0,1,0,5,,train
0554307_as-0016797.jpg,1,0,1,0,2,,train
0554308_sc-217406.jpg,1,0,0,0,1,,val
0554309_sc-217406.jpg,1,0,1,0,2,,val
0554310_sc-217406.jpg,5,0,1,0,6,,test
0554311_sc-217406.jpg,6,0,1,0,7,,train
0554312_sc-217406.jpg,4,0,1,0,5,,train
0554313_sc-217406.jpg,4,0,1,0,5,,train
0554314_sc-217406.jpg,5,1,1,0,7,,train
0554315_as-7426119.jpg,2,1,1,0,4,,train
0554316_as-7043670.jpg,2,1,2,0,5,,train
0554317_sc-156394.jpg,0,0,0,3,3,,train
0554318_as-2576951.jpg,0,0,1,0,1,,val
0554321_as-0077059.jpg,2,0,1,1,4,,val
0554322_as-0077059.jpg,0,0,1,1,2,,test
0554324_sc-193289.jpg,2,0,1,2,5,,train
0554325_sc-193289.jpg,0,0,1,1,2,,train
0554328_as-0058808.jpg,1,0,1,1,3,,train
0554331_sc-1021893.jpg,1,0,1,0,2,,train
0554332_as-9000424.jpg,2,0,0,0,2,,train
0554333_as-2653628.jpg,1,0,0,1,2,,train
0554334_sc-1038006.jpg,5,0,0,0,5,,train
0554335_sc-1038006.jpg,6,0,0,0,6,,val
0554336_sc-1038006.jpg,7,0,0,0,7,,val
0554337_sc-1029805.jpg,1,0,1,0,2,,test
0554338_sc-1029805.jpg,1,0,0,0,1,,train
0554339_sc-1029805.jpg,2,0,0,0,2,,train
0554340_sc-1029805.jpg,3,0,0,0,3,,train
0554341_sc-1029805.jpg,1,0,0,0,1,,train
0554342_as-3399450.jpg,8,1,1,0,10,,train
0554344_sc-211369.jpg,1,0,0,0,1,,train
0554345_sc-211369.jpg,2,1,0,0,3,,train
0554346_sc-211369.jpg,2,1,0,0,3,,val
0554347_sc-211369.jpg,3,1,0,0,4,,val
0554348_sc-211369.jpg,2,0,0,0,2,,test
0554349_sc-211369.jpg,1,0,0,0,1,,train
0554350_as-0048359.jpg,1,0,0,0,1,,train
0554352_sc-1006045.jpg,1,0,1,0,2,,train
0554353_sc-1006045.jpg,1,0,0,0,1,,train
0554354_sc-1006045.jpg,2,0,1,1,4,,train
0554355_sc-1006045.jpg,1,0,1,1,3,,train
0554357_sc-1006045.jpg,1,0,1,1,3,,train
0554360_as-0060448.jpg,1,0,0,0,1,,val
0554361_as-0060448.jpg,3,0,0,0,3,,val
0554362_as-0060448.jpg,1,0,0,0,1,,test
0554363_as-0060448.jpg,1,0,0,0,1,,train
0554364_as-2853933.jpg,1,0,0,0,1,,train
0554365_sc-216642.jpg,4,1,1,1,7,,train
0554366_sc-1018789.jpg,1,0,1,0,2,,train
0554368_sc-1018789.jpg,1,0,0,0,1,,train
0554369_sc-1018789.jpg,2,0,1,0,3,,train
0554370_sc-1018789.jpg,1,0,1,2,4,,train
0554371_sc-1018789.jpg,3,3,1,2,9,,val
0554372_sc-1018789.jpg,1,1,1,1,4,,val
0554373_sc-1018789.jpg,3,0,1,1,5,,test
0554374_as-3321247.jpg,1,0,0,0,1,,train
0554376_as-0064961.jpg,3,0,0,0,3,,train
0554377_as-0064961.jpg,5,0,0,0,5,,train
0554379_as-0064961.jpg,5,0,0,0,5,,train
0554380_as-0064961.jpg,1,0,0,0,1,,train
0554382_as-0064961.jpg,5,0,0,0,5,,train
0554383_as-0097164.jpg,0,1,0,0,1,,train
0554384_sc-144125.jpg,2,0,0,0,2,,val
0554385_sc-144125.jpg,2,0,0,0,2,,val
0554386_sc-177623.jpg,2,0,2,0,4,,test
0554387_sc-177623.jpg,2,0,3,2,7,,train
0554389_as-0074466.jpg,1,0,3,1,5,,train
0554390_as-0074466.jpg,3,2,1,0,6,,train
0554391_as-0074466.jpg,1,1,3,1,6,,train
0554392_as-2914993.jpg,3,0,1,0,4,,train
0554393_sc-228735.jpg,1,0,1,1,3,,train
0554394_as-2724813.jpg,0,1,0,0,1,,train
0554396_as-3311605.jpg,2,0,0,0,2,,val
0554397_as-2755215.jpg,2,0,0,0,2,,val
0554398_as-9036880.jpg,0,0,1,0,1,,test
0554399_as-3273786.jpg,1,0,0,0,1,,train
0554401_as-0012536.jpg,2,0,0,0,2,,train
0554403_sc-208997.jpg,3,0,0,1,4,,train
0554404_sc-208997.jpg,1,0,0,0,1,,train
0554405_sc-131891.jpg,1,0,0,0,1,,train
0554407_sc-192005.jpg,5,2,2,2,11,,train
0554408_sc-192005.jpg,3,2,1,2,8,,train
0554409_sc-192005.jpg,3,2,1,2,8,,val
0554410_sc-192005.jpg,3,1,1,1,6,,val
0554411_sc-192005.jpg,2,1,1,1,5,,test
0554412_sc-192005.jpg,2,0,1,1,4,,train
0554413_sc-219935.jpg,0,0,0,1,1,,train
0554414_sc-219935.jpg,2,0,0,0,2,,train
0554415_sc-219935.jpg,0,0,0,1,1,,train
0554416_as-0076612.jpg,1,0,0,0,1,,train
0554417_as-7605272.jpg,2,0,0,0,2,,train
0554418_as-0088810.jpg,2,0,0,1,3,,train
0554419_as-0088810.jpg,2,0,0,1,3,,val
0554420_as-0088810.jpg,1,0,0,1,2,,val
0554421_as-2640049.jpg,2,1,1,2,6,,test
0554422_as-2833102.jpg,0,0,2,0,2,,train
0554423_as-0046340.jpg,0,1,1,0,2,,train
0554424_as-0046340.jpg,1,0,0,0,1,,train
0554425_sc-198869.jpg,1,0,0,0,1,,train
0554426_sc-198869.jpg,2,0,0,0,2,,train
0554427_sc-198869.jpg,1,0,0,0,1,,train
0554428_sc-198869.jpg,1,0,0,0,1,,train
0554432_sc-175207.jpg,2,0,1,0,3,,val
0554433_sc-175207.jpg,1,0,0,0,1,,val
0554434_sc-175207.jpg,1,0,1,0,2,,test
0554435_sc-175207.jpg,1,0,0,0,1,,train
0554437_sc-175207.jpg,1,0,1,0,2,,train
0554439_sc-1028841.jpg,3,1,1,1,6,,train
0554440_sc-1028841.jpg,2,2,1,1,6,,train
0554441_sc-165309.jpg,2,0,0,0,2,,train
0554442_as-3436123.jpg,2,1,0,0,3,,train
0554443_sc-142160.jpg,1,1,0,1,3,,train
0554445_as-0028061.jpg,2,2,1,0,5,,val
0554446_as-0028061.jpg,0,0,1,0,1,,val
0554447_sc-139416.jpg,0,1,0,0,1,,test
0554448_sc-139416.jpg,0,1,0,0,1,,train
0554450_as-0096185.jpg,2,0,1,1,4,,train
0554452_as-0096185.jpg,1,1,0,0,2,,train
0554453_as-0040186.jpg,1,1,0,0,2,,train
0554454_as-0040186.jpg,1,0,0,0,1,,train
0554455_as-0040186.jpg,1,1,0,0,2,,train
0554456_as-0040186.jpg,1,0,0,0,1,,train
0554457_as-0040186.jpg,1,1,0,0,2,,val
0554458_as-0040186.jpg,1,0,0,0,1,,val
0554459_as-0040186.jpg,2,0,0,0,2,,test
0554460_as-0040186.jpg,0,0,1,0,1,,train
0554461_as-0040186.jpg,3,1,1,0,5,,train
0554462_as-0040186.jpg,2,1,1,0,4,,train
0554463_as-0040186.jpg,3,1,1,0,5,,train
0554464_as-0040186.jpg,0,0,1,0,1,,train
0554465_as-0040186.jpg,1,1,0,0,2,,train
0554466_as-2573061.jpg,0,0,1,0,1,,train
0554467_sc-221263.jpg,7,0,0,0,7,,val
0554468_sc-221263.jpg,4,0,2,1,7,,val
0554469_sc-221263.jpg,2,0,1,0,3,,test
0554471_as-3496170.jpg,5,0,0,0,5,,train
0554472_as-2761323.jpg,1,0,0,1,2,,train
0554473_as-0012238.jpg,2,0,0,0,2,,train
0554474_as-0012238.jpg,3,0,0,0,3,,train
0554475_as-0012238.jpg,3,0,0,0,3,,train
0554476_as-0012238.jpg,2,0,0,0,2,,train
0554477_as-0012238.jpg,2,0,0,0,2,,train
0554478_as-2624157.jpg,1,0,0,0,1,,val
0554480_as-7468593.jpg,6,2,5,1,14,,val
0554481_sc-222169.jpg,0,0,1,0,1,,test
0554482_sc-222169.jpg,0,0,2,0,2,,train
0554483_sc-222169.jpg,0,0,0,1,1,,train
0554485_as-0037437.jpg,0,1,0,0,1,,train
0554486_as-0037437.jpg,1,0,0,0,1,,train
0554487_as-0048760.jpg,1,0,0,1,2,,train
0554488_as-0048760.jpg,1,0,0,1,2,,train
0554489_as-0048760.jpg,1,0,0,1,2,,train
0554490_as-0048760.jpg,1,0,0,1,2,,val
0554491_as-0048760.jpg,1,0,0,1,2,,val
0554492_as-0048760.jpg,1,0,0,1,2,,test
0554494_sc-148448.jpg,1,0,0,0,1,,train
0554495_as-3198233.jpg,1,0,0,0,1,,train
0554499_sc-1023810.jpg,2,0,1,1,4,,train
0554500_sc-1037335.jpg,9,2,0,0,11,,train
0554501_sc-1037335.jpg,5,0,0,0,5,,train
0554502_sc-1037335.jpg,5,2,2,1,10,,train
0554503_sc-1037335.jpg,8,0,1,0,9,,train
0554504_as-2825327.jpg,1,0,1,0,2,,val
0554506_sc-195242.jpg,0,1,0,0,1,,val
0554507_sc-195242.jpg,7,1,1,1,10,,test
0554509_sc-195242.jpg,4,1,1,1,7,,train
0554510_as-0033717.jpg,3,0,0,0,3,,train
0554511_as-0033717.jpg,2,0,1,1,4,,train
0554512_as-0033717.jpg,1,0,1,0,2,,train
0554518_as-0053671.jpg,1,0,1,1,3,,train
0554519_as-0053671.jpg,1,1,2,1,5,,train
0554520_as-0053671.jpg,2,0,0,0,2,,train
0554521_as-0053671.jpg,1,0,0,0,1,,val
0554522_sc-174372.jpg,0,0,0,1,1,,val
0554523_sc-174372.jpg,1,0,1,1,3,,test
0554524_sc-174372.jpg,2,0,0,1,3,,train
0554525_sc-1011835.jpg,1,0,0,0,1,,train
0554526_sc-1011835.jpg,0,0,1,0,1,,train
0554527_sc-1011835.jpg,1,0,0,0,1,,train
0554528_sc-1011835.jpg,1,0,0,0,1,,train
0554529_as-3301678.jpg,3,0,2,1,6,,train
0554531_sc-199888.jpg,2,0,0,0,2,,train
0554532_sc-199888.jpg,4,0,2,0,6,,val
0554533_sc-199888.jpg,4,0,2,0,6,,val
0554534_sc-199888.jpg,3,0,2,0,5,,test
0554535_as-0005703.jpg,2,0,1,1,4,,train
0554536_as-0005703.jpg,1,0,1,1,3,,train
0554538_as-0005703.jpg,2,0,0,1,3,,train
0554539_as-3105941.jpg,2,0,0,0,2,,train
0554540_sc-202403.jpg,3,0,1,0,4,,train
0554541_sc-202403.jpg,5,0,1,0,6,,train
0554542_sc-202403.jpg,3,0,1,0,4,,train
0554543_sc-202403.jpg,1,0,0,0,1,,val
0554545_sc-1025459.jpg,1,0,0,0,1,,val
0554546_sc-1025459.jpg,3,0,0,0,3,,test
0554548_sc-1025459.jpg,1,0,0,0,1,,train
0554549_sc-1025459.jpg,3,0,1,1,5,,train
0554550_sc-1025459.jpg,2,0,0,0,2,,train
0554551_sc-1025459.jpg,3,0,1,1,5,,train
0554552_sc-1025459.jpg,2,0,3,1,6,,train
0554553_as-2782289.jpg,2,3,1,0,6,,train
0554556_as-0004165.jpg,2,1,3,1,7,,train
0554557_as-0067281.jpg,1,0,0,0,1,,val
0554558_as-0067281.jpg,1,1,0,0,2,,val
0554559_as-0067281.jpg,1,0,0,0,1,,test
0554560_as-0067281.jpg,3,1,0,0,4,,train
0554561_as-0067281.jpg,2,1,0,0,3,,train
0554562_as-0067281.jpg,3,0,0,0,3,,train
0554563_as-3165234.jpg,3,0,0,0,3,,train
0554564_as-3096506.jpg,1,0,0,0,1,,train
0554565_sc-199909.jpg,1,0,0,0,1,,train
0554566_sc-1007437.jpg,2,0,0,0,2,,train
0554567_sc-1007437.jpg,1,0,0,0,1,,val
0554568_sc-1007437.jpg,1,0,0,0,1,,val
0554569_sc-1007437.jpg,2,0,0,0,2,,test
0554570_sc-1007437.jpg,1,0,0,0,1,,train
0554571_as-2852327.jpg,1,0,0,0,1,,train
0554573_as-0048197.jpg,2,0,3,1,6,,train
0554574_as-0048197.jpg,1,0,1,1,3,,train
0554575_as-0048197.jpg,1,0,2,1,4,,train
0554576_as-0048197.jpg,2,0,2,0,4,,train
0554577_as-0048197.jpg,1,0,2,0,3,,train
0554578_as-0048197.jpg,1,0,1,0,2,,val
0554579_as-0048197.jpg,1,0,0,0,1,,val
0554580_as-0048197.jpg,2,0,1,0,3,,test
0554581_as-0048197.jpg,1,0,2,0,3,,train
0554582_as-0048197.jpg,1,0,2,0,3,,train
0554583_as-0048197.jpg,1,0,1,0,2,,train
0554584_as-0048197.jpg,0,0,1,1,2,,train
0554585_as-0048197.jpg,1,0,0,0,1,,train
0554586_as-0048197.jpg,1,0,0,0,1,,train
0554587_as-0048197.jpg,1,0,0,0,1,,train
0554588_as-0048197.jpg,1,0,1,0,2,,val
0554589_as-0048197.jpg,2,0,1,1,4,,val
0554590_as-3043092.jpg,1,0,0,0,1,,test
0554591_as-7391345.jpg,0,0,0,1,1,,train
0554594_sc-1012081.jpg,4,0,2,0,6,,train
0554595_sc-1012081.jpg,2,0,0,0,2,,train
0554596_sc-1012081.jpg,10,0,0,0,10,,train
0554597_sc-1012081.jpg,2,0,0,0,2,,train
0554598_sc-1012081.jpg,2,1,0,0,3,,train
0554599_sc-1012081.jpg,2,0,0,0,2,,train
0554600_sc-207160.jpg,13,0,1,0,14,,val
0554601_sc-204252.jpg,2,0,0,0,2,,val
0554602_sc-204252.jpg,0,0,1,0,1,,test
0554603_sc-204252.jpg,1,1,0,1,3,,train
0554604_sc-204252.jpg,2,0,0,0,2,,train
0554605_sc-152056.jpg,1,0,0,0,1,,train
0554606_sc-152056.jpg,1,0,1,0,2,,train
0554607_sc-152056.jpg,1,0,1,0,2,,train
0554608_as-3152814.jpg,2,0,0,0,2,,train
0554609_as-9028982.jpg,2,0,0,0,2,,train
0554610_as-2849520.jpg,16,1,0,0,17,,val
0554612_sc-116435.jpg,0,1,1,0,2,,val
0554613_sc-116435.jpg,1,1,2,0,4,,test
0554614_sc-204186.jpg,6,0,0,0,6,,train
0554615_sc-204186.jpg,4,1,0,0,5,,train
0554616_sc-204186.jpg,3,3,1,0,7,,train
0554617_sc-204186.jpg,4,1,0,0,5,,train
0554618_sc-122661.jpg,3,1,0,0,4,,train
0554619_as-2531604.jpg,6,0,1,2,9,,train
0554620_as-0048741.jpg,1,0,0,0,1,,train
0554621_as-0048741.jpg,1,0,0,0,1,,val
0554622_as-0048741.jpg,1,0,0,0,1,,val
0554623_as-0048741.jpg,0,0,0,1,1,,test
0554624_as-0048741.jpg,1,0,0,1,2,,train
0554625_as-0048741.jpg,1,0,0,0,1,,train
0554626_sc-222415.jpg,3,0,0,1,4,,train
0554627_sc-222415.jpg,1,0,0,0,1,,train
0554628_sc-222415.jpg,1,0,0,0,1,,train
0554629_sc-222415.jpg,1,0,0,0,1,,train
0554630_sc-222415.jpg,1,0,0,0,1,,train
0554631_sc-222415.jpg,1,0,0,1,2,,val
0554633_sc-197036.jpg,1,0,0,0,1,,val
0554634_sc-206646.jpg,1,0,1,0,2,,test
0554635_sc-206646.jpg,1,0,1,0,2,,train
0554636_sc-206646.jpg,1,0,1,0,2,,train
0554637_sc-206646.jpg,1,0,0,0,1,,train
0554638_sc-206646.jpg,1,0,0,0,1,,train
0554644_sc-126258.jpg,2,0,1,1,4,,train
0554645_sc-126258.jpg,1,0,2,0,3,,train
0554647_sc-126258.jpg,6,0,1,1,8,,train
0554648_sc-126258.jpg,3,0,1,0,4,,val
0554649_sc-126258.jpg,1,0,2,0,3,,val
0554650_sc-126258.jpg,1,0,2,0,3,,test
0554653_as-0040150.jpg,1,0,1,1,3,,train
0554654_as-0040150.jpg,1,0,1,1,3,,train
0554655_as-3314800.jpg,1,0,0,0,1,,train
0554656_as-0024770.jpg,8,0,2,0,10,,train
0554657_as-0024770.jpg,7,0,1,0,8,,train
0554658_as-2540632.jpg,0,1,1,1,3,,train
0554659_as-3096844.jpg,2,0,0,0,2,,train
0554660_sc-165863.jpg,0,0,1,0,1,,val
0554661_sc-165863.jpg,1,0,0,0,1,,val
0554662_as-0074050.jpg,3,0,1,1,5,,test
0554663_as-0074050.jpg,2,0,1,1,4,,train
0554665_sc-1018175.jpg,1,1,0,0,2,,train
0554666_sc-1018175.jpg,4,2,1,0,7,,train
0554667_as-7974041.jpg,1,0,0,0,1,,train
0554668_as-2608960.jpg,5,0,0,0,5,,train
0554669_as-2739585.jpg,7,0,0,0,7,,train
0554670_sc-139360.jpg,1,2,0,0,3,,train
0554671_sc-139360.jpg,2,0,0,1,3,,val
0554672_sc-139360.jpg,2,0,0,1,3,,val
0554673_sc-139360.jpg,0,1,0,0,1,,test
0554674_sc-180911.jpg,1,0,1,1,3,,train
0554675_sc-180911.jpg,0,2,0,0,2,,train
0554676_sc-180911.jpg,3,1,0,0,4,,train
0554677_sc-180911.jpg,0,0,0,1,1,,train
0554678_as-2971697.jpg,1,0,0,0,1,,train
0554679_sc-1005833.jpg,3,0,0,1,4,,train
0554680_as-3240835.jpg,1,0,0,0,1,,train
0554682_sc-1011998.jpg,1,1,1,0,3,,val
0554685_sc-1011998.jpg,1,0,1,0,2,,val
0554686_as-2921642.jpg,3,0,0,0,3,,test
0554688_as-7693474.jpg,1,0,0,1,2,,train
0554689_as-3076025.jpg,3,0,0,0,3,,train
0554693_sc-228040.jpg,2,1,0,1,4,,train
0554694_sc-228040.jpg,1,0,1,0,2,,train
0554695_sc-228040.jpg,1,1,1,0,3,,train
0554696_sc-228040.jpg,1,2,1,1,5,,train
0554698_as-0030312.jpg,2,0,0,0,2,,train
0554699_as-0030312.jpg,1,0,0,1,2,,val
0554700_as-0030312.jpg,1,0,0,0,1,,val
0554701_as-2832950.jpg,1,0,1,0,2,,test
0554702_sc-186143.jpg,3,1,0,0,4,,train
0554703_sc-186143.jpg,5,0,0,0,5,,train
0554704_sc-186143.jpg,5,0,0,0,5,,train
0554705_sc-186143.jpg,2,0,0,0,2,,train
0554706_sc-186143.jpg,3,0,0,0,3,,train
0554707_sc-186143.jpg,3,0,0,0,3,,train
0554709_as-0032654.jpg,4,5,0,1,10,,train
0554710_as-0032654.jpg,3,1,0,0,4,,val
0554712_as-3041415.jpg,5,1,2,0,8,,val
0554713_as-4797273.jpg,0,1,0,0,1,,test
0554714_as-2614734.jpg,2,0,0,1,3,,train
0554715_as-0000786.jpg,2,0,1,1,4,,train
0554716_as-0000786.jpg,6,0,1,3,10,,train
0554717_sc-104200.jpg,0,1,0,0,1,,train
0554718_sc-104200.jpg,0,1,0,0,1,,train
0554721_as-3058095.jpg,1,0,1,0,2,,train
0554722_as-7112444.jpg,3,0,0,0,3,,train
0554724_as-0096407.jpg,1,0,1,1,3,,val
0554725_as-0096407.jpg,1,0,0,0,1,,val
0554726_as-0096407.jpg,3,1,2,0,6,,test
0554727_as-0096407.jpg,3,1,0,0,4,,train
0554730_as-0039486.jpg,0,0,1,0,1,,train
0554731_as-0039486.jpg,1,1,3,0,5,,train
0554733_as-0039486.jpg,0,0,2,0,2,,train
0554734_as-0076851.jpg,1,1,1,1,4,,train
0554735_as-0076851.jpg,0,0,2,0,2,,train
0554737_as-0076851.jpg,0,0,2,0,2,,train
0554738_sc-214990.jpg,0,1,0,0,1,,val
0554739_sc-214990.jpg,0,1,0,0,1,,val
0554740_sc-144594.jpg,4,0,0,2,6,,test
0554741_sc-144594.jpg,2,0,0,1,3,,train
0554742_sc-144594.jpg,1,0,1,1,3,,train
0554743_sc-135334.jpg,1,0,0,0,1,,train
0554744_as-0072338.jpg,1,0,0,0,1,,train
0554745_as-0072338.jpg,0,1,2,1,4,,train
0554747_as-0072338.jpg,4,0,1,0,5,,train
0554748_sc-219012.jpg,1,0,0,0,1,,train
0554749_sc-219012.jpg,1,0,0,0,1,,val
0554750_as-2834800.jpg,1,0,0,0,1,,val
0554751_as-0082902.jpg,2,2,0,0,4,,test
0554752_as-0082902.jpg,1,1,0,0,2,,train
0554753_as-2957179.jpg,2,0,0,0,2,,train
0554754_as-3410548.jpg,4,0,1,2,7,,train
0554755_as-2770487.jpg,1,0,0,0,1,,train
0554757_as-0026415.jpg,2,0,1,0,3,,train
0554758_as-0026415.jpg,2,0,1,0,3,,train
0554759_as-3240978.jpg,2,0,1,0,3,,train
0554763_as-0015315.jpg,0,1,0,0,1,,val
0554764_as-0015315.jpg,1,0,0,0,1,,val
0554765_as-0015315.jpg,3,1,0,0,4,,test
0554766_as-0015315.jpg,1,0,0,0,1,,train
0554768_sc-1031293.jpg,5,0,0,0,5,,train
0554769_sc-1031293.jpg,7,0,0,0,7,,train
0554770_as-3412754.jpg,1,0,0,0,1,,train
0554771_as-3486944.jpg,1,0,0,0,1,,train
0554772_sc-206532.jpg,1,0,0,0,1,,train
0554774_as-0017234.jpg,1,0,0,1,2,,train
0554775_sc-184071.jpg,2,0,0,1,3,,val
0554776_sc-184071.jpg,5,0,1,0,6,,val
0554779_as-3439194.jpg,0,1,1,0,2,,test
0554780_as-7658661.jpg,0,0,1,0,1,,train
0554781_sc-216978.jpg,1,0,0,0,1,,train
0554782_sc-216978.jpg,3,0,0,0,3,,train
0554783_sc-216978.jpg,3,0,0,0,3,,train
0554784_sc-216978.jpg,3,0,0,0,3,,train
0554785_sc-216978.jpg,2,0,0,0,2,,train
0554786_sc-216978.jpg,2,0,0,0,2,,train
0554788_sc-1019954.jpg,0,0,1,0,1,,val
0554789_sc-1019954.jpg,1,0,0,0,1,,val
0554790_as-0046718.jpg,2,0,0,0,2,,test
0554791_sc-121492.jpg,1,0,0,0,1,,train
0554792_sc-127902.jpg,2,0,0,0,2,,train
0554793_sc-127902.jpg,3,1,0,0,4,,train
0554794_sc-198930.jpg,2,0,0,0,2,,train
0554795_sc-198930.jpg,2,0,0,0,2,,train
0554796_sc-198930.jpg,3,0,0,0,3,,train
0554797_sc-198930.jpg,1,0,0,0,1,,train
0554798_sc-198930.jpg,1,0,0,0,1,,val
0554799_as-9033236.jpg,1,0,0,0,1,,val
0554800_as-2930024.jpg,1,0,0,0,1,,test
0554803_as-0060399.jpg,1,1,0,0,2,,train
0554804_as-0060399.jpg,1,0,1,1,3,,train
0554805_as-0060399.jpg,1,0,1,1,3,,train
0554806_as-0060399.jpg,1,0,1,1,3,,train
0554807_as-0060399.jpg,0,0,1,0,1,,train
0554808_sc-211543.jpg,2,0,1,0,3,,train
0554809_sc-205439.jpg,3,0,0,0,3,,train
0554810_sc-205439.jpg,3,0,0,0,3,,val
0554811_sc-205439.jpg,3,0,0,0,3,,val
0554812_sc-205439.jpg,2,0,0,0,2,,test
0554813_sc-205439.jpg,1,0,0,0,1,,train
0554814_sc-205439.jpg,3,0,0,0,3,,train
0554815_as-3438287.jpg,0,0,1,0,1,,train
0554816_sc-175386.jpg,1,0,0,0,1,,train
0554817_sc-145237.jpg,0,0,0,2,2,,train
0554819_sc-1013917.jpg,1,1,1,0,3,,train
0554820_as-3280951.jpg,0,0,1,0,1,,train
0554821_as-7060403.jpg,1,0,0,0,1,,val
0554824_as-0001495.jpg,0,1,1,0,2,,val
0554825_as-0089561.jpg,2,0,1,1,4,,test
0554826_as-0089561.jpg,2,0,0,1,3,,train
0554827_as-0089561.jpg,0,0,1,0,1,,train
0554828_sc-190213.jpg,6,0,0,0,6,,train
0554829_sc-190213.jpg,4,0,1,0,5,,train
0554830_sc-190213.jpg,0,0,1,0,1,,train
0554831_sc-190213.jpg,1,0,0,0,1,,train
0554832_sc-190213.jpg,1,0,0,0,1,,train
0554833_sc-1002074.jpg,2,1,2,1,6,,val
0554834_as-0080326.jpg,5,2,1,0,8,,val
0554835_as-0080326.jpg,1,0,1,0,2,,test
0554836_as-0080326.jpg,1,1,0,0,2,,train
0554837_sc-193628.jpg,6,0,0,1,7,,train
0554838_sc-193628.jpg,2,0,1,1,4,,train
0554839_sc-193628.jpg,5,0,0,2,7,,train
0554840_sc-193628.jpg,3,0,0,1,4,,train
0554841_sc-193628.jpg,11,0,0,2,13,,train
0554842_sc-193628.jpg,12,0,0,1,13,,train
0554843_sc-193628.jpg,10,0,0,2,12,,val
0554844_as-9015054.jpg,1,0,0,0,1,,val
0554845_sc-1015807.jpg,0,2,0,0,2,,test
0554846_sc-1015807.jpg,1,2,0,0,3,,train
0554847_sc-1015807.jpg,1,2,0,0,3,,train
0554848_sc-1010300.jpg,1,0,0,0,1,,train
0554850_as-2628397.jpg,0,0,0,1,1,,train
0554851_sc-141350.jpg,1,0,0,1,2,,train
0554852_sc-141350.jpg,1,0,0,2,3,,train
0554853_sc-141350.jpg,1,0,0,2,3,,train
0554854_sc-141350.jpg,1,0,0,2,3,,val
0554855_sc-182511.jpg,2,0,1,1,4,,val
0554856_sc-182511.jpg,2,0,0,0,2,,test
0554857_sc-182511.jpg,2,0,0,0,2,,train
0554858_sc-182511.jpg,1,0,0,0,1,,train
0554859_sc-230182.jpg,1,0,0,0,1,,train
0554860_as-7968259.jpg,0,0,1,1,2,,train
0554861_sc-185013.jpg,2,0,1,1,4,,train
0554863_sc-185013.jpg,3,0,0,0,3,,train
0554864_sc-185013.jpg,5,0,0,0,5,,train
0554866_sc-185013.jpg,1,0,1,1,3,,val
0554867_sc-185013.jpg,0,0,1,0,1,,val
0554868_sc-185013.jpg,5,0,0,0,5,,test
0554870_as-0040984.jpg,1,0,0,0,1,,train
0554871_as-0040984.jpg,1,0,0,0,1,,train
0554872_as-0040984.jpg,1,0,0,0,1,,train
0554873_as-0074611.jpg,1,0,0,0,1,,train
0554874_as-0074611.jpg,1,0,0,0,1,,train
0554875_as-0074611.jpg,1,0,0,0,1,,train
0554876_as-0074611.jpg,1,0,0,0,1,,train
0554877_as-0074611.jpg,1,0,0,0,1,,val
0554878_sc-141105.jpg,5,0,0,0,5,,val
0554879_sc-141105.jpg,2,0,0,0,2,,test
0554881_sc-112429.jpg,4,1,1,0,6,,train
0554882_sc-112429.jpg,1,0,0,0,1,,train
0554883_sc-112429.jpg,3,0,0,0,3,,train
0554884_sc-112429.jpg,6,0,0,2,8,,train
0554885_as-0034846.jpg,2,1,1,1,5,,train
0554886_as-0034846.jpg,0,0,1,0,1,,train
0554887_as-0034846.jpg,3,2,1,0,6,,train
0554889_as-0034846.jpg,0,0,1,0,1,,val
0554890_as-0034846.jpg,0,1,0,0,1,,val
0554893_as-0092122.jpg,2,0,0,0,2,,test
0554894_as-0092122.jpg,3,0,0,0,3,,train
0554895_as-0092122.jpg,4,0,0,0,4,,train
0554896_as-0092122.jpg,2,0,0,0,2,,train
0554897_as-0092122.jpg,1,0,0,0,1,,train
0554900_as-3473023.jpg,0,0,1,0,1,,train
0554902_as-0092519.jpg,3,0,1,0,4,,train
0554903_as-0092519.jpg,3,0,0,0,3,,train
0554904_as-0092519.jpg,4,0,1,0,5,,val
0554905_as-0092519.jpg,2,0,1,0,3,,val
0554907_sc-1005019.jpg,2,0,0,0,2,,test
0554908_sc-1005019.jpg,1,0,0,0,1,,train
0554909_sc-1005019.jpg,4,0,0,0,4,,train
0554910_sc-1005019.jpg,3,0,0,0,3,,train
0554913_as-2668549.jpg,2,0,1,1,4,,train
0554914_as-0009029.jpg,3,0,0,0,3,,train
0554917_as-0024584.jpg,1,0,0,0,1,,train
0554918_as-0024584.jpg,1,0,0,0,1,,train
0554920_sc-150274.jpg,2,0,1,1,4,,val
0554921_sc-150274.jpg,1,1,0,0,2,,val
0554922_sc-150274.jpg,2,0,2,0,4,,test
0554923_sc-150274.jpg,1,0,1,0,2,,train
0554924_sc-150274.jpg,1,0,0,0,1,,train
0554925_sc-150274.jpg,1,1,2,0,4,,train
0554926_as-0099174.jpg,1,0,0,0,1,,train
0554927_as-0099174.jpg,2,0,0,0,2,,train
0554928_as-0099174.jpg,1,0,2,0,3,,train
0554929_as-0099174.jpg,1,0,0,0,1,,train
0554930_as-0099174.jpg,1,0,1,0,2,,val
0554931_as-0099174.jpg,2,0,1,1,4,,val
0554939_sc-189883.jpg,1,0,0,0,1,,test
0554940_sc-107608.jpg,1,0,0,0,1,,train
0554941_sc-107608.jpg,1,0,0,0,1,,train
0554942_sc-107608.jpg,1,0,0,0,1,,train
0554944_as-3034506.jpg,5,0,0,0,5,,train
0554945_sc-1035342.jpg,2,1,0,0,3,,train
0554946_sc-1035342.jpg,1,1,0,0,2,,train
0554947_sc-1035342.jpg,1,1,0,0,2,,train
0554948_sc-1035342.jpg,2,1,0,0,3,,val
0554949_sc-226596.jpg,8,1,1,0,10,,val
0554950_sc-226596.jpg,1,0,0,1,2,,test
0554951_sc-226596.jpg,5,5,3,0,13,,train
0554952_sc-226596.jpg,4,1,3,0,8,,train
0554953_sc-226596.jpg,4,1,5,0,10,,train
0554955_as-0084710.jpg,1,0,0,1,2,,train
0554956_as-0084710.jpg,1,0,0,1,2,,train
0554957_as-0084710.jpg,1,0,0,1,2,,train
0554958_as-0084710.jpg,3,0,0,0,3,,train
0554959_sc-1039447.jpg,2,0,0,0,2,,val
0554960_sc-1039447.jpg,2,0,0,0,2,,val
0554961_sc-1013180.jpg,2,1,0,0,3,,test
0554963_sc-1013180.jpg,4,1,1,0,6,,train
0554965_sc-1013180.jpg,1,2,0,1,4,,train
0554966_sc-1013180.jpg,2,3,0,2,7,,train
0554967_as-0038057.jpg,0,2,0,0,2,,train
0554973_as-3401272.jpg,1,0,0,0,1,,train
0554974_as-0010815.jpg,2,0,0,0,2,,train
0554975_as-0010815.jpg,0,0,0,1,1,,train
0554976_as-0010815.jpg,0,0,2,1,3,,val
0554977_as-0010815.jpg,0,0,1,1,2,,val
0554978_sc-153863.jpg,1,0,0,0,1,,test
0554979_sc-153863.jpg,1,0,0,0,1,,train
0554980_sc-153863.jpg,2,0,0,0,2,,train
0554981_sc-153863.jpg,1,0,0,0,1,,train
0554982_sc-171387.jpg,2,0,0,0,2,,train
0554983_sc-171387.jpg,1,0,1,0,2,,train
0554984_sc-171387.jpg,1,0,0,0,1,,train
0554985_sc-171387.jpg,3,0,1,0,4,,train
0554986_sc-171387.jpg,3,0,1,0,4,,val
0554987_sc-1028540.jpg,2,0,0,0,2,,val
0554988_sc-1028540.jpg,2,0,0,0,2,,test
0554989_sc-1028540.jpg,2,0,0,0,2,,train
0554990_sc-1028540.jpg,2,0,0,0,2,,train
0554993_as-0038279.jpg,4,0,0,1,5,,train
0554994_as-0038279.jpg,1,0,0,1,2,,train
0554995_as-0038279.jpg,2,0,1,1,4,,train
0554996_as-0038279.jpg,2,0,1,1,4,,train
0554997_as-0018535.jpg,1,0,1,0,2,,train
0554998_as-0018535.jpg,1,0,1,0,2,,val
0554999_as-0018535.jpg,1,0,1,0,2,,val
0555000_as-7413809.jpg,1,0,0,0,1,,test
0555001_as-3405150.jpg,2,0,0,0,2,,train
0555002_as-5205574.jpg,1,1,0,0,2,,train
0555003_sc-191707.jpg,5,1,2,1,9,,train
0555004_sc-191707.jpg,0,0,1,1,2,,train
0555005_as-2864069.jpg,8,0,0,0,8,,train
0555008_as-0077812.jpg,2,0,1,0,3,,train
0555010_as-0077812.jpg,3,0,0,0,3,,train
0555011_as-0077812.jpg,1,0,1,0,2,,val
0555012_sc-216549.jpg,0,1,0,0,1,,val
0555013_sc-216549.jpg,0,2,0,0,2,,test
0555014_sc-196059.jpg,3,0,1,0,4,,train
0555015_sc-196059.jpg,2,0,0,0,2,,train
0555016_sc-196059.jpg,5,1,1,0,7,,train
0555017_as-7893217.jpg,2,0,0,0,2,,train
0555018_as-3488090.jpg,1,0,0,1,2,,train
0555019_as-2771651.jpg,1,0,0,0,1,,train
0555022_as-0086143.jpg,3,2,1,1,7,,train
0555023_as-0086143.jpg,2,2,1,1,6,,val
0555026_as-0086143.jpg,1,2,0,0,3,,val
0555028_sc-1029179.jpg,0,0,1,0,1,,test
0555029_sc-1029179.jpg,2,0,0,0,2,,train
0555032_sc-1029179.jpg,2,1,0,0,3,,train
0555033_sc-1029179.jpg,3,0,0,0,3,,train
0555034_as-0021911.jpg,4,1,0,0,5,,train
0555035_sc-192277.jpg,1,1,0,0,2,,train
0555036_sc-1016945.jpg,1,3,2,0,6,,train
0555038_sc-1023729.jpg,1,0,0,0,1,,train
0555039_sc-1023729.jpg,4,1,0,0,5,,val
0555040_sc-1023729.jpg,1,0,0,0,1,,val
0555041_sc-1035982.jpg,5,0,0,0,5,,test
0555042_sc-1035982.jpg,2,0,0,0,2,,train
0555043_sc-1035982.jpg,5,0,0,0,5,,train
0555045_as-0068718.jpg,0,0,1,0,1,,train
0555046_as-0068718.jpg,0,0,1,0,1,,train
0555047_as-0068718.jpg,0,2,1,0,3,,train
0555048_as-0068718.jpg,1,1,1,0,3,,train
0555049_as-0068718.jpg,0,1,1,0,2,,train
0555050_as-0068718.jpg,0,0,1,0,1,,val
0555051_sc-105415.jpg,1,0,0,1,2,,val
0555052_sc-105415.jpg,1,0,1,1,3,,test
0555053_sc-105415.jpg,2,0,2,1,5,,train
0555054_sc-105415.jpg,1,0,0,2,3,,train
0555055_sc-105415.jpg,2,0,1,1,4,,train
0555056_sc-105415.jpg,2,0,0,0,2,,train
0555057_sc-105415.jpg,2,0,0,1,3,,train
0555058_sc-105415.jpg,2,0,0,1,3,,train
0555059_sc-105415.jpg,2,1,0,2,5,,train
0555060_as-0076724.jpg,2,0,0,0,2,,val
0555062_as-0076724.jpg,7,4,2,1,14,,val
0555063_as-0076724.jpg,8,3,1,1,13,,test
0555064_as-0076724.jpg,0,1,2,1,4,,train
0555067_as-0076724.jpg,11,3,2,2,18,,train
0555068_as-0076724.jpg,3,1,2,3,9,,train
0555069_as-0076724.jpg,0,1,0,2,3,,train
0555072_as-0076724.jpg,1,0,0,0,1,,train
0555074_sc-225831.jpg,3,0,1,0,4,,train
0555075_as-2711416.jpg,1,0,1,0,2,,train
0555078_sc-1027761.jpg,1,0,0,1,2,,val
0555079_sc-1027761.jpg,1,0,0,1,2,,val
0555080_sc-196174.jpg,1,0,1,0,2,,test
0555081_sc-225467.jpg,1,0,0,0,1,,train
0555082_sc-225467.jpg,2,0,0,0,2,,train
0555083_sc-225467.jpg,1,0,0,0,1,,train
0555084_as-0007202.jpg,1,0,0,0,1,,train
0555085_as-0007202.jpg,1,0,1,1,3,,train
0555086_as-3392550.jpg,1,0,0,0,1,,train
0555087_sc-194926.jpg,4,0,0,0,4,,train
0555088_sc-194926.jpg,2,0,0,0,2,,val
0555089_sc-196365.jpg,2,0,0,0,2,,val
0555090_sc-196365.jpg,2,0,0,0,2,,test
0555095_as-0086463.jpg,2,0,1,0,3,,train
0555096_as-0086463.jpg,0,0,0,1,1,,train
0555099_as-0070126.jpg,2,0,3,1,6,,train
0555100_as-0070126.jpg,1,0,2,1,4,,train
0555101_as-0070126.jpg,1,0,0,1,2,,train
0555106_as-0050557.jpg,1,1,0,0,2,,train
0555107_as-0050557.jpg,3,1,1,0,5,,train
0555108_as-0050557.jpg,1,1,0,0,2,,val
0555109_as-0050557.jpg,1,0,1,0,2,,val
0555110_as-0050557.jpg,1,0,1,0,2,,test
0555111_as-0050557.jpg,2,1,0,0,3,,train
0555112_as-0050557.jpg,1,0,0,0,1,,train
0555113_as-0050557.jpg,2,0,1,0,3,,train
0555114_as-0051942.jpg,0,1,0,0,1,,train
0555115_as-0051942.jpg,3,0,1,0,4,,train
0555116_as-0051942.jpg,1,0,2,0,3,,train
0555117_as-3382835.jpg,2,0,0,0,2,,train
0555118_as-3192127.jpg,1,0,0,0,1,,val
0555119_as-0099592.jpg,1,0,0,0,1,,val
0555120_as-0001621.jpg,0,0,1,0,1,,test
0555121_as-0001621.jpg,1,0,0,0,1,,train
0555122_as-0001621.jpg,3,0,1,0,4,,train
0555123_as-0001621.jpg,2,0,1,0,3,,train
0555124_as-0001621.jpg,1,0,1,0,2,,train
0555125_as-0001621.jpg,6,0,0,1,7,,train
0555126_as-0001621.jpg,4,0,0,1,5,,train
0555127_as-0001621.jpg,4,0,0,2,6,,train
0555128_as-0001621.jpg,2,0,0,0,2,,val
0555130_as-0001621.jpg,5,0,0,1,6,,val
0555131_as-0001621.jpg,3,0,0,1,4,,test
0555133_sc-1037194.jpg,1,2,4,0,7,,train
0555134_sc-1037194.jpg,0,1,2,0,3,,train
0555135_sc-142876.jpg,2,1,1,0,4,,train
0555137_sc-142876.jpg,1,1,1,0,3,,train
0555138_as-2554515.jpg,2,0,0,0,2,,train
0555139_as-7939312.jpg,4,0,1,0,5,,train
0555141_as-0081918.jpg,3,0,1,0,4,,train
0555143_as-0081918.jpg,2,0,0,0,2,,val
0555144_as-0081918.jpg,3,0,1,0,4,,val
0555145_sc-227148.jpg,1,0,0,1,2,,test
0555146_sc-227148.jpg,0,0,0,1,1,,train
0555147_sc-227148.jpg,1,0,0,0,1,,train
0555148_sc-227148.jpg,1,0,0,0,1,,train
0555149_sc-227148.jpg,1,0,0,0,1,,train
0555150_as-2977630.jpg,1,0,0,0,1,,train
0555154_as-0040359.jpg,0,0,1,0,1,,train
0555155_as-2984460.jpg,3,0,1,0,4,,train
0555156_as-0064144.jpg,1,0,0,0,1,,val
0555157_as-0064144.jpg,2,0,0,0,2,,val
0555159_as-0064144.jpg,2,0,1,0,3,,test
0555160_as-0064144.jpg,1,0,0,0,1,,train
0555163_as-0064144.jpg,1,0,1,0,2,,train
0555164_as-0018446.jpg,1,0,0,0,1,,train
0555165_as-0018446.jpg,0,1,0,0,1,,train
0555166_as-0018446.jpg,0,0,1,0,1,,train
0555167_as-0018446.jpg,0,1,0,0,1,,train
0555168_as-0018446.jpg,0,1,0,0,1,,train
0555169_sc-1025519.jpg,1,0,2,1,4,,val
0555170_sc-1025519.jpg,9,2,1,1,13,,val
0555171_sc-220774.jpg,3,0,1,1,5,,test
0555172_sc-220774.jpg,2,0,1,1,4,,train
0555173_sc-220774.jpg,2,0,1,1,4,,train
0555174_sc-1031061.jpg,1,1,0,0,2,,train
0555176_sc-1031061.jpg,3,1,1,0,5,,train
0555177_sc-178962.jpg,3,0,0,1,4,,train
0555178_sc-178962.jpg,3,0,0,1,4,,train
0555179_sc-168625.jpg,1,2,1,1,5,,train
0555180_sc-168625.jpg,1,2,1,1,5,,val
0555181_sc-168625.jpg,1,2,1,1,5,,val
0555182_sc-168625.jpg,1,1,1,1,4,,test
0555183_sc-168625.jpg,1,2,0,1,4,,train
0555185_sc-168625.jpg,1,2,1,1,5,,train
0555186_as-7606521.jpg,1,1,1,2,5,,train
0555187_as-2587911.jpg,5,0,0,0,5,,train
0555188_sc-122063.jpg,1,0,1,1,3,,train
0555189_sc-122063.jpg,1,0,1,1,3,,train
0555190_sc-122063.jpg,1,0,0,0,1,,train
0555191_sc-122063.jpg,2,0,0,0,2,,val
0555192_sc-122063.jpg,3,1,0,0,4,,val
0555193_sc-122063.jpg,2,0,1,0,3,,test
0555194_sc-122063.jpg,2,0,0,0,2,,train
0555195_sc-122063.jpg,2,0,0,0,2,,train
0555196_sc-122063.jpg,1,0,0,0,1,,train
0555197_sc-122063.jpg,2,1,0,0,3,,train
0555198_sc-122063.jpg,2,0,0,0,2,,train
0555199_sc-122063.jpg,1,0,0,0,1,,train
0555201_as-2539831.jpg,3,0,0,1,4,,train
0555203_as-0023942.jpg,1,0,0,0,1,,val
0555204_as-0023942.jpg,1,0,0,0,1,,val
0555205_sc-209607.jpg,9,0,0,0,9,,test
0555206_sc-209607.jpg,1,0,0,0,1,,train
0555207_sc-209607.jpg,5,0,0,0,5,,train
0555208_sc-209607.jpg,3,0,1,0,4,,train
0555209_sc-209607.jpg,2,0,0,0,2,,train
0555210_sc-209607.jpg,3,1,0,0,4,,train
0555214_as-7981926.jpg,1,0,0,0,1,,train
0555215_as-2610105.jpg,0,0,1,0,1,,train
0555216_sc-113108.jpg,0,1,0,0,1,,val
0555217_sc-212607.jpg,1,0,0,0,1,,val
0555218_sc-212607.jpg,2,0,0,0,2,,test
0555219_sc-212607.jpg,2,0,0,0,2,,train
0555221_as-0080042.jpg,3,0,0,1,4,,train
0555225_as-3205400.jpg,0,0,1,0,1,,train
0555226_as-2669596.jpg,9,0,0,2,11,,train
0555227_as-0089274.jpg,4,0,0,0,4,,train
0555228_as-0089274.jpg,8,0,0,0,8,,train
0555229_as-0089274.jpg,2,0,0,0,2,,train
0555230_as-0089274.jpg,3,0,0,0,3,,val
0555231_as-0089274.jpg,3,0,0,0,3,,val
0555232_as-2991329.jpg,1,0,0,0,1,,test
0555233_as-9092345.jpg,1,0,0,0,1,,train
0555235_sc-122471.jpg,1,0,0,0,1,,train
0555236_sc-122471.jpg,1,0,0,0,1,,train
0555238_as-3059071.jpg,2,0,0,0,2,,train
0555239_sc-182241.jpg,2,0,0,0,2,,train
0555240_sc-182241.jpg,5,0,0,0,5,,train
0555241_as-7111115.jpg,1,0,0,0,1,,train
0555242_as-0018801.jpg,1,0,0,0,1,,val
0555243_as-5494408.jpg,4,0,1,2,7,,val
0555244_sc-222827.jpg,3,0,0,0,3,,test
0555245_as-5172540.jpg,1,0,0,1,2,,train
0555246_as-9065934.jpg,1,0,1,0,2,,train
0555248_as-2539158.jpg,1,0,0,0,1,,train
0555250_sc-1019022.jpg,1,0,1,0,2,,train
0555251_as-2667318.jpg,1,1,1,0,3,,train
0555252_sc-1003858.jpg,1,0,0,2,3,,train
0555253_as-0053198.jpg,1,0,0,1,2,,train
0555254_as-0053198.jpg,2,0,0,1,3,,val
0555257_sc-143601.jpg,2,0,1,3,6,,val
0555258_sc-143601.jpg,3,0,3,0,6,,test
0555259_sc-143601.jpg,1,0,2,1,4,,train
0555260_sc-143601.jpg,1,0,0,0,1,,train
0555261_sc-143601.jpg,2,0,1,1,4,,train
0555262_sc-143601.jpg,2,0,0,1,3,,train
0555266_sc-143601.jpg,1,0,0,1,2,,train
0555267_sc-143601.jpg,1,0,2,0,3,,train
0555268_sc-143601.jpg,2,0,1,2,5,,train
0555269_sc-143601.jpg,2,0,2,0,4,,val
0555272_sc-175409.jpg,6,1,0,4,11,,val
0555273_sc-175409.jpg,3,1,0,1,5,,test
0555274_sc-175409.jpg,1,0,1,0,2,,train
0555275_as-0098840.jpg,2,0,0,0,2,,train
0555276_as-0098840.jpg,2,0,0,0,2,,train
0555281_sc-1021922.jpg,2,0,0,0,2,,train
0555282_sc-1021922.jpg,3,0,0,0,3,,train
0555283_sc-1021922.jpg,0,1,0,0,1,,train
0555284_sc-1021922.jpg,7,0,0,0,7,,train
0555286_as-0043946.jpg,2,1,0,2,5,,val
0555287_sc-142087.jpg,0,2,0,0,2,,val
0555290_sc-142087.jpg,0,2,0,0,2,,test
0555291_as-3005252.jpg,2,0,1,0,3,,train
0555292_sc-153193.jpg,1,0,0,0,1,,train
0555293_sc-153193.jpg,1,0,0,0,1,,train
0555294_as-0048198.jpg,0,0,1,0,1,,train
0555295_as-0048198.jpg,0,0,1,0,1,,train
0555296_as-0048198.jpg,3,0,2,1,6,,train
0555297_as-0048198.jpg,3,5,3,1,12,,train
0555298_as-0062439.jpg,2,2,0,2,6,,val
0555299_as-0062439.jpg,5,2,1,1,9,,val
0555304_as-2533196.jpg,2,0,0,0,2,,test
0555305_as-0043589.jpg,0,0,0,1,1,,train
0555306_as-2952715.jpg,2,0,1,0,3,,train
0555307_as-3060445.jpg,1,0,0,0,1,,train
0555308_sc-208411.jpg,3,0,0,0,3,,train
0555309_sc-208411.jpg,2,0,0,0,2,,train
0555310_sc-208411.jpg,1,0,0,0,1,,train
0555311_sc-208411.jpg,7,0,0,0,7,,train
0555312_sc-208411.jpg,4,0,0,0,4,,val
0555313_sc-208411.jpg,1,0,0,1,2,,val
0555314_as-2743074.jpg,5,2,1,0,8,,test
0555315_sc-206494.jpg,5,0,1,0,6,,train
0555316_sc-206494.jpg,4,0,0,0,4,,train
0555317_sc-206494.jpg,4,0,0,0,4,,train
0555318_sc-145312.jpg,1,0,1,1,3,,train
0555319_sc-145312.jpg,4,0,1,1,6,,train
0555320_sc-145312.jpg,1,0,1,1,3,,train
0555321_sc-145312.jpg,1,0,1,1,3,,train
0555324_sc-1025698.jpg,5,2,1,0,8,,val
0555327_as-0019170.jpg,1,2,1,0,4,,val
0555329_as-0019170.jpg,0,0,1,0,1,,test
0555330_as-0019170.jpg,0,0,1,0,1,,train
0555332_as-0019170.jpg,0,0,1,0,1,,train
0555335_sc-176394.jpg,0,1,2,1,4,,train
0555336_sc-176394.jpg,7,3,2,2,14,,train
0555338_sc-176394.jpg,7,3,3,1,14,,train
0555339_sc-176394.jpg,3,2,3,1,9,,train
0555340_sc-1019650.jpg,2,0,0,2,4,,train
0555341_sc-141398.jpg,6,0,1,1,8,,val
0555343_as-0084434.jpg,2,0,0,0,2,,val
0555344_as-0084434.jpg,2,0,0,0,2,,test
0555345_as-0084434.jpg,2,0,0,0,2,,train
0555346_as-0084434.jpg,1,0,0,0,1,,train
0555348_as-0047980.jpg,0,0,1,0,1,,train
0555349_as-0047980.jpg,2,2,1,2,7,,train
0555350_as-0047980.jpg,2,4,3,1,10,,train
0555351_as-0047980.jpg,7,3,2,1,13,,train
0555352_as-0047980.jpg,2,0,0,0,2,,train
0555353_as-0047980.jpg,1,0,1,0,2,,val
0555354_as-0047980.jpg,1,0,1,0,2,,val
0555355_as-0047980.jpg,2,1,0,0,3,,test
0555356_as-0047980.jpg,0,1,1,0,2,,train
0555357_as-7438559.jpg,1,0,0,0,1,,train
0555358_as-0065007.jpg,2,0,0,0,2,,train
0555359_as-0065007.jpg,2,1,0,0,3,,train
0555360_as-0065007.jpg,5,0,0,0,5,,train
0555362_as-0065007.jpg,2,0,0,0,2,,train
0555365_as-0065007.jpg,2,0,0,0,2,,train
0555367_as-0065007.jpg,1,0,0,0,1,,val
0555369_as-7580040.jpg,1,0,0,0,1,,val
0555370_sc-220587.jpg,3,1,1,0,5,,test
0555371_sc-220587.jpg,1,1,0,0,2,,train
0555372_sc-220587.jpg,1,0,0,0,1,,train
0555373_sc-220587.jpg,2,1,0,0,3,,train
0555374_sc-213345.jpg,1,0,0,0,1,,train
0555375_sc-213345.jpg,2,0,0,0,2,,train
0555376_sc-213345.jpg,1,0,0,0,1,,train
0555377_sc-186262.jpg,0,1,1,0,2,,train
0555378_as-9060209.jpg,3,1,0,0,4,,val
0555380_as-0031523.jpg,1,0,0,0,1,,val
0555381_as-7091102.jpg,3,2,0,1,6,,test
0555382_sc-108044.jpg,1,1,1,0,3,,train
0555383_sc-108044.jpg,2,1,1,0,4,,train
0555384_sc-1010708.jpg,0,0,1,0,1,,train
0555385_sc-1010708.jpg,5,0,1,0,6,,train
0555386_sc-1010708.jpg,5,0,1,0,6,,train
0555387_sc-1010708.jpg,6,0,1,0,7,,train
0555389_as-0055413.jpg,1,0,0,0,1,,train
0555390_as-0055413.jpg,1,0,0,0,1,,val
0555391_sc-117045.jpg,0,1,0,0,1,,val
0555392_sc-117045.jpg,1,1,2,1,5,,test
0555393_sc-117045.jpg,0,1,0,0,1,,train
0555394_as-0001203.jpg,1,0,0,0,1,,train
0555395_as-2886917.jpg,1,0,0,0,1,,train
0555396_sc-221544.jpg,2,0,0,0,2,,train
0555397_sc-221544.jpg,4,0,0,0,4,,train
0555398_sc-221544.jpg,2,0,0,0,2,,train
0555400_as-0051689.jpg,2,0,1,0,3,,train
0555401_as-0051689.jpg,0,0,1,0,1,,val
0555402_as-0051689.jpg,4,1,0,1,6,,val
0555404_as-3377750.jpg,3,0,2,1,6,,test
0555405_sc-191105.jpg,1,0,0,0,1,,train
0555406_sc-191105.jpg,2,0,0,0,2,,train
0555407_as-2864333.jpg,1,1,1,0,3,,train
0555409_as-0001063.jpg,1,0,0,0,1,,train
0555410_as-0001063.jpg,1,0,0,0,1,,train
0555413_as-0086315.jpg,3,0,1,0,4,,train
0555414_as-0086315.jpg,0,0,2,1,3,,train
0555415_as-0086315.jpg,0,0,1,1,2,,val
0555418_as-7077591.jpg,0,0,1,1,2,,val
0555419_sc-166725.jpg,2,0,2,0,4,,test
0555420_as-0009614.jpg,1,0,0,0,1,,train
0555421_as-0009614.jpg,1,0,0,0,1,,train
0555422_as-0009614.jpg,2,0,0,0,2,,train
0555423_as-0009614.jpg,2,0,0,0,2,,train
0555425_as-7470627.jpg,1,0,0,0,1,,train
0555427_as-0093557.jpg,1,0,0,0,1,,train
0555428_as-0093557.jpg,1,0,0,0,1,,train
0555429_sc-106591.jpg,1,0,0,0,1,,val
0555430_sc-106591.jpg,1,0,0,1,2,,val
0555431_sc-106591.jpg,1,0,0,0,1,,test
0555432_sc-106591.jpg,1,0,0,0,1,,train
0555433_sc-106591.jpg,1,0,0,0,1,,train
0555434_sc-106591.jpg,1,0,0,1,2,,train
0555435_as-0048851.jpg,1,0,0,0,1,,train
0555436_as-0048851.jpg,1,0,0,0,1,,train
0555437_as-0048851.jpg,1,0,0,0,1,,train
0555438_as-0048851.jpg,1,0,0,0,1,,train
0555439_as-0048851.jpg,1,0,0,0,1,,val
0555440_as-0048851.jpg,1,0,0,0,1,,val
0555441_as-0066751.jpg,1,1,1,0,3,,test
0555442_sc-158850.jpg,0,1,0,0,1,,train
0555443_as-3473441.jpg,1,0,0,1,2,,train
0555444_as-2732915.jpg,1,0,0,0,1,,train
0555445_as-7571469.jpg,2,0,0,0,2,,train
0555448_as-0091787.jpg,8,1,1,0,10,,train
0555449_as-0091787.jpg,4,2,3,1,10,,train
0555450_as-0091787.jpg,0,0,1,0,1,,train
0555451_as-0001543.jpg,4,0,0,1,5,,val
0555453_as-0013172.jpg,2,0,0,1,3,,val
0555454_as-0013172.jpg,1,0,0,1,2,,test
0555455_sc-162439.jpg,1,0,1,3,5,,train
0555456_sc-162439.jpg,1,0,0,3,4,,train
0555457_sc-162439.jpg,1,0,1,1,3,,train
0555458_sc-162439.jpg,1,0,0,3,4,,train
0555460_as-0093501.jpg,1,0,0,0,1,,train
0555461_as-0093501.jpg,2,0,1,0,3,,train
0555463_as-0079137.jpg,1,0,0,0,1,,train
0555465_as-0048736.jpg,3,0,0,0,3,,val
0555466_as-2515488.jpg,1,0,0,1,2,,val
0555467_sc-217471.jpg,3,0,0,0,3,,test
0555469_as-0013454.jpg,3,0,0,0,3,,train
0555470_as-0013454.jpg,3,0,0,0,3,,train
0555471_as-0013454.jpg,1,0,0,0,1,,train
0555472_sc-139411.jpg,3,0,0,0,3,,train
0555473_sc-139411.jpg,3,0,0,0,3,,train
0555475_sc-139411.jpg,1,0,0,0,1,,train
0555476_sc-200694.jpg,4,1,2,1,8,,train
0555477_sc-200694.jpg,0,1,2,0,3,,val
0555478_as-7440582.jpg,4,0,2,1,7,,val
0555483_as-0018988.jpg,4,0,0,1,5,,test
0555489_as-7020038.jpg,2,0,0,0,2,,train
0555490_as-3068334.jpg,3,0,1,1,5,,train
0555491_sc-117904.jpg,3,0,0,0,3,,train
0555492_sc-117904.jpg,1,0,0,0,1,,train
0555494_sc-117904.jpg,1,0,0,0,1,,train
0555495_sc-117904.jpg,1,0,0,0,1,,train
0555496_as-3080657.jpg,0,0,0,1,1,,train
0555501_sc-159557.jpg,1,1,1,0,3,,val
0555504_as-0001673.jpg,0,1,0,0,1,,val
0555505_as-0001673.jpg,2,0,0,0,2,,test
0555507_sc-172243.jpg,3,0,0,0,3,,train
0555508_sc-172243.jpg,2,0,0,0,2,,train
0555509_sc-172243.jpg,2,0,0,0,2,,train
0555511_sc-149388.jpg,4,0,1,0,5,,train
0555512_sc-149388.jpg,3,0,0,0,3,,train
0555513_as-7988343.jpg,2,0,1,1,4,,train
0555515_sc-183826.jpg,1,0,0,0,1,,train
0555516_sc-177054.jpg,3,1,0,0,4,,val
0555517_sc-177054.jpg,4,1,1,0,6,,val
0555518_sc-177054.jpg,1,0,0,0,1,,test
0555519_sc-1009534.jpg,1,0,0,0,1,,train
0555520_sc-1009534.jpg,0,0,2,0,2,,train
0555521_sc-1009534.jpg,0,0,1,0,1,,train
0555522_as-7911572.jpg,1,0,0,0,1,,train
0555523_sc-1009603.jpg,2,0,0,0,2,,train
0555525_as-0003012.jpg,1,0,0,0,1,,train
0555526_as-0003012.jpg,1,0,0,0,1,,train
0555528_sc-142938.jpg,2,0,0,0,2,,val
0555529_sc-188784.jpg,1,0,0,1,2,,val
0555530_sc-188784.jpg,2,0,0,1,3,,test
0555531_sc-188784.jpg,2,0,0,1,3,,train
0555533_as-0023780.jpg,1,0,0,1,2,,train
0555535_sc-110021.jpg,3,0,1,0,4,,train
0555536_sc-110021.jpg,1,0,1,0,2,,train
0555537_sc-1022378.jpg,1,0,0,0,1,,train
0555538_sc-1022378.jpg,6,0,1,0,7,,train
0555539_as-3151135.jpg,0,0,0,1,1,,train
0555540_sc-161587.jpg,1,0,0,0,1,,val
0555541_sc-161587.jpg,1,0,0,0,1,,val
0555542_as-7502882.jpg,0,0,1,1,2,,test
0555543_as-3446928.jpg,0,0,2,0,2,,train
0555545_as-2668259.jpg,8,0,0,0,8,,train
0555548_sc-135754.jpg,0,0,1,0,1,,train
0555549_sc-1009026.jpg,1,0,0,0,1,,train
0555550_sc-1037073.jpg,1,1,0,0,2,,train
0555551_sc-1037073.jpg,1,1,0,0,2,,train
0555553_sc-228077.jpg,1,0,0,1,2,,train
0555554_sc-228077.jpg,1,0,1,1,3,,val
0555555_sc-228077.jpg,2,0,1,1,4,,val
0555556_sc-228077.jpg,2,0,0,0,2,,test
0555557_sc-207390.jpg,3,1,0,0,4,,train
0555558_sc-207390.jpg,5,0,0,1,6,,train
0555561_sc-207390.jpg,5,0,0,0,5,,train
0555562_sc-207390.jpg,4,2,0,0,6,,train
0555563_sc-207390.jpg,6,2,0,0,8,,train
0555564_sc-207390.jpg,8,2,0,0,10,,train
0555565_sc-207390.jpg,4,1,0,0,5,,train
0555566_sc-207390.jpg,3,0,0,1,4,,val
0555567_sc-202761.jpg,3,0,0,0,3,,val
0555568_sc-202761.jpg,2,0,0,0,2,,test
0555569_sc-202761.jpg,1,0,0,0,1,,train
0555570_sc-202761.jpg,5,0,0,0,5,,train
0555571_as-0072754.jpg,4,0,0,0,4,,train
0555572_as-0072754.jpg,5,0,0,0,5,,train
0555573_sc-147512.jpg,1,0,0,0,1,,train
0555574_sc-147512.jpg,0,0,1,0,1,,train
0555575_sc-140646.jpg,3,0,0,1,4,,train
0555576_sc-140646.jpg,3,0,0,1,4,,val
0555577_sc-140646.jpg,1,0,0,0,1,,val
0555578_sc-128712.jpg,0,1,1,0,2,,test
0555580_as-2914104.jpg,4,1,1,0,6,,train
0555581_as-0051063.jpg,4,0,0,0,4,,train
0555583_as-0051063.jpg,3,0,0,0,3,,train
0555585_sc-1023487.jpg,0,1,0,0,1,,train
0555586_sc-1023487.jpg,1,0,0,0,1,,train
0555588_as-0021320.jpg,2,0,1,1,4,,train
0555589_as-0021320.jpg,2,0,1,0,3,,train
0555590_as-0021320.jpg,3,0,1,0,4,,val
0555591_as-0021320.jpg,3,0,1,1,5,,val
0555592_as-0021320.jpg,2,0,0,0,2,,test
0555593_as-0021320.jpg,1,0,0,1,2,,train
0555594_as-0021320.jpg,1,0,0,0,1,,train
0555595_as-0021320.jpg,2,0,0,0,2,,train
0555596_as-0021320.jpg,1,0,0,0,1,,train
0555597_as-0021320.jpg,1,0,0,0,1,,train
0555598_as-0021320.jpg,2,0,0,0,2,,train
0555599_as-3402110.jpg,2,1,4,1,8,,train
0555601_sc-159485.jpg,3,0,0,0,3,,val
0555602_sc-159485.jpg,3,0,0,0,3,,val
0555603_as-3009235.jpg,2,3,1,0,6,,test
0555604_sc-189941.jpg,4,0,0,0,4,,train
0555605_sc-189941.jpg,3,0,0,0,3,,train
0555606_sc-189941.jpg,2,0,0,0,2,,train
0555607_as-0037752.jpg,2,0,0,0,2,,train
0555608_as-0037752.jpg,1,0,0,0,1,,train
0555609_as-0037752.jpg,2,0,0,0,2,,train
0555610_as-0037752.jpg,1,0,0,0,1,,train
0555611_as-0037752.jpg,1,0,0,0,1,,val
0555612_as-0037752.jpg,0,1,1,1,3,,val
0555613_as-0004826.jpg,2,0,0,0,2,,test
0555614_as-0004826.jpg,1,0,0,0,1,,train
0555615_sc-218886.jpg,2,0,0,1,3,,train
0555616_sc-218886.jpg,2,0,0,1,3,,train
0555617_sc-218886.jpg,3,0,0,0,3,,train
0555618_as-0072649.jpg,2,1,0,0,3,,train
0555619_as-0072649.jpg,1,1,0,0,2,,train
0555620_sc-138299.jpg,5,1,0,0,6,,train
0555621_sc-138299.jpg,4,1,0,0,5,,val
0555622_sc-138299.jpg,1,1,0,0,2,,val
0555623_as-0097187.jpg,1,0,0,0,1,,test
0555624_as-0097187.jpg,1,0,0,0,1,,train
0555625_as-0097187.jpg,1,0,0,0,1,,train
0555626_as-0097187.jpg,5,1,0,0,6,,train
0555627_as-3266108.jpg,1,0,0,1,2,,train
0555629_as-7110705.jpg,1,0,1,0,2,,train
0555630_sc-1034854.jpg,1,0,0,0,1,,train
0555631_sc-1034854.jpg,1,0,0,0,1,,train
0555632_sc-1034854.jpg,1,0,0,0,1,,val
0555633_sc-1037450.jpg,2,1,0,1,4,,val
0555635_as-2665455.jpg,2,0,1,0,3,,test
0555639_as-0038785.jpg,6,0,2,1,9,,train
0555640_as-0038785.jpg,3,1,1,0,5,,train
0555641_as-0038785.jpg,3,0,0,0,3,,train
0555642_as-0038785.jpg,5,2,0,1,8,,train
0555644_as-0038785.jpg,3,2,1,0,6,,train
0555645_as-0038785.jpg,2,0,2,1,5,,train
0555646_as-0038785.jpg,2,0,0,1,3,,train
0555647_as-0038785.jpg,2,0,1,1,4,,val
0555649_as-0047376.jpg,1,0,0,0,1,,val
0555650_as-0047376.jpg,1,0,0,0,1,,test
0555651_as-0047376.jpg,1,0,0,0,1,,train
0555652_as-0047376.jpg,3,0,0,0,3,,train
0555653_sc-121664.jpg,1,0,0,0,1,,train
0555654_sc-121664.jpg,3,0,0,0,3,,train
0555655_sc-121664.jpg,2,0,0,0,2,,train
0555656_as-7920118.jpg,1,0,0,1,2,,train
0555658_as-0035961.jpg,4,1,1,1,7,,train
0555659_as-0035961.jpg,3,3,2,1,9,,val
0555661_as-0035961.jpg,3,1,1,0,5,,val
0555662_as-0035961.jpg,2,0,1,1,4,,test
0555663_as-0035961.jpg,2,1,1,0,4,,train
0555665_sc-1036886.jpg,3,1,0,1,5,,train
0555666_sc-1036886.jpg,0,1,0,1,2,,train
0555667_sc-109698.jpg,1,1,0,0,2,,train
0555668_sc-109698.jpg,1,0,0,0,1,,train
0555670_sc-1037917.jpg,0,0,1,3,4,,train
0555671_sc-1037917.jpg,0,0,1,2,3,,train
0555672_sc-1037917.jpg,1,0,1,4,6,,val
0555675_sc-229480.jpg,1,2,0,0,3,,val
0555677_sc-116838.jpg,0,0,1,0,1,,test
0555678_sc-116838.jpg,7,1,2,0,10,,train
0555679_sc-116838.jpg,10,1,1,0,12,,train
0555680_sc-116838.jpg,1,0,1,0,2,,train
0555682_as-0005716.jpg,2,0,0,0,2,,train
0555683_as-9022603.jpg,7,0,0,0,7,,train
0555685_sc-200183.jpg,3,1,1,0,5,,train
0555686_sc-200183.jpg,2,1,1,0,4,,train
0555687_sc-200183.jpg,2,0,0,0,2,,val
0555688_sc-137769.jpg,0,1,0,0,1,,val
0555689_as-0016164.jpg,1,0,0,0,1,,test
0555690_as-0016164.jpg,1,0,0,0,1,,train
0555691_sc-198919.jpg,3,0,1,1,5,,train
0555692_sc-177279.jpg,2,1,0,0,3,,train
0555693_sc-177279.jpg,1,1,0,0,2,,train
0555694_sc-119518.jpg,2,0,0,1,3,,train
0555696_sc-119518.jpg,2,0,1,1,4,,train
0555697_sc-119518.jpg,2,0,1,1,4,,train
0555698_as-5413311.jpg,2,1,1,0,4,,val
0555699_sc-1034254.jpg,6,0,0,0,6,,val
0555700_sc-1034254.jpg,6,0,0,0,6,,test
0555701_sc-1034254.jpg,6,0,0,0,6,,train
0555703_sc-1034254.jpg,4,0,0,1,5,,train
0555707_as-3249502.jpg,4,0,0,0,4,,train
0555708_as-0056269.jpg,2,0,0,0,2,,train
0555709_as-0056269.jpg,2,0,0,0,2,,train
0555710_as-0056269.jpg,1,0,0,0,1,,train
0555711_as-0056269.jpg,1,0,0,0,1,,train
0555712_as-9090716.jpg,3,3,1,0,7,,val
0555713_sc-133174.jpg,2,0,1,1,4,,val
0555714_sc-133174.jpg,0,0,1,0,1,,test
0555716_sc-1037596.jpg,1,0,1,0,2,,train
0555717_sc-1037596.jpg,1,1,1,0,3,,train
0555718_sc-1037596.jpg,1,0,1,0,2,,train
0555719_sc-194682.jpg,1,1,0,0,2,,train
0555720_sc-194682.jpg,2,1,0,0,3,,train
0555721_sc-194682.jpg,1,1,0,0,2,,train
0555722_as-0067738.jpg,0,0,1,0,1,,train
0555723_as-0067738.jpg,1,0,1,0,2,,val
0555724_as-0067738.jpg,2,0,0,0,2,,val
0555726_as-0091388.jpg,2,0,1,1,4,,test
0555727_as-0091388.jpg,2,0,1,1,4,,train
0555728_as-0091388.jpg,1,0,1,1,3,,train
0555729_as-0091388.jpg,2,0,1,1,4,,train
0555730_as-0091388.jpg,1,0,1,1,3,,train
0555731_as-0091388.jpg,3,0,1,1,5,,train
0555732_as-0091388.jpg,3,0,0,1,4,,train
0555734_as-0064078.jpg,3,0,2,1,6,,train
0555735_as-0064078.jpg,1,0,1,0,2,,val
0555736_as-0064078.jpg,4,0,2,1,7,,val
0555741_as-0064078.jpg,2,0,1,1,4,,test
0555742_as-0064078.jpg,3,0,1,1,5,,train
0555743_as-0064078.jpg,4,0,2,0,6,,train
0555744_as-0064078.jpg,3,0,2,1,6,,train
0555745_as-0064078.jpg,1,0,1,0,2,,train
0555746_as-0064078.jpg,0,0,1,0,1,,train
0555747_as-0064078.jpg,0,0,1,0,1,,train
0555748_sc-113621.jpg,1,0,0,0,1,,train
0555749_as-2797373.jpg,1,0,0,0,1,,val
0555750_sc-204588.jpg,8,0,0,1,9,,val
0555751_sc-204588.jpg,7,0,0,1,8,,test
0555752_sc-204588.jpg,7,0,0,0,7,,train
0555753_as-0030402.jpg,0,1,0,0,1,,train
0555754_as-2815113.jpg,0,0,1,0,1,,train
0555755_as-0057972.jpg,1,1,0,0,2,,train
0555756_as-0004538.jpg,2,0,0,1,3,,train
0555757_as-0004538.jpg,2,0,0,0,2,,train
0555758_as-0004538.jpg,1,0,0,0,1,,train
0555759_as-2744848.jpg,3,0,0,1,4,,val
0555761_as-0093443.jpg,1,0,0,0,1,,val
0555762_as-0093443.jpg,2,0,1,0,3,,test
0555764_sc-211873.jpg,2,1,1,1,5,,train
0555765_sc-1019227.jpg,3,1,1,1,6,,train
0555766_sc-1019227.jpg,2,0,1,2,5,,train
0555767_sc-1019227.jpg,2,0,1,0,3,,train
0555768_sc-1019227.jpg,2,2,0,3,7,,train
0555769_sc-1019227.jpg,2,1,1,1,5,,train
0555770_sc-1019227.jpg,1,0,0,1,2,,train
0555772_as-7470292.jpg,2,0,0,0,2,,val
0555774_as-7399279.jpg,4,0,1,1,6,,val
0555775_sc-1016377.jpg,1,0,0,0,1,,test
0555776_sc-1016377.jpg,3,1,1,0,5,,train
0555777_sc-1016377.jpg,3,0,1,2,6,,train
0555778_sc-1016377.jpg,1,2,0,0,3,,train
0555779_sc-1016377.jpg,4,0,2,2,8,,train
0555780_sc-1016377.jpg,3,0,0,1,4,,train
0555781_sc-1016377.jpg,1,1,1,0,3,,train
0555782_sc-1016377.jpg,2,0,0,0,2,,train
0555784_sc-1016377.jpg,1,0,0,0,1,,val
0555785_sc-1016377.jpg,3,0,0,1,4,,val
0555786_sc-1016377.jpg,3,0,0,1,4,,test
0555787_sc-1016377.jpg,6,1,1,0,8,,train
0555788_sc-1016377.jpg,1,0,0,0,1,,train
0555789_sc-1016377.jpg,2,0,0,0,2,,train
0555790_sc-1016377.jpg,1,0,0,0,1,,train
0555791_sc-1016377.jpg,1,0,1,1,3,,train
0555792_sc-1016377.jpg,2,0,0,0,2,,train
0555793_sc-1008995.jpg,2,0,0,0,2,,train
0555794_sc-1008995.jpg,1,0,0,0,1,,val
0555795_sc-1008995.jpg,3,0,0,0,3,,val
0555796_sc-1008995.jpg,3,0,0,0,3,,test
0555797_sc-1008995.jpg,1,1,0,0,2,,train
0555798_as-0018933.jpg,0,0,1,0,1,,train
0555799_as-0018933.jpg,0,0,1,0,1,,train
0555800_as-0018933.jpg,0,0,1,0,1,,train
0555801_as-3087641.jpg,1,0,0,1,2,,train
0555802_sc-225875.jpg,2,0,0,0,2,,train
0555803_sc-225875.jpg,2,0,0,2,4,,train
0555804_as-0052346.jpg,1,0,0,0,1,,val
0555805_as-0052346.jpg,1,0,0,0,1,,val
0555806_as-0052346.jpg,1,0,0,0,1,,test
0555807_as-0052346.jpg,1,0,0,0,1,,train
0555808_as-0052346.jpg,1,0,0,0,1,,train
0555809_as-0052346.jpg,1,0,0,0,1,,train
0555812_as-0063372.jpg,1,0,0,0,1,,train
0555813_as-0063372.jpg,1,0,0,0,1,,train
0555814_as-0063372.jpg,2,0,0,0,2,,train
0555815_as-0063372.jpg,1,0,0,0,1,,train
0555816_as-0063372.jpg,0,0,0,1,1,,val
0555817_as-0063372.jpg,1,0,0,0,1,,val
0555819_sc-131071.jpg,0,0,1,0,1,,test
0555820_sc-131071.jpg,3,0,0,0,3,,train
0555821_sc-131071.jpg,2,0,0,0,2,,train
0555822_as-0048909.jpg,1,0,0,0,1,,train
0555823_as-0048909.jpg,1,1,0,0,2,,train
0555824_as-0048909.jpg,2,0,1,0,3,,train
0555825_as-0048909.jpg,2,0,0,0,2,,train
0555826_as-0048909.jpg,1,1,0,0,2,,train
0555827_as-0048909.jpg,1,1,0,0,2,,val
0555829_sc-181347.jpg,4,0,0,0,4,,val
0555830_sc-181347.jpg,8,0,0,0,8,,test
0555831_as-3285503.jpg,6,0,0,1,7,,train
0555832_sc-211365.jpg,1,0,0,0,1,,train
0555833_sc-211365.jpg,2,0,0,0,2,,train
0555834_sc-211365.jpg,1,0,0,0,1,,train
0555835_sc-211365.jpg,1,0,0,0,1,,train
0555836_as-0047850.jpg,1,0,0,0,1,,train
0555838_as-0047850.jpg,3,0,0,0,3,,train
0555839_as-0047850.jpg,2,0,0,0,2,,val
0555840_as-0047850.jpg,1,0,0,0,1,,val
0555841_as-0047850.jpg,1,0,0,0,1,,test
0555842_as-0047850.jpg,1,0,0,0,1,,train
0555843_as-0047850.jpg,1,0,0,1,2,,train
0555845_as-0047850.jpg,1,0,0,0,1,,train
0555846_as-0047850.jpg,1,0,0,0,1,,train
0555847_as-0047850.jpg,1,0,0,0,1,,train
0555848_as-0047850.jpg,1,0,0,0,1,,train
0555850_as-0059585.jpg,1,0,0,0,1,,train
0555851_as-0059585.jpg,2,0,0,0,2,,val
0555852_as-0059585.jpg,1,0,0,0,1,,val
0555853_as-0059585.jpg,1,0,0,0,1,,test
0555854_as-0059585.jpg,1,0,0,0,1,,train
0555855_as-0059585.jpg,1,0,0,0,1,,train
0555856_sc-156278.jpg,3,0,1,1,5,,train
0555858_as-0079640.jpg,0,1,3,1,5,,train
0555859_as-0079640.jpg,4,1,1,1,7,,train
0555861_as-0034450.jpg,1,0,0,0,1,,train
0555862_as-0034450.jpg,1,0,0,1,2,,train
0555863_as-0034450.jpg,2,2,1,0,5,,val
0555865_as-0034450.jpg,1,2,0,0,3,,val
0555866_as-3246565.jpg,5,0,1,0,6,,test
0555867_sc-212996.jpg,1,0,0,0,1,,train
0555868_sc-212996.jpg,1,0,0,0,1,,train
0555870_as-0020643.jpg,2,1,0,0,3,,train
0555871_as-0020643.jpg,2,0,1,1,4,,train
0555872_as-0020643.jpg,2,0,2,1,5,,train
0555873_sc-107002.jpg,3,0,0,0,3,,train
0555874_sc-107002.jpg,3,0,0,0,3,,train
0555875_sc-107002.jpg,4,0,0,0,4,,val
0555876_sc-107002.jpg,4,0,0,0,4,,val
0555879_as-0059745.jpg,3,0,0,0,3,,test
0555880_as-0059745.jpg,2,0,0,1,3,,train
0555881_as-0059745.jpg,4,0,1,1,6,,train
0555883_as-0059745.jpg,1,0,0,1,2,,train
0555884_as-0059745.jpg,1,0,0,1,2,,train
0555885_as-0051068.jpg,1,0,0,0,1,,train
0555886_as-0051068.jpg,1,0,0,0,1,,train
0555887_as-0051068.jpg,1,0,0,0,1,,train
0555888_as-0051068.jpg,3,0,0,0,3,,val
0555889_as-0051068.jpg,1,0,0,0,1,,val
0555890_as-0056105.jpg,2,0,0,0,2,,test
0555891_sc-221623.jpg,2,0,0,0,2,,train
0555892_sc-159156.jpg,5,0,2,0,7,,train
0555893_sc-159156.jpg,7,0,2,0,9,,train
0555894_sc-159156.jpg,2,0,2,0,4,,train
0555895_sc-1032447.jpg,2,0,0,0,2,,train
0555896_sc-1032447.jpg,2,0,0,0,2,,train
0555897_sc-1032447.jpg,2,0,0,0,2,,train
0555900_as-2933437.jpg,1,0,0,1,2,,val
0555902_as-0083886.jpg,1,0,0,0,1,,val
0555903_as-0083886.jpg,1,0,0,0,1,,test
0555904_as-0083886.jpg,1,0,0,1,2,,train
0555905_as-0083886.jpg,1,0,1,0,2,,train
0555906_as-0083886.jpg,1,0,0,0,1,,train
0555908_as-0083886.jpg,1,0,0,0,1,,train
0555909_sc-1001766.jpg,0,0,1,0,1,,train
0555911_as-0017173.jpg,2,0,0,1,3,,train
0555912_as-0017173.jpg,2,0,0,1,3,,train
0555913_as-0017173.jpg,2,0,0,0,2,,val
0555914_as-0017173.jpg,1,0,0,1,2,,val
0555915_as-0017173.jpg,2,0,0,0,2,,test
0555916_as-0017173.jpg,2,0,0,0,2,,train
0555918_sc-138466.jpg,3,0,0,0,3,,train
0555919_as-0035734.jpg,1,0,0,1,2,,train
0555921_sc-132807.jpg,1,0,1,0,2,,train
0555922_sc-132807.jpg,1,0,2,1,4,,train
0555923_sc-132807.jpg,1,0,2,1,4,,train
0555924_sc-132807.jpg,0,1,0,0,1,,train
0555926_sc-155198.jpg,1,0,0,0,1,,val
0555927_sc-155198.jpg,1,0,0,0,1,,val
0555928_sc-155198.jpg,1,0,0,0,1,,test
0555929_sc-155198.jpg,1,0,1,0,2,,train
0555931_sc-127889.jpg,1,1,0,0,2,,train
0555932_sc-127889.jpg,1,1,0,0,2,,train
0555935_sc-127889.jpg,1,1,0,0,2,,train
0555936_sc-127889.jpg,1,2,1,0,4,,train
0555937_sc-127889.jpg,0,1,0,0,1,,train
0555938_sc-127889.jpg,0,0,2,0,2,,train
0555939_as-0065538.jpg,2,0,0,0,2,,val
0555941_as-0065538.jpg,7,1,1,0,9,,val
0555942_as-0065538.jpg,2,0,0,1,3,,test
0555943_as-0065538.jpg,1,0,3,0,4,,train
0555944_as-0065538.jpg,0,0,2,0,2,,train
0555945_as-0065538.jpg,6,0,1,1,8,,train
0555946_as-0065538.jpg,2,0,1,0,3,,train
0555947_as-0065538.jpg,4,0,2,3,9,,train
0555948_as-0065538.jpg,1,0,0,0,1,,train
0555949_as-0065538.jpg,1,1,0,0,2,,train
0555950_as-0065538.jpg,7,0,1,1,9,,val
0555951_as-0065538.jpg,3,0,1,0,4,,val
0555952_as-0065538.jpg,1,0,0,0,1,,test
0555953_as-0065538.jpg,1,0,0,0,1,,train
0555954_as-0065538.jpg,1,0,4,1,6,,train
0555956_as-0065538.jpg,1,0,0,1,2,,train
0555957_as-0065538.jpg,2,0,0,1,3,,train
0555958_as-0065538.jpg,2,0,1,0,3,,train
0555959_as-0065538.jpg,2,0,0,0,2,,train
0555961_sc-201464.jpg,0,0,0,1,1,,train
0555962_sc-201464.jpg,1,0,0,1,2,,val
0555963_sc-1039848.jpg,5,1,1,1,8,,val
0555964_sc-1039848.jpg,9,2,4,0,15,,test
0555965_sc-1039848.jpg,5,1,3,1,10,,train
0555966_sc-1039848.jpg,3,0,1,1,5,,train
0555967_sc-1039848.jpg,11,1,2,0,14,,train
0555970_sc-1037167.jpg,3,1,1,0,5,,train
0555971_sc-1037167.jpg,2,1,1,0,4,,train
0555972_sc-1037167.jpg,1,1,1,1,4,,train
0555973_sc-135412.jpg,1,0,0,1,2,,train
0555976_sc-1009080.jpg,2,0,0,0,2,,val
0555977_sc-1009080.jpg,1,0,0,0,1,,val
0555978_as-3466165.jpg,1,0,2,1,4,,test
0555979_sc-1008390.jpg,2,0,0,0,2,,train
0555980_sc-1008390.jpg,5,0,0,0,5,,train
0555981_sc-1008390.jpg,3,0,0,0,3,,train
0555982_sc-1008390.jpg,2,1,0,0,3,,train
0555983_sc-1008390.jpg,4,0,0,0,4,,train
0555984_sc-1008390.jpg,11,3,1,0,15,,train
0555985_sc-1008390.jpg,10,0,0,0,10,,train
0555986_sc-1008390.jpg,3,3,1,0,7,,val
0555987_sc-1008390.jpg,2,1,0,0,3,,val
0555988_sc-1008390.jpg,1,2,0,0,3,,test
0555990_sc-1030751.jpg,1,0,0,0,1,,train
0555991_sc-1030751.jpg,1,0,0,0,1,,train
0555993_sc-225281.jpg,1,0,0,0,1,,train
0555994_sc-225281.jpg,3,0,0,0,3,,train
0555995_as-7167522.jpg,0,1,0,0,1,,train
0555996_as-3428253.jpg,1,0,0,0,1,,train
0555997_as-0037343.jpg,1,3,1,0,5,,train
0555998_as-0037343.jpg,1,1,0,0,2,,val
0555999_as-9015688.jpg,1,0,1,0,2,,val
0556001_sc-221709.jpg,1,0,0,0,1,,test
0556002_sc-221709.jpg,1,0,0,0,1,,train
0556003_sc-133870.jpg,2,0,1,1,4,,train
0556004_sc-1041224.jpg,2,0,0,0,2,,train
0556005_sc-189786.jpg,0,1,1,0,2,,train
0556006_sc-189786.jpg,0,1,0,0,1,,train
0556007_as-7378473.jpg,0,0,1,1,2,,train
0556009_as-0089933.jpg,0,0,1,1,2,,train
0556011_as-0089933.jpg,0,0,2,2,4,,val
0556012_as-0089933.jpg,0,0,2,2,4,,val
0556013_sc-1012489.jpg,2,4,2,1,9,,test
0556014_sc-1012489.jpg,0,2,1,0,3,,train
0556015_sc-1012489.jpg,0,1,1,0,2,,train
0556017_sc-1012489.jpg,1,0,0,0,1,,train
0556018_sc-218446.jpg,2,0,0,0,2,,train
0556019_sc-218446.jpg,1,0,0,0,1,,train
0556020_sc-218446.jpg,2,0,0,0,2,,train
0556021_sc-218446.jpg,1,0,0,0,1,,train
0556022_sc-218446.jpg,2,0,0,0,2,,val
0556023_sc-218446.jpg,0,1,1,0,2,,val
0556024_sc-218446.jpg,1,0,1,0,2,,test
0556025_sc-218446.jpg,4,0,0,0,4,,train
0556026_sc-218446.jpg,1,0,0,0,1,,train
0556027_sc-218446.jpg,1,0,0,0,1,,train
0556028_sc-218446.jpg,2,0,0,0,2,,train
0556029_sc-218446.jpg,6,0,0,0,6,,train
0556030_as-3165481.jpg,1,0,0,0,1,,train
0556031_sc-212653.jpg,2,0,0,0,2,,train
0556032_sc-212653.jpg,1,0,0,0,1,,val
0556033_sc-212653.jpg,1,0,0,0,1,,val
0556034_as-2866780.jpg,1,0,0,0,1,,test
0556035_sc-181020.jpg,1,0,1,1,3,,train
0556036_sc-145717.jpg,0,0,1,0,1,,train
0556037_sc-145717.jpg,1,0,1,0,2,,train
0556038_sc-145717.jpg,1,0,0,0,1,,train
0556040_sc-145717.jpg,0,0,1,0,1,,train
0556041_as-2797435.jpg,0,0,2,0,2,,train
0556042_sc-104219.jpg,6,0,0,0,6,,train
0556043_sc-214201.jpg,1,0,1,1,3,,val
0556044_sc-214201.jpg,1,0,1,1,3,,val
0556045_sc-214201.jpg,3,0,1,1,5,,test
0556046_sc-214201.jpg,4,0,1,1,6,,train
0556047_sc-214201.jpg,2,0,1,1,4,,train
0556048_sc-1026210.jpg,12,0,1,3,16,,train
0556049_sc-1026210.jpg,4,0,1,1,6,,train
0556050_sc-1026210.jpg,3,0,0,0,3,,train
0556051_sc-206612.jpg,2,5,1,2,10,,train
0556052_sc-206612.jpg,2,1,2,2,7,,train
0556053_sc-206612.jpg,5,2,2,2,11,,val
0556054_sc-120379.jpg,4,0,1,2,7,,val
0556055_sc-120379.jpg,4,0,2,2,8,,test
0556056_sc-120379.jpg,3,0,2,2,7,,train
0556057_sc-120379.jpg,1,0,1,1,3,,train
0556061_as-0084697.jpg,1,0,0,0,1,,train
0556062_as-0084697.jpg,1,0,0,0,1,,train
0556066_as-0081532.jpg,3,0,0,0,3,,train
0556067_sc-128686.jpg,2,0,0,0,2,,train
0556068_as-3099466.jpg,1,1,0,0,2,,train
0556069_sc-179874.jpg,4,1,0,1,6,,val
0556071_sc-177693.jpg,1,0,3,1,5,,val
0556072_sc-177693.jpg,1,0,4,1,6,,test
0556073_sc-177693.jpg,1,0,1,1,3,,train
0556074_sc-190619.jpg,1,0,0,1,2,,train
0556075_sc-190619.jpg,1,0,0,1,2,,train
0556076_sc-190619.jpg,1,0,1,1,3,,train
0556077_sc-190619.jpg,1,0,1,1,3,,train
0556079_as-0081692.jpg,3,0,0,0,3,,train
0556080_as-0081692.jpg,2,0,0,0,2,,train
0556081_as-0081692.jpg,2,0,0,0,2,,val
0556082_as-0081692.jpg,4,0,0,0,4,,val
0556083_as-0081692.jpg,3,0,0,0,3,,test
0556084_sc-1017397.jpg,3,0,2,0,5,,train
0556087_sc-145827.jpg,4,0,0,0,4,,train
0556088_as-7130594.jpg,2,0,0,0,2,,train
0556089_as-7395814.jpg,2,0,1,0,3,,train
0556090_sc-211380.jpg,0,1,0,0,1,,train
0556091_sc-1037503.jpg,1,1,2,0,4,,train
0556092_sc-1037503.jpg,1,1,1,1,4,,train
0556093_sc-159202.jpg,3,0,0,0,3,,val
0556094_sc-159202.jpg,1,0,0,0,1,,val
0556096_sc-115481.jpg,3,0,0,0,3,,test
0556097_as-0090364.jpg,1,0,0,0,1,,train
0556098_as-0090364.jpg,1,0,0,0,1,,train
0556099_as-0090364.jpg,1,0,0,0,1,,train
0556100_as-0090364.jpg,1,0,0,0,1,,train
0556101_as-0090364.jpg,1,0,0,0,1,,train
0556103_as-0052072.jpg,9,0,0,0,9,,train
0556110_as-0009896.jpg,2,0,0,2,4,,train
0556112_as-0009896.jpg,1,0,0,2,3,,val
0556116_as-0009896.jpg,7,1,0,1,9,,val
0556122_as-0009896.jpg,3,1,3,1,8,,test
0556126_as-0009896.jpg,2,1,1,1,5,,train
0556130_as-0009896.jpg,2,0,0,2,4,,train
0556133_as-0009896.jpg,2,2,2,1,7,,train
0556134_as-0033719.jpg,2,0,0,1,3,,train
0556135_as-0033719.jpg,4,0,0,1,5,,train
0556136_as-0033719.jpg,3,0,0,1,4,,train
0556138_as-0033719.jpg,1,0,0,0,1,,train
0556139_as-0033719.jpg,1,0,0,1,2,,val
0556140_sc-208845.jpg,3,0,2,3,8,,val
0556141_sc-208845.jpg,2,0,3,2,7,,test
0556142_sc-208845.jpg,4,0,2,3,9,,train
0556143_sc-208845.jpg,3,1,1,1,6,,train
0556144_sc-208845.jpg,1,1,1,2,5,,train
0556145_sc-208845.jpg,1,1,1,0,3,,train
0556146_sc-208845.jpg,2,0,0,1,3,,train
0556147_sc-208845.jpg,2,0,0,1,3,,train
0556148_sc-208845.jpg,3,0,0,1,4,,train
0556149_sc-208845.jpg,5,1,1,4,11,,val
0556151_sc-165195.jpg,2,1,1,0,4,,val
0556152_sc-165195.jpg,3,0,0,0,3,,test
0556153_sc-165195.jpg,1,0,1,0,2,,train
0556154_sc-165195.jpg,2,0,0,0,2,,train
0556155_sc-145087.jpg,3,1,0,0,4,,train
0556156_sc-145087.jpg,2,1,0,0,3,,train
0556157_sc-145087.jpg,3,0,0,0,3,,train
0556160_as-0002594.jpg,0,0,1,0,1,,train
0556161_as-0002594.jpg,2,0,1,0,3,,train
0556163_as-0036732.jpg,1,1,2,1,5,,val
0556164_as-0036732.jpg,0,2,2,1,5,,val
0556165_as-0036732.jpg,0,1,1,2,4,,test
0556166_as-3199891.jpg,1,0,0,0,1,,train
0556167_sc-197701.jpg,1,0,0,0,1,,train
0556168_sc-197701.jpg,2,0,0,1,3,,train
0556169_sc-197701.jpg,3,0,0,1,4,,train
0556170_sc-197701.jpg,2,0,0,0,2,,train
0556171_sc-197701.jpg,4,0,1,0,5,,train
0556172_sc-197701.jpg,4,0,0,0,4,,train
0556173_sc-197701.jpg,4,0,1,0,5,,val
0556174_sc-197701.jpg,4,0,0,1,5,,val
0556175_sc-197701.jpg,1,0,0,0,1,,test
0556176_sc-197701.jpg,2,0,0,0,2,,train
0556178_sc-129792.jpg,1,0,0,1,2,,train
0556179_sc-129792.jpg,1,0,0,2,3,,train
0556180_sc-129792.jpg,3,0,0,1,4,,train
0556181_sc-129792.jpg,1,0,0,2,3,,train
0556184_as-0058060.jpg,1,1,0,0,2,,train
0556185_as-0058060.jpg,1,1,0,0,2,,train
0556186_as-0058060.jpg,1,3,0,0,4,,val
0556188_as-0058060.jpg,0,1,0,0,1,,val
0556190_sc-121840.jpg,4,5,0,0,9,,test
0556192_as-3241778.jpg,2,0,0,0,2,,train
0556193_sc-186773.jpg,1,1,0,0,2,,train
0556194_sc-186773.jpg,1,1,0,0,2,,train
0556198_as-3271379.jpg,3,2,2,0,7,,train
0556201_sc-193966.jpg,0,1,0,0,1,,train
0556202_sc-193966.jpg,1,1,0,0,2,,train
0556203_sc-193966.jpg,1,1,0,0,2,,train
0556204_sc-193966.jpg,1,1,0,0,2,,val
0556205_sc-193966.jpg,1,0,0,0,1,,val
0556206_sc-193966.jpg,1,1,0,0,2,,test
0556208_as-0087287.jpg,1,0,1,0,2,,train
0556210_as-0071727.jpg,2,0,0,0,2,,train
0556211_sc-183179.jpg,1,0,0,0,1,,train
0556212_sc-183179.jpg,1,0,0,0,1,,train
0556213_sc-216315.jpg,2,0,1,0,3,,train
0556214_sc-216315.jpg,1,0,2,2,5,,train
0556215_sc-216315.jpg,2,0,1,1,4,,train
0556217_as-5091675.jpg,1,1,1,1,4,,val
0556218_sc-213338.jpg,3,0,2,2,7,,val
0556219_sc-213338.jpg,2,0,2,1,5,,test
0556220_as-3010105.jpg,2,0,0,0,2,,train
0556221_as-3010105.jpg,3,0,1,0,4,,train
0556222_as-3373113.jpg,0,2,1,0,3,,train
0556224_as-3040447.jpg,2,0,0,0,2,,train
0556225_sc-152310.jpg,2,0,1,0,3,,train
0556226_sc-124516.jpg,1,1,0,0,2,,train
0556227_sc-124516.jpg,3,0,1,1,5,,train
0556228_sc-124516.jpg,2,0,1,0,3,,val
0556230_as-3158192.jpg,1,1,1,0,3,,val
0556234_sc-1020466.jpg,2,0,0,0,2,,test
0556235_sc-1020466.jpg,1,0,0,0,1,,train
0556236_sc-1020466.jpg,2,0,0,0,2,,train
0556238_as-0036936.jpg,3,2,0,1,6,,train
0556239_as-0036936.jpg,3,2,0,1,6,,train
0556240_as-2962094.jpg,1,0,0,0,1,,train
0556242_as-0061438.jpg,3,0,0,1,4,,train
0556243_as-0061438.jpg,1,0,0,0,1,,train
0556244_as-0062875.jpg,1,0,0,1,2,,val
0556245_as-0062875.jpg,4,0,1,0,5,,val
0556248_sc-223620.jpg,0,0,0,1,1,,test
0556249_sc-223620.jpg,0,0,0,1,1,,train
0556250_sc-223620.jpg,0,0,0,1,1,,train
0556251_sc-223620.jpg,0,0,1,0,1,,train
0556252_sc-223620.jpg,0,0,1,0,1,,train
0556253_sc-223620.jpg,0,0,0,1,1,,train
0556255_sc-1003839.jpg,0,1,0,0,1,,train
0556256_as-3165987.jpg,7,0,0,0,7,,train
0556257_as-3437945.jpg,1,0,1,0,2,,val
0556261_as-0064039.jpg,2,0,0,0,2,,val
0556262_as-0064039.jpg,1,0,0,0,1,,test
0556263_as-0064039.jpg,2,0,0,0,2,,train
0556264_as-0064039.jpg,2,0,0,0,2,,train
0556265_as-0064039.jpg,2,0,0,0,2,,train
0556266_as-0064039.jpg,2,0,0,0,2,,train
0556267_as-0064039.jpg,3,0,0,0,3,,train
0556268_as-0064039.jpg,3,0,0,0,3,,train
0556271_as-0064039.jpg,0,1,0,0,1,,train
0556272_as-2879655.jpg,0,0,1,0,1,,val
0556273_sc-202766.jpg,1,0,0,1,2,,val
0556275_as-0031313.jpg,2,3,1,1,7,,test
0556276_as-0031313.jpg,3,2,2,1,8,,train
0556277_as-0031313.jpg,0,0,0,1,1,,train
0556278_as-0031313.jpg,0,0,3,0,3,,train
0556279_as-0031313.jpg,1,0,1,0,2,,train
0556280_as-0031313.jpg,0,0,1,0,1,,train
0556284_as-0076128.jpg,3,1,4,4,12,,train
0556285_as-0076128.jpg,0,0,3,2,5,,train
0556286_sc-159161.jpg,1,0,1,0,2,,val
0556287_as-7593856.jpg,0,0,0,1,1,,val
0556288_as-0053073.jpg,2,0,0,0,2,,test
0556289_as-0053073.jpg,1,0,0,0,1,,train
0556290_as-0028198.jpg,1,0,0,0,1,,train
0556292_as-0028198.jpg,3,0,0,0,3,,train
0556293_sc-114566.jpg,1,1,1,0,3,,train
0556296_sc-114566.jpg,2,0,1,0,3,,train
0556298_as-2757117.jpg,1,0,0,0,1,,train
0556299_sc-133754.jpg,2,0,2,1,5,,train
0556300_sc-133754.jpg,1,0,1,0,2,,val
0556301_sc-133754.jpg,2,0,1,0,3,,val
0556303_sc-133754.jpg,4,0,1,1,6,,test
0556305_sc-133754.jpg,3,0,1,2,6,,train
0556306_sc-133754.jpg,1,0,1,0,2,,train
0556307_sc-113923.jpg,1,0,0,0,1,,train
0556308_sc-196217.jpg,4,0,0,0,4,,train
0556309_sc-196217.jpg,1,0,0,0,1,,train
0556310_sc-196217.jpg,4,0,1,1,6,,train
0556311_sc-196217.jpg,3,1,1,0,5,,train
0556312_as-3349846.jpg,3,2,2,2,9,,val
0556315_as-2983958.jpg,1,0,1,0,2,,val
0556317_sc-1031543.jpg,1,0,0,0,1,,test
0556318_sc-1031543.jpg,2,0,0,0,2,,train
0556320_sc-1031543.jpg,7,0,0,0,7,,train
0556321_sc-1031543.jpg,2,0,0,1,3,,train
0556322_sc-1031543.jpg,2,0,0,1,3,,train
0556324_as-2576307.jpg,1,0,0,0,1,,train
0556325_sc-1033679.jpg,0,1,0,0,1,,train
0556326_sc-1033679.jpg,2,2,0,0,4,,train
0556327_sc-169865.jpg,3,0,0,0,3,,val
0556328_sc-169865.jpg,2,0,0,0,2,,val
0556329_sc-169865.jpg,3,0,0,0,3,,test
0556331_as-0047374.jpg,3,0,0,0,3,,train
0556332_as-0047374.jpg,1,1,0,0,2,,train
0556333_as-0047374.jpg,1,1,0,2,4,,train
0556334_as-0047374.jpg,3,0,0,0,3,,train
0556335_sc-213768.jpg,2,0,1,0,3,,train
0556336_sc-213768.jpg,1,0,1,0,2,,train
0556337_sc-213768.jpg,2,0,1,0,3,,train
0556338_as-0028168.jpg,2,0,0,0,2,,val
0556340_as-0028168.jpg,1,0,0,0,1,,val
0556341_as-2775602.jpg,0,0,1,0,1,,test
0556343_as-0017997.jpg,1,0,0,1,2,,train
0556344_as-0017997.jpg,1,0,0,1,2,,train
0556345_as-0017997.jpg,1,0,0,1,2,,train
0556346_as-0017997.jpg,3,0,0,1,4,,train
0556347_as-0017997.jpg,3,0,0,1,4,,train
0556348_as-0017997.jpg,2,0,0,1,3,,train
0556349_as-0017997.jpg,2,0,0,0,2,,train
0556350_as-0017997.jpg,1,0,0,0,1,,val
0556351_as-0017997.jpg,1,0,0,0,1,,val
0556352_as-0017997.jpg,4,0,0,0,4,,test
0556353_as-0017997.jpg,3,0,0,0,3,,train
0556354_as-0017997.jpg,2,0,0,0,2,,train
0556357_as-0036959.jpg,1,0,0,0,1,,train
0556359_sc-1041002.jpg,2,0,1,0,3,,train
0556360_sc-1006157.jpg,2,0,0,0,2,,train
0556361_sc-1006157.jpg,1,0,0,0,1,,train
0556362_sc-1006157.jpg,1,0,0,0,1,,train
0556364_sc-1006157.jpg,3,0,0,0,3,,val
0556366_sc-1006157.jpg,3,2,3,1,9,,val
0556367_sc-1006157.jpg,2,0,0,0,2,,test
0556368_sc-1006157.jpg,4,0,0,0,4,,train
0556369_sc-1006157.jpg,3,0,0,0,3,,train
0556370_as-7109322.jpg,1,0,0,0,1,,train
0556371_as-2644419.jpg,9,0,0,0,9,,train
0556372_sc-207262.jpg,1,0,0,0,1,,train
0556373_sc-207262.jpg,3,0,1,0,4,,train
0556374_sc-207262.jpg,1,0,1,0,2,,train
0556375_sc-155502.jpg,5,1,0,0,6,,val
0556376_sc-155502.jpg,2,1,0,0,3,,val
0556377_sc-155502.jpg,2,0,1,0,3,,test
0556378_sc-155502.jpg,1,1,1,0,3,,train
0556379_as-7278785.jpg,1,0,2,0,3,,train
0556380_sc-1037549.jpg,1,0,1,2,4,,train
0556381_sc-1037549.jpg,1,1,1,1,4,,train
0556382_sc-1037549.jpg,1,0,0,1,2,,train
0556383_sc-1037549.jpg,1,0,1,1,3,,train
0556385_sc-1005317.jpg,4,0,0,0,4,,train
0556386_sc-1005317.jpg,3,0,2,0,5,,val
0556387_as-2940852.jpg,2,0,0,0,2,,val
0556388_sc-208725.jpg,5,0,0,0,5,,test
0556389_sc-208725.jpg,7,0,0,1,8,,train
0556390_sc-208725.jpg,2,0,0,0,2,,train
0556391_sc-208725.jpg,3,0,1,1,5,,train
0556392_sc-205143.jpg,4,0,0,0,4,,train
0556393_sc-205143.jpg,1,0,0,0,1,,train
0556394_sc-205143.jpg,4,0,0,0,4,,train
0556395_sc-205143.jpg,1,0,0,0,1,,train
0556396_sc-205143.jpg,1,0,0,0,1,,val
0556397_sc-205143.jpg,1,0,0,0,1,,val
0556400_as-7084545.jpg,0,0,1,0,1,,test
0556401_as-3488427.jpg,1,0,1,0,2,,train
0556402_sc-109982.jpg,5,0,3,1,9,,train
0556403_sc-109982.jpg,1,0,0,0,1,,train
0556404_sc-109982.jpg,4,0,0,0,4,,train
0556405_sc-109982.jpg,3,0,0,0,3,,train
0556406_sc-109982.jpg,3,0,3,2,8,,train
0556407_sc-109982.jpg,4,0,1,1,6,,train
0556408_sc-109982.jpg,3,0,2,1,6,,val
0556409_as-2949926.jpg,1,0,2,0,3,,val
0556410_as-7015852.jpg,0,0,1,1,2,,test
0556411_sc-170072.jpg,5,0,0,0,5,,train
0556412_sc-170072.jpg,5,0,1,0,6,,train
0556413_sc-170072.jpg,3,0,1,0,4,,train
0556414_sc-170072.jpg,2,0,1,0,3,,train
0556417_as-2823608.jpg,3,0,1,1,5,,train
0556419_as-0079418.jpg,4,0,1,0,5,,train
0556420_as-3183136.jpg,0,1,1,0,2,,train
0556423_as-7151272.jpg,3,0,1,0,4,,val
0556424_sc-166621.jpg,3,0,1,1,5,,val
0556425_sc-166621.jpg,3,0,1,1,5,,test
0556426_sc-166621.jpg,0,0,1,1,2,,train
0556428_sc-1020350.jpg,1,0,0,0,1,,train
0556429_sc-1020350.jpg,1,0,0,0,1,,train
0556430_sc-161715.jpg,6,0,0,0,6,,train
0556431_sc-148530.jpg,1,0,0,1,2,,train
0556432_sc-148530.jpg,2,0,0,1,3,,train
0556433_sc-148530.jpg,2,0,0,1,3,,train
0556434_sc-148530.jpg,1,0,0,1,2,,val
0556435_sc-148530.jpg,1,0,0,1,2,,val
0556436_sc-207031.jpg,1,0,0,1,2,,test
0556438_sc-207031.jpg,1,0,0,1,2,,train
0556439_sc-207031.jpg,1,0,1,1,3,,train
0556440_sc-207031.jpg,1,0,0,1,2,,train
0556441_sc-207031.jpg,1,0,0,0,1,,train
0556442_sc-207031.jpg,1,0,1,0,2,,train
0556443_sc-207031.jpg,1,0,2,1,4,,train
0556444_sc-207031.jpg,1,0,1,1,3,,train
0556445_as-0084248.jpg,1,0,0,1,2,,val
0556446_as-0084248.jpg,6,1,0,0,7,,val
0556447_as-0084248.jpg,0,1,1,0,2,,test
0556449_as-0016016.jpg,0,0,0,1,1,,train
0556453_as-0016016.jpg,1,0,0,0,1,,train
0556454_as-0016016.jpg,1,0,1,1,3,,train
0556455_as-0016016.jpg,1,1,1,1,4,,train
0556458_as-0016016.jpg,0,1,3,0,4,,train
0556461_sc-118957.jpg,1,0,1,0,2,,train
0556463_sc-118957.jpg,1,0,2,0,3,,train
0556464_sc-218083.jpg,2,0,0,0,2,,val
0556465_sc-218083.jpg,1,0,0,0,1,,val
0556466_sc-218083.jpg,1,0,0,0,1,,test
0556467_as-3239837.jpg,2,0,0,2,4,,train
0556468_as-3111915.jpg,2,0,1,0,3,,train
0556469_as-7167043.jpg,2,1,0,1,4,,train
0556470_as-0048442.jpg,1,0,1,1,3,,train
0556471_as-0048442.jpg,1,1,0,1,3,,train
0556472_as-0048442.jpg,1,2,0,1,4,,train
0556473_as-0048442.jpg,2,1,1,1,5,,train
0556474_as-0048442.jpg,1,0,0,0,1,,val
0556475_as-0048442.jpg,1,0,0,0,1,,val
0556476_as-0048442.jpg,1,0,0,0,1,,test
0556477_as-0048442.jpg,1,0,0,0,1,,train
0556478_as-0048442.jpg,4,0,1,0,5,,train
0556479_as-0048442.jpg,1,0,1,0,2,,train
0556481_as-0076977.jpg,1,1,0,0,2,,train
0556482_as-0076977.jpg,4,1,0,1,6,,train
0556483_as-0076977.jpg,2,0,0,0,2,,train
0556484_as-0091812.jpg,1,0,2,0,3,,train
0556485_sc-1015952.jpg,1,0,0,0,1,,val
0556486_sc-1015952.jpg,1,0,0,0,1,,val
0556487_sc-1015952.jpg,1,0,0,0,1,,test
0556488_as-0082748.jpg,1,0,0,0,1,,train
0556489_as-0082748.jpg,1,0,0,1,2,,train
0556490_sc-169732.jpg,3,0,1,0,4,,train
0556491_sc-169732.jpg,1,1,0,0,2,,train
0556492_sc-169732.jpg,2,1,0,0,3,,train
0556493_sc-169732.jpg,2,1,0,1,4,,train
0556495_sc-169732.jpg,2,0,1,0,3,,train
0556496_sc-169732.jpg,1,0,1,1,3,,val
0556497_as-2647375.jpg,3,0,0,0,3,,val
0556498_sc-1017701.jpg,0,0,1,1,2,,test
0556499_as-0080596.jpg,1,0,0,0,1,,train
0556502_as-0080596.jpg,0,0,1,1,2,,train
0556506_as-0068579.jpg,3,0,3,0,6,,train
0556507_as-0068579.jpg,3,0,2,1,6,,train
0556508_as-0068579.jpg,2,0,3,0,5,,train
0556509_as-0068579.jpg,2,0,2,0,4,,train
0556510_sc-1025938.jpg,2,0,0,0,2,,train
0556511_sc-156809.jpg,6,0,0,1,7,,val
0556512_sc-156809.jpg,5,0,1,1,7,,val
0556513_sc-156809.jpg,1,0,1,0,2,,test
0556515_sc-158000.jpg,3,0,0,1,4,,train
0556516_sc-158000.jpg,1,0,0,1,2,,train
0556517_sc-158000.jpg,1,0,0,1,2,,train
0556518_sc-158000.jpg,0,0,0,1,1,,train
0556519_as-0018529.jpg,1,0,1,0,2,,train
0556520_as-3092008.jpg,2,0,0,0,2,,train
0556522_sc-114825.jpg,2,0,0,0,2,,train
0556523_sc-114825.jpg,1,0,2,1,4,,val
0556524_sc-114825.jpg,5,0,0,0,5,,val
0556525_sc-183784.jpg,6,0,2,0,8,,test
0556526_sc-183784.jpg,3,1,0,3,7,,train
0556528_sc-183784.jpg,2,0,1,0,3,,train
0556529_sc-183784.jpg,2,0,0,0,2,,train
0556530_sc-183784.jpg,5,0,0,2,7,,train
0556531_sc-183784.jpg,4,0,1,0,5,,train
0556532_sc-183784.jpg,5,1,0,0,6,,train
0556533_sc-183784.jpg,2,0,1,0,3,,train
0556534_sc-183784.jpg,2,0,2,0,4,,val
0556535_as-2520577.jpg,0,0,1,1,2,,val
0556536_sc-181475.jpg,7,0,0,0,7,,test
0556538_as-3265212.jpg,2,0,0,0,2,,train
0556539_as-0021093.jpg,0,0,0,1,1,,train
0556540_as-0021093.jpg,0,0,0,1,1,,train
0556541_as-0021093.jpg,1,0,0,0,1,,train
0556542_as-2905980.jpg,1,0,0,1,2,,train
0556545_as-0073207.jpg,3,0,1,0,4,,train
0556549_sc-1020520.jpg,3,0,0,1,4,,train
0556550_sc-1020520.jpg,1,1,1,1,4,,val
0556551_sc-1020520.jpg,1,1,0,1,3,,val
0556552_sc-1020520.jpg,4,0,0,1,5,,test
0556553_sc-192629.jpg,3,0,0,1,4,,train
0556554_sc-192629.jpg,1,0,0,0,1,,train
0556555_sc-192629.jpg,2,1,1,1,5,,train
0556556_sc-192629.jpg,3,0,0,0,3,,train
0556557_sc-210036.jpg,1,0,0,0,1,,train
0556558_sc-210036.jpg,0,0,1,0,1,,train
0556559_sc-210036.jpg,2,0,1,1,4,,train
0556560_sc-131974.jpg,1,0,0,0,1,,val
0556561_sc-131974.jpg,1,0,1,1,3,,val
0556562_sc-131974.jpg,1,0,0,0,1,,test
0556563_sc-131974.jpg,1,0,0,0,1,,train
0556564_sc-131974.jpg,1,0,0,0,1,,train
0556565_sc-131974.jpg,1,0,1,2,4,,train
0556566_sc-131974.jpg,1,0,1,2,4,,train
0556568_as-0094230.jpg,3,0,0,0,3,,train
0556569_as-0094230.jpg,3,1,0,0,4,,train
0556570_as-0036264.jpg,1,0,0,1,2,,train
0556571_as-0036264.jpg,1,0,0,0,1,,val
0556573_sc-1036004.jpg,2,1,1,0,4,,val
0556574_sc-1036004.jpg,3,1,2,1,7,,test
0556575_sc-1036004.jpg,2,2,2,1,7,,train
0556576_sc-1036004.jpg,1,1,0,1,3,,train
0556578_sc-1036004.jpg,1,1,1,0,3,,train
0556579_as-0043060.jpg,10,0,1,0,11,,train
0556580_as-0043060.jpg,8,0,0,0,8,,train
0556581_sc-145089.jpg,1,0,1,0,2,,train
0556582_sc-145089.jpg,1,0,1,1,3,,train
0556583_sc-145089.jpg,1,0,0,0,1,,val
0556587_as-0016625.jpg,0,1,1,0,2,,val
0556588_as-0016625.jpg,0,0,1,0,1,,test
0556589_as-0016625.jpg,2,0,1,0,3,,train
0556590_as-0016625.jpg,2,0,1,0,3,,train
0556591_as-0016625.jpg,1,0,1,0,2,,train
0556592_as-0016625.jpg,2,0,1,0,3,,train
0556593_as-0016625.jpg,0,0,1,0,1,,train
0556594_sc-1001591.jpg,1,0,0,0,1,,train
0556596_sc-1001591.jpg,1,0,0,0,1,,train
0556600_as-0096502.jpg,3,1,2,1,7,,val
0556602_as-0096502.jpg,1,0,0,0,1,,val
0556603_as-0096502.jpg,0,2,1,0,3,,test
0556604_as-0096502.jpg,2,1,3,1,7,,train
0556605_as-0096502.jpg,2,0,1,0,3,,train
0556607_sc-208471.jpg,6,0,0,0,6,,train
0556608_sc-208471.jpg,2,0,0,0,2,,train
0556609_sc-208471.jpg,1,0,0,0,1,,train
0556610_sc-208471.jpg,2,0,0,0,2,,train
0556611_sc-208471.jpg,1,0,0,0,1,,train
0556612_sc-208471.jpg,2,0,0,0,2,,val
0556613_sc-208471.jpg,2,0,0,0,2,,val
0556614_sc-208471.jpg,1,0,0,0,1,,test
0556615_sc-208471.jpg,1,0,0,0,1,,train
0556617_as-0047059.jpg,13,0,2,1,16,,train
0556618_as-0047059.jpg,4,0,0,1,5,,train
0556619_as-0047059.jpg,5,0,0,0,5,,train
0556620_as-0047059.jpg,7,0,0,0,7,,train
0556621_as-0047059.jpg,7,0,0,0,7,,train
0556622_as-0047059.jpg,0,0,1,1,2,,train
0556623_as-0047059.jpg,1,0,2,1,4,,val
0556627_as-3169290.jpg,0,0,1,0,1,,val
0556628_as-3220760.jpg,4,0,1,0,5,,test
0556630_as-2502321.jpg,1,0,0,1,2,,train
0556631_as-2502571.jpg,1,0,0,0,1,,train
0556632_as-3222567.jpg,1,0,0,0,1,,train
0556634_as-0000356.jpg,0,1,0,0,1,,train
0556635_as-0000356.jpg,0,1,0,1,2,,train
0556636_as-0000356.jpg,0,1,0,1,2,,train
0556637_as-0000356.jpg,0,1,0,1,2,,train
0556639_as-3105653.jpg,1,0,0,0,1,,val
0556643_sc-1023310.jpg,2,1,0,0,3,,val
0556644_sc-1023310.jpg,2,1,0,0,3,,test
0556645_sc-1023310.jpg,1,1,0,0,2,,train
0556646_sc-124219.jpg,0,1,0,0,1,,train
0556647_sc-124219.jpg,1,0,0,1,2,,train
0556648_sc-124219.jpg,1,1,0,0,2,,train
0556650_as-0021855.jpg,1,0,1,0,2,,train
0556651_as-3191405.jpg,0,2,3,0,5,,train
0556652_sc-191809.jpg,2,0,1,0,3,,train
0556653_as-0037990.jpg,1,0,0,0,1,,val
0556654_as-0037990.jpg,1,0,0,0,1,,val
0556655_as-9042649.jpg,1,0,1,0,2,,test
0556658_as-3166143.jpg,0,1,0,0,1,,train
0556659_sc-1040096.jpg,1,0,0,0,1,,train
0556660_sc-1040096.jpg,1,1,2,0,4,,train
0556661_sc-1040096.jpg,2,1,1,0,4,,train
0556662_sc-1040096.jpg,1,0,1,0,2,,train
0556664_as-3228476.jpg,1,0,2,0,3,,train
0556665_as-2695752.jpg,4,0,1,2,7,,train
0556666_as-3110746.jpg,2,0,0,0,2,,val
0556667_as-7627518.jpg,1,0,2,2,5,,val
0556668_as-3329073.jpg,1,1,1,1,4,,test
0556670_sc-119640.jpg,0,0,1,0,1,,train
0556671_sc-119640.jpg,0,1,1,0,2,,train
0556673_sc-119640.jpg,0,0,1,0,1,,train
0556676_as-0079850.jpg,1,0,0,0,1,,train
0556677_as-0079850.jpg,4,0,0,0,4,,train
0556681_as-2577062.jpg,2,0,0,1,3,,train
0556683_as-2780560.jpg,1,0,0,1,2,,train
0556684_as-7494028.jpg,1,0,0,2,3,,val
0556688_as-0050680.jpg,3,1,0,0,4,,val
0556689_as-0050680.jpg,1,2,0,0,3,,test
0556690_as-0050680.jpg,1,3,1,0,5,,train
0556692_as-0050680.jpg,1,0,1,0,2,,train
0556694_as-0050680.jpg,1,0,0,0,1,,train
0556695_as-0050680.jpg,0,0,1,0,1,,train
0556696_as-0050680.jpg,0,0,1,0,1,,train
0556697_as-0050680.jpg,0,0,1,0,1,,train
0556698_as-0050680.jpg,0,0,1,0,1,,train
0556699_as-0050680.jpg,0,2,2,0,4,,val
0556700_as-0050680.jpg,0,2,2,0,4,,val
0556701_as-0050680.jpg,1,2,2,0,5,,test
0556702_as-0050680.jpg,1,2,2,0,5,,train
0556703_as-0050680.jpg,2,0,1,0,3,,train
0556704_as-0050680.jpg,0,0,1,0,1,,train
0556705_as-0050680.jpg,0,0,1,0,1,,train
0556706_as-0050680.jpg,1,0,1,0,2,,train
0556707_as-0050680.jpg,0,0,2,0,2,,train
0556708_as-0050680.jpg,0,1,3,0,4,,train
0556709_as-0050680.jpg,0,0,2,0,2,,val
0556710_as-0050680.jpg,0,0,1,0,1,,val
0556711_as-0050680.jpg,1,0,1,0,2,,test
0556713_as-0052552.jpg,4,0,0,0,4,,train
0556714_as-0052552.jpg,11,0,0,0,11,,train
0556715_as-0052552.jpg,8,0,0,0,8,,train
0556717_as-3319083.jpg,1,1,3,0,5,,train
0556719_as-0026267.jpg,2,0,0,0,2,,train
0556720_as-0026267.jpg,2,0,0,0,2,,train
0556721_as-0026267.jpg,3,0,0,0,3,,train
0556722_as-0026267.jpg,2,0,0,0,2,,val
0556723_as-0038455.jpg,4,2,0,1,7,,val
0556727_as-0038455.jpg,1,0,0,1,2,,test
0556728_as-0038455.jpg,2,2,1,0,5,,train
0556729_as-0038455.jpg,2,2,0,1,5,,train
0556730_as-0038455.jpg,0,1,0,0,1,,train
0556731_as-0038455.jpg,0,0,1,0,1,,train
0556732_as-0038455.jpg,0,0,2,0,2,,train
0556733_as-0038455.jpg,0,1,0,0,1,,train
0556734_as-3461303.jpg,2,0,0,0,2,,train
0556735_sc-123550.jpg,2,0,0,0,2,,val
0556736_sc-123550.jpg,1,0,0,0,1,,val
0556737_sc-123550.jpg,2,0,0,0,2,,test
0556738_sc-123550.jpg,1,0,0,0,1,,train
0556739_sc-210920.jpg,4,0,2,1,7,,train
0556740_sc-210920.jpg,0,0,1,0,1,,train
0556741_sc-210920.jpg,2,0,2,1,5,,train
0556742_sc-210920.jpg,3,0,1,1,5,,train
0556743_sc-210920.jpg,3,0,0,0,3,,train
0556744_sc-210920.jpg,0,0,1,0,1,,train
0556745_as-7319776.jpg,0,1,0,0,1,,val
0556747_as-0087136.jpg,2,0,0,0,2,,val
0556748_as-0087136.jpg,2,0,0,0,2,,test
0556749_as-7101367.jpg,0,1,0,0,1,,train
0556751_sc-122526.jpg,1,1,0,1,3,,train
0556752_as-9082073.jpg,2,0,0,0,2,,train
0556754_as-0072386.jpg,1,1,0,0,2,,train
0556755_sc-207891.jpg,2,0,2,2,6,,train
0556756_sc-207891.jpg,1,0,2,1,4,,train
0556757_as-7032475.jpg,1,1,0,0,2,,train
0556758_as-2903576.jpg,3,0,4,1,8,,val
0556759_sc-1024809.jpg,1,2,0,0,3,,val
0556760_sc-1024809.jpg,2,0,1,0,3,,test
0556761_sc-219726.jpg,7,1,1,1,10,,train
0556762_sc-125048.jpg,2,0,0,0,2,,train
0556764_as-2864818.jpg,4,1,1,1,7,,train
0556765_sc-1037521.jpg,1,2,2,0,5,,train
0556767_sc-1037521.jpg,1,0,0,1,2,,train
0556768_as-0072256.jpg,0,1,0,0,1,,train
0556769_sc-105733.jpg,1,1,0,1,3,,train
0556770_as-2732614.jpg,1,0,0,0,1,,val
0556771_sc-133138.jpg,4,0,1,0,5,,val
0556772_sc-195954.jpg,3,0,0,0,3,,test
0556773_sc-195954.jpg,5,0,0,0,5,,train
0556774_sc-195954.jpg,0,0,2,0,2,,train
0556775_sc-226325.jpg,2,0,0,1,3,,train
0556776_sc-226325.jpg,2,0,0,1,3,,train
0556777_sc-226325.jpg,2,0,0,1,3,,train
0556780_as-0092718.jpg,0,1,0,0,1,,train
0556781_as-0092718.jpg,0,1,0,0,1,,train
0556782_as-0092718.jpg,0,1,0,0,1,,val
0556783_as-0092718.jpg,0,1,0,0,1,,val
0556784_as-0092718.jpg,0,1,0,0,1,,test
0556785_sc-114724.jpg,3,0,0,1,4,,train
0556786_sc-114724.jpg,2,0,0,2,4,,train
0556788_sc-1002932.jpg,2,0,0,0,2,,train
0556789_sc-1002932.jpg,3,0,1,0,4,,train
0556790_as-0009360.jpg,2,0,0,0,2,,train
0556791_as-0009360.jpg,2,0,0,0,2,,train
0556794_as-0016743.jpg,2,0,2,0,4,,train
0556796_as-0016743.jpg,0,0,3,0,3,,val
0556797_as-0032817.jpg,1,1,1,0,3,,val
0556798_as-0032817.jpg,1,1,1,0,3,,test
0556799_sc-216134.jpg,5,0,1,0,6,,train
0556801_sc-216134.jpg,5,0,0,0,5,,train
0556802_sc-216134.jpg,2,0,1,0,3,,train
0556803_sc-216134.jpg,2,0,1,0,3,,train
0556807_as-0099112.jpg,2,0,0,0,2,,train
0556808_as-0099112.jpg,1,0,0,0,1,,train
0556809_sc-155133.jpg,1,0,0,0,1,,train
0556810_sc-155133.jpg,1,0,0,0,1,,val
0556811_sc-155133.jpg,1,0,0,0,1,,val
0556812_as-0082176.jpg,0,0,1,1,2,,test
0556813_as-0082176.jpg,0,0,1,0,1,,train
0556814_as-0082176.jpg,0,0,1,0,1,,train
0556815_as-0082176.jpg,0,0,1,0,1,,train
0556816_as-0082176.jpg,0,0,2,0,2,,train
0556819_as-0082176.jpg,1,2,3,1,7,,train
0556820_as-0082176.jpg,2,2,0,1,5,,train
0556822_as-0082176.jpg,4,0,0,0,4,,train
0556823_as-0082176.jpg,0,1,1,1,3,,val
0556825_as-0027535.jpg,2,0,0,1,3,,val
0556827_as-0027535.jpg,2,0,0,0,2,,test
0556828_as-0027535.jpg,1,0,0,0,1,,train
0556829_as-7332575.jpg,1,0,0,0,1,,train
0556830_as-9049171.jpg,1,0,0,0,1,,train
0556831_as-0073507.jpg,3,0,0,0,3,,train
0556832_as-0073507.jpg,3,0,0,0,3,,train
0556833_as-0073507.jpg,1,0,2,1,4,,train
0556834_as-0073507.jpg,1,0,1,1,3,,train
0556835_as-0073507.jpg,0,0,0,1,1,,val
0556836_sc-109715.jpg,2,0,0,1,3,,val
0556837_as-0014585.jpg,1,0,0,0,1,,test
0556838_as-0014585.jpg,1,1,0,3,5,,train
0556839_as-0014585.jpg,1,2,0,0,3,,train
0556840_as-0020289.jpg,1,0,0,0,1,,train
0556843_as-7049445.jpg,1,0,0,0,1,,train
0556845_as-0057325.jpg,3,0,0,0,3,,train
0556846_as-0057325.jpg,1,1,0,0,2,,train
0556847_as-0057325.jpg,4,1,0,0,5,,train
0556848_as-0057325.jpg,5,0,1,0,6,,val
0556849_as-2938170.jpg,1,0,0,0,1,,val
0556851_as-0003096.jpg,5,0,0,0,5,,test
0556852_as-0003096.jpg,8,1,1,0,10,,train
0556853_as-0003096.jpg,4,0,0,0,4,,train
0556854_sc-180281.jpg,1,0,0,0,1,,train
0556855_sc-180281.jpg,1,0,0,0,1,,train
0556856_sc-153526.jpg,4,0,0,0,4,,train
0556857_sc-1016300.jpg,3,0,0,0,3,,train
0556859_sc-1016300.jpg,5,1,0,0,6,,train
0556860_sc-150076.jpg,0,0,1,0,1,,val
0556861_sc-150076.jpg,2,0,2,0,4,,val
0556862_sc-150076.jpg,4,0,3,0,7,,test
0556863_sc-124461.jpg,3,2,2,2,9,,train
0556866_sc-124461.jpg,1,1,0,0,2,,train
0556867_sc-124461.jpg,3,3,1,0,7,,train
0556868_sc-124461.jpg,3,2,1,0,6,,train
0556869_as-2809794.jpg,5,0,3,1,9,,train
0556870_as-2653523.jpg,1,0,0,0,1,,train
0556872_sc-168399.jpg,4,0,1,0,5,,train
0556873_sc-168399.jpg,7,0,1,1,9,,val
0556874_as-7163459.jpg,0,0,0,1,1,,val
0556875_sc-1028896.jpg,1,0,0,1,2,,test
0556876_sc-1028896.jpg,1,0,2,1,4,,train
0556878_as-3498732.jpg,1,0,0,0,1,,train
0556879_as-3007860.jpg,3,2,0,0,5,,train
0556881_as-0020361.jpg,1,1,1,1,4,,train
0556882_as-0020361.jpg,6,0,1,1,8,,train
0556883_as-0020361.jpg,0,0,1,1,2,,train
0556884_as-0020361.jpg,1,1,1,1,4,,train
0556886_as-0020361.jpg,0,0,2,0,2,,val
0556888_as-0061505.jpg,1,0,0,0,1,,val
0556889_as-0061505.jpg,1,0,0,0,1,,test
0556890_as-0061505.jpg,1,0,0,0,1,,train
0556891_as-0061505.jpg,2,0,0,0,2,,train
0556892_as-0061505.jpg,1,0,0,0,1,,train
0556893_as-0061505.jpg,1,0,1,0,2,,train
0556895_as-7051685.jpg,1,0,1,1,3,,train
0556896_as-3379855.jpg,5,0,0,0,5,,train
0556897_as-0034607.jpg,2,0,0,0,2,,train
0556898_as-0034607.jpg,5,0,0,0,5,,val
0556900_as-2749787.jpg,1,0,1,0,2,,val
0556902_as-0010552.jpg,1,2,1,0,4,,test
0556905_sc-225049.jpg,2,0,1,0,3,,train
0556906_sc-225049.jpg,4,0,1,0,5,,train
0556908_sc-225049.jpg,2,0,1,0,3,,train
0556909_sc-225049.jpg,1,0,0,0,1,,train
0556910_as-7430797.jpg,2,0,0,0,2,,train
0556912_as-0013336.jpg,1,0,0,0,1,,train
0556913_as-0013336.jpg,5,1,0,0,6,,train
0556914_as-0006501.jpg,1,0,0,1,2,,val
0556915_as-0006501.jpg,1,0,0,1,2,,val
0556918_as-0043648.jpg,1,0,0,0,1,,test
0556919_as-0043648.jpg,1,0,0,1,2,,train
0556920_as-0043648.jpg,9,3,0,0,12,,train
0556921_as-0043648.jpg,2,3,0,0,5,,train
0556924_as-0016083.jpg,1,1,2,0,4,,train
0556926_as-0016083.jpg,0,0,2,0,2,,train
0556930_as-0016083.jpg,2,1,1,0,4,,train
0556933_as-0016083.jpg,1,0,2,2,5,,train
0556935_as-0016083.jpg,1,1,1,0,3,,val
0556936_as-0016083.jpg,1,1,1,1,4,,val
0556938_as-0016083.jpg,1,1,1,1,4,,test
0556939_as-0016083.jpg,0,0,1,0,1,,train
0556940_as-0016083.jpg,1,0,0,0,1,,train
0556942_sc-196716.jpg,1,0,0,0,1,,train
0556943_as-2844270.jpg,2,0,0,0,2,,train
0556944_as-2924648.jpg,0,0,0,1,1,,train
0556945_sc-123487.jpg,2,1,0,0,3,,train
0556946_sc-123487.jpg,1,1,0,0,2,,train
0556947_sc-123487.jpg,2,1,0,0,3,,val
0556949_as-0061442.jpg,1,0,0,0,1,,val
0556950_as-0061442.jpg,1,0,1,0,2,,test
0556951_as-0061442.jpg,1,0,1,0,2,,train
0556952_as-0049862.jpg,2,0,0,0,2,,train
0556953_as-0049862.jpg,2,0,0,0,2,,train
0556954_as-0049862.jpg,1,0,0,0,1,,train
0556955_sc-162081.jpg,1,0,0,0,1,,train
0556956_sc-162081.jpg,1,0,0,1,2,,train
0556957_sc-194784.jpg,1,0,0,0,1,,train
0556958_as-0063122.jpg,2,0,0,0,2,,val
0556962_sc-116313.jpg,2,0,0,0,2,,val
0556963_sc-116313.jpg,3,2,0,0,5,,test
0556964_sc-116313.jpg,4,1,0,1,6,,train
0556965_sc-116313.jpg,3,2,0,0,5,,train
0556966_as-7552059.jpg,1,1,0,0,2,,train
0556967_sc-110773.jpg,2,0,0,0,2,,train
0556968_sc-110773.jpg,1,0,0,0,1,,train
0556969_sc-110773.jpg,1,0,0,0,1,,train
0556970_sc-110773.jpg,1,0,0,0,1,,train
0556971_sc-110773.jpg,1,0,1,0,2,,val
0556972_sc-110773.jpg,1,0,0,0,1,,val
0556975_sc-213402.jpg,3,0,2,1,6,,test
0556976_sc-185500.jpg,2,1,0,0,3,,train
0556977_sc-185500.jpg,2,1,0,0,3,,train
0556979_sc-1040791.jpg,1,0,0,0,1,,train
0556980_sc-177976.jpg,0,1,0,0,1,,train
0556981_sc-177976.jpg,3,0,0,0,3,,train
0556982_sc-177976.jpg,1,0,0,0,1,,train
0556983_sc-177976.jpg,1,0,0,0,1,,train
0556984_sc-177976.jpg,1,0,0,0,1,,val
0556985_sc-177976.jpg,3,0,0,0,3,,val
0556986_sc-177976.jpg,1,0,0,0,1,,test
0556987_sc-177976.jpg,1,0,0,0,1,,train
0556988_sc-177976.jpg,1,0,0,0,1,,train
0556989_sc-177976.jpg,1,0,0,0,1,,train
0556990_sc-177976.jpg,1,0,0,0,1,,train
0556993_as-3376520.jpg,1,0,0,0,1,,train
0556994_sc-139996.jpg,2,1,0,0,3,,train
0556996_sc-139996.jpg,1,0,0,0,1,,train
0556997_sc-139996.jpg,1,0,1,1,3,,val
0556998_sc-139996.jpg,3,0,1,1,5,,val
0556999_sc-139996.jpg,1,0,0,0,1,,test
0557002_sc-139996.jpg,4,0,0,0,4,,train
0557003_sc-139996.jpg,1,1,1,0,3,,train
0557004_as-0039550.jpg,4,1,2,0,7,,train
0557005_as-0039550.jpg,7,1,2,0,10,,train
0557007_as-0072791.jpg,1,0,3,0,4,,train
0557008_as-0072791.jpg,1,0,2,0,3,,train
0557010_sc-197328.jpg,1,0,0,0,1,,train
0557011_sc-197328.jpg,1,0,0,0,1,,val
0557012_sc-197328.jpg,1,0,0,0,1,,val
0557013_sc-197328.jpg,1,0,0,0,1,,test
0557014_sc-227490.jpg,3,0,0,2,5,,train
0557015_sc-227490.jpg,1,0,0,2,3,,train
0557016_sc-124313.jpg,1,0,0,1,2,,train
0557017_as-0032162.jpg,1,0,0,0,1,,train
0557018_as-0032162.jpg,1,1,0,0,2,,train
0557019_as-0032162.jpg,1,0,0,0,1,,train
0557020_as-0032162.jpg,2,0,0,0,2,,train
0557021_as-0032162.jpg,1,1,0,0,2,,val
0557022_as-0032162.jpg,0,1,0,0,1,,val
0557026_as-0047548.jpg,1,0,0,0,1,,test
0557027_as-0047548.jpg,1,0,0,0,1,,train
0557028_as-0047548.jpg,1,0,0,0,1,,train
0557029_as-0047548.jpg,1,0,0,0,1,,train
0557030_as-0047548.jpg,1,0,0,0,1,,train
0557031_as-0047548.jpg,1,0,0,0,1,,train
0557033_as-0017221.jpg,2,0,1,1,4,,train
0557034_as-0017221.jpg,1,0,1,0,2,,train
0557035_as-0017221.jpg,1,1,1,2,5,,val
0557036_as-0017221.jpg,1,0,1,2,4,,val
0557038_as-0017221.jpg,1,2,0,0,3,,test
0557039_as-0017221.jpg,1,1,0,1,3,,train
0557040_as-0017221.jpg,2,0,1,0,3,,train
0557041_as-0017221.jpg,1,1,1,1,4,,train
0557042_as-0034175.jpg,2,0,1,2,5,,train
0557044_as-7651764.jpg,3,0,1,0,4,,train
0557046_as-0031108.jpg,2,0,0,0,2,,train
0557047_as-0031108.jpg,10,0,0,0,10,,train
0557048_as-0031108.jpg,2,0,0,0,2,,val
0557049_as-0031108.jpg,0,0,1,0,1,,val
0557050_as-0031108.jpg,2,1,2,0,5,,test
0557051_as-0031108.jpg,4,1,1,0,6,,train
0557052_as-3370196.jpg,1,0,0,0,1,,train
0557053_as-0074974.jpg,8,1,3,2,14,,train
0557054_as-0074974.jpg,5,2,1,2,10,,train
0557056_as-3066693.jpg,1,0,0,1,2,,train
0557057_sc-1038627.jpg,3,0,0,3,6,,train
0557058_as-2866300.jpg,4,0,1,0,5,,train
0557059_sc-224435.jpg,3,0,1,0,4,,val
0557060_sc-224435.jpg,2,0,1,0,3,,val
0557061_sc-224435.jpg,4,0,1,0,5,,test
0557062_sc-224435.jpg,5,0,1,0,6,,train
0557063_sc-224435.jpg,2,0,1,0,3,,train
0557064_sc-224435.jpg,2,0,0,0,2,,train
0557065_sc-224435.jpg,2,0,0,0,2,,train
0557066_sc-224435.jpg,4,0,1,0,5,,train
0557067_sc-224435.jpg,2,0,1,0,3,,train
0557068_sc-224435.jpg,3,0,0,0,3,,train
0557069_sc-224435.jpg,1,0,0,0,1,,val
0557071_as-0067242.jpg,2,0,1,1,4,,val
0557073_as-0067242.jpg,2,0,1,1,4,,test
0557076_as-0018681.jpg,1,0,1,1,3,,train
0557077_as-0018681.jpg,1,0,1,1,3,,train
0557078_as-0018681.jpg,1,0,1,1,3,,train
0557079_as-0018681.jpg,1,0,1,0,2,,train
0557081_sc-184338.jpg,4,1,0,0,5,,train
0557082_sc-184338.jpg,5,1,0,0,6,,train
0557083_sc-184338.jpg,1,0,0,0,1,,train
0557084_sc-146066.jpg,9,0,0,0,9,,val
0557086_sc-147945.jpg,2,0,1,1,4,,val
0557087_sc-1023649.jpg,1,0,0,0,1,,test
0557088_sc-1023649.jpg,3,0,0,0,3,,train
0557089_sc-1023649.jpg,3,0,0,0,3,,train
0557090_sc-1023649.jpg,2,0,0,0,2,,train
0557091_sc-1023649.jpg,2,0,0,0,2,,train
0557093_sc-196757.jpg,2,1,0,0,3,,train
0557094_sc-196757.jpg,1,1,0,0,2,,train
0557095_sc-196757.jpg,1,0,1,1,3,,train
0557096_as-0053803.jpg,1,0,0,0,1,,val
0557097_as-0053803.jpg,1,0,0,0,1,,val
0557098_as-0053803.jpg,1,0,0,0,1,,test
0557100_as-0061332.jpg,2,0,1,0,3,,train
0557101_as-0061332.jpg,2,2,1,0,5,,train
0557102_as-0061332.jpg,1,0,0,0,1,,train
0557103_sc-1034175.jpg,4,1,0,0,5,,train
0557104_sc-1034175.jpg,1,2,1,0,4,,train
0557105_sc-1034175.jpg,1,1,1,0,3,,train
0557106_as-0017631.jpg,1,0,0,1,2,,train
0557108_sc-220516.jpg,2,1,0,0,3,,val
0557109_sc-220516.jpg,2,1,1,0,4,,val
0557110_as-0034559.jpg,1,2,1,0,4,,test
0557111_as-0034559.jpg,1,2,1,0,4,,train
0557112_as-0034559.jpg,1,2,0,0,3,,train
0557114_as-0078898.jpg,2,1,2,0,5,,train
0557118_sc-1033886.jpg,4,0,1,1,6,,train
0557119_sc-1033886.jpg,3,0,1,2,6,,train
0557120_sc-1033886.jpg,2,0,1,2,5,,train
0557121_sc-1033886.jpg,3,0,1,2,6,,train
0557122_as-9053338.jpg,3,0,0,0,3,,val
0557123_as-7883034.jpg,2,0,0,0,2,,val
0557124_sc-213605.jpg,3,0,0,0,3,,test
0557125_sc-213605.jpg,3,0,0,0,3,,train
0557126_as-0096076.jpg,1,0,0,0,1,,train
0557127_as-0096076.jpg,4,4,0,0,8,,train
0557128_as-0096076.jpg,1,6,0,0,7,,train
0557129_as-0096076.jpg,0,0,1,0,1,,train
0557130_as-0096076.jpg,0,0,1,0,1,,train
0557131_as-0096076.jpg,1,3,0,0,4,,train
0557132_as-0017755.jpg,2,0,0,1,3,,val
0557133_as-0017755.jpg,1,0,1,0,2,,val
0557134_as-0017755.jpg,1,0,1,0,2,,test
0557135_as-3292103.jpg,3,0,0,0,3,,train
0557136_as-3292103.jpg,6,0,0,0,6,,train
0557138_as-0068861.jpg,1,0,0,0,1,,train
0557139_as-0068861.jpg,1,0,0,0,1,,train
0557140_as-0068861.jpg,1,0,0,0,1,,train
0557141_as-0068861.jpg,1,0,3,0,4,,train
0557142_as-0068861.jpg,2,1,2,0,5,,train
0557143_as-0068861.jpg,2,0,2,0,4,,val
0557144_as-0068861.jpg,1,0,2,0,3,,val
0557145_as-0068861.jpg,1,1,1,0,3,,test
0557146_as-0068861.jpg,1,0,0,0,1,,train
0557147_as-0068861.jpg,1,0,0,0,1,,train
0557148_as-0068861.jpg,1,0,0,0,1,,train
0557149_as-0068861.jpg,1,0,0,0,1,,train
0557150_as-0016320.jpg,1,0,0,0,1,,train
0557151_as-7767101.jpg,2,0,0,0,2,,train
0557154_as-0086667.jpg,2,1,1,1,5,,train
0557155_as-0086667.jpg,2,2,1,1,6,,val
0557156_sc-161320.jpg,1,0,2,0,3,,val
0557157_sc-161320.jpg,3,0,2,0,5,,test
0557158_sc-161320.jpg,1,0,1,0,2,,train
0557159_sc-161320.jpg,0,0,0,1,1,,train
0557160_sc-161320.jpg,0,0,0,1,1,,train
0557161_sc-161320.jpg,0,0,1,0,1,,train
0557162_sc-161320.jpg,1,0,1,1,3,,train
0557163_sc-161320.jpg,0,0,1,0,1,,train
0557165_sc-131043.jpg,2,0,0,0,2,,train
0557166_sc-131043.jpg,1,0,0,0,1,,val
0557167_sc-131043.jpg,2,0,1,0,3,,val
0557169_as-3238623.jpg,1,0,0,0,1,,test
0557170_sc-217871.jpg,0,1,0,0,1,,train
0557171_as-2746608.jpg,1,0,1,0,2,,train
0557172_as-0077139.jpg,1,0,0,0,1,,train
0557173_as-0077139.jpg,3,0,0,0,3,,train
0557174_as-3224947.jpg,2,0,1,1,4,,train
0557175_sc-154830.jpg,6,0,1,0,7,,train
0557176_as-3394354.jpg,1,0,0,0,1,,train
0557177_as-3460851.jpg,2,0,0,0,2,,val
0557178_sc-227047.jpg,2,0,0,0,2,,val
0557179_sc-227047.jpg,2,0,0,0,2,,test
0557180_sc-227047.jpg,1,0,0,0,1,,train
0557181_sc-215808.jpg,1,0,0,0,1,,train
0557182_sc-215808.jpg,1,0,0,0,1,,train
0557183_as-2936757.jpg,1,1,0,1,3,,train
0557185_as-0047891.jpg,1,2,2,0,5,,train
0557187_as-0047891.jpg,3,2,1,1,7,,train
0557188_as-0047891.jpg,2,2,1,1,6,,train
0557189_as-0047891.jpg,3,2,1,1,7,,val
0557191_as-0047891.jpg,0,1,2,1,4,,val
0557192_as-0047891.jpg,0,1,2,1,4,,test
0557193_as-0047891.jpg,0,1,1,1,3,,train
0557194_as-0047891.jpg,1,1,1,1,4,,train
0557197_as-0059802.jpg,1,1,1,2,5,,train
0557198_as-0059802.jpg,1,1,1,0,3,,train
0557199_as-0059802.jpg,1,1,2,0,4,,train
0557200_as-7996009.jpg,1,0,0,0,1,,train
0557201_sc-155970.jpg,1,0,0,0,1,,train
0557202_as-3464295.jpg,0,0,2,0,2,,val
0557205_as-0060191.jpg,3,0,0,0,3,,val
0557206_as-0060191.jpg,2,0,0,0,2,,test
0557208_as-0068308.jpg,1,0,0,0,1,,train
0557209_as-0068308.jpg,1,0,0,0,1,,train
0557210_as-0068308.jpg,2,0,0,0,2,,train
0557211_sc-201866.jpg,0,0,1,0,1,,train
0557212_sc-201866.jpg,0,0,1,0,1,,train
0557213_sc-201866.jpg,4,0,0,0,4,,train
0557214_sc-201866.jpg,1,0,1,0,2,,train
0557215_sc-104338.jpg,2,0,0,1,3,,val
0557216_sc-104338.jpg,1,0,0,0,1,,val
0557218_sc-104338.jpg,0,1,0,0,1,,test
0557219_sc-104338.jpg,1,0,0,0,1,,train
0557220_sc-147503.jpg,0,0,1,0,1,,train
0557221_as-0099827.jpg,4,1,2,2,9,,train
0557222_as-0099827.jpg,3,1,2,0,6,,train
0557223_as-0099827.jpg,5,0,1,0,6,,train
0557224_as-0099827.jpg,3,0,1,0,4,,train
0557225_as-0099827.jpg,4,0,1,0,5,,train
0557226_as-0099827.jpg,1,1,1,0,3,,val
0557227_as-0099827.jpg,2,0,0,0,2,,val
0557228_as-7377489.jpg,0,0,1,0,1,,test
0557230_as-2959225.jpg,3,1,1,0,5,,train
0557232_sc-214899.jpg,1,0,0,1,2,,train
0557234_as-0015506.jpg,1,0,0,0,1,,train
0557235_as-0015506.jpg,2,0,0,1,3,,train
0557237_as-0015506.jpg,4,0,0,0,4,,train
0557238_as-0015506.jpg,2,0,0,0,2,,train
0557240_as-0015506.jpg,4,0,0,0,4,,train
0557241_as-0015506.jpg,1,0,0,0,1,,val
0557245_sc-218782.jpg,4,0,0,2,6,,val
0557246_as-3048524.jpg,7,0,0,0,7,,test
0557247_sc-227863.jpg,1,0,0,0,1,,train
0557248_sc-227863.jpg,2,0,0,0,2,,train
0557249_sc-227863.jpg,2,0,0,0,2,,train
0557250_sc-227863.jpg,3,0,0,0,3,,train
0557251_sc-227863.jpg,3,0,0,0,3,,train
0557252_as-3329690.jpg,1,0,0,2,3,,train
0557254_as-0080309.jpg,3,1,1,1,6,,train
0557256_as-0080309.jpg,3,1,1,1,6,,val
0557257_sc-107810.jpg,2,0,0,1,3,,val
0557258_sc-107810.jpg,1,0,0,1,2,,test
0557260_sc-129878.jpg,3,0,1,2,6,,train
0557261_sc-129878.jpg,2,0,0,2,4,,train
0557262_sc-129878.jpg,2,0,0,2,4,,train
0557263_sc-129878.jpg,2,0,1,1,4,,train
0557265_sc-129878.jpg,1,0,0,1,2,,train
0557266_sc-129878.jpg,3,0,0,2,5,,train
0557267_sc-129878.jpg,2,0,1,1,4,,train
0557271_sc-171097.jpg,1,0,0,1,2,,val
0557272_sc-171097.jpg,1,0,0,1,2,,val
0557273_sc-171097.jpg,1,0,0,1,2,,test
0557274_sc-171097.jpg,1,0,0,0,1,,train
0557275_sc-171097.jpg,2,0,0,1,3,,train
0557276_sc-171097.jpg,1,0,0,1,2,,train
0557277_sc-171097.jpg,1,0,0,1,2,,train
0557278_sc-120913.jpg,1,1,0,0,2,,train
0557279_as-3232221.jpg,2,0,1,1,4,,train
0557280_sc-1020181.jpg,2,0,0,0,2,,train
0557281_sc-1020181.jpg,3,0,0,0,3,,val
0557282_as-7211344.jpg,1,0,0,0,1,,val
0557283_sc-144358.jpg,1,0,1,0,2,,test
0557284_sc-144358.jpg,4,0,0,0,4,,train
0557285_sc-144358.jpg,1,0,1,0,2,,train
0557286_sc-144358.jpg,6,0,1,0,7,,train
0557287_sc-144358.jpg,0,1,0,0,1,,train
0557289_sc-144358.jpg,1,0,0,0,1,,train
0557290_sc-144358.jpg,2,0,0,0,2,,train
0557292_sc-144358.jpg,1,0,0,0,1,,train
0557293_as-2586348.jpg,1,0,0,1,2,,val
0557294_sc-1013476.jpg,5,1,1,1,8,,val
0557295_sc-1013476.jpg,2,2,1,1,6,,test
0557296_sc-1013476.jpg,7,4,2,0,13,,train
0557297_sc-1013476.jpg,1,1,2,0,4,,train
0557300_as-0051129.jpg,1,0,1,2,4,,train
0557303_sc-227648.jpg,2,1,0,0,3,,train
0557304_sc-105377.jpg,4,0,0,0,4,,train
0557305_sc-105377.jpg,3,0,0,0,3,,train
0557307_sc-123551.jpg,2,0,1,0,3,,train
0557308_sc-123551.jpg,1,0,0,0,1,,val
0557309_sc-123551.jpg,2,0,0,0,2,,val
0557310_as-0091757.jpg,3,0,0,0,3,,test
0557312_as-0091757.jpg,4,0,0,1,5,,train
0557313_as-0091757.jpg,5,0,0,0,5,,train
0557314_as-0091757.jpg,3,0,0,0,3,,train
0557315_sc-1024178.jpg,1,0,0,1,2,,train
0557316_sc-111603.jpg,1,0,1,0,2,,train
0557318_sc-111603.jpg,7,0,0,0,7,,train
0557319_sc-111603.jpg,3,0,0,0,3,,train
0557320_sc-168226.jpg,1,0,0,1,2,,val
0557321_sc-1036259.jpg,1,1,0,1,3,,val
0557322_sc-207525.jpg,0,0,3,0,3,,test
0557323_sc-207525.jpg,0,0,1,0,1,,train
0557324_as-7076929.jpg,1,1,1,0,3,,train
0557327_as-0027418.jpg,1,0,1,0,2,,train
0557329_sc-114641.jpg,3,0,0,0,3,,train
0557330_sc-114641.jpg,2,0,0,0,2,,train
0557331_as-3435737.jpg,0,0,2,0,2,,train
0557332_as-0089026.jpg,1,0,0,0,1,,train
0557333_sc-110271.jpg,3,0,0,0,3,,val
0557334_sc-110271.jpg,2,0,0,0,2,,val
0557335_as-0028956.jpg,1,0,1,0,2,,test
0557336_as-0028956.jpg,2,0,0,0,2,,train
0557337_as-0028956.jpg,0,1,0,0,1,,train
0557338_as-0028956.jpg,2,0,0,0,2,,train
0557339_as-0028956.jpg,3,0,0,0,3,,train
0557340_as-0028956.jpg,1,0,1,3,5,,train
0557341_as-0028956.jpg,4,0,1,8,13,,train
0557343_as-0028956.jpg,2,0,0,0,2,,train
0557345_as-0046205.jpg,4,0,0,0,4,,val
0557346_as-0046205.jpg,1,0,0,0,1,,val
0557347_as-0046205.jpg,1,0,0,0,1,,test
0557348_as-0046205.jpg,2,0,0,0,2,,train
0557349_as-0046205.jpg,4,0,0,0,4,,train
0557350_as-0046205.jpg,4,0,0,0,4,,train
0557351_as-3404636.jpg,1,0,0,0,1,,train
0557353_sc-133999.jpg,0,1,0,0,1,,train
0557355_as-9088941.jpg,1,0,0,0,1,,train
0557356_sc-139001.jpg,2,1,0,0,3,,train
0557357_sc-139001.jpg,1,2,0,0,3,,val
0557358_sc-139001.jpg,3,2,0,0,5,,val
0557359_sc-139001.jpg,1,1,0,0,2,,test
0557364_as-0075395.jpg,0,1,0,0,1,,train
0557365_sc-229352.jpg,1,0,0,0,1,,train
0557366_sc-229352.jpg,3,0,0,0,3,,train
0557367_sc-229352.jpg,1,0,0,0,1,,train
0557368_sc-229352.jpg,2,0,0,0,2,,train
0557369_sc-229352.jpg,3,0,0,0,3,,train
0557370_sc-229352.jpg,7,0,0,0,7,,train
0557371_sc-229352.jpg,2,0,0,0,2,,val
0557372_sc-229352.jpg,3,0,0,0,3,,val
0557373_sc-229352.jpg,2,0,0,0,2,,test
0557374_sc-229352.jpg,1,0,0,0,1,,train
0557375_sc-229352.jpg,1,0,0,0,1,,train
0557378_as-0077548.jpg,0,0,1,1,2,,train
0557379_as-0077548.jpg,1,0,1,1,3,,train
0557380_as-0077548.jpg,5,0,1,1,7,,train
0557381_as-0077548.jpg,4,0,0,1,5,,train
0557382_as-0077548.jpg,3,0,0,1,4,,train
0557383_as-0077548.jpg,2,0,1,0,3,,val
0557384_sc-129858.jpg,1,0,0,0,1,,val
0557385_sc-129858.jpg,2,0,0,0,2,,test
0557386_sc-129858.jpg,1,0,0,0,1,,train
0557387_sc-124817.jpg,5,0,0,0,5,,train
0557389_sc-191816.jpg,5,0,0,0,5,,train
0557390_sc-191816.jpg,1,0,1,0,2,,train
0557391_sc-191816.jpg,3,0,0,0,3,,train
0557392_sc-191816.jpg,5,0,0,0,5,,train
0557393_sc-229201.jpg,1,0,0,0,1,,train
0557394_sc-229201.jpg,1,1,1,0,3,,val
0557395_sc-229201.jpg,1,1,0,0,2,,val
0557396_as-2557021.jpg,0,1,0,0,1,,test
0557398_as-3403683.jpg,6,0,0,0,6,,train
0557399_as-2919973.jpg,1,0,1,1,3,,train
0557400_sc-1039473.jpg,6,0,0,0,6,,train
0557401_as-3299396.jpg,2,0,0,0,2,,train
0557402_as-0063064.jpg,1,0,0,0,1,,train
0557403_as-0063064.jpg,1,0,1,1,3,,train
0557404_as-0063064.jpg,2,0,0,0,2,,train
0557405_as-0063064.jpg,1,0,0,0,1,,val
0557406_as-0063064.jpg,1,0,1,1,3,,val
0557407_as-0037749.jpg,1,4,0,0,5,,test
0557408_as-0037749.jpg,1,2,0,0,3,,train
0557409_as-0037749.jpg,0,2,0,0,2,,train
0557410_as-0037749.jpg,1,2,0,0,3,,train
0557411_sc-194797.jpg,1,0,0,0,1,,train
0557412_sc-194797.jpg,1,0,0,0,1,,train
0557414_sc-194797.jpg,1,0,0,0,1,,train
0557415_sc-194797.jpg,1,0,0,0,1,,train
0557416_as-7341620.jpg,1,0,0,1,2,,val
0557417_as-0023644.jpg,4,0,0,0,4,,val
0557418_as-0023644.jpg,3,0,0,0,3,,test
0557419_as-0023644.jpg,1,0,0,0,1,,train
0557420_as-0023644.jpg,1,0,0,0,1,,train
0557421_sc-1026459.jpg,2,0,0,0,2,,train
0557424_as-0038994.jpg,1,2,1,0,4,,train
0557425_as-0038994.jpg,4,2,1,0,7,,train
0557426_as-0038994.jpg,5,2,1,0,8,,train
0557428_as-0013729.jpg,1,0,0,0,1,,train
0557430_as-0013729.jpg,1,0,1,0,2,,val
0557431_sc-204476.jpg,2,0,1,0,3,,val
0557433_as-0063954.jpg,3,0,0,0,3,,test
0557435_sc-150001.jpg,4,0,0,3,7,,train
0557436_sc-150001.jpg,3,0,0,2,5,,train
0557437_as-0052893.jpg,2,0,0,0,2,,train
0557442_as-2641998.jpg,1,2,1,0,4,,train
0557444_sc-171826.jpg,3,1,0,0,4,,train
0557446_sc-128800.jpg,2,1,0,0,3,,train
0557449_sc-1004791.jpg,1,0,0,0,1,,train
0557450_sc-1004791.jpg,3,0,0,0,3,,val
0557451_sc-1004791.jpg,2,0,0,2,4,,val
0557452_sc-1004791.jpg,3,0,0,0,3,,test
0557453_sc-1004791.jpg,3,0,0,1,4,,train
0557454_as-0013325.jpg,1,0,0,0,1,,train
0557455_as-0013325.jpg,1,0,0,0,1,,train
0557456_sc-144421.jpg,2,1,0,0,3,,train
0557457_sc-144421.jpg,1,1,0,0,2,,train
0557458_as-3400357.jpg,1,1,0,0,2,,train
0557459_sc-103218.jpg,1,0,1,0,2,,train
0557461_sc-103218.jpg,2,1,1,1,5,,val
0557462_sc-103218.jpg,3,1,1,1,6,,val
0557463_sc-103218.jpg,3,1,1,1,6,,test
0557465_sc-103218.jpg,3,1,1,1,6,,train
0557466_sc-103218.jpg,2,1,1,1,5,,train
0557468_as-0061283.jpg,3,0,0,0,3,,train
0557469_as-0061283.jpg,3,0,0,0,3,,train
0557470_sc-128902.jpg,1,0,0,0,1,,train
0557472_sc-128902.jpg,2,0,2,0,4,,train
0557473_sc-128902.jpg,1,0,0,0,1,,train
0557474_sc-128902.jpg,1,0,0,0,1,,val
0557476_as-9011887.jpg,0,0,1,0,1,,val
0557477_as-0002508.jpg,1,0,0,0,1,,test
0557478_as-0002508.jpg,2,0,0,0,2,,train
0557479_as-0002508.jpg,2,0,0,1,3,,train
0557480_as-0002508.jpg,2,0,0,0,2,,train
0557481_as-0002508.jpg,1,0,1,0,2,,train
0557484_as-0056565.jpg,1,0,0,1,2,,train
0557486_as-0051489.jpg,1,0,1,1,3,,train
0557487_as-3426421.jpg,1,0,0,0,1,,train
0557489_as-0021567.jpg,0,1,0,0,1,,val
0557490_as-0021567.jpg,0,1,0,0,1,,val
0557491_as-0021567.jpg,2,1,0,0,3,,test
0557492_as-0021567.jpg,0,1,0,0,1,,train
0557493_sc-156924.jpg,2,2,0,0,4,,train
0557494_sc-156924.jpg,2,2,0,0,4,,train
0557495_sc-156924.jpg,4,0,0,0,4,,train
0557499_sc-137675.jpg,1,0,0,2,3,,train
0557501_sc-140757.jpg,0,1,0,0,1,,train
0557503_sc-140757.jpg,3,1,1,1,6,,train
0557504_sc-140757.jpg,1,1,1,1,4,,val
0557505_sc-140757.jpg,2,0,1,1,4,,val
0557506_sc-193951.jpg,6,1,1,0,8,,test
0557507_sc-193951.jpg,6,1,1,0,8,,train
0557508_sc-193951.jpg,2,1,1,0,4,,train
0557509_sc-1026288.jpg,0,0,1,1,2,,train
0557510_sc-1026288.jpg,2,2,1,2,7,,train
0557513_as-0080477.jpg,5,0,0,0,5,,train
0557515_as-0080477.jpg,7,0,0,1,8,,train
0557516_as-0080477.jpg,2,0,0,0,2,,train
0557517_as-0080477.jpg,1,0,0,0,1,,val
0557518_sc-1016856.jpg,1,1,0,0,2,,val
0557520_sc-1016856.jpg,1,0,0,0,1,,test
0557521_sc-1016856.jpg,1,0,0,0,1,,train
0557522_sc-1016856.jpg,1,2,0,0,3,,train
0557523_sc-1031648.jpg,1,0,0,0,1,,train
0557524_sc-1031648.jpg,2,0,0,0,2,,train
0557525_sc-1031648.jpg,6,1,1,1,9,,train
0557527_sc-1031648.jpg,1,0,0,0,1,,train
0557528_sc-1031648.jpg,3,0,1,2,6,,train
0557529_as-2653896.jpg,1,0,0,1,2,,val
0557531_as-9073554.jpg,1,0,0,0,1,,val
0557532_as-9073554.jpg,1,0,0,0,1,,test
0557533_as-2675190.jpg,1,0,0,0,1,,train
0557534_sc-1014207.jpg,2,0,0,0,2,,train
0557535_sc-1014207.jpg,1,0,0,0,1,,train
0557536_sc-1014207.jpg,1,0,0,0,1,,train
0557537_sc-1014207.jpg,1,0,1,0,2,,train
0557538_sc-1014207.jpg,2,0,0,0,2,,train
0557539_sc-1006975.jpg,2,0,0,0,2,,train
0557540_sc-1006975.jpg,4,0,1,0,5,,val
0557541_sc-1006975.jpg,1,0,1,0,2,,val
0557543_as-0045167.jpg,3,1,0,0,4,,test
0557544_as-0045167.jpg,1,1,0,0,2,,train
0557545_as-0045167.jpg,1,1,0,0,2,,train
0557546_as-0045167.jpg,1,0,0,0,1,,train
0557547_as-2597895.jpg,1,1,0,0,2,,train
0557548_sc-106821.jpg,8,0,1,3,12,,train
0557549_sc-106821.jpg,4,2,0,4,10,,train
0557550_sc-106821.jpg,3,1,0,6,10,,train
0557551_sc-106821.jpg,1,2,1,1,5,,val
0557552_sc-106821.jpg,3,1,1,3,8,,val
0557553_sc-106821.jpg,1,1,1,3,6,,test
0557555_as-0016945.jpg,2,0,1,1,4,,train
0557556_as-0016945.jpg,1,0,0,0,1,,train
0557557_as-0016945.jpg,1,0,1,1,3,,train
0557558_as-0016945.jpg,1,0,0,1,2,,train
0557560_as-0022322.jpg,1,1,0,0,2,,train
0557561_as-0022322.jpg,3,0,0,1,4,,train
0557562_as-0022322.jpg,2,0,1,1,4,,train
0557563_as-2977066.jpg,1,0,0,0,1,,val
0557565_as-2736318.jpg,4,0,0,1,5,,val
0557566_as-0032427.jpg,2,0,0,0,2,,test
0557567_as-0032427.jpg,2,0,0,0,2,,train
0557568_as-0032427.jpg,3,0,0,0,3,,train
0557569_as-0077152.jpg,1,0,0,0,1,,train
0557570_as-0077152.jpg,1,0,0,0,1,,train
0557571_as-0077152.jpg,1,0,0,0,1,,train
0557573_sc-172811.jpg,1,1,0,0,2,,train
0557575_as-0044410.jpg,1,0,0,0,1,,train
0557576_as-0044410.jpg,2,0,1,0,3,,val
0557577_as-0044410.jpg,2,0,1,0,3,,val
0557578_sc-212711.jpg,4,0,0,0,4,,test
0557579_sc-212711.jpg,14,0,1,0,15,,train
0557580_sc-212711.jpg,8,0,0,0,8,,train
0557581_sc-191864.jpg,2,2,1,0,5,,train
0557582_sc-191864.jpg,8,0,0,0,8,,train
0557583_sc-191864.jpg,4,1,1,0,6,,train
0557584_sc-191864.jpg,4,0,0,0,4,,train
0557585_as-7743518.jpg,2,0,0,0,2,,train
0557586_as-0018700.jpg,1,0,0,1,2,,val
0557587_as-0018700.jpg,2,0,0,1,3,,val
0557588_as-0018700.jpg,2,0,0,1,3,,test
0557589_as-0018700.jpg,1,0,0,1,2,,train
0557590_as-0018700.jpg,1,0,0,0,1,,train
0557591_as-0018700.jpg,1,0,0,0,1,,train
0557592_as-3013111.jpg,2,0,0,0,2,,train
0557594_sc-165678.jpg,2,1,1,1,5,,train
0557595_sc-200429.jpg,4,2,6,2,14,,train
0557596_as-0013248.jpg,1,0,0,0,1,,train
0557597_as-0013248.jpg,1,1,0,0,2,,val
0557598_as-0013248.jpg,2,0,1,0,3,,val
0557599_sc-1016686.jpg,7,0,0,0,7,,test
0557601_sc-1016686.jpg,8,0,1,0,9,,train
0557602_as-7694123.jpg,3,1,1,0,5,,train
0557604_as-3285721.jpg,1,0,0,0,1,,train
0557605_as-3132892.jpg,1,0,0,0,1,,train
0557606_sc-1017094.jpg,1,1,0,0,2,,train
0557607_sc-1034728.jpg,2,0,0,0,2,,train
0557608_sc-222501.jpg,1,3,0,0,4,,train
0557609_sc-222501.jpg,2,3,0,0,5,,val
0557610_as-3250421.jpg,1,0,0,0,1,,val
0557611_sc-159754.jpg,1,0,0,0,1,,test
0557612_sc-1023173.jpg,4,1,1,0,6,,train
0557613_as-3435456.jpg,2,2,1,0,5,,train
0557614_sc-116494.jpg,1,0,1,0,2,,train
0557615_sc-135272.jpg,1,0,1,1,3,,train
0557616_sc-135272.jpg,1,0,0,1,2,,train
0557618_as-0025324.jpg,1,0,0,0,1,,train
0557619_sc-193281.jpg,1,1,1,0,3,,train
0557621_sc-193281.jpg,1,1,1,0,3,,val
0557622_sc-193131.jpg,1,0,1,2,4,,val
0557623_sc-193131.jpg,1,0,0,1,2,,test
0557624_sc-193131.jpg,2,0,1,1,4,,train
0557625_sc-193131.jpg,1,0,0,1,2,,train
0557626_sc-193131.jpg,1,0,1,1,3,,train
0557627_sc-196521.jpg,2,1,0,0,3,,train
0557630_as-0004897.jpg,1,0,0,0,1,,train
0557631_as-0004897.jpg,5,0,1,1,7,,train
0557632_as-0004897.jpg,3,0,1,1,5,,train
0557633_as-0004897.jpg,1,0,0,0,1,,val
0557634_sc-1011741.jpg,0,1,1,0,2,,val
0557635_sc-103730.jpg,1,0,0,0,1,,test
0557636_sc-103730.jpg,1,0,0,0,1,,train
0557637_sc-103730.jpg,1,0,1,0,2,,train
0557638_sc-103730.jpg,3,2,0,0,5,,train
0557639_sc-103730.jpg,2,0,1,1,4,,train
0557641_sc-103730.jpg,3,0,1,0,4,,train
0557642_sc-103730.jpg,3,0,0,0,3,,train
0557643_sc-1018494.jpg,1,0,0,0,1,,train
0557644_sc-1018494.jpg,1,0,0,0,1,,val
0557645_as-2919963.jpg,2,0,1,1,4,,val
0557647_sc-1003208.jpg,1,2,0,0,3,,test
0557649_as-7155611.jpg,1,0,0,0,1,,train
0557650_sc-137917.jpg,1,0,0,0,1,,train
0557651_sc-178850.jpg,6,0,0,1,7,,train
0557652_sc-178850.jpg,5,0,0,1,6,,train
0557653_sc-178850.jpg,6,0,2,1,9,,train
0557654_sc-178850.jpg,9,0,2,1,12,,train
0557655_sc-178850.jpg,4,0,0,2,6,,train
0557656_sc-178850.jpg,4,0,0,1,5,,val
0557657_sc-178850.jpg,3,0,0,0,3,,val
0557658_sc-178850.jpg,9,0,0,2,11,,test
0557659_sc-178850.jpg,9,0,0,2,11,,train
0557662_sc-1008605.jpg,2,1,1,0,4,,train
0557663_sc-1008605.jpg,3,1,1,0,5,,train
0557666_as-2876671.jpg,2,0,2,0,4,,train
0557667_as-2893753.jpg,1,0,0,0,1,,train
0557668_sc-126903.jpg,2,0,0,0,2,,train
0557669_sc-126903.jpg,5,0,0,0,5,,train
0557670_sc-126903.jpg,4,0,0,0,4,,val
0557671_sc-126903.jpg,1,0,0,0,1,,val
0557672_as-3317401.jpg,0,1,1,1,3,,test
0557673_as-3441762.jpg,13,0,0,3,16,,train
0557674_as-9034038.jpg,1,0,0,1,2,,train
0557675_sc-226401.jpg,1,0,0,0,1,,train
0557676_sc-226401.jpg,1,0,0,0,1,,train
0557677_sc-226401.jpg,1,0,0,0,1,,train
0557679_sc-177738.jpg,1,0,0,1,2,,train
0557681_sc-1030568.jpg,2,0,0,0,2,,train
0557682_sc-189218.jpg,3,1,0,1,5,,val
0557684_as-0052424.jpg,0,0,2,0,2,,val
0557685_as-0052424.jpg,0,0,2,1,3,,test
0557687_as-0050099.jpg,5,0,0,0,5,,train
0557688_as-0050099.jpg,5,0,0,0,5,,train
0557689_as-0050099.jpg,3,0,0,0,3,,train
0557690_as-0050099.jpg,4,0,0,0,4,,train
0557691_as-0037007.jpg,1,0,0,0,1,,train
0557692_as-3192629.jpg,1,0,0,0,1,,train
0557694_as-0055802.jpg,1,1,0,0,2,,train
0557696_sc-1005525.jpg,1,0,0,0,1,,val
0557697_sc-1005525.jpg,1,0,0,0,1,,val
0557698_sc-1005525.jpg,5,0,0,0,5,,test
0557699_sc-1005525.jpg,3,0,0,0,3,,train
0557700_sc-1005525.jpg,5,0,0,0,5,,train
0557701_sc-1005525.jpg,2,4,0,0,6,,train
0557704_as-0076094.jpg,2,0,0,0,2,,train
0557705_as-0076094.jpg,1,0,0,0,1,,train
0557706_as-0036009.jpg,2,0,0,0,2,,train
0557707_as-0036009.jpg,1,0,0,0,1,,train
0557709_as-0075435.jpg,1,1,1,1,4,,val
0557710_as-0075435.jpg,0,1,2,1,4,,val
0557711_as-0075435.jpg,0,1,0,0,1,,test
0557713_as-0075435.jpg,0,1,1,1,3,,train
0557715_sc-192622.jpg,1,0,0,0,1,,train
0557716_sc-192622.jpg,1,0,0,0,1,,train
0557717_sc-192622.jpg,1,0,0,0,1,,train
0557720_sc-126918.jpg,3,0,0,0,3,,train
0557721_sc-126918.jpg,3,0,0,0,3,,train
0557722_sc-126918.jpg,4,0,0,0,4,,train
0557723_sc-126918.jpg,3,0,0,0,3,,val
0557724_sc-126918.jpg,1,0,0,0,1,,val
0557726_sc-126918.jpg,4,0,0,1,5,,test
0557728_as-0006156.jpg,1,0,1,0,2,,train
0557729_as-0006156.jpg,3,0,0,0,3,,train
0557731_as-0006156.jpg,3,0,0,0,3,,train
0557732_as-0006156.jpg,1,0,0,0,1,,train
0557733_as-3158107.jpg,2,0,2,0,4,,train
0557734_sc-1029005.jpg,3,0,0,0,3,,train
0557735_sc-1029005.jpg,1,0,0,0,1,,train
0557736_as-7389857.jpg,1,0,1,0,2,,val
0557738_as-7092678.jpg,0,0,1,0,1,,val
0557740_as-0082407.jpg,1,0,0,1,2,,test
0557741_as-0082407.jpg,1,0,0,1,2,,train
0557742_as-0082407.jpg,1,0,0,1,2,,train
0557743_as-0082407.jpg,1,0,0,1,2,,train
0557744_as-2694962.jpg,1,1,0,0,2,,train
0557745_sc-218806.jpg,1,0,0,0,1,,train
0557746_sc-145281.jpg,2,0,0,0,2,,train
0557748_sc-145281.jpg,1,0,0,0,1,,train
0557749_as-3397898.jpg,0,1,0,0,1,,val
0557750_sc-215721.jpg,1,0,2,0,3,,val
0557751_sc-215721.jpg,1,0,1,0,2,,test
0557752_sc-215721.jpg,1,0,0,0,1,,train
0557754_as-7776501.jpg,1,0,0,0,1,,train
0557755_sc-1036492.jpg,1,1,0,0,2,,train
0557756_sc-1036492.jpg,1,0,1,0,2,,train
0557758_sc-1036492.jpg,1,0,1,1,3,,train
0557761_as-0082959.jpg,1,1,2,0,4,,train
0557763_as-0082959.jpg,3,2,3,1,9,,train
0557764_as-0082959.jpg,5,2,1,1,9,,val
0557765_as-0082959.jpg,4,0,1,1,6,,val
0557766_as-0082959.jpg,0,0,1,0,1,,test
0557767_as-0082959.jpg,2,0,1,0,3,,train
0557768_as-0082959.jpg,2,0,0,0,2,,train
0557769_as-0082959.jpg,0,0,1,1,2,,train
0557770_as-0082959.jpg,0,0,3,1,4,,train
0557771_as-0082959.jpg,1,0,1,1,3,,train
0557773_as-0082959.jpg,2,1,0,0,3,,train
0557774_as-3175161.jpg,2,0,1,0,3,,train
0557775_as-0008402.jpg,2,0,0,0,2,,val
0557776_sc-1006556.jpg,2,1,0,0,3,,val
0557777_sc-156014.jpg,1,0,0,0,1,,test
0557779_sc-156014.jpg,1,0,0,0,1,,train
0557780_sc-1019487.jpg,1,0,0,0,1,,train
0557781_as-3330127.jpg,1,0,0,0,1,,train
0557782_sc-115218.jpg,2,1,1,0,4,,train
0557783_sc-115218.jpg,2,0,1,0,3,,train
0557784_sc-115218.jpg,2,0,1,0,3,,train
0557786_sc-196063.jpg,1,0,1,0,2,,train
0557787_sc-196063.jpg,2,0,0,0,2,,val
0557788_sc-196063.jpg,3,0,0,0,3,,val
0557789_sc-193765.jpg,2,0,1,1,4,,test
0557790_sc-193765.jpg,3,0,1,2,6,,train
0557791_sc-193765.jpg,1,0,1,1,3,,train
0557793_sc-1027315.jpg,3,0,0,0,3,,train
0557794_sc-1027315.jpg,4,0,1,0,5,,train
0557795_sc-226749.jpg,2,0,0,0,2,,train
0557796_sc-226749.jpg,3,0,1,0,4,,train
0557797_sc-226749.jpg,5,0,1,0,6,,train
0557798_sc-226749.jpg,5,0,1,0,6,,val
0557799_sc-199557.jpg,6,0,0,1,7,,val
0557801_as-0095513.jpg,2,0,0,0,2,,test
0557803_sc-125878.jpg,3,0,1,1,5,,train
0557804_sc-125878.jpg,2,0,0,1,3,,train
0557805_sc-151023.jpg,1,0,0,0,1,,train
0557806_sc-151023.jpg,1,0,0,0,1,,train
0557808_sc-157013.jpg,2,0,0,0,2,,train
0557809_sc-157013.jpg,3,0,0,0,3,,train
0557810_sc-157013.jpg,3,0,0,0,3,,train
0557811_sc-157013.jpg,2,0,0,0,2,,val
0557812_sc-157013.jpg,2,0,0,0,2,,val
0557813_sc-173175.jpg,4,0,0,0,4,,test
0557814_as-3229616.jpg,1,0,1,0,2,,train
0557816_sc-1031395.jpg,1,0,0,0,1,,train
0557817_as-9099577.jpg,1,0,0,0,1,,train
0557818_as-0094919.jpg,3,0,2,0,5,,train
0557819_as-0094919.jpg,3,0,2,1,6,,train
0557820_as-2695396.jpg,1,0,1,0,2,,train
0557821_as-3077833.jpg,3,0,0,0,3,,train
0557828_as-0076303.jpg,1,0,0,0,1,,val
0557829_as-3254645.jpg,1,0,0,0,1,,val
0557841_as-0090101.jpg,1,0,2,2,5,,test
0557842_as-0090101.jpg,0,0,1,0,1,,train
0557843_as-0090101.jpg,1,0,1,0,2,,train
0557844_as-0090101.jpg,2,0,2,1,5,,train
0557845_as-0090101.jpg,0,1,1,1,3,,train
0557846_as-0090101.jpg,4,0,0,1,5,,train
0557847_as-0090101.jpg,2,0,0,1,3,,train
0557848_as-0090101.jpg,0,0,1,0,1,,train
0557849_as-2551080.jpg,2,0,0,0,2,,val
0557850_as-0046021.jpg,1,0,1,1,3,,val
0557851_sc-183990.jpg,1,0,0,0,1,,test
0557852_sc-183990.jpg,0,2,0,0,2,,train
0557853_sc-183990.jpg,1,0,0,0,1,,train
0557854_sc-183990.jpg,2,0,0,0,2,,train
0557856_as-7884894.jpg,1,0,0,0,1,,train
0557857_sc-217751.jpg,0,1,0,0,1,,train
0557858_as-0051537.jpg,0,0,1,1,2,,train
0557859_sc-134489.jpg,4,0,0,1,5,,train
0557861_as-0013702.jpg,1,0,0,1,2,,val
0557862_as-0013702.jpg,1,0,0,1,2,,val
0557863_as-0013702.jpg,1,0,1,1,3,,test
0557864_as-0013702.jpg,1,0,0,2,3,,train
0557865_as-0013702.jpg,1,0,0,1,2,,train
0557866_as-0013702.jpg,1,0,0,1,2,,train
0557867_as-0013702.jpg,1,0,0,0,1,,train
0557868_as-0013702.jpg,1,0,0,0,1,,train
0557870_as-0013702.jpg,1,0,0,0,1,,train
0557872_as-3463408.jpg,1,1,1,0,3,,train
0557873_sc-1011679.jpg,1,0,1,0,2,,val
0557876_as-0059879.jpg,1,1,0,0,2,,val
0557877_as-0059879.jpg,1,0,0,0,1,,test
0557878_as-0059879.jpg,1,0,1,1,3,,train
0557879_as-3076844.jpg,4,0,0,0,4,,train
0557881_sc-103602.jpg,1,0,0,0,1,,train
0557884_sc-112203.jpg,1,1,0,0,2,,train
0557887_as-0077016.jpg,5,0,0,0,5,,train
0557888_as-0077016.jpg,8,0,0,0,8,,train
0557889_as-0077016.jpg,3,0,0,1,4,,train
0557890_as-0077016.jpg,5,0,0,0,5,,val
0557891_as-0061874.jpg,3,0,2,0,5,,val
0557892_as-0061874.jpg,3,0,2,0,5,,test
0557896_as-0061874.jpg,1,0,2,0,3,,train
0557897_as-0061874.jpg,4,0,1,0,5,,train
0557898_as-0061874.jpg,0,0,2,0,2,,train
0557899_as-0061874.jpg,1,0,1,0,2,,train
0557900_as-3312000.jpg,1,0,0,0,1,,train
0557901_sc-195517.jpg,2,1,1,1,5,,train
0557902_sc-195517.jpg,2,1,1,2,6,,train
0557903_sc-195517.jpg,2,1,1,0,4,,val
0557904_sc-195517.jpg,2,0,1,0,3,,val
0557906_sc-195517.jpg,1,0,1,0,2,,test
0557907_as-0001134.jpg,1,0,0,0,1,,train
0557908_as-0001134.jpg,2,0,0,0,2,,train
0557909_sc-1006417.jpg,1,0,0,0,1,,train
0557910_as-3213519.jpg,2,0,1,0,3,,train
0557911_sc-143447.jpg,2,0,0,0,2,,train
0557912_sc-143447.jpg,2,0,0,0,2,,train
0557913_sc-143447.jpg,3,0,0,0,3,,train
0557914_sc-143447.jpg,2,0,0,0,2,,val
0557915_as-3244949.jpg,1,2,0,0,3,,val
0557916_as-2647023.jpg,2,0,1,1,4,,test
0557917_sc-212957.jpg,3,0,0,0,3,,train
0557918_sc-212957.jpg,1,0,0,1,2,,train
0557919_sc-212957.jpg,2,0,1,1,4,,train
0557920_sc-212957.jpg,1,0,0,1,2,,train
0557921_sc-212957.jpg,1,0,0,1,2,,train
0557922_sc-212957.jpg,0,0,0,1,1,,train
0557923_sc-212957.jpg,0,0,0,1,1,,train
0557924_sc-212957.jpg,2,0,0,0,2,,val
0557925_sc-1032786.jpg,1,1,0,0,2,,val
0557926_sc-1032786.jpg,1,1,0,0,2,,test
0557928_as-0013200.jpg,3,0,0,1,4,,train
0557929_as-0013200.jpg,6,1,0,1,8,,train
0557930_as-0013200.jpg,7,0,0,0,7,,train
0557931_as-3285842.jpg,1,1,2,1,5,,train
0557932_as-0023458.jpg,1,0,1,0,2,,train
0557933_as-0023458.jpg,1,0,1,0,2,,train
0557934_as-0023458.jpg,0,0,1,0,1,,train
0557935_as-0023458.jpg,0,0,1,0,1,,val
0557936_as-0023458.jpg,1,0,0,0,1,,val
0557937_as-0023458.jpg,0,0,1,0,1,,test
0557938_as-0023458.jpg,2,2,0,1,5,,train
0557939_as-0023458.jpg,1,1,1,0,3,,train
0557940_as-0023458.jpg,0,0,1,0,1,,train
0557941_as-0023458.jpg,0,0,1,0,1,,train
0557944_sc-206016.jpg,4,0,1,1,6,,train
0557945_sc-154742.jpg,1,0,0,0,1,,train
0557946_sc-154742.jpg,4,0,0,0,4,,train
0557947_as-0068222.jpg,2,2,7,0,11,,val
0557951_as-0068222.jpg,1,0,2,0,3,,val
0557954_as-0068222.jpg,1,0,1,0,2,,test
0557955_as-0068222.jpg,0,0,1,0,1,,train
0557958_as-0051235.jpg,2,0,1,0,3,,train
0557959_as-0051235.jpg,5,0,1,0,6,,train
0557961_as-0051235.jpg,3,0,1,0,4,,train
0557962_as-0091076.jpg,0,0,0,1,1,,train
0557963_as-0091076.jpg,0,0,0,1,1,,train
0557964_as-7656683.jpg,2,0,0,0,2,,train
0557965_sc-137463.jpg,3,0,0,0,3,,val
0557966_sc-137463.jpg,2,1,0,0,3,,val
0557967_sc-137463.jpg,3,1,0,0,4,,test
0557968_sc-137463.jpg,1,0,0,0,1,,train
0557969_as-3435431.jpg,3,1,2,0,6,,train
0557970_sc-166819.jpg,1,0,0,0,1,,train
0557971_sc-166819.jpg,1,0,0,0,1,,train
0557972_sc-166819.jpg,1,0,0,0,1,,train
0557973_sc-166819.jpg,1,0,0,0,1,,train
0557974_sc-166819.jpg,1,0,0,0,1,,train
0557975_as-3108040.jpg,2,1,1,0,4,,val
0557976_as-3155295.jpg,3,0,0,0,3,,val
0557977_as-2513168.jpg,1,1,1,0,3,,test
0557979_sc-162890.jpg,2,0,0,0,2,,train
0557980_sc-179228.jpg,3,2,2,0,7,,train
0557982_sc-179228.jpg,1,1,1,0,3,,train
0557983_as-7767244.jpg,3,0,1,0,4,,train
0557984_sc-1005216.jpg,1,0,1,0,2,,train
0557985_sc-1005216.jpg,0,0,1,0,1,,train
0557986_sc-172762.jpg,2,0,2,0,4,,train
0557987_sc-172762.jpg,4,1,1,1,7,,val
0557988_sc-172762.jpg,0,0,3,0,3,,val
0557989_sc-172762.jpg,3,1,4,2,10,,test
0557990_sc-172762.jpg,2,0,1,2,5,,train
0557991_sc-172762.jpg,4,0,2,1,7,,train
0557992_sc-172762.jpg,1,0,1,0,2,,train
0557993_sc-172762.jpg,0,1,2,1,4,,train
0557994_sc-172762.jpg,0,1,1,0,2,,train
0557995_sc-172762.jpg,6,0,0,0,6,,train
0557996_as-2730847.jpg,1,0,1,1,3,,train
0557997_sc-113527.jpg,2,1,0,0,3,,val
0558000_sc-150420.jpg,3,0,0,0,3,,val
0558001_sc-150420.jpg,2,0,0,0,2,,test
0558002_sc-150420.jpg,3,0,0,0,3,,train
0558003_sc-150420.jpg,2,1,0,0,3,,train
0558004_as-3318160.jpg,1,0,0,0,1,,train
0558006_sc-144291.jpg,2,0,0,0,2,,train
0558007_sc-144291.jpg,1,0,0,0,1,,train
0558008_sc-169643.jpg,1,0,0,0,1,,train
0558009_sc-140269.jpg,3,0,1,1,5,,train
0558010_sc-140269.jpg,2,0,0,1,3,,val
0558011_sc-140269.jpg,1,0,1,0,2,,val
0558012_as-3127035.jpg,1,0,0,0,1,,test
0558013_sc-131406.jpg,5,0,0,1,6,,train
0558014_sc-131406.jpg,1,0,0,0,1,,train
0558015_as-3393171.jpg,1,0,2,0,3,,train
0558016_as-0028941.jpg,1,0,0,0,1,,train
0558017_as-2707897.jpg,1,0,1,1,3,,train
0558021_as-0038112.jpg,1,0,0,0,1,,train
0558023_as-0038112.jpg,1,0,0,0,1,,train
0558024_sc-188742.jpg,3,0,0,0,3,,val
0558025_sc-188742.jpg,2,0,2,0,4,,val
0558026_sc-188742.jpg,1,0,1,0,2,,test
0558027_sc-209122.jpg,1,0,0,0,1,,train
0558028_sc-209122.jpg,2,0,0,0,2,,train
0558029_sc-209122.jpg,1,0,1,0,2,,train
0558030_sc-209122.jpg,1,0,0,0,1,,train
0558033_sc-133058.jpg,0,1,1,1,3,,train
0558034_sc-133058.jpg,0,1,1,0,2,,train
0558035_sc-133058.jpg,1,0,2,2,5,,train
0558036_sc-157838.jpg,2,0,0,1,3,,val
0558037_as-3373671.jpg,1,0,0,0,1,,val
0558038_as-9074452.jpg,5,0,0,0,5,,test
0558040_sc-146111.jpg,1,0,0,0,1,,train
0558042_sc-180662.jpg,1,0,2,1,4,,train
0558043_sc-180662.jpg,1,0,1,1,3,,train
0558045_sc-216726.jpg,2,0,1,0,3,,train
0558046_as-7882866.jpg,3,0,0,0,3,,train
0558049_sc-128409.jpg,0,1,0,0,1,,train
0558050_sc-128409.jpg,1,0,0,0,1,,train
0558052_sc-150839.jpg,0,1,1,0,2,,val
0558053_sc-150839.jpg,0,1,1,0,2,,val
0558054_as-7521262.jpg,1,1,2,1,5,,test
0558055_as-2598270.jpg,2,1,0,0,3,,train
0558057_sc-142781.jpg,1,0,0,0,1,,train
0558058_sc-142781.jpg,1,0,0,1,2,,train
0558059_sc-142781.jpg,1,0,0,1,2,,train
0558062_sc-120524.jpg,5,1,0,0,6,,train
0558063_sc-120524.jpg,2,1,0,0,3,,train
0558064_sc-120524.jpg,6,1,0,0,7,,train
0558065_sc-1032220.jpg,1,0,0,0,1,,val
0558066_sc-1032220.jpg,1,0,0,0,1,,val
0558067_sc-1032220.jpg,2,0,0,0,2,,test
0558070_sc-182210.jpg,2,0,0,0,2,,train
0558071_sc-182210.jpg,1,0,0,0,1,,train
0558072_as-0059030.jpg,1,0,0,0,1,,train
0558073_as-0059030.jpg,0,1,0,0,1,,train
0558074_as-0059030.jpg,2,0,0,0,2,,train
0558075_as-0059030.jpg,0,1,0,0,1,,train
0558076_as-0059030.jpg,1,0,0,0,1,,train
0558077_as-0059030.jpg,1,0,0,0,1,,val
0558078_as-0059030.jpg,1,0,0,0,1,,val
0558079_as-2690606.jpg,1,1,1,0,3,,test
0558080_sc-114456.jpg,1,1,1,3,6,,train
0558081_sc-114456.jpg,1,1,1,1,4,,train
0558083_sc-154398.jpg,1,1,1,1,4,,train
0558084_sc-154398.jpg,1,1,1,1,4,,train
0558086_sc-175402.jpg,1,1,0,0,2,,train
0558089_sc-175402.jpg,1,1,0,0,2,,train
0558090_as-2698325.jpg,3,0,0,0,3,,train
0558091_as-0031668.jpg,1,1,2,0,4,,val
0558092_as-0031668.jpg,3,1,1,0,5,,val
0558094_sc-200253.jpg,3,0,0,0,3,,test
0558095_sc-195473.jpg,1,0,0,1,2,,train
0558097_sc-227207.jpg,1,0,0,1,2,,train
0558098_sc-227207.jpg,1,0,0,0,1,,train
0558099_sc-227207.jpg,2,0,0,0,2,,train
0558100_sc-134810.jpg,1,0,0,0,1,,train
0558101_sc-134810.jpg,1,0,0,0,1,,train
0558102_sc-134810.jpg,1,0,0,0,1,,train
0558103_sc-105163.jpg,2,0,0,0,2,,val
0558104_sc-105163.jpg,4,0,0,1,5,,val
0558106_as-0093427.jpg,1,2,0,0,3,,test
0558107_as-0093427.jpg,3,2,2,0,7,,train
0558108_as-0093427.jpg,2,1,0,0,3,,train
0558109_as-0093427.jpg,2,1,1,0,4,,train
0558111_as-0075125.jpg,2,0,0,0,2,,train
0558112_as-2998474.jpg,0,1,0,0,1,,train
0558113_sc-186169.jpg,0,0,0,1,1,,train
0558116_as-3359712.jpg,0,0,1,0,1,,train
0558117_sc-1038804.jpg,2,0,0,1,3,,val
0558118_sc-1038804.jpg,2,0,2,1,5,,val
0558119_sc-1038804.jpg,2,0,0,1,3,,test
0558120_as-0053098.jpg,1,0,0,0,1,,train
0558121_as-0053098.jpg,2,0,0,0,2,,train
0558123_as-0053098.jpg,1,0,0,0,1,,train
0558125_as-0047744.jpg,1,1,1,1,4,,train
0558126_as-0047744.jpg,1,2,1,1,5,,train
0558127_as-0047744.jpg,1,1,0,0,2,,train
0558128_as-0047744.jpg,2,0,0,0,2,,train
0558129_as-0047744.jpg,1,1,1,1,4,,val
0558130_as-0047744.jpg,0,0,1,0,1,,val
0558131_as-0047744.jpg,0,0,1,0,1,,test
0558132_as-0047744.jpg,1,0,0,1,2,,train
0558133_as-0047744.jpg,1,0,0,0,1,,train
0558134_as-9043960.jpg,1,0,0,0,1,,train
0558135_sc-222872.jpg,2,0,0,1,3,,train
0558136_sc-222872.jpg,0,0,0,1,1,,train
0558138_sc-221951.jpg,1,0,0,0,1,,train
0558139_sc-221951.jpg,1,0,0,0,1,,train
0558140_sc-221951.jpg,2,0,0,0,2,,val
0558141_sc-221951.jpg,1,0,0,0,1,,val
0558142_sc-221951.jpg,1,1,0,0,2,,test
0558143_sc-221951.jpg,1,1,0,0,2,,train
0558144_sc-168527.jpg,1,0,0,0,1,,train
0558145_as-3165312.jpg,1,0,1,1,3,,train
0558146_sc-104740.jpg,4,0,0,0,4,,train
0558147_sc-104740.jpg,2,0,0,0,2,,train
0558149_sc-104740.jpg,7,0,0,0,7,,train
0558152_as-0081191.jpg,2,0,0,0,2,,train
0558153_as-2843481.jpg,2,0,2,1,5,,val
0558154_as-2755366.jpg,0,1,0,0,1,,val
0558155_as-0092081.jpg,0,2,0,1,3,,test
0558157_as-0092081.jpg,1,0,0,0,1,,train
0558158_as-0092081.jpg,1,0,0,0,1,,train
0558159_as-0092081.jpg,4,0,1,0,5,,train
0558160_as-0049323.jpg,3,0,0,0,3,,train
0558161_as-0049323.jpg,1,0,0,0,1,,train
0558162_as-0049323.jpg,1,0,0,0,1,,train
0558163_as-0049323.jpg,1,0,0,0,1,,train
0558164_as-0049323.jpg,2,0,0,0,2,,val
0558165_as-0049323.jpg,2,0,0,0,2,,val
0558166_sc-163683.jpg,8,1,3,0,12,,test
0558167_sc-163683.jpg,6,1,2,0,9,,train
0558168_as-3323562.jpg,1,0,0,0,1,,train
0558169_as-2844326.jpg,1,0,0,1,2,,train
0558173_as-0074958.jpg,4,1,1,1,7,,train
0558174_as-0074958.jpg,1,0,1,0,2,,train
0558175_as-0074958.jpg,1,1,2,1,5,,train
0558176_as-0074958.jpg,3,1,1,1,6,,train
0558177_as-0074958.jpg,1,1,2,1,5,,val
0558179_as-2931928.jpg,1,0,0,0,1,,val
0558180_sc-214371.jpg,5,0,0,0,5,,test
0558181_sc-214371.jpg,2,1,0,1,4,,train
0558182_sc-214371.jpg,1,1,0,0,2,,train
0558183_sc-214371.jpg,1,1,0,0,2,,train
0558184_sc-214371.jpg,3,0,1,0,4,,train
0558186_sc-214371.jpg,2,1,0,1,4,,train
0558187_sc-140255.jpg,1,0,0,1,2,,train
0558188_sc-199011.jpg,3,0,0,0,3,,train
0558189_sc-199011.jpg,1,0,0,0,1,,val
0558191_sc-105400.jpg,2,0,0,0,2,,val
0558192_sc-105400.jpg,1,0,1,0,2,,test
0558193_sc-105400.jpg,1,0,0,0,1,,train
0558195_sc-105400.jpg,2,0,0,0,2,,train
0558196_sc-145451.jpg,6,0,0,0,6,,train
0558197_sc-1008948.jpg,1,0,1,0,2,,train
0558200_as-0049815.jpg,2,0,0,0,2,,train
0558201_as-0049815.jpg,1,0,0,0,1,,train
0558202_as-0049815.jpg,1,0,1,1,3,,train
0558203_as-0049815.jpg,1,0,1,1,3,,val
0558205_as-0049815.jpg,1,0,1,0,2,,val
0558206_as-0049815.jpg,1,0,1,1,3,,test
0558207_as-0049815.jpg,2,0,0,0,2,,train
0558208_as-0049815.jpg,1,0,0,0,1,,train
0558210_as-0049815.jpg,2,0,0,0,2,,train
0558211_as-0049815.jpg,2,0,0,0,2,,train
0558212_as-0049815.jpg,1,0,0,0,1,,train
0558213_as-0049815.jpg,1,0,0,0,1,,train
0558214_as-0049815.jpg,2,0,0,0,2,,train
0558215_as-0049815.jpg,1,0,0,0,1,,val
0558216_as-0049815.jpg,1,0,0,0,1,,val
0558217_as-0049815.jpg,1,0,0,0,1,,test
0558218_as-0049815.jpg,1,0,0,0,1,,train
0558219_as-0049815.jpg,1,0,1,1,3,,train
0558220_as-0049815.jpg,1,0,1,0,2,,train
0558221_as-0049815.jpg,1,0,0,1,2,,train
0558223_as-0030108.jpg,3,0,0,0,3,,train
0558224_as-0030108.jpg,0,0,2,1,3,,train
0558227_as-0033395.jpg,2,0,0,1,3,,train
0558228_as-0033395.jpg,1,0,1,1,3,,val
0558229_as-0033395.jpg,1,0,0,0,1,,val
0558230_as-0033395.jpg,3,1,0,1,5,,test
0558231_as-0033395.jpg,3,0,0,0,3,,train
0558232_as-0033395.jpg,1,1,0,0,2,,train
0558233_as-0033395.jpg,2,0,0,0,2,,train
0558234_as-0033395.jpg,2,0,0,0,2,,train
0558235_sc-223915.jpg,1,1,0,1,3,,train
0558236_sc-223915.jpg,1,1,1,1,4,,train
0558237_sc-223915.jpg,2,0,0,0,2,,train
0558243_as-0021214.jpg,2,0,1,0,3,,val
0558244_as-0021214.jpg,1,1,0,0,2,,val
0558245_as-0062606.jpg,1,0,0,0,1,,test
0558248_as-0062606.jpg,2,0,0,0,2,,train
0558250_as-0062606.jpg,1,0,0,0,1,,train
0558251_as-0062606.jpg,1,0,0,0,1,,train
0558252_as-0062606.jpg,1,0,0,0,1,,train
0558253_as-0062606.jpg,2,0,0,0,2,,train
0558254_as-0062606.jpg,6,0,0,0,6,,train
0558255_as-3224375.jpg,1,1,0,0,2,,train
0558256_as-2699545.jpg,9,0,0,0,9,,val
0558257_as-0029638.jpg,0,0,1,0,1,,val
0558258_as-0029638.jpg,1,0,0,0,1,,test
0558260_as-0022553.jpg,3,0,0,0,3,,train
0558261_sc-191313.jpg,2,0,0,1,3,,train
0558262_sc-191313.jpg,1,0,0,0,1,,train
0558263_sc-191313.jpg,4,0,0,0,4,,train
0558265_as-0040835.jpg,2,0,0,1,3,,train
0558266_as-2619190.jpg,0,1,0,0,1,,train
0558267_as-3135894.jpg,7,1,1,0,9,,train
0558269_as-0085274.jpg,1,0,0,1,2,,val
0558270_as-0085274.jpg,2,0,0,1,3,,val
0558271_as-0085274.jpg,2,0,0,0,2,,test
0558272_as-0085274.jpg,2,0,0,0,2,,train
0558276_as-0042065.jpg,2,0,0,1,3,,train
0558278_as-0042065.jpg,2,0,0,0,2,,train
0558279_as-0042065.jpg,8,0,0,1,9,,train
0558280_sc-152690.jpg,1,0,1,1,3,,train
0558283_as-3481132.jpg,3,1,0,1,5,,train
0558284_sc-104478.jpg,1,0,0,0,1,,train
0558285_sc-1007190.jpg,6,0,0,0,6,,val
0558286_as-2759340.jpg,3,2,0,0,5,,val
0558287_as-3482808.jpg,0,0,1,1,2,,test
0558288_as-0073778.jpg,3,0,0,0,3,,train
0558289_as-0073778.jpg,1,0,0,0,1,,train
0558290_as-0073778.jpg,1,0,0,0,1,,train
0558291_as-0073778.jpg,1,0,0,0,1,,train
0558292_as-0099200.jpg,1,0,0,0,1,,train
0558293_as-0099200.jpg,1,0,0,0,1,,train
0558294_as-0099200.jpg,1,0,0,0,1,,train
0558295_as-0099200.jpg,1,0,0,0,1,,val
0558296_as-0008412.jpg,1,0,0,0,1,,val
0558297_as-0008412.jpg,1,0,0,0,1,,test
0558298_as-0008412.jpg,1,0,0,0,1,,train
0558299_as-0008412.jpg,0,1,1,0,2,,train
0558301_as-2692756.jpg,1,0,0,0,1,,train
0558302_as-3094424.jpg,2,0,0,0,2,,train
0558303_sc-1018036.jpg,1,0,0,1,2,,train
0558304_sc-174147.jpg,1,0,0,0,1,,train
0558305_as-0078723.jpg,0,0,0,1,1,,train
0558306_as-0041416.jpg,2,0,2,1,5,,val
0558307_as-0041416.jpg,5,0,0,0,5,,val
0558309_as-0041416.jpg,1,0,0,0,1,,test
0558311_as-2823579.jpg,2,0,1,0,3,,train
0558312_sc-1015609.jpg,2,0,0,0,2,,train
0558313_sc-1015609.jpg,2,0,0,0,2,,train
0558314_sc-1015609.jpg,1,0,0,0,1,,train
0558315_sc-1015609.jpg,2,0,0,0,2,,train
0558316_sc-1015609.jpg,1,0,0,0,1,,train
0558317_as-0050754.jpg,1,0,1,0,2,,train
0558318_as-0050754.jpg,3,1,2,0,6,,val
0558319_as-0050754.jpg,2,0,0,0,2,,val
0558320_as-7059184.jpg,1,0,1,1,3,,test
0558323_as-0025777.jpg,0,2,1,0,3,,train
0558327_as-0094554.jpg,1,1,2,0,4,,train
0558328_as-0094554.jpg,0,2,1,2,5,,train
0558329_as-0094554.jpg,1,2,0,0,3,,train
0558330_as-0094554.jpg,1,0,0,0,1,,train
0558331_as-0094554.jpg,0,0,0,1,1,,train
0558332_as-2520424.jpg,3,0,1,0,4,,train
0558333_as-3132306.jpg,0,1,0,0,1,,val
0558334_as-2663590.jpg,3,0,0,1,4,,val
0558335_as-3278140.jpg,2,0,0,0,2,,test
0558336_as-3278140.jpg,2,0,0,0,2,,train
0558337_sc-191671.jpg,1,0,0,0,1,,train
0558338_sc-189841.jpg,1,0,1,1,3,,train
0558340_sc-189841.jpg,2,0,0,1,3,,train
0558341_sc-189841.jpg,1,0,0,1,2,,train
0558342_sc-189841.jpg,1,0,1,0,2,,train
0558343_sc-189841.jpg,3,0,0,0,3,,train
0558344_sc-189841.jpg,1,0,0,1,2,,val
0558345_as-2549000.jpg,2,0,1,0,3,,val
0558346_as-7960038.jpg,4,0,1,0,5,,test
0558347_sc-1000668.jpg,3,1,2,0,6,,train
0558349_sc-1000668.jpg,1,1,2,0,4,,train
0558350_as-2914396.jpg,1,0,0,0,1,,train
0558351_as-7595007.jpg,3,1,0,0,4,,train
0558352_sc-208436.jpg,4,0,0,3,7,,train
0558353_sc-208436.jpg,4,0,0,3,7,,train
0558354_sc-208436.jpg,4,0,0,5,9,,train
0558357_as-3424477.jpg,1,0,0,0,1,,val
0558359_as-0013216.jpg,1,2,2,0,5,,val
0558360_as-0013216.jpg,1,0,1,0,2,,test
0558361_as-0013216.jpg,1,0,0,0,1,,train
0558362_as-0013216.jpg,2,1,2,0,5,,train
0558363_as-0013216.jpg,0,0,1,0,1,,train
0558364_as-0013216.jpg,3,0,1,0,4,,train
0558367_as-0021421.jpg,1,0,0,1,2,,train
0558368_as-0021421.jpg,2,0,0,0,2,,train
0558369_as-0021421.jpg,2,0,0,0,2,,train
0558370_as-0021421.jpg,1,0,0,0,1,,val
0558372_sc-133466.jpg,2,0,1,4,7,,val
0558373_sc-133466.jpg,4,0,1,3,8,,test
0558374_sc-1004379.jpg,5,0,0,1,6,,train
0558375_sc-1004379.jpg,4,0,1,0,5,,train
0558377_as-7968726.jpg,8,0,1,0,9,,train
0558378_as-0025593.jpg,2,0,1,0,3,,train
0558379_sc-109402.jpg,1,0,0,0,1,,train
0558380_sc-109402.jpg,1,0,0,0,1,,train
0558381_as-3111349.jpg,2,1,0,0,3,,train
0558382_sc-176493.jpg,2,0,2,1,5,,val
0558383_sc-180791.jpg,4,0,0,0,4,,val
0558384_sc-180791.jpg,1,0,0,0,1,,test
0558387_sc-188901.jpg,2,0,0,1,3,,train
0558388_sc-188901.jpg,1,0,0,1,2,,train
0558389_sc-188901.jpg,3,0,0,2,5,,train
0558390_sc-188901.jpg,3,0,0,1,4,,train
0558391_sc-188901.jpg,3,0,0,1,4,,train
0558392_as-2656491.jpg,3,3,4,3,13,,train
0558393_as-0032069.jpg,3,0,0,0,3,,train
0558394_as-0032069.jpg,4,1,1,1,7,,val
0558395_sc-1037501.jpg,1,0,1,2,4,,val
0558398_as-3109451.jpg,1,0,0,0,1,,test
0558400_as-0081733.jpg,1,0,0,1,2,,train
0558401_as-2635941.jpg,2,1,0,0,3,,train
0558402_as-7587545.jpg,0,0,2,0,2,,train
0558403_as-3240784.jpg,0,1,0,0,1,,train
0558404_sc-174609.jpg,0,2,0,0,2,,train
0558405_as-3228390.jpg,1,0,1,0,2,,train
0558407_sc-134901.jpg,3,0,0,0,3,,train
0558408_sc-134901.jpg,1,0,2,1,4,,val
0558410_sc-134901.jpg,1,0,1,1,3,,val
0558411_sc-134901.jpg,1,0,1,1,3,,test
0558412_as-7699309.jpg,5,0,1,0,6,,train
0558413_as-2668062.jpg,1,0,0,0,1,,train
0558414_as-7786551.jpg,1,0,1,0,2,,train
0558415_sc-1009248.jpg,2,0,0,0,2,,train
0558416_sc-1009248.jpg,1,1,0,0,2,,train
0558417_as-2568825.jpg,2,0,1,2,5,,train
0558418_as-0048880.jpg,1,0,1,0,2,,train
0558419_as-0048880.jpg,2,0,0,0,2,,val
0558420_as-2784263.jpg,1,1,0,0,2,,val
0558421_sc-143515.jpg,2,0,0,0,2,,test
0558422_sc-143515.jpg,6,0,0,0,6,,train
0558424_sc-143515.jpg,2,0,1,0,3,,train
0558425_sc-143515.jpg,1,0,1,0,2,,train
0558426_sc-143515.jpg,2,0,1,0,3,,train
0558427_sc-143515.jpg,2,2,0,0,4,,train
0558429_sc-143515.jpg,2,0,0,0,2,,train
0558430_sc-143515.jpg,1,0,0,0,1,,train
0558432_sc-173108.jpg,1,0,1,0,2,,val
0558433_sc-173108.jpg,1,0,1,0,2,,val
0558435_as-9064235.jpg,1,0,1,0,2,,test
0558437_as-0023851.jpg,1,0,0,0,1,,train
0558438_as-0023851.jpg,1,0,0,0,1,,train
0558439_as-0023851.jpg,1,0,0,0,1,,train
0558440_as-0023851.jpg,0,0,1,0,1,,train
0558441_as-0023851.jpg,0,0,1,0,1,,train
0558442_sc-223637.jpg,1,0,0,0,1,,train
0558443_sc-223637.jpg,1,0,0,0,1,,train
0558444_as-7361528.jpg,1,0,0,0,1,,val
0558445_sc-1008256.jpg,1,0,0,0,1,,val
0558446_sc-1008256.jpg,0,1,0,0,1,,test
0558453_as-0086955.jpg,0,1,2,1,4,,train
0558454_as-0043173.jpg,3,0,0,0,3,,train
0558455_as-0033724.jpg,3,0,1,0,4,,train
0558456_as-0033724.jpg,1,0,0,0,1,,train
0558458_as-0033724.jpg,0,0,1,0,1,,train
0558459_as-0033724.jpg,1,0,1,0,2,,train
0558460_as-2893116.jpg,2,0,0,0,2,,train
0558461_as-9088720.jpg,0,0,1,0,1,,val
0558463_sc-188651.jpg,0,1,0,0,1,,val
0558464_sc-188651.jpg,0,1,0,0,1,,test
0558465_sc-188651.jpg,0,1,0,0,1,,train
0558466_sc-188651.jpg,0,1,0,0,1,,train
0558469_sc-172514.jpg,2,0,0,1,3,,train
0558470_sc-172514.jpg,0,0,1,0,1,,train
0558471_sc-172514.jpg,1,0,0,0,1,,train
0558474_sc-128263.jpg,1,0,0,0,1,,train
0558475_sc-171574.jpg,1,0,1,2,4,,train
0558477_sc-171574.jpg,3,0,3,1,7,,val
0558478_sc-171574.jpg,1,0,2,1,4,,val
0558479_as-3249302.jpg,2,1,0,1,4,,test
0558481_sc-1026386.jpg,2,2,0,1,5,,train
0558482_sc-1026386.jpg,2,2,0,0,4,,train
0558483_sc-158716.jpg,3,0,1,3,7,,train
0558484_sc-158716.jpg,4,0,0,0,4,,train
0558485_sc-197876.jpg,6,1,0,0,7,,train
0558486_sc-197876.jpg,7,1,0,0,8,,train
0558487_sc-197876.jpg,2,1,0,0,3,,train
0558488_as-0047667.jpg,1,0,0,1,2,,val
0558489_as-0047667.jpg,1,0,1,0,2,,val
0558491_as-2518822.jpg,1,1,0,1,3,,test
0558493_as-7376230.jpg,1,1,0,1,3,,train
0558494_as-3091599.jpg,1,0,1,0,2,,train
0558495_as-2610847.jpg,0,1,1,1,3,,train
0558496_as-2610847.jpg,3,0,0,0,3,,train
0558497_sc-145124.jpg,2,0,0,0,2,,train
0558498_sc-145124.jpg,1,0,0,0,1,,train
0558499_sc-145124.jpg,1,0,1,0,2,,train
0558500_sc-145124.jpg,1,0,0,0,1,,val
0558501_sc-145124.jpg,1,0,1,0,2,,val
0558502_sc-145124.jpg,1,0,1,0,2,,test
0558503_sc-145124.jpg,1,0,1,0,2,,train
0558505_as-2794398.jpg,1,0,0,0,1,,train
0558508_as-0005339.jpg,1,1,0,1,3,,train
0558510_as-0005339.jpg,1,1,0,1,3,,train
0558511_as-0005339.jpg,1,1,0,0,2,,train
0558512_as-0005339.jpg,0,1,0,0,1,,train
0558513_sc-1036261.jpg,1,0,1,0,2,,train
0558514_sc-1036261.jpg,2,0,1,0,3,,val
0558516_as-0048755.jpg,2,0,0,0,2,,val
0558517_as-0048755.jpg,1,0,0,1,2,,test
0558518_as-0048755.jpg,0,0,0,1,1,,train
0558519_as-0048755.jpg,2,0,0,1,3,,train
0558520_sc-1029421.jpg,1,0,0,0,1,,train
0558521_sc-128948.jpg,0,1,0,0,1,,train
0558522_sc-128948.jpg,6,1,0,0,7,,train
0558523_sc-128948.jpg,6,2,0,0,8,,train
0558524_sc-128948.jpg,0,1,0,0,1,,train
0558527_as-0029812.jpg,1,0,0,0,1,,val
0558528_as-0029812.jpg,1,0,0,0,1,,val
0558529_as-0029812.jpg,2,0,0,0,2,,test
0558531_as-7344043.jpg,1,0,0,0,1,,train
0558534_as-0003742.jpg,2,2,4,1,9,,train
0558535_as-0003742.jpg,1,1,2,2,6,,train
0558536_as-0003742.jpg,1,2,1,2,6,,train
0558537_as-0003742.jpg,0,1,1,0,2,,train
0558539_as-0020712.jpg,3,0,0,0,3,,train
0558540_as-0020712.jpg,3,0,0,0,3,,train
0558541_as-0020712.jpg,4,0,0,0,4,,val
0558542_as-0020712.jpg,2,0,0,0,2,,val
0558548_sc-184660.jpg,0,2,3,0,5,,test
0558549_sc-184660.jpg,0,3,2,0,5,,train
0558550_as-0053094.jpg,1,1,0,0,2,,train
0558551_as-0053094.jpg,1,1,0,0,2,,train
0558552_as-0053094.jpg,1,1,0,0,2,,train
0558553_as-0053094.jpg,1,1,0,0,2,,train
0558554_as-0053094.jpg,1,0,0,0,1,,train
0558555_as-0053094.jpg,3,0,0,0,3,,train
0558556_as-0053094.jpg,1,0,0,0,1,,val
0558558_as-0016022.jpg,2,0,0,0,2,,val
0558559_sc-226660.jpg,0,0,1,0,1,,test
0558560_sc-226660.jpg,0,0,1,0,1,,train
0558561_as-2775804.jpg,1,1,0,0,2,,train
0558562_as-7558823.jpg,0,0,1,0,1,,train
0558563_as-0083285.jpg,1,0,0,0,1,,train
0558564_as-0083285.jpg,2,0,0,0,2,,train
0558569_as-0027298.jpg,3,0,0,0,3,,train
0558570_as-0027298.jpg,2,0,1,1,4,,train
0558571_as-0027298.jpg,3,0,1,1,5,,val
0558572_as-0027298.jpg,2,0,0,0,2,,val
0558573_as-3249092.jpg,2,0,1,0,3,,test
0558574_sc-199383.jpg,2,0,1,1,4,,train
0558575_sc-199383.jpg,1,0,0,0,1,,train
0558576_sc-199383.jpg,1,0,1,0,2,,train
0558577_sc-199383.jpg,3,0,1,0,4,,train
0558579_as-0012065.jpg,2,2,0,0,4,,train
0558580_as-0012065.jpg,1,0,0,0,1,,train
0558581_as-0012065.jpg,0,1,0,0,1,,train
0558582_as-0012065.jpg,0,2,0,0,2,,val
0558583_as-0012065.jpg,3,1,0,0,4,,val
0558585_as-0054112.jpg,1,0,0,0,1,,test
0558586_sc-180402.jpg,3,0,0,1,4,,train
0558587_sc-228588.jpg,3,1,2,0,6,,train
0558588_sc-228588.jpg,5,1,1,0,7,,train
0558589_sc-228588.jpg,5,0,0,0,5,,train
0558590_as-2512493.jpg,3,0,0,0,3,,train
0558591_as-0000513.jpg,7,0,1,1,9,,train
0558592_sc-148026.jpg,2,0,1,0,3,,train
0558593_sc-148026.jpg,5,0,0,0,5,,val
0558594_sc-148026.jpg,2,0,0,0,2,,val
0558595_sc-148026.jpg,1,0,0,0,1,,test
0558596_sc-148026.jpg,2,0,0,0,2,,train
0558597_sc-148026.jpg,4,0,0,0,4,,train
0558598_sc-148026.jpg,1,0,0,0,1,,train
0558599_sc-148026.jpg,1,0,0,0,1,,train
0558600_sc-148026.jpg,2,0,0,0,2,,train
0558601_sc-148026.jpg,1,0,0,0,1,,train
0558603_sc-141535.jpg,1,0,1,0,2,,train
0558604_sc-141535.jpg,2,0,0,0,2,,val
0558605_as-0012627.jpg,1,0,3,0,4,,val
0558606_as-3195683.jpg,0,0,1,0,1,,test
0558607_as-2988115.jpg,1,0,0,0,1,,train
0558608_as-3294687.jpg,2,0,0,0,2,,train
0558609_sc-1010865.jpg,1,1,0,0,2,,train
0558610_sc-1010865.jpg,1,0,0,0,1,,train
0558611_sc-1010865.jpg,1,1,0,0,2,,train
0558612_as-0033052.jpg,1,0,0,1,2,,train
0558613_as-0033052.jpg,1,0,0,0,1,,train
0558614_as-0033052.jpg,2,0,0,0,2,,val
0558616_sc-197982.jpg,2,0,0,0,2,,val
0558617_as-7262670.jpg,0,0,1,0,1,,test
0558619_as-0079576.jpg,1,0,3,1,5,,train
0558620_as-0079576.jpg,2,0,2,1,5,,train
0558621_as-0079576.jpg,0,0,2,0,2,,train
0558622_as-7155526.jpg,0,0,0,2,2,,train
0558623_as-3365497.jpg,0,1,0,0,1,,train
0558624_as-2914997.jpg,2,0,0,0,2,,train
0558625_as-0077975.jpg,12,0,0,0,12,,train
0558626_as-0077975.jpg,1,0,0,0,1,,val
0558628_as-0077975.jpg,1,0,0,0,1,,val
0558629_as-0077975.jpg,1,0,0,0,1,,test
0558630_as-7344923.jpg,1,0,0,0,1,,train
0558631_sc-129988.jpg,1,0,0,0,1,,train
0558632_sc-129988.jpg,2,0,0,0,2,,train
0558633_sc-129988.jpg,1,0,0,0,1,,train
0558634_sc-129988.jpg,1,0,0,0,1,,train
0558637_as-2813471.jpg,1,0,0,0,1,,train
0558641_as-0063609.jpg,9,0,0,0,9,,train
0558642_as-7639514.jpg,1,0,1,0,2,,val
0558643_sc-228508.jpg,2,2,2,0,6,,val
0558644_sc-228508.jpg,3,1,1,1,6,,test
0558645_as-2651654.jpg,1,0,0,0,1,,train
0558646_as-2604397.jpg,6,4,2,1,13,,train
0558647_sc-1022543.jpg,3,0,0,0,3,,train
0558649_as-0016784.jpg,1,0,1,1,3,,train
0558650_as-0016784.jpg,1,0,0,0,1,,train
0558651_sc-1015632.jpg,3,0,0,0,3,,train
0558652_as-7138463.jpg,3,0,0,1,4,,train
0558653_as-7269147.jpg,1,0,2,0,3,,val
0558654_as-3191676.jpg,2,0,1,1,4,,val
0558656_sc-1006843.jpg,1,0,0,0,1,,test
0558657_sc-1006843.jpg,1,0,0,0,1,,train
0558658_sc-1006843.jpg,3,0,0,0,3,,train
0558659_sc-1006843.jpg,2,0,0,0,2,,train
0558661_sc-168228.jpg,2,0,0,0,2,,train
0558662_sc-168228.jpg,1,0,0,0,1,,train
0558666_as-0070298.jpg,5,2,0,1,8,,train
0558667_as-0070298.jpg,1,0,0,1,2,,train
0558669_as-0070298.jpg,1,0,0,1,2,,val
0558670_as-0070298.jpg,2,1,0,1,4,,val
0558672_as-2798600.jpg,1,0,1,0,2,,test
0558673_as-7555554.jpg,1,0,0,0,1,,train
0558674_as-0033887.jpg,4,0,1,0,5,,train
0558675_as-0033887.jpg,2,0,1,0,3,,train
0558676_as-0033887.jpg,1,0,0,1,2,,train
0558677_as-0033887.jpg,5,0,1,1,7,,train
0558680_as-0083818.jpg,1,0,0,1,2,,train
0558681_as-0083818.jpg,1,0,0,1,2,,train
0558682_as-0083818.jpg,2,0,0,1,3,,val
0558683_as-7544789.jpg,3,2,2,0,7,,val
0558684_as-9066787.jpg,1,1,0,0,2,,test
0558688_as-0051332.jpg,1,0,1,1,3,,train
0558689_as-0051332.jpg,1,0,1,0,2,,train
0558691_sc-204431.jpg,1,1,0,0,2,,train
0558692_as-0035284.jpg,1,0,0,0,1,,train
0558693_as-0035284.jpg,1,0,0,0,1,,train
0558694_as-3026170.jpg,4,0,0,1,5,,train
0558695_as-3063982.jpg,1,0,0,0,1,,train
0558696_sc-163535.jpg,1,0,0,1,2,,val
0558697_sc-163535.jpg,4,0,0,0,4,,val
0558698_sc-163535.jpg,1,0,0,1,2,,test
0558699_sc-163535.jpg,3,0,1,2,6,,train
0558700_sc-163535.jpg,1,0,0,0,1,,train
0558701_sc-222142.jpg,2,1,1,1,5,,train
0558702_sc-222142.jpg,2,1,2,1,6,,train
0558703_sc-222142.jpg,1,1,2,1,5,,train
0558704_sc-222142.jpg,1,0,1,0,2,,train
0558705_as-2738246.jpg,1,0,0,0,1,,train
0558706_as-3352717.jpg,1,0,0,1,2,,val
0558707_as-2525596.jpg,2,0,0,0,2,,val
0558708_as-0006189.jpg,1,0,0,0,1,,test
0558709_as-0006189.jpg,1,0,0,0,1,,train
0558711_as-0057865.jpg,2,0,1,0,3,,train
0558712_as-0057865.jpg,2,0,1,0,3,,train
0558713_sc-1010773.jpg,2,0,0,0,2,,train
0558714_sc-1010773.jpg,2,0,0,0,2,,train
0558715_sc-1010773.jpg,4,0,0,0,4,,train
0558720_as-0075600.jpg,2,0,1,1,4,,train
0558721_as-0075600.jpg,1,0,1,0,2,,val
0558722_as-0075600.jpg,1,0,1,0,2,,val
0558723_as-2734446.jpg,1,0,1,0,2,,test
0558724_sc-227921.jpg,1,0,0,0,1,,train
0558725_sc-227921.jpg,1,1,0,0,2,,train
0558726_as-3353261.jpg,2,0,0,0,2,,train
0558727_sc-1017726.jpg,2,0,0,0,2,,train
0558730_sc-1017726.jpg,6,0,0,0,6,,train
0558732_sc-1017726.jpg,4,0,0,0,4,,train
0558733_sc-1017726.jpg,2,0,0,0,2,,train
0558734_sc-151471.jpg,1,0,0,0,1,,val
0558735_sc-151471.jpg,1,0,0,0,1,,val
0558736_sc-216222.jpg,1,0,0,0,1,,test
0558737_sc-216222.jpg,1,0,0,0,1,,train
0558738_sc-216222.jpg,1,0,0,0,1,,train
0558739_sc-216222.jpg,1,0,0,0,1,,train
0558740_sc-216222.jpg,1,0,0,0,1,,train
0558741_sc-216222.jpg,5,0,0,0,5,,train
0558742_sc-216222.jpg,3,0,0,0,3,,train
0558743_sc-216222.jpg,3,0,0,0,3,,train
0558744_sc-216222.jpg,3,0,0,0,3,,val
0558748_as-0005181.jpg,1,0,0,0,1,,val
0558749_as-0005181.jpg,1,0,0,0,1,,test
0558750_as-2692008.jpg,3,0,1,0,4,,train
0558751_as-3372741.jpg,1,0,0,0,1,,train
0558752_as-0060121.jpg,1,0,0,0,1,,train
0558755_as-0060121.jpg,1,0,0,0,1,,train
0558757_as-0060121.jpg,1,0,0,0,1,,train
0558758_sc-213471.jpg,1,0,0,0,1,,train
0558759_as-0048013.jpg,1,0,1,1,3,,train
0558760_as-0048013.jpg,0,0,1,1,2,,val
0558761_as-2829959.jpg,0,2,0,0,2,,val
0558766_as-0006261.jpg,1,1,1,1,4,,test
0558768_sc-225560.jpg,7,0,0,0,7,,train
0558769_as-3373450.jpg,1,0,0,0,1,,train
0558770_as-2750561.jpg,2,0,1,2,5,,train
0558771_sc-1008055.jpg,1,0,0,1,2,,train
0558772_sc-1008055.jpg,1,0,0,1,2,,train
0558773_as-7443468.jpg,2,1,0,0,3,,train
0558774_as-2744212.jpg,1,0,0,0,1,,train
0558775_sc-1028371.jpg,3,0,0,0,3,,val
0558776_sc-198249.jpg,1,0,2,0,3,,val
0558777_sc-198249.jpg,1,0,0,0,1,,test
0558778_as-2534261.jpg,2,1,0,0,3,,train
0558780_as-0077765.jpg,7,0,0,0,7,,train
0558781_as-0077765.jpg,0,0,0,1,1,,train
0558782_as-0077765.jpg,0,0,0,1,1,,train
0558785_sc-223117.jpg,5,0,1,1,7,,train
0558786_sc-223117.jpg,4,0,1,2,7,,train
0558787_sc-223117.jpg,2,0,2,1,5,,train
0558788_sc-223117.jpg,2,0,1,0,3,,val
0558789_sc-223117.jpg,4,0,0,1,5,,val
0558790_sc-223117.jpg,5,0,1,1,7,,test
0558791_sc-1016536.jpg,1,0,1,1,3,,train
0558792_sc-1016536.jpg,1,0,0,1,2,,train
0558793_sc-1016536.jpg,4,0,1,1,6,,train
0558794_sc-1016536.jpg,1,0,0,0,1,,train
0558795_sc-1016536.jpg,1,0,1,1,3,,train
0558796_as-7329943.jpg,3,0,0,0,3,,train
0558798_as-0044837.jpg,4,1,2,0,7,,train
0558799_sc-201955.jpg,1,0,1,0,2,,val
0558800_sc-201955.jpg,3,0,1,0,4,,val
0558801_sc-201955.jpg,0,1,1,0,2,,test
0558802_sc-174103.jpg,2,0,0,1,3,,train
0558803_sc-174103.jpg,5,0,0,1,6,,train
0558804_sc-174103.jpg,3,0,0,1,4,,train
0558806_as-7246946.jpg,2,0,0,0,2,,train
0558807_as-3294910.jpg,0,0,1,1,2,,train
0558810_as-0004228.jpg,2,1,0,0,3,,train
0558811_as-0004228.jpg,1,0,0,0,1,,train
0558812_as-0004228.jpg,3,1,1,0,5,,val
0558813_as-0004228.jpg,0,0,1,0,1,,val
0558814_as-0082668.jpg,1,0,0,0,1,,test
0558815_as-0082668.jpg,1,0,0,0,1,,train
0558816_as-0082668.jpg,1,0,0,0,1,,train
0558817_sc-223029.jpg,3,1,1,0,5,,train
0558818_sc-223029.jpg,1,0,0,0,1,,train
0558819_sc-223029.jpg,0,1,0,0,1,,train
0558820_as-3139707.jpg,1,0,0,0,1,,train
0558821_sc-1020526.jpg,1,2,0,0,3,,train
0558822_sc-1020526.jpg,1,1,1,0,3,,val
0558823_as-0022832.jpg,1,0,0,0,1,,val
0558824_as-0022832.jpg,3,0,0,0,3,,test
0558825_as-0022832.jpg,3,0,0,0,3,,train
0558827_as-0047329.jpg,0,1,0,0,1,,train
0558828_as-0047329.jpg,1,1,0,0,2,,train
0558830_as-0047329.jpg,1,0,0,0,1,,train
0558831_as-0047329.jpg,3,0,0,0,3,,train
0558832_as-0047329.jpg,1,0,1,0,2,,train
0558833_as-0047329.jpg,1,2,2,1,6,,train
0558834_as-0047329.jpg,1,0,0,0,1,,val
0558835_as-0047329.jpg,2,0,0,0,2,,val
0558836_as-0047329.jpg,1,0,0,0,1,,test
0558837_as-0047329.jpg,0,1,3,0,4,,train
0558838_as-0047329.jpg,0,2,3,0,5,,train
0558841_as-0022811.jpg,1,0,1,2,4,,train
0558842_as-0022811.jpg,1,0,1,1,3,,train
0558843_sc-135752.jpg,1,0,0,1,2,,train
0558844_sc-135752.jpg,1,0,0,1,2,,train
0558845_sc-135752.jpg,1,0,0,0,1,,train
0558846_sc-135752.jpg,1,0,0,1,2,,val
0558847_as-3072499.jpg,1,0,1,1,3,,val
0558848_sc-105441.jpg,0,0,1,0,1,,test
0558852_as-0052117.jpg,4,0,1,0,5,,train
0558853_as-0052117.jpg,1,0,1,0,2,,train
0558854_sc-221854.jpg,8,0,0,2,10,,train
0558855_sc-221854.jpg,4,0,0,1,5,,train
0558856_sc-221854.jpg,3,0,0,1,4,,train
0558857_sc-128905.jpg,1,1,0,0,2,,train
0558858_sc-128905.jpg,2,1,0,0,3,,train
0558859_sc-182433.jpg,4,0,0,0,4,,val
0558860_as-9022775.jpg,1,0,1,0,2,,val
0558861_sc-1015879.jpg,1,0,1,0,2,,test
0558862_sc-1015879.jpg,2,0,0,0,2,,train
0558863_sc-1015879.jpg,2,0,0,0,2,,train
0558864_sc-1015879.jpg,1,0,1,0,2,,train
0558867_as-0076107.jpg,1,0,0,0,1,,train
0558868_as-0076107.jpg,0,0,0,1,1,,train
0558869_as-0076107.jpg,1,0,0,0,1,,train
0558870_as-3417868.jpg,0,1,0,0,1,,train
0558871_sc-163552.jpg,3,1,1,1,6,,val
0558872_sc-163552.jpg,2,1,0,0,3,,val
0558873_sc-163552.jpg,3,1,0,0,4,,test
0558874_sc-163552.jpg,1,1,0,0,2,,train
0558875_sc-163552.jpg,2,1,1,1,5,,train
0558876_sc-1009461.jpg,2,0,0,1,3,,train
0558877_sc-1009461.jpg,7,0,0,1,8,,train
0558878_sc-1009461.jpg,2,0,0,0,2,,train
0558879_sc-1009461.jpg,5,0,0,0,5,,train
0558881_as-0058587.jpg,1,0,1,0,2,,train
0558882_sc-1022141.jpg,1,0,0,0,1,,val
0558883_sc-1022141.jpg,2,0,0,1,3,,val
0558884_sc-1022141.jpg,1,0,0,1,2,,test
0558886_sc-1032137.jpg,1,1,1,0,3,,train
0558887_as-7624575.jpg,0,0,1,1,2,,train
0558888_as-2751687.jpg,3,0,2,1,6,,train
0558889_as-2809997.jpg,1,0,1,0,2,,train
0558891_as-0030381.jpg,3,0,1,1,5,,train
0558893_as-0080403.jpg,4,0,0,0,4,,train
0558894_as-0080403.jpg,1,0,0,0,1,,train
0558895_as-3413464.jpg,1,0,0,0,1,,val
0558896_sc-191077.jpg,4,0,1,0,5,,val
0558897_sc-191077.jpg,3,0,1,0,4,,test
0558898_sc-191077.jpg,2,1,0,0,3,,train
0558899_sc-191077.jpg,1,0,1,0,2,,train
0558900_sc-1026995.jpg,1,1,2,0,4,,train
0558901_sc-1026995.jpg,1,0,1,0,2,,train
0558902_sc-1026995.jpg,2,1,1,1,5,,train
0558904_as-0029092.jpg,12,0,2,1,15,,train
0558905_as-0029092.jpg,6,0,1,1,8,,train
0558906_as-0029092.jpg,9,0,2,1,12,,val
0558908_as-0029092.jpg,5,0,0,1,6,,val
0558909_as-0029092.jpg,2,0,0,1,3,,test
0558910_as-0029092.jpg,1,0,0,0,1,,train
0558911_as-2810575.jpg,2,0,0,0,2,,train
0558912_as-2810575.jpg,5,0,1,0,6,,train
0558913_as-9014005.jpg,2,0,2,2,6,,train
0558915_sc-220126.jpg,1,0,0,0,1,,train
0558916_sc-220126.jpg,2,0,0,0,2,,train
0558917_sc-220126.jpg,1,0,0,0,1,,train
0558918_sc-220126.jpg,1,0,0,0,1,,val
0558919_sc-220126.jpg,2,0,1,0,3,,val
0558920_sc-220126.jpg,2,0,0,0,2,,test
0558921_sc-220126.jpg,1,0,0,0,1,,train
0558922_sc-220126.jpg,2,0,0,0,2,,train
0558923_sc-220126.jpg,3,0,0,0,3,,train
0558924_as-0093227.jpg,1,0,0,0,1,,train
0558925_as-9058025.jpg,4,1,1,0,6,,train
0558926_sc-134896.jpg,4,0,0,0,4,,train
0558927_sc-134896.jpg,0,0,1,0,1,,train
0558928_sc-134896.jpg,2,0,1,0,3,,val
0558929_sc-134896.jpg,0,0,1,0,1,,val
0558930_sc-134896.jpg,2,0,0,0,2,,test
0558931_sc-134896.jpg,3,0,0,0,3,,train
0558932_sc-134896.jpg,1,0,1,0,2,,train
0558934_as-0003067.jpg,3,0,1,0,4,,train
0558935_as-0003067.jpg,2,1,1,0,4,,train
0558938_as-0084674.jpg,1,0,0,0,1,,train
0558939_as-0084674.jpg,1,0,1,0,2,,train
0558940_as-0084674.jpg,1,0,1,0,2,,train
0558944_as-0022614.jpg,4,0,0,0,4,,val
0558945_as-0022614.jpg,4,0,0,0,4,,val
0558946_as-0022614.jpg,6,0,0,0,6,,test
0558948_as-0022614.jpg,5,0,0,0,5,,train
0558950_as-9087626.jpg,1,1,1,0,3,,train
0558951_as-2689669.jpg,2,0,1,1,4,,train
0558952_as-3163999.jpg,1,0,0,1,2,,train
0558953_sc-195920.jpg,5,0,1,0,6,,train
0558954_sc-195920.jpg,4,0,1,0,5,,train
0558956_as-0076872.jpg,2,1,0,1,4,,train
0558957_sc-1009842.jpg,3,0,0,0,3,,val
0558959_sc-213865.jpg,2,0,0,0,2,,val
0558960_sc-150900.jpg,2,4,1,1,8,,test
0558961_sc-150900.jpg,1,1,1,0,3,,train
0558962_sc-150900.jpg,2,0,2,0,4,,train
0558964_sc-208420.jpg,3,0,0,1,4,,train
0558965_sc-208420.jpg,6,0,0,0,6,,train
0558966_sc-208420.jpg,1,0,0,1,2,,train
0558967_sc-208420.jpg,2,0,0,1,3,,train
0558968_sc-208420.jpg,6,0,0,0,6,,train
0558969_sc-208420.jpg,4,0,0,0,4,,val
0558970_sc-219306.jpg,4,0,0,0,4,,val
0558971_as-3329634.jpg,5,1,2,1,9,,test
0558972_sc-171955.jpg,5,0,0,1,6,,train
0558973_sc-171955.jpg,6,0,0,0,6,,train
0558974_sc-171955.jpg,6,0,0,0,6,,train
0558975_as-0046528.jpg,1,0,0,0,1,,train
0558976_as-0046528.jpg,2,0,0,0,2,,train
0558977_as-0046528.jpg,1,0,0,0,1,,train
0558978_sc-177274.jpg,1,0,0,0,1,,train
0558981_as-0077957.jpg,4,0,1,3,8,,val
0558983_sc-132780.jpg,2,2,1,0,5,,val
0558985_sc-132780.jpg,2,1,1,0,4,,test
0558986_sc-132780.jpg,1,0,0,0,1,,train
0558987_as-0032992.jpg,1,0,1,1,3,,train
0558988_as-0032992.jpg,1,0,1,0,2,,train
0558990_sc-210412.jpg,1,0,0,0,1,,train
0558991_sc-210412.jpg,4,0,0,0,4,,train
0558992_sc-210412.jpg,3,0,0,0,3,,train
0558993_sc-210412.jpg,2,0,0,0,2,,train
0558994_sc-210412.jpg,1,0,0,0,1,,val
0558995_sc-210412.jpg,4,0,0,0,4,,val
0558996_as-2621591.jpg,1,0,0,0,1,,test
0558998_as-0048053.jpg,2,0,1,0,3,,train
0559002_as-0017598.jpg,0,1,2,1,4,,train
0559005_as-0017598.jpg,0,0,1,0,1,,train
0559006_as-0017598.jpg,1,0,1,0,2,,train
0559007_as-0017598.jpg,1,0,1,0,2,,train
0559011_as-0017598.jpg,0,0,1,0,1,,train
0559012_as-0017598.jpg,0,0,1,0,1,,train
0559014_as-0017598.jpg,0,0,1,0,1,,val
0559015_as-0017598.jpg,1,0,3,0,4,,val
0559016_as-0017598.jpg,1,0,1,0,2,,test
0559017_as-0017598.jpg,1,0,2,0,3,,train
0559018_as-0017598.jpg,3,0,1,1,5,,train
0559019_as-0017598.jpg,3,0,1,1,5,,train
0559020_as-0017598.jpg,0,1,1,0,2,,train
0559021_as-0017598.jpg,0,1,2,1,4,,train
0559022_as-0017598.jpg,0,0,1,0,1,,train
0559023_as-0017598.jpg,1,0,3,1,5,,train
0559024_as-0017598.jpg,0,1,1,0,2,,val
0559025_as-0017598.jpg,3,0,2,0,5,,val
0559026_as-2567778.jpg,0,1,0,0,1,,test
0559027_sc-1023939.jpg,2,1,1,0,4,,train
0559028_sc-1023939.jpg,3,1,1,0,5,,train
0559029_sc-1040284.jpg,1,0,2,1,4,,train
0559030_sc-1040284.jpg,1,0,1,0,2,,train
0559031_sc-1040284.jpg,0,0,1,0,1,,train
0559032_sc-1040284.jpg,2,1,2,1,6,,train
0559034_sc-1040284.jpg,1,0,2,1,4,,train
0559036_sc-206878.jpg,3,0,0,0,3,,val
0559038_sc-210567.jpg,2,0,0,1,3,,val
0559039_sc-210567.jpg,2,0,1,1,4,,test
0559040_sc-210567.jpg,2,0,0,1,3,,train
0559041_sc-210567.jpg,2,0,1,1,4,,train
0559042_as-3072855.jpg,7,0,0,0,7,,train
0559044_as-0075619.jpg,1,1,1,1,4,,train
0559045_as-0075619.jpg,0,1,1,1,3,,train
0559046_as-0075619.jpg,1,0,3,1,5,,train
0559047_as-0075619.jpg,0,0,1,1,2,,train
0559048_as-0075619.jpg,3,0,0,0,3,,val
0559049_as-2820754.jpg,1,0,0,0,1,,val
0559050_sc-168300.jpg,1,1,1,1,4,,test
0559053_as-3321854.jpg,2,1,0,0,3,,train
0559054_as-0092549.jpg,4,0,0,1,5,,train
0559055_as-0092549.jpg,2,0,1,0,3,,train
0559057_as-2773207.jpg,5,0,1,0,6,,train
0559058_as-2528151.jpg,2,0,0,0,2,,train
0559060_sc-118405.jpg,2,0,2,0,4,,train
0559061_sc-118405.jpg,2,0,2,0,4,,train
0559062_sc-118405.jpg,2,0,1,0,3,,val
0559063_as-0088133.jpg,1,1,0,1,3,,val
0559064_as-0088133.jpg,2,1,0,1,4,,test
0559065_as-0088133.jpg,2,1,0,1,4,,train
0559067_sc-1024936.jpg,2,0,0,0,2,,train
0559068_sc-1024936.jpg,2,0,0,0,2,,train
0559069_sc-189528.jpg,6,0,1,0,7,,train
0559070_sc-189528.jpg,7,0,1,0,8,,train
0559071_sc-214480.jpg,2,0,1,0,3,,train
0559072_sc-214480.jpg,2,0,1,0,3,,train
0559074_sc-112206.jpg,1,0,0,0,1,,val
0559075_sc-112206.jpg,1,0,0,0,1,,val
0559076_as-2666949.jpg,2,0,1,0,3,,test
0559077_sc-1039334.jpg,2,0,0,0,2,,train
0559079_as-0005098.jpg,1,0,0,0,1,,train
0559081_as-0005098.jpg,1,0,0,0,1,,train
0559082_as-0005098.jpg,1,0,0,0,1,,train
0559083_as-0005098.jpg,1,0,0,0,1,,train
0559084_as-2993421.jpg,4,0,0,0,4,,train
0559085_sc-1013401.jpg,2,1,0,0,3,,train
0559087_as-0045435.jpg,1,0,1,1,3,,val
0559088_as-0045435.jpg,1,0,1,0,2,,val
0559089_as-0045435.jpg,2,0,1,0,3,,test
0559090_as-0045435.jpg,1,0,1,0,2,,train
0559091_as-0045435.jpg,2,0,1,0,3,,train
0559093_as-0073402.jpg,3,0,0,0,3,,train
0559094_as-0073402.jpg,2,0,0,0,2,,train
0559095_as-0073402.jpg,4,0,0,0,4,,train
0559096_as-0073402.jpg,3,0,0,0,3,,train
0559097_as-0073402.jpg,2,0,0,0,2,,train
0559098_as-0073402.jpg,1,0,0,0,1,,val
0559099_as-0073402.jpg,2,0,0,0,2,,val
0559100_as-0073402.jpg,2,0,0,0,2,,test
0559101_as-0073402.jpg,1,0,0,0,1,,train
0559102_as-0073402.jpg,2,0,0,0,2,,train
0559103_as-3223798.jpg,1,0,0,0,1,,train
0559104_as-2872424.jpg,3,0,0,0,3,,train
0559106_sc-163090.jpg,3,0,2,1,6,,train
0559108_sc-163090.jpg,2,0,2,1,5,,train
0559110_sc-178693.jpg,1,0,1,1,3,,train
0559111_sc-206289.jpg,0,0,0,1,1,,val
0559112_sc-206289.jpg,1,0,0,0,1,,val
0559113_sc-206289.jpg,1,0,0,0,1,,test
0559114_sc-206289.jpg,1,0,0,0,1,,train
0559115_as-0008076.jpg,1,1,0,0,2,,train
0559117_as-0042945.jpg,6,0,1,2,9,,train
0559118_as-0042945.jpg,8,0,1,2,11,,train
0559119_sc-160804.jpg,1,0,1,1,3,,train
0559120_sc-160804.jpg,2,0,1,1,4,,train
0559121_sc-160804.jpg,2,0,1,1,4,,train
0559122_as-0077486.jpg,3,0,0,0,3,,val
0559123_as-0077486.jpg,4,0,0,0,4,,val
0559124_as-0077486.jpg,6,0,0,0,6,,test
0559125_as-0077486.jpg,2,0,0,0,2,,train
0559127_sc-1018766.jpg,5,0,0,0,5,,train
0559128_sc-1000798.jpg,3,0,0,0,3,,train
0559129_sc-1000798.jpg,2,0,0,0,2,,train
0559130_sc-203077.jpg,1,0,0,1,2,,train
0559131_sc-203077.jpg,0,0,0,1,1,,train
0559132_sc-203077.jpg,1,0,0,1,2,,train
0559134_sc-146758.jpg,2,0,1,0,3,,val
0559136_sc-115110.jpg,2,0,1,1,4,,val
0559137_sc-225418.jpg,1,1,1,0,3,,test
0559140_sc-225418.jpg,1,1,1,0,3,,train
0559141_sc-1039902.jpg,2,0,0,1,3,,train
0559142_sc-208958.jpg,4,1,1,1,7,,train
0559143_sc-152077.jpg,4,1,0,0,5,,train
0559144_sc-152077.jpg,9,1,0,0,10,,train
0559147_sc-1002792.jpg,1,1,0,0,2,,train
0559148_sc-1002792.jpg,2,1,1,0,4,,train
0559149_as-9091227.jpg,2,0,0,0,2,,val
0559150_sc-223159.jpg,1,0,0,1,2,,val
0559151_sc-186549.jpg,4,0,0,1,5,,test
0559153_sc-186549.jpg,1,1,1,0,3,,train
0559154_sc-186549.jpg,2,0,0,0,2,,train
0559155_sc-186549.jpg,5,0,0,0,5,,train
0559156_sc-1039765.jpg,1,0,0,0,1,,train
0559158_sc-1039765.jpg,2,0,0,0,2,,train
0559159_sc-1039765.jpg,2,0,0,0,2,,train
0559160_sc-1039765.jpg,2,0,0,0,2,,train
0559161_sc-1039765.jpg,3,0,0,0,3,,val
0559162_sc-1039765.jpg,2,0,0,0,2,,val
0559164_sc-151767.jpg,5,0,0,0,5,,test
0559166_sc-151767.jpg,3,0,0,0,3,,train
0559167_as-2566621.jpg,2,0,1,0,3,,train
0559168_sc-1009488.jpg,4,2,1,0,7,,train
0559169_sc-1009488.jpg,1,1,0,0,2,,train
0559170_sc-1009488.jpg,3,3,1,0,7,,train
0559172_sc-1004684.jpg,2,2,3,1,8,,train
0559174_sc-1004684.jpg,2,1,3,0,6,,train
0559175_sc-105011.jpg,3,0,0,1,4,,val
0559178_sc-105011.jpg,3,0,0,1,4,,val
0559179_sc-105011.jpg,3,0,0,0,3,,test
0559180_sc-105011.jpg,1,0,0,0,1,,train
0559182_sc-159197.jpg,6,1,2,0,9,,train
0559183_sc-159197.jpg,3,1,2,0,6,,train
0559184_sc-159197.jpg,7,1,2,0,10,,train
0559185_sc-159197.jpg,3,1,1,0,5,,train
0559187_sc-1027916.jpg,4,1,0,0,5,,train
0559188_sc-1027916.jpg,2,1,0,0,3,,train
0559189_sc-1020085.jpg,2,0,0,0,2,,val
0559190_sc-1020085.jpg,1,0,0,1,2,,val
0559191_sc-1020085.jpg,1,0,0,0,1,,test
0559192_sc-165741.jpg,1,0,0,0,1,,train
0559193_sc-165741.jpg,7,1,0,0,8,,train
0559194_sc-165741.jpg,0,0,1,0,1,,train
0559195_as-0026368.jpg,1,0,0,0,1,,train
0559197_as-7068694.jpg,1,0,0,0,1,,train
0559198_as-2515305.jpg,3,1,0,0,4,,train
0559199_as-3315459.jpg,0,1,1,1,3,,train
0559200_sc-179105.jpg,1,0,1,1,3,,val
0559201_sc-179105.jpg,2,0,0,1,3,,val
0559202_sc-179105.jpg,3,0,0,1,4,,test
0559204_sc-179105.jpg,2,0,1,1,4,,train
0559205_as-2731730.jpg,1,0,1,0,2,,train
0559206_sc-226057.jpg,1,1,1,0,3,,train
0559207_sc-226057.jpg,0,1,0,0,1,,train
0559208_sc-226057.jpg,3,1,1,0,5,,train
0559209_sc-1002246.jpg,3,1,1,1,6,,train
0559211_sc-1002246.jpg,3,1,2,0,6,,train
0559212_as-0003913.jpg,1,1,0,0,2,,val
0559213_as-0003913.jpg,2,1,0,0,3,,val
0559214_as-0003913.jpg,1,1,0,0,2,,test
0559215_as-0003913.jpg,1,0,0,0,1,,train
0559217_as-0043036.jpg,1,0,0,0,1,,train
0559218_as-0043036.jpg,1,0,0,0,1,,train
0559219_as-3438719.jpg,3,1,0,0,4,,train
0559221_sc-218163.jpg,3,2,0,0,5,,train
0559222_sc-218163.jpg,1,1,1,1,4,,train
0559223_sc-218163.jpg,2,1,0,2,5,,train
0559224_sc-218163.jpg,3,0,1,1,5,,val
0559226_sc-218163.jpg,1,0,0,0,1,,val
0559227_sc-218163.jpg,1,0,0,1,2,,test
0559228_sc-218163.jpg,1,0,0,0,1,,train
0559229_sc-218163.jpg,3,2,0,1,6,,train
0559230_as-0095974.jpg,1,0,0,0,1,,train
0559231_as-0095974.jpg,1,0,0,0,1,,train
0559232_as-0095974.jpg,1,0,0,0,1,,train
0559233_as-0069977.jpg,0,0,1,0,1,,train
0559234_as-0069977.jpg,4,0,0,1,5,,train
0559235_as-0083779.jpg,1,1,0,0,2,,val
0559236_as-0083779.jpg,0,0,0,1,1,,val
0559237_as-0083779.jpg,1,1,0,0,2,,test
0559238_as-2938172.jpg,3,0,0,0,3,,train
0559239_as-3393248.jpg,1,0,0,0,1,,train
0559240_sc-167709.jpg,3,0,0,0,3,,train
0559242_sc-173403.jpg,3,0,1,1,5,,train
0559243_as-3336211.jpg,2,0,2,1,5,,train
0559245_sc-208140.jpg,1,0,0,1,2,,train
0559246_sc-208140.jpg,2,0,0,0,2,,train
0559247_sc-208140.jpg,2,0,0,0,2,,val
0559249_as-0058106.jpg,1,0,1,2,4,,val
0559250_as-0058106.jpg,1,0,0,0,1,,test
0559251_as-0058106.jpg,2,0,1,1,4,,train
0559252_sc-220803.jpg,2,0,1,0,3,,train
0559254_as-0072668.jpg,1,0,0,0,1,,train
0559255_as-0072668.jpg,2,0,0,0,2,,train
0559256_as-0072668.jpg,3,0,0,0,3,,train
0559259_as-0073481.jpg,8,1,3,1,13,,train
0559260_as-0073481.jpg,7,0,2,0,9,,train
0559261_as-0073481.jpg,12,1,4,1,18,,val
0559262_as-0073481.jpg,6,1,2,1,10,,val
0559263_as-0073481.jpg,7,2,2,1,12,,test
0559264_sc-1016843.jpg,2,1,2,0,5,,train
0559265_as-2913166.jpg,1,0,0,0,1,,train
0559267_sc-1013776.jpg,1,0,1,1,3,,train
0559268_sc-1013776.jpg,3,0,1,2,6,,train
0559270_sc-1013776.jpg,5,0,1,1,7,,train
0559271_sc-1013776.jpg,2,0,0,1,3,,train
0559272_as-3124731.jpg,0,0,1,0,1,,train
0559273_as-2526072.jpg,1,0,1,0,2,,val
0559274_sc-171919.jpg,3,0,0,0,3,,val
0559275_as-2566275.jpg,3,1,2,2,8,,test
0559276_as-2566275.jpg,1,0,0,0,1,,train
0559277_sc-1006795.jpg,0,0,1,1,2,,train
0559278_sc-1006795.jpg,1,0,0,0,1,,train
0559279_sc-1006795.jpg,0,0,0,1,1,,train
0559281_as-0074642.jpg,0,0,1,0,1,,train
0559282_as-0074642.jpg,0,0,1,0,1,,train
0559283_as-0074642.jpg,1,0,0,0,1,,train
0559284_as-0074642.jpg,2,0,0,0,2,,val
0559286_as-0022577.jpg,0,2,3,0,5,,val
0559287_sc-103231.jpg,0,0,0,1,1,,test
0559289_sc-200363.jpg,1,0,0,1,2,,train
0559290_sc-200363.jpg,1,0,0,1,2,,train
0559291_sc-200363.jpg,1,0,0,1,2,,train
0559292_sc-200363.jpg,2,0,0,1,3,,train
0559293_sc-200363.jpg,1,0,0,1,2,,train
0559294_sc-206892.jpg,4,0,0,0,4,,train
0559295_sc-206892.jpg,2,0,0,0,2,,train
0559296_sc-206892.jpg,3,0,0,0,3,,val
0559297_sc-206892.jpg,3,0,0,0,3,,val
0559298_sc-206892.jpg,2,0,0,0,2,,test
0559299_sc-206892.jpg,1,0,0,1,2,,train
0559300_sc-110195.jpg,1,1,0,0,2,,train
0559301_sc-110195.jpg,2,0,0,1,3,,train
0559302_as-0002043.jpg,7,2,0,0,9,,train
0559307_as-0092397.jpg,13,1,0,0,14,,train
0559308_as-0092397.jpg,9,0,0,0,9,,train
0559309_as-0092397.jpg,13,1,0,1,15,,train
0559310_sc-220827.jpg,1,1,1,0,3,,val
0559311_sc-227816.jpg,1,0,1,0,2,,val
0559312_sc-227816.jpg,2,0,1,1,4,,test
0559313_sc-227816.jpg,2,0,1,0,3,,train
0559314_sc-227816.jpg,2,0,0,0,2,,train
0559315_sc-227816.jpg,4,3,0,0,7,,train
0559316_sc-227816.jpg,1,0,1,0,2,,train
0559319_sc-133536.jpg,1,0,0,0,1,,train
0559320_sc-133536.jpg,1,0,0,0,1,,train
0559321_sc-133536.jpg,1,0,0,0,1,,train
0559323_sc-133536.jpg,1,0,0,0,1,,val
0559324_sc-133536.jpg,2,0,1,0,3,,val
0559326_sc-133536.jpg,2,0,0,0,2,,test
0559327_as-9045444.jpg,5,0,0,0,5,,train
0559328_as-3401985.jpg,1,0,0,0,1,,train
0559331_as-0084721.jpg,1,1,0,0,2,,train
0559332_as-0084721.jpg,2,1,1,0,4,,train
0559333_as-0084721.jpg,1,1,1,0,3,,train
0559334_as-0084721.jpg,0,1,1,0,2,,train
0559335_sc-195027.jpg,1,0,0,0,1,,train
0559336_sc-195027.jpg,2,0,0,0,2,,val
0559337_sc-1011677.jpg,1,0,0,0,1,,val
0559338_sc-1011677.jpg,3,0,1,0,4,,test
0559339_sc-1011677.jpg,6,0,2,1,9,,train
0559340_as-7347225.jpg,1,0,0,0,1,,train
0559343_as-0068792.jpg,1,0,0,1,2,,train
0559344_as-0068792.jpg,1,0,0,1,2,,train
0559347_as-0063222.jpg,3,0,0,0,3,,train
0559349_as-0063222.jpg,1,1,0,0,2,,train
0559350_as-0063222.jpg,9,1,0,0,10,,train
0559351_as-3141547.jpg,13,1,2,2,18,,val
0559355_as-0028209.jpg,1,1,0,0,2,,val
0559356_as-0028209.jpg,1,1,0,0,2,,test
0559357_as-2549945.jpg,2,0,0,1,3,,train
0559360_sc-139479.jpg,1,0,1,0,2,,train
0559361_sc-139479.jpg,1,0,0,0,1,,train
0559362_sc-139479.jpg,1,1,2,0,4,,train
0559363_sc-139479.jpg,1,0,0,0,1,,train
0559365_sc-139479.jpg,1,0,0,0,1,,train
0559367_sc-139479.jpg,1,0,1,0,2,,train
0559368_as-7456425.jpg,3,0,2,1,6,,val
0559369_as-3110246.jpg,1,1,0,1,3,,val
0559370_sc-221292.jpg,0,1,1,0,2,,test
0559371_sc-221292.jpg,1,1,1,2,5,,train
0559372_sc-221292.jpg,1,1,1,2,5,,train
0559373_sc-221292.jpg,1,1,1,1,4,,train
0559374_sc-221292.jpg,3,0,1,1,5,,train
0559375_sc-221292.jpg,2,0,0,0,2,,train
0559376_as-0000990.jpg,2,0,1,0,3,,train
0559377_as-0000990.jpg,4,0,0,0,4,,train
0559378_as-2861359.jpg,1,0,0,0,1,,val
0559379_as-2916893.jpg,2,0,1,0,3,,val
0559380_sc-120232.jpg,1,0,0,0,1,,test
0559381_sc-200040.jpg,2,1,1,0,4,,train
0559382_sc-200040.jpg,3,1,2,0,6,,train
0559383_as-3016010.jpg,3,0,0,1,4,,train
0559385_as-0082894.jpg,1,0,0,0,1,,train
0559389_as-0082894.jpg,0,0,1,1,2,,train
0559391_as-0082894.jpg,2,0,1,0,3,,train
0559392_as-0082894.jpg,1,0,1,0,2,,train
0559393_sc-220338.jpg,2,0,0,0,2,,val
0559394_sc-220338.jpg,3,0,0,0,3,,val
0559395_sc-182553.jpg,6,0,0,1,7,,test
0559396_sc-182553.jpg,4,0,0,1,5,,train
0559397_sc-182553.jpg,4,0,0,0,4,,train
0559398_sc-182553.jpg,2,0,0,0,2,,train
0559399_as-0081099.jpg,8,0,0,0,8,,train
0559400_as-0061898.jpg,4,0,0,0,4,,train
0559401_as-0061898.jpg,1,0,0,0,1,,train
0559404_as-0061898.jpg,1,0,0,0,1,,train
0559405_as-0061898.jpg,1,0,0,0,1,,val
0559407_as-0079026.jpg,1,1,3,0,5,,val
0559408_as-0079026.jpg,1,1,2,0,4,,test
0559409_as-0079026.jpg,0,1,2,1,4,,train
0559410_as-0079026.jpg,0,1,1,1,3,,train
0559411_as-7808989.jpg,1,0,0,0,1,,train
0559412_sc-187427.jpg,1,1,0,0,2,,train
0559413_sc-187427.jpg,3,0,0,0,3,,train
0559414_sc-187427.jpg,3,0,0,0,3,,train
0559415_sc-187427.jpg,0,1,1,0,2,,train
0559417_sc-187427.jpg,1,1,0,0,2,,val
0559418_sc-187427.jpg,3,0,0,0,3,,val
0559419_as-5305403.jpg,0,0,2,1,3,,test
0559420_as-0024919.jpg,0,0,2,0,2,,train
0559421_as-0081007.jpg,3,0,2,1,6,,train
0559422_as-0081007.jpg,2,0,2,1,5,,train
0559423_as-0081007.jpg,2,0,1,1,4,,train
0559424_as-0081007.jpg,2,0,1,0,3,,train
0559426_sc-162465.jpg,2,0,1,0,3,,train
0559427_sc-162465.jpg,3,0,1,0,4,,train
0559428_sc-162465.jpg,0,0,1,0,1,,val
0559429_as-0039243.jpg,2,0,0,0,2,,val
0559430_as-0039243.jpg,2,0,0,0,2,,test
0559433_sc-132305.jpg,0,2,0,1,3,,train
0559434_sc-132305.jpg,1,1,0,1,3,,train
0559435_sc-132305.jpg,1,0,0,0,1,,train
0559436_as-3356354.jpg,1,0,1,0,2,,train
0559437_as-0035666.jpg,1,0,0,1,2,,train
0559438_as-0035666.jpg,1,0,0,0,1,,train
0559439_as-0035666.jpg,2,1,0,1,4,,train
0559440_as-0035666.jpg,2,1,0,1,4,,val
0559442_as-3377651.jpg,1,0,1,0,2,,val
0559443_sc-132184.jpg,1,0,0,0,1,,test
0559444_sc-195609.jpg,3,0,0,0,3,,train
0559445_sc-195609.jpg,2,0,0,0,2,,train
0559446_sc-195609.jpg,3,0,0,0,3,,train
0559447_sc-195609.jpg,3,0,0,0,3,,train
0559448_sc-195609.jpg,4,0,0,0,4,,train
0559449_sc-195609.jpg,6,0,0,0,6,,train
0559450_sc-195609.jpg,3,0,0,0,3,,train
0559451_sc-195609.jpg,1,0,0,0,1,,val
0559452_sc-220508.jpg,2,1,0,1,4,,val
0559453_sc-220508.jpg,4,0,1,1,6,,test
0559454_sc-220508.jpg,3,0,2,1,6,,train
0559455_sc-195822.jpg,1,0,0,0,1,,train
0559456_sc-195822.jpg,1,0,0,1,2,,train
0559457_sc-195822.jpg,1,0,0,1,2,,train
0559458_sc-195822.jpg,1,0,0,1,2,,train
0559459_sc-195822.jpg,1,0,0,0,1,,train
0559460_sc-195822.jpg,1,0,0,0,1,,train
0559461_sc-195822.jpg,1,0,0,1,2,,val
0559462_sc-195822.jpg,1,0,0,1,2,,val
0559463_sc-195822.jpg,1,0,0,0,1,,test
0559464_sc-195822.jpg,1,0,0,1,2,,train
0559465_as-2639750.jpg,8,0,0,1,9,,train
0559466_as-3305939.jpg,1,0,1,0,2,,train
0559467_as-0035628.jpg,0,1,0,0,1,,train
0559468_as-0035628.jpg,3,0,0,0,3,,train
0559469_as-2714030.jpg,1,0,0,1,2,,train
0559470_sc-228858.jpg,3,0,0,0,3,,train
0559471_sc-228858.jpg,2,0,0,0,2,,val
0559472_sc-228858.jpg,2,0,0,0,2,,val
0559473_sc-228858.jpg,3,0,0,1,4,,test
0559474_sc-214906.jpg,2,0,0,0,2,,train
0559475_sc-210666.jpg,3,2,0,1,6,,train
0559476_sc-210666.jpg,2,3,2,1,8,,train
0559477_sc-210666.jpg,1,4,2,1,8,,train
0559478_sc-210666.jpg,1,2,2,1,6,,train
0559479_sc-1039679.jpg,0,1,0,0,1,,train
0559480_sc-209977.jpg,2,0,1,0,3,,train
0559481_sc-209977.jpg,2,0,0,0,2,,val
0559482_sc-209977.jpg,4,1,0,0,5,,val
0559483_sc-209977.jpg,2,0,0,0,2,,test
0559484_sc-209977.jpg,3,0,0,0,3,,train
0559485_sc-209977.jpg,2,0,0,0,2,,train
0559486_sc-209977.jpg,2,0,0,0,2,,train
0559487_as-0014405.jpg,1,0,0,0,1,,train
0559488_as-0014405.jpg,1,0,0,0,1,,train
0559489_as-0014405.jpg,1,0,0,0,1,,train
0559490_as-0014405.jpg,1,0,0,0,1,,train
0559491_as-0014405.jpg,1,0,0,0,1,,val
0559492_as-0014405.jpg,1,0,0,0,1,,val
0559493_as-0014405.jpg,1,0,0,0,1,,test
0559494_as-0014405.jpg,1,0,0,0,1,,train
0559495_as-0014405.jpg,1,0,0,0,1,,train
0559496_as-0014405.jpg,1,0,0,0,1,,train
0559497_as-0014405.jpg,1,0,0,0,1,,train
0559498_as-0014405.jpg,1,0,0,0,1,,train
0559499_as-7665643.jpg,1,0,0,0,1,,train
0559500_as-2855860.jpg,1,0,2,0,3,,train
0559501_sc-214520.jpg,1,0,0,1,2,,val
0559502_sc-214520.jpg,1,0,0,1,2,,val
0559503_sc-214520.jpg,2,0,0,1,3,,test
0559505_sc-151736.jpg,3,0,0,0,3,,train
0559506_sc-151736.jpg,4,0,0,0,4,,train
0559507_sc-151736.jpg,2,0,1,0,3,,train
0559508_sc-151736.jpg,0,0,1,0,1,,train
0559510_sc-209255.jpg,2,2,0,0,4,,train
0559513_as-0019590.jpg,1,0,0,0,1,,train
0559514_as-0019590.jpg,1,1,0,0,2,,train
0559515_as-0019590.jpg,1,0,0,0,1,,val
0559516_as-0019590.jpg,1,0,1,1,3,,val
0559517_as-0019590.jpg,1,0,1,1,3,,test
0559518_as-0069791.jpg,2,0,0,0,2,,train
0559519_as-0069791.jpg,2,1,0,0,3,,train
0559520_as-0069791.jpg,1,0,1,0,2,,train
0559521_as-0069791.jpg,0,0,1,0,1,,train
0559522_sc-151305.jpg,1,0,0,1,2,,train
0559523_as-0069518.jpg,1,0,0,1,2,,train
0559525_as-0069518.jpg,1,0,0,1,2,,train
0559526_sc-147415.jpg,2,0,0,0,2,,val
0559527_sc-147415.jpg,2,0,0,0,2,,val
0559529_sc-147415.jpg,1,0,0,0,1,,test
0559530_sc-147415.jpg,1,0,0,1,2,,train
0559534_sc-142451.jpg,3,1,1,2,7,,train
0559535_sc-142451.jpg,1,0,0,1,2,,train
0559536_sc-142451.jpg,0,0,1,0,1,,train
0559537_sc-142451.jpg,0,0,1,0,1,,train
0559539_as-2730266.jpg,1,0,0,1,2,,train
0559540_as-0048389.jpg,1,0,0,0,1,,train
0559541_as-0048389.jpg,2,0,0,0,2,,val
0559542_as-0048389.jpg,1,0,0,0,1,,val
0559543_as-0048389.jpg,1,0,0,0,1,,test
0559544_as-0048389.jpg,2,0,0,0,2,,train
0559545_as-0048389.jpg,1,0,0,0,1,,train
0559546_as-0048389.jpg,1,0,0,0,1,,train
0559547_sc-136025.jpg,5,0,0,0,5,,train
0559548_as-3444546.jpg,1,0,1,1,3,,train
0559549_sc-128161.jpg,1,0,0,0,1,,train
0559550_sc-128161.jpg,1,0,0,0,1,,train
0559551_sc-128161.jpg,0,0,1,0,1,,val
0559552_sc-195720.jpg,2,0,0,0,2,,val
0559553_sc-195720.jpg,1,0,0,0,1,,test
0559554_sc-195720.jpg,1,0,0,0,1,,train
0559555_sc-195720.jpg,1,0,0,0,1,,train
0559556_sc-195720.jpg,2,0,0,0,2,,train
0559557_sc-195720.jpg,2,0,0,0,2,,train
0559558_sc-195720.jpg,1,0,0,0,1,,train
0559559_as-0058889.jpg,1,0,1,0,2,,train
0559562_as-0058889.jpg,1,0,0,1,2,,train
0559563_as-0058889.jpg,0,0,0,1,1,,val
0559564_as-0058889.jpg,1,0,0,1,2,,val
0559565_as-0058889.jpg,1,0,0,1,2,,test
0559566_as-0058889.jpg,1,0,0,1,2,,train
0559568_as-0058889.jpg,1,0,0,0,1,,train
0559571_sc-112057.jpg,1,0,0,0,1,,train
0559576_as-0086579.jpg,1,0,1,0,2,,train
0559577_as-0086579.jpg,1,0,1,0,2,,train
0559579_sc-225225.jpg,1,0,0,0,1,,train
0559580_sc-217972.jpg,0,0,1,0,1,,train
0559581_sc-217972.jpg,1,1,0,0,2,,val
0559582_sc-217972.jpg,1,1,0,0,2,,val
0559584_sc-118439.jpg,4,2,0,0,6,,test
0559585_sc-118439.jpg,4,2,0,0,6,,train
0559586_sc-118439.jpg,4,2,0,0,6,,train
0559587_as-0093509.jpg,2,2,0,0,4,,train
0559588_as-0093509.jpg,3,3,0,0,6,,train
0559590_as-7237125.jpg,6,2,3,1,12,,train
0559591_as-2933701.jpg,1,0,0,1,2,,train
0559594_sc-1026398.jpg,1,0,0,0,1,,train
0559595_sc-169516.jpg,0,0,1,0,1,,val
0559597_as-3160105.jpg,0,0,1,0,1,,val
0559598_sc-139396.jpg,2,0,0,0,2,,test
0559599_sc-139396.jpg,1,0,0,0,1,,train
0559600_sc-139396.jpg,2,0,0,0,2,,train
0559601_sc-1041232.jpg,1,0,0,1,2,,train
0559602_sc-1041232.jpg,2,0,0,1,3,,train
0559603_sc-1041232.jpg,3,0,0,1,4,,train
0559604_sc-1031072.jpg,0,0,1,0,1,,train
0559605_sc-206666.jpg,1,0,0,0,1,,train
0559606_sc-206666.jpg,1,0,0,0,1,,val
0559607_sc-206666.jpg,1,0,0,0,1,,val
0559608_sc-1019807.jpg,0,2,0,0,2,,test
0559609_sc-1019807.jpg,1,5,1,0,7,,train
0559610_sc-1019807.jpg,6,0,0,0,6,,train
0559611_sc-210269.jpg,3,0,0,0,3,,train
0559612_sc-210269.jpg,3,0,0,0,3,,train
0559613_sc-210269.jpg,3,0,0,0,3,,train
0559614_sc-186356.jpg,2,0,0,0,2,,train
0559615_as-0053572.jpg,1,1,0,0,2,,train
0559616_as-0053572.jpg,1,1,0,0,2,,val
0559617_sc-1015245.jpg,3,0,0,0,3,,val
0559618_sc-1029374.jpg,0,0,1,0,1,,test
0559619_sc-1029374.jpg,1,0,0,0,1,,train
0559620_sc-1029374.jpg,1,0,0,0,1,,train
0559623_sc-145889.jpg,2,0,1,0,3,,train
0559624_sc-145889.jpg,1,0,0,0,1,,train
0559626_as-0053322.jpg,5,0,1,1,7,,train
0559627_as-0053322.jpg,3,0,1,1,5,,train
0559628_as-0053322.jpg,2,0,1,1,4,,train
0559629_as-3244526.jpg,1,1,0,0,2,,val
0559630_as-3244526.jpg,3,0,1,0,4,,val
0559631_as-2902862.jpg,2,0,0,0,2,,test
0559632_as-0044613.jpg,2,1,0,0,3,,train
0559634_sc-104586.jpg,1,0,0,0,1,,train
0559635_sc-104586.jpg,1,0,0,1,2,,train
0559636_as-0029764.jpg,6,0,0,0,6,,train
0559637_as-0029764.jpg,4,0,0,0,4,,train
0559638_as-0029764.jpg,2,1,0,0,3,,train
0559639_as-0029764.jpg,9,1,1,0,11,,train
0559640_as-0029764.jpg,4,1,0,0,5,,val
0559641_as-0029764.jpg,0,0,0,1,1,,val
0559642_as-0029764.jpg,1,0,0,0,1,,test
0559643_as-3445632.jpg,4,3,0,0,7,,train
0559644_sc-189083.jpg,1,0,1,0,2,,train
0559645_sc-207029.jpg,0,0,0,1,1,,train
0559646_as-2853283.jpg,1,0,0,0,1,,train
0559648_as-0018978.jpg,3,0,0,0,3,,train
0559649_as-0018978.jpg,2,0,0,0,2,,train
0559652_as-0045771.jpg,5,1,0,0,6,,train
0559653_as-0045771.jpg,3,1,0,0,4,,val
0559654_as-0045771.jpg,2,1,0,0,3,,val
0559656_as-0045771.jpg,3,1,0,0,4,,test
0559657_as-2705624.jpg,3,0,0,0,3,,train
0559659_sc-229647.jpg,2,0,1,0,3,,train
0559661_sc-150661.jpg,1,0,0,0,1,,train
0559662_sc-150661.jpg,2,0,0,0,2,,train
0559664_sc-144753.jpg,1,1,0,0,2,,train
0559666_sc-144753.jpg,2,1,0,0,3,,train
0559670_as-0002039.jpg,3,0,0,0,3,,train
0559671_as-0002039.jpg,2,0,1,0,3,,val
0559672_as-0002039.jpg,2,0,1,0,3,,val
0559673_as-0002039.jpg,2,0,0,0,2,,test
0559674_as-0002039.jpg,1,0,0,0,1,,train
0559675_as-0002039.jpg,1,0,0,0,1,,train
0559677_as-0075280.jpg,3,0,0,0,3,,train
0559678_as-0075280.jpg,3,0,0,0,3,,train
0559679_sc-191207.jpg,1,0,1,0,2,,train
0559680_sc-173270.jpg,7,0,0,0,7,,train
0559681_as-2561350.jpg,1,0,0,0,1,,train
0559682_as-3369283.jpg,0,1,0,0,1,,val
0559683_sc-176181.jpg,3,0,0,1,4,,val
0559684_sc-176181.jpg,3,0,0,1,4,,test
0559686_sc-176181.jpg,2,0,0,1,3,,train
0559687_as-3111136.jpg,2,0,2,1,5,,train
0559688_as-2678945.jpg,3,0,1,1,5,,train
0559689_as-7583384.jpg,2,0,0,0,2,,train
0559690_as-0009398.jpg,0,1,0,0,1,,train
0559691_sc-153982.jpg,1,0,0,0,1,,train
0559692_sc-153982.jpg,1,0,0,0,1,,train
0559694_as-0073537.jpg,1,0,0,1,2,,val
0559695_as-0073537.jpg,1,0,0,1,2,,val
0559696_as-0073537.jpg,1,0,0,1,2,,test
0559697_as-0073537.jpg,1,0,0,1,2,,train
0559698_as-3149926.jpg,4,0,0,0,4,,train
0559701_as-2803939.jpg,1,0,1,0,2,,train
0559702_as-0042088.jpg,0,0,1,0,1,,train
0559703_as-0042088.jpg,1,0,1,0,2,,train
0559704_as-0042088.jpg,2,0,1,0,3,,train
0559705_as-0042088.jpg,0,0,1,0,1,,train
0559707_as-0016657.jpg,2,0,0,0,2,,val
0559709_as-0016657.jpg,2,0,0,0,2,,val
0559710_as-0016657.jpg,2,0,0,0,2,,test
0559711_as-0016657.jpg,2,0,1,0,3,,train
0559712_as-0016657.jpg,2,0,1,0,3,,train
0559713_as-0016657.jpg,1,0,1,0,2,,train
0559714_as-0016657.jpg,1,0,0,0,1,,train
0559716_as-0016657.jpg,3,4,2,0,9,,train
0559717_as-0016657.jpg,1,2,1,0,4,,train
0559718_as-0016657.jpg,2,1,1,0,4,,train
0559719_as-0016657.jpg,1,4,4,1,10,,val
0559720_as-0016657.jpg,0,0,1,0,1,,val
0559721_as-0016657.jpg,2,0,1,0,3,,test
0559722_as-0016657.jpg,1,0,1,0,2,,train
0559723_as-0016657.jpg,1,0,1,0,2,,train
0559724_sc-181603.jpg,4,0,0,0,4,,train
0559725_sc-181603.jpg,4,0,0,0,4,,train
0559726_sc-181603.jpg,12,0,1,0,13,,train
0559727_sc-181603.jpg,3,0,0,1,4,,train
0559728_sc-181603.jpg,5,0,0,1,6,,train
0559729_sc-181603.jpg,4,0,0,0,4,,val
0559730_sc-181603.jpg,4,0,0,0,4,,val
0559731_sc-181603.jpg,1,0,0,1,2,,test
0559733_sc-1040902.jpg,8,4,1,1,14,,train
0559734_sc-162522.jpg,2,0,0,0,2,,train
0559735_sc-162522.jpg,1,0,0,0,1,,train
0559736_sc-162522.jpg,2,0,1,0,3,,train
0559737_sc-162522.jpg,3,0,0,0,3,,train
0559738_sc-162522.jpg,2,0,0,0,2,,train
0559741_as-2513356.jpg,3,1,1,1,6,,train
0559743_as-0072339.jpg,1,0,0,1,2,,val
0559744_as-0072339.jpg,1,0,0,0,1,,val
0559745_as-0072339.jpg,1,0,0,0,1,,test
0559746_as-3251263.jpg,1,0,0,0,1,,train
0559747_sc-143970.jpg,6,1,0,0,7,,train
0559748_sc-143970.jpg,2,0,0,0,2,,train
0559750_sc-143970.jpg,6,1,0,0,7,,train
0559752_as-0006979.jpg,0,0,1,1,2,,train
0559753_as-0006979.jpg,2,2,1,2,7,,train
0559754_as-0006979.jpg,0,0,1,1,2,,train
0559757_as-0062368.jpg,1,0,0,1,2,,val
0559758_as-0081682.jpg,1,0,0,1,2,,val
0559760_as-0081682.jpg,2,0,0,1,3,,test
0559761_as-0081682.jpg,1,0,0,0,1,,train
0559762_as-0081682.jpg,5,0,0,2,7,,train
0559763_as-0081682.jpg,1,0,0,1,2,,train
0559764_as-0081682.jpg,2,0,0,1,3,,train
0559765_as-0081682.jpg,1,0,0,1,2,,train
0559767_as-0081682.jpg,1,0,0,0,1,,train
0559768_as-0081682.jpg,1,1,0,0,2,,train
0559769_as-0071110.jpg,2,0,1,1,4,,val
0559770_as-0071110.jpg,1,0,0,0,1,,val
0559771_as-0071110.jpg,1,0,1,1,3,,test
0559772_as-0071110.jpg,1,0,1,1,3,,train
0559773_as-0071110.jpg,1,0,1,1,3,,train
0559774_sc-122056.jpg,2,0,0,0,2,,train
0559775_sc-122056.jpg,2,0,0,0,2,,train
0559776_sc-122056.jpg,1,0,0,0,1,,train
0559777_as-9030528.jpg,2,0,0,0,2,,train
0559778_as-2646400.jpg,4,0,0,0,4,,train
0559781_sc-1026252.jpg,3,0,0,1,4,,val
0559783_as-3399566.jpg,1,0,1,0,2,,val
0559784_as-2972314.jpg,1,0,0,0,1,,test
0559786_as-0083470.jpg,8,0,0,0,8,,train
0559787_as-0083470.jpg,2,0,0,0,2,,train
0559788_as-0083470.jpg,3,0,1,0,4,,train
0559789_as-0083470.jpg,2,0,0,0,2,,train
0559790_as-0083470.jpg,6,0,0,1,7,,train
0559791_as-0083470.jpg,4,0,0,0,4,,train
0559792_sc-195107.jpg,2,0,0,0,2,,train
0559793_sc-195107.jpg,1,0,0,0,1,,val
0559795_as-3175795.jpg,1,0,0,0,1,,val
0559797_as-0054445.jpg,1,0,0,0,1,,test
0559798_as-0054445.jpg,1,0,0,0,1,,train
0559799_sc-226655.jpg,4,0,0,0,4,,train
0559800_sc-226655.jpg,2,0,0,0,2,,train
0559801_sc-226655.jpg,8,0,0,2,10,,train
0559802_sc-226655.jpg,5,0,0,1,6,,train
0559803_sc-157913.jpg,6,0,0,0,6,,train
0559804_sc-157913.jpg,4,0,0,0,4,,train
0559805_sc-157913.jpg,2,0,0,0,2,,val
0559806_sc-113376.jpg,2,0,0,0,2,,val
0559807_sc-113376.jpg,1,0,0,0,1,,test
0559808_as-2526208.jpg,1,0,1,0,2,,train
0559809_as-2709506.jpg,1,1,0,0,2,,train
0559810_as-7282235.jpg,4,0,1,1,6,,train
0559811_sc-134790.jpg,1,0,1,0,2,,train
0559812_sc-134790.jpg,1,0,0,0,1,,train
0559813_sc-134790.jpg,1,0,0,0,1,,train
0559814_as-0002531.jpg,0,1,0,0,1,,train
0559815_as-0002531.jpg,0,1,0,0,1,,val
0559816_as-0085818.jpg,2,0,0,0,2,,val
0559817_as-0085818.jpg,1,0,0,0,1,,test
0559818_as-0019311.jpg,5,0,1,0,6,,train
0559819_as-0019311.jpg,4,0,1,0,5,,train
0559820_as-0019311.jpg,6,0,1,0,7,,train
0559821_as-0019311.jpg,3,0,1,0,4,,train
0559822_as-0005471.jpg,2,0,0,0,2,,train
0559829_as-7168926.jpg,1,0,1,1,3,,train
0559830_as-7248835.jpg,8,0,1,0,9,,train
0559831_sc-210741.jpg,1,0,0,1,2,,val
0559832_sc-210741.jpg,1,0,0,1,2,,val
0559833_sc-210741.jpg,1,0,1,1,3,,test
0559834_sc-210741.jpg,1,0,0,0,1,,train
0559835_sc-210741.jpg,1,0,0,0,1,,train
0559836_as-2623602.jpg,4,1,1,0,6,,train
0559838_as-0051051.jpg,2,0,1,1,4,,train
0559839_as-0051051.jpg,2,0,1,1,4,,train
0559840_as-0036769.jpg,1,1,0,0,2,,train
0559841_as-0036769.jpg,2,0,1,0,3,,train
0559842_as-0036769.jpg,1,1,0,0,2,,val
0559843_as-0036769.jpg,1,0,0,0,1,,val
0559844_as-0036769.jpg,3,0,0,1,4,,test
0559845_sc-205508.jpg,2,0,0,0,2,,train
0559846_sc-205508.jpg,4,0,0,0,4,,train
0559847_sc-205508.jpg,2,0,0,2,4,,train
0559848_sc-200779.jpg,1,0,0,0,1,,train
0559849_as-3350575.jpg,1,1,1,2,5,,train
0559851_as-2676819.jpg,2,0,0,0,2,,train
0559852_as-9071290.jpg,1,0,0,1,2,,train
0559853_sc-1000094.jpg,1,0,0,0,1,,val
0559854_sc-174884.jpg,5,0,2,0,7,,val
0559855_sc-1028165.jpg,2,0,0,1,3,,test
0559856_sc-1028165.jpg,2,0,0,0,2,,train
0559857_sc-1028165.jpg,3,0,0,1,4,,train
0559858_as-2862165.jpg,2,0,0,0,2,,train
0559859_as-2606993.jpg,1,1,0,0,2,,train
0559860_sc-1036480.jpg,2,0,0,2,4,,train
0559861_sc-1036480.jpg,3,0,0,2,5,,train
0559862_as-2891036.jpg,2,0,2,0,4,,train
0559863_as-7293910.jpg,1,2,1,0,4,,val
0559864_as-2854535.jpg,0,2,1,0,3,,val
0559866_as-9077411.jpg,1,0,0,0,1,,test
0559867_as-0004698.jpg,1,0,1,0,2,,train
0559868_sc-104366.jpg,2,0,0,1,3,,train
0559872_as-0059039.jpg,1,0,1,0,2,,train
0559873_as-0059039.jpg,3,0,1,1,5,,train
0559874_as-0059039.jpg,1,0,0,0,1,,train
0559875_as-0059039.jpg,1,1,1,1,4,,train
0559876_sc-1004615.jpg,1,1,0,0,2,,train
0559877_sc-1004615.jpg,4,1,0,0,5,,val
0559878_sc-1004615.jpg,4,1,0,0,5,,val
0559879_sc-1004615.jpg,2,0,0,0,2,,test
0559880_sc-1004615.jpg,4,0,0,0,4,,train
0559881_as-0007728.jpg,3,0,0,0,3,,train
0559882_sc-159505.jpg,4,2,0,0,6,,train
0559883_sc-159505.jpg,1,0,0,0,1,,train
0559884_sc-159505.jpg,3,0,0,0,3,,train
0559888_as-0036534.jpg,1,0,0,0,1,,train
0559889_as-0036534.jpg,1,0,0,0,1,,train
0559891_as-0036534.jpg,1,0,0,0,1,,val
0559892_as-0036534.jpg,1,0,1,0,2,,val
0559893_as-0036534.jpg,2,0,1,1,4,,test
0559894_as-0036534.jpg,1,0,0,0,1,,train
0559897_as-3109802.jpg,2,0,1,1,4,,train
0559898_as-0013784.jpg,6,0,0,0,6,,train
0559899_as-0013784.jpg,2,0,0,0,2,,train
0559900_as-0013784.jpg,1,0,0,0,1,,train
0559901_as-0013784.jpg,4,0,3,0,7,,train
0559902_as-0013784.jpg,2,0,0,0,2,,train
0559903_as-0013784.jpg,2,0,0,0,2,,val
0559904_as-0013784.jpg,1,0,0,0,1,,val
0559905_sc-1001365.jpg,1,0,0,0,1,,test
0559906_as-0071499.jpg,1,0,0,0,1,,train
0559907_as-0071499.jpg,1,0,0,0,1,,train
0559908_as-0071499.jpg,1,0,0,0,1,,train
0559909_as-0071499.jpg,1,0,0,0,1,,train
0559910_as-0071499.jpg,1,0,0,0,1,,train
0559911_as-0071499.jpg,1,0,0,0,1,,train
0559912_as-0071499.jpg,1,0,0,0,1,,train
0559913_as-0071499.jpg,1,0,0,0,1,,val
0559914_as-0071499.jpg,1,0,0,0,1,,val
0559915_as-0071499.jpg,1,0,0,0,1,,test
0559916_as-0071499.jpg,1,0,0,0,1,,train
0559921_as-0008263.jpg,2,0,0,0,2,,train
0559922_as-0008263.jpg,2,0,0,0,2,,train
0559923_sc-1003870.jpg,2,3,1,0,6,,train
0559925_as-2511058.jpg,1,0,0,0,1,,train
0559926_as-0033093.jpg,2,0,0,0,2,,train
0559927_as-0033093.jpg,3,0,0,0,3,,train
0559928_as-0033093.jpg,1,0,0,0,1,,val
0559929_as-0033093.jpg,1,0,0,0,1,,val
0559930_as-0033093.jpg,1,0,0,0,1,,test
0559931_as-0033093.jpg,1,0,0,1,2,,train
0559932_as-0033093.jpg,1,0,0,0,1,,train
0559933_as-0033093.jpg,1,0,0,0,1,,train
0559934_as-0033093.jpg,1,0,1,0,2,,train
0559936_as-0033093.jpg,1,0,0,0,1,,train
0559937_as-0033093.jpg,1,1,1,0,3,,train
0559938_as-0033093.jpg,5,0,1,0,6,,train
0559940_as-2667470.jpg,1,1,4,2,8,,val
0559941_sc-144663.jpg,2,0,0,1,3,,val
0559942_sc-144663.jpg,2,0,0,0,2,,test
0559943_sc-144663.jpg,2,0,0,0,2,,train
0559944_sc-144663.jpg,2,0,0,0,2,,train
0559945_sc-144663.jpg,2,0,0,0,2,,train
0559946_sc-144663.jpg,3,0,0,1,4,,train
0559949_as-0029481.jpg,2,0,0,0,2,,train
0559950_as-0029481.jpg,2,0,0,0,2,,train
0559951_as-0029481.jpg,3,0,0,0,3,,train
0559952_as-0029481.jpg,3,0,0,0,3,,val
0559955_as-2528946.jpg,1,0,1,1,3,,val
0559956_sc-166206.jpg,1,0,0,0,1,,test
0559957_sc-166206.jpg,1,0,0,0,1,,train
0559958_sc-166206.jpg,5,0,0,0,5,,train
0559959_sc-166206.jpg,1,0,0,0,1,,train
0559961_as-0035484.jpg,1,0,1,0,2,,train
0559962_as-0035484.jpg,1,0,1,0,2,,train
0559963_as-0035484.jpg,1,0,0,0,1,,train
0559965_as-0035484.jpg,1,0,0,0,1,,train
0559966_sc-179549.jpg,5,1,0,0,6,,val
0559967_sc-130305.jpg,3,1,0,0,4,,val
0559968_sc-130305.jpg,1,1,0,0,2,,test
0559969_sc-212633.jpg,1,0,1,1,3,,train
0559970_sc-212633.jpg,2,0,0,1,3,,train
0559971_as-3372686.jpg,2,0,0,0,2,,train
0559972_sc-149916.jpg,0,1,0,0,1,,train
0559973_sc-1006643.jpg,1,0,0,0,1,,train
0559974_sc-1006643.jpg,2,0,1,0,3,,train
0559975_sc-1006643.jpg,2,0,1,0,3,,train
0559978_sc-1006643.jpg,2,0,1,0,3,,val
0559979_sc-1006643.jpg,1,0,1,0,2,,val
0559981_as-0022010.jpg,3,0,0,2,5,,test
0559982_as-0022010.jpg,3,0,1,2,6,,train
0559983_as-0022010.jpg,1,0,0,1,2,,train
0559984_as-0022010.jpg,1,0,0,0,1,,train
0559985_as-0022010.jpg,2,0,0,0,2,,train
0559986_sc-1038553.jpg,4,0,0,0,4,,train
0559987_as-2864757.jpg,1,0,1,2,4,,train
0559988_as-2599600.jpg,1,0,0,0,1,,train
0559989_sc-1035915.jpg,1,0,0,0,1,,val
0559990_sc-193088.jpg,1,1,0,0,2,,val
0559991_as-7209219.jpg,1,1,3,1,6,,test
0559992_as-3182042.jpg,0,1,0,0,1,,train
0559993_as-9002627.jpg,2,0,0,0,2,,train
0559994_as-3303088.jpg,1,1,0,0,2,,train
0559995_as-2531737.jpg,1,0,0,0,1,,train
0559996_as-0085386.jpg,3,0,0,0,3,,train
0559999_as-0085386.jpg,1,0,0,0,1,,train
0560000_as-3327106.jpg,1,0,0,0,1,,train
0560001_as-5385892.jpg,4,0,1,0,5,,val
0560005_sc-226121.jpg,1,0,0,0,1,,val
0560006_sc-226121.jpg,1,0,0,0,1,,test
0560007_sc-226121.jpg,1,1,1,0,3,,train
0560008_sc-226121.jpg,1,1,1,0,3,,train
0560009_sc-226121.jpg,1,0,0,0,1,,train
0560010_sc-226121.jpg,1,0,0,0,1,,train
0560011_sc-226121.jpg,1,0,0,0,1,,train
0560012_sc-226121.jpg,2,1,1,0,4,,train
0560013_sc-226121.jpg,2,0,0,0,2,,train
0560014_sc-1021520.jpg,2,5,3,0,10,,val
0560015_sc-1021520.jpg,2,0,1,2,5,,val
0560016_sc-1021520.jpg,1,0,0,0,1,,test
0560017_sc-1021520.jpg,7,5,3,0,15,,train
0560018_sc-1021520.jpg,2,1,1,1,5,,train
0560019_sc-1021520.jpg,4,5,0,0,9,,train
0560023_as-3403120.jpg,2,0,1,1,4,,train
0560024_sc-1013883.jpg,1,0,1,0,2,,train
0560025_sc-1013883.jpg,2,0,0,0,2,,train
0560026_sc-1013883.jpg,1,0,0,0,1,,train
0560027_sc-1013883.jpg,1,0,1,0,2,,val
0560028_sc-1013883.jpg,1,0,0,0,1,,val
0560030_as-0058825.jpg,9,1,2,0,12,,test
0560031_as-0058825.jpg,6,0,1,0,7,,train
0560032_as-0058825.jpg,5,0,2,0,7,,train
0560033_as-0058825.jpg,2,0,1,0,3,,train
0560034_as-0058825.jpg,2,0,1,0,3,,train
0560035_as-3141860.jpg,3,0,2,1,6,,train
0560037_sc-160805.jpg,0,0,1,1,2,,train
0560038_sc-160805.jpg,1,0,1,1,3,,train
0560039_sc-160805.jpg,1,0,0,0,1,,val
0560041_sc-160805.jpg,2,0,1,0,3,,val
0560042_sc-160805.jpg,3,1,0,0,4,,test
0560044_sc-174446.jpg,6,1,1,0,8,,train
0560045_as-3214995.jpg,1,0,0,0,1,,train
0560046_as-0083317.jpg,1,0,0,0,1,,train
0560047_as-0083317.jpg,2,0,0,0,2,,train
0560049_as-0019475.jpg,2,0,0,0,2,,train
0560050_as-0019475.jpg,2,0,0,0,2,,train
0560051_as-3144272.jpg,0,0,1,0,1,,train
0560052_as-0063949.jpg,1,0,0,0,1,,val
0560056_sc-175020.jpg,1,0,2,0,3,,val
0560057_as-2521289.jpg,2,0,0,0,2,,test
0560058_sc-1040732.jpg,3,0,0,0,3,,train
0560060_sc-1040982.jpg,0,0,0,1,1,,train
0560061_sc-1040982.jpg,1,0,0,0,1,,train
0560062_sc-1040982.jpg,1,0,0,1,2,,train
0560064_as-0066111.jpg,1,0,0,0,1,,train
0560065_as-3315563.jpg,2,1,1,0,4,,train
0560066_sc-220509.jpg,1,0,0,0,1,,train
0560067_sc-220509.jpg,1,0,1,0,2,,val
0560068_sc-220509.jpg,2,0,1,0,3,,val
0560069_sc-220509.jpg,6,0,0,0,6,,test
0560070_sc-1038841.jpg,7,0,1,0,8,,train
0560071_sc-1038841.jpg,5,0,1,0,6,,train
0560073_as-3261716.jpg,1,0,1,1,3,,train
0560075_as-0027135.jpg,1,0,0,0,1,,train
0560078_as-0011013.jpg,1,1,1,0,3,,train
0560079_as-0011013.jpg,1,0,0,0,1,,train
0560080_as-0011013.jpg,1,0,1,0,2,,train
0560081_as-0011013.jpg,0,0,1,0,1,,val
0560082_as-0073602.jpg,0,0,1,0,1,,val
0560083_as-0073602.jpg,8,0,0,0,8,,test
0560084_as-0073602.jpg,2,0,0,0,2,,train
0560085_as-3307639.jpg,1,0,1,1,3,,train
0560086_sc-126356.jpg,1,1,0,0,2,,train
0560087_sc-186977.jpg,1,0,0,0,1,,train
0560088_as-3143637.jpg,3,0,0,1,4,,train
0560089_sc-1016679.jpg,2,0,2,1,5,,train
0560091_sc-1016679.jpg,2,0,2,3,7,,train
0560093_as-7426993.jpg,2,1,0,3,6,,val
0560095_as-2891313.jpg,3,0,0,0,3,,val
0560096_sc-1025046.jpg,3,0,0,0,3,,test
0560097_as-0036570.jpg,2,0,0,0,2,,train
0560099_as-0036570.jpg,1,0,0,1,2,,train
0560100_as-0036570.jpg,1,0,1,1,3,,train
0560101_as-0036570.jpg,3,0,1,1,5,,train
0560102_as-0036570.jpg,1,0,1,1,3,,train
0560104_as-3221684.jpg,1,4,1,1,7,,train
0560105_sc-105859.jpg,1,0,0,0,1,,train
0560107_sc-120915.jpg,3,0,0,0,3,,val
0560108_sc-120915.jpg,6,0,0,0,6,,val
0560109_as-2677504.jpg,2,0,0,0,2,,test
0560110_sc-1023360.jpg,1,0,0,0,1,,train
0560111_sc-1023360.jpg,1,0,0,0,1,,train
0560112_sc-1023360.jpg,2,0,0,0,2,,train
0560113_sc-1023360.jpg,2,0,0,0,2,,train
0560114_sc-1023360.jpg,4,0,0,1,5,,train
0560115_sc-1023360.jpg,1,0,1,0,2,,train
0560117_as-7584214.jpg,5,0,0,0,5,,train
0560118_sc-107566.jpg,1,0,0,0,1,,val
0560119_as-7722124.jpg,1,2,2,4,9,,val
0560120_sc-192680.jpg,1,0,1,1,3,,test
0560122_as-0022015.jpg,1,0,1,0,2,,train
0560123_as-2952678.jpg,1,0,0,0,1,,train
0560125_as-0069189.jpg,3,0,0,0,3,,train
0560126_as-0069189.jpg,1,0,0,0,1,,train
0560127_sc-200090.jpg,2,0,0,1,3,,train
0560128_sc-200090.jpg,1,0,0,1,2,,train
0560129_sc-200090.jpg,2,0,0,0,2,,train
0560130_sc-200090.jpg,1,0,0,0,1,,val
0560131_sc-200090.jpg,3,0,0,0,3,,val
0560132_sc-200090.jpg,2,0,0,0,2,,test
0560133_sc-200090.jpg,3,0,0,1,4,,train
0560134_sc-200090.jpg,2,0,0,1,3,,train
0560135_sc-200090.jpg,3,0,0,1,4,,train
0560136_sc-200090.jpg,2,0,0,0,2,,train
0560137_as-0000239.jpg,3,0,1,1,5,,train
0560138_as-0000239.jpg,1,0,1,2,4,,train
0560139_as-0000239.jpg,1,0,0,1,2,,train
0560140_as-0000239.jpg,1,0,0,1,2,,val
0560141_as-0000239.jpg,1,0,0,0,1,,val
0560142_as-0000239.jpg,2,0,0,0,2,,test
0560143_as-0000239.jpg,1,0,0,1,2,,train
0560144_as-0000239.jpg,1,0,0,1,2,,train
0560145_sc-1036580.jpg,3,1,1,0,5,,train
0560146_as-0028379.jpg,1,0,0,0,1,,train
0560147_as-0028379.jpg,1,0,0,0,1,,train
0560150_as-7807967.jpg,0,0,0,1,1,,train
0560152_sc-188543.jpg,1,0,0,0,1,,train
0560153_sc-188543.jpg,0,1,1,0,2,,val
0560154_sc-188543.jpg,1,1,1,0,3,,val
0560155_sc-188543.jpg,0,0,1,0,1,,test
0560156_as-3036564.jpg,1,0,0,0,1,,train
0560157_as-3036564.jpg,1,1,3,1,6,,train
0560158_sc-110391.jpg,2,0,0,0,2,,train
0560159_sc-110391.jpg,1,0,0,1,2,,train
0560160_sc-110391.jpg,3,0,0,1,4,,train
0560161_sc-110391.jpg,2,1,0,1,4,,train
0560162_sc-110391.jpg,1,0,0,0,1,,train
0560163_sc-110391.jpg,1,0,0,0,1,,val
0560164_sc-110391.jpg,1,0,0,0,1,,val
0560165_sc-110391.jpg,2,1,0,0,3,,test
0560166_sc-110391.jpg,0,2,0,0,2,,train
0560167_sc-110391.jpg,2,0,0,0,2,,train
0560168_as-7454381.jpg,1,0,2,0,3,,train
0560169_sc-155847.jpg,1,0,1,0,2,,train
0560171_sc-155847.jpg,5,0,0,0,5,,train
0560173_as-9011631.jpg,1,0,0,0,1,,train
0560174_sc-120521.jpg,4,0,0,0,4,,train
0560175_sc-120521.jpg,2,0,0,0,2,,val
0560178_sc-1009282.jpg,1,0,0,0,1,,val
0560179_sc-1009282.jpg,1,0,0,0,1,,test
0560180_sc-1009282.jpg,1,0,0,0,1,,train
0560181_sc-1009282.jpg,1,0,0,0,1,,train
0560182_sc-1009282.jpg,1,0,1,0,2,,train
0560183_sc-1009282.jpg,1,2,2,1,6,,train
0560185_sc-1009282.jpg,0,1,1,1,3,,train
0560186_sc-1009282.jpg,3,0,1,2,6,,train
0560187_sc-1009282.jpg,2,1,1,0,4,,train
0560189_sc-130299.jpg,2,0,1,2,5,,val
0560190_sc-130299.jpg,1,1,2,0,4,,val
0560191_sc-130299.jpg,1,1,2,0,4,,test
0560192_sc-130299.jpg,2,1,2,0,5,,train
0560193_as-0033349.jpg,1,0,1,0,2,,train
0560194_as-0033349.jpg,2,1,1,1,5,,train
0560195_as-0033349.jpg,1,1,0,1,3,,train
0560196_sc-141579.jpg,0,1,0,0,1,,train
0560197_sc-141579.jpg,0,1,0,0,1,,train
0560198_as-3218721.jpg,2,0,0,0,2,,train
0560205_as-0096953.jpg,1,0,0,0,1,,val
0560206_sc-1014724.jpg,1,0,0,0,1,,val
0560207_as-0073862.jpg,4,1,0,0,5,,test
0560208_as-0073862.jpg,4,1,0,0,5,,train
0560209_as-0073862.jpg,4,1,0,0,5,,train
0560210_as-0073862.jpg,4,1,0,0,5,,train
0560211_as-0073862.jpg,4,1,0,0,5,,train
0560212_as-7212307.jpg,1,1,0,0,2,,train
0560214_sc-1001166.jpg,2,0,1,0,3,,train
0560215_sc-1001166.jpg,1,0,1,0,2,,train
0560216_as-7990454.jpg,1,0,1,0,2,,val
0560217_sc-111966.jpg,2,0,1,0,3,,val
0560218_sc-111966.jpg,4,0,1,0,5,,test
0560219_sc-111966.jpg,3,0,1,0,4,,train
0560220_sc-111966.jpg,1,0,1,0,2,,train
0560221_as-3477245.jpg,15,0,8,4,27,,train
0560223_as-0005323.jpg,1,0,0,0,1,,train
0560224_as-0005323.jpg,1,0,0,0,1,,train
0560225_as-0041068.jpg,2,0,0,0,2,,train
0560228_sc-130444.jpg,0,2,0,0,2,,train
0560229_sc-130444.jpg,2,1,0,0,3,,val
0560230_sc-117773.jpg,0,1,0,0,1,,val
0560234_as-3349492.jpg,4,0,0,1,5,,test
0560235_as-3453564.jpg,1,0,0,0,1,,train
0560236_sc-1040270.jpg,2,1,0,0,3,,train
0560237_sc-1040270.jpg,3,0,0,0,3,,train
0560238_sc-1040270.jpg,2,1,0,0,3,,train
0560240_sc-143771.jpg,1,0,1,0,2,,train
0560241_sc-143771.jpg,1,0,0,0,1,,train
0560244_sc-143771.jpg,1,0,0,0,1,,train
0560245_sc-191419.jpg,3,0,0,0,3,,val
0560246_as-0060697.jpg,1,0,0,0,1,,val
0560247_as-0060697.jpg,1,0,0,1,2,,test
0560248_as-0060697.jpg,1,0,0,0,1,,train
0560249_as-0060697.jpg,1,0,1,0,2,,train
0560251_sc-192195.jpg,2,1,1,0,4,,train
0560253_as-7582563.jpg,1,0,2,0,3,,train
0560254_sc-140193.jpg,4,0,1,1,6,,train
0560255_sc-140193.jpg,5,1,1,2,9,,train
0560256_sc-140193.jpg,4,1,0,2,7,,train
0560257_as-0033035.jpg,1,0,1,1,3,,val
0560258_as-0033035.jpg,2,0,1,1,4,,val
0560259_as-0033035.jpg,1,0,1,1,3,,test
0560264_sc-205188.jpg,2,2,1,1,6,,train
0560265_sc-205188.jpg,1,1,1,1,4,,train
0560266_sc-205188.jpg,2,2,1,1,6,,train
0560267_sc-205188.jpg,2,2,1,1,6,,train
0560268_sc-205188.jpg,2,2,1,1,6,,train
0560269_sc-205188.jpg,2,2,1,2,7,,train
0560271_as-7959355.jpg,2,0,0,0,2,,train
0560272_as-7798825.jpg,4,0,0,0,4,,val
0560273_as-0087364.jpg,1,0,0,0,1,,val
0560274_as-0087364.jpg,1,0,0,0,1,,test
0560275_as-0087364.jpg,1,0,0,0,1,,train
0560276_as-0087364.jpg,3,0,0,0,3,,train
0560277_as-0087364.jpg,4,0,0,0,4,,train
0560278_sc-1007220.jpg,2,2,0,0,4,,train
0560279_sc-1007220.jpg,3,0,0,0,3,,train
0560280_sc-1007220.jpg,5,0,0,0,5,,train
0560281_sc-1007220.jpg,1,0,0,0,1,,train
0560283_as-0082690.jpg,6,0,0,0,6,,val
0560284_as-0082690.jpg,4,0,0,0,4,,val
0560285_as-0082690.jpg,2,0,0,0,2,,test
0560286_as-0082690.jpg,1,0,1,0,2,,train
0560287_as-0082690.jpg,1,0,1,0,2,,train
0560288_as-0082690.jpg,2,0,2,0,4,,train
0560289_as-0082690.jpg,3,0,1,0,4,,train
0560291_as-0040779.jpg,4,1,0,1,6,,train
0560295_as-0040779.jpg,1,0,0,0,1,,train
0560296_as-0040779.jpg,1,0,0,0,1,,train
0560297_as-0040779.jpg,1,0,0,0,1,,val
0560298_as-0040779.jpg,3,0,0,0,3,,val
0560299_as-0040779.jpg,1,0,1,0,2,,test
0560300_as-0040779.jpg,0,0,1,0,1,,train
0560301_as-0040779.jpg,1,0,0,0,1,,train
0560302_as-0040779.jpg,1,0,0,0,1,,train
0560303_as-0040779.jpg,1,0,0,0,1,,train
0560305_as-0066741.jpg,2,0,0,0,2,,train
0560306_sc-217107.jpg,1,0,0,0,1,,train
0560307_sc-217107.jpg,2,0,1,0,3,,train
0560308_sc-191512.jpg,2,0,0,0,2,,val
0560309_sc-191512.jpg,1,1,0,0,2,,val
0560310_sc-1027508.jpg,0,1,0,0,1,,test
0560312_sc-193473.jpg,3,0,0,0,3,,train
0560313_sc-193473.jpg,6,0,2,0,8,,train
0560315_sc-193473.jpg,6,0,0,0,6,,train
0560318_sc-207944.jpg,2,0,1,0,3,,train
0560319_sc-1028246.jpg,1,0,0,0,1,,train
0560320_sc-1028246.jpg,0,0,1,0,1,,train
0560321_sc-1028246.jpg,1,0,1,0,2,,train
0560322_sc-1028246.jpg,3,0,1,0,4,,val
0560323_sc-194416.jpg,1,0,0,0,1,,val
0560325_as-0016829.jpg,0,2,1,0,3,,test
0560327_as-0016829.jpg,1,2,0,1,4,,train
0560328_as-0016829.jpg,0,2,2,0,4,,train
0560329_as-0016829.jpg,0,2,1,0,3,,train
0560330_as-0016829.jpg,0,1,0,1,2,,train
0560331_as-0016829.jpg,4,2,1,1,8,,train
0560332_as-0016829.jpg,2,2,2,0,6,,train
0560333_sc-1009889.jpg,1,0,0,0,1,,train
0560334_as-7663780.jpg,1,0,0,1,2,,val
0560335_as-7663780.jpg,2,1,2,1,6,,val
0560337_sc-212146.jpg,1,0,0,0,1,,test
0560338_as-7444246.jpg,1,0,2,0,3,,train
0560339_sc-220064.jpg,1,0,0,0,1,,train
0560340_sc-116318.jpg,1,0,0,2,3,,train
0560341_sc-116318.jpg,2,0,0,2,4,,train
0560342_sc-116318.jpg,1,0,0,1,2,,train
0560343_as-2604306.jpg,2,0,1,0,3,,train
0560344_as-3377816.jpg,1,4,1,1,7,,train
0560345_as-0011954.jpg,1,5,1,0,7,,val
0560346_as-0011954.jpg,0,3,3,0,6,,val
0560347_as-7875535.jpg,1,0,1,1,3,,test
0560349_as-0070617.jpg,1,0,1,1,3,,train
0560350_sc-1019988.jpg,2,0,0,0,2,,train
0560351_as-0005381.jpg,1,0,0,0,1,,train
0560352_sc-156800.jpg,1,1,0,0,2,,train
0560353_sc-125735.jpg,2,0,0,0,2,,train
0560354_sc-125735.jpg,7,1,0,0,8,,train
0560355_sc-125735.jpg,5,2,0,0,7,,train
0560356_sc-125735.jpg,3,0,0,0,3,,val
0560357_sc-125735.jpg,2,0,0,1,3,,val
0560358_sc-125735.jpg,1,0,0,0,1,,test
0560359_sc-125735.jpg,2,0,0,0,2,,train
0560360_sc-125735.jpg,1,0,0,2,3,,train
0560361_sc-125735.jpg,2,0,0,0,2,,train
0560362_sc-135483.jpg,1,0,0,1,2,,train
0560363_sc-135483.jpg,1,0,0,0,1,,train
0560367_sc-135483.jpg,3,0,0,0,3,,train
0560368_sc-135483.jpg,3,0,0,0,3,,train
0560369_sc-135483.jpg,1,0,0,0,1,,val
0560372_as-2885743.jpg,1,1,0,0,2,,val
0560373_as-2855929.jpg,1,0,1,1,3,,test
0560374_as-2978279.jpg,1,0,0,0,1,,train
0560375_sc-178019.jpg,2,1,0,0,3,,train
0560377_as-7076146.jpg,0,0,0,2,2,,train
0560379_sc-122588.jpg,1,1,1,0,3,,train
0560380_sc-122588.jpg,4,0,1,1,6,,train
0560381_sc-122588.jpg,1,1,1,0,3,,train
0560382_sc-122588.jpg,1,1,1,0,3,,train
0560384_sc-122588.jpg,4,1,1,0,6,,val
0560386_sc-181987.jpg,1,1,1,0,3,,val
0560389_sc-181987.jpg,1,1,1,0,3,,test
0560390_sc-181987.jpg,1,1,0,0,2,,train
0560392_as-2879857.jpg,3,0,1,0,4,,train
0560393_as-3408520.jpg,1,0,0,0,1,,train
0560394_sc-173924.jpg,5,1,2,0,8,,train
0560395_sc-173924.jpg,3,2,2,0,7,,train
0560397_as-0026748.jpg,1,0,0,0,1,,train
0560398_sc-177565.jpg,4,0,0,0,4,,train
0560399_sc-177565.jpg,0,1,0,0,1,,val
0560400_as-3152833.jpg,2,0,2,0,4,,val
0560401_as-3124007.jpg,4,0,1,0,5,,test
0560402_as-7591906.jpg,1,0,0,1,2,,train
0560403_as-3043212.jpg,1,0,0,0,1,,train
0560404_as-3043212.jpg,1,0,0,0,1,,train
0560405_sc-226483.jpg,2,0,0,0,2,,train
0560406_as-7208324.jpg,1,0,0,0,1,,train
0560407_as-3239966.jpg,5,0,0,0,5,,train
0560408_sc-1026294.jpg,8,0,0,0,8,,train
0560409_sc-1026294.jpg,11,0,1,0,12,,val
0560410_sc-1026294.jpg,8,0,1,0,9,,val
0560411_as-9091069.jpg,0,1,1,2,4,,test
0560412_as-7409073.jpg,0,0,1,0,1,,train
0560413_as-0078296.jpg,1,0,0,0,1,,train
0560414_as-0011254.jpg,3,1,0,1,5,,train
0560415_as-0011254.jpg,3,0,0,0,3,,train
0560416_as-2546517.jpg,1,1,0,0,2,,train
0560417_sc-1020614.jpg,2,0,0,2,4,,train
0560418_sc-1020614.jpg,2,1,0,0,3,,train
0560419_sc-1020614.jpg,0,3,0,0,3,,val
0560420_sc-121417.jpg,1,0,0,0,1,,val
0560421_sc-121417.jpg,1,0,0,0,1,,test
0560422_sc-121417.jpg,1,0,0,0,1,,train
0560424_sc-111538.jpg,2,3,0,0,5,,train
0560425_sc-111538.jpg,2,3,0,0,5,,train
0560426_sc-111538.jpg,2,3,1,0,6,,train
0560428_sc-161355.jpg,1,1,0,1,3,,train
0560430_sc-161355.jpg,1,1,1,1,4,,train
0560431_as-0050157.jpg,1,0,0,0,1,,train
0560432_as-0050157.jpg,1,1,0,0,2,,val
0560433_sc-143814.jpg,2,0,0,0,2,,val
0560434_sc-143814.jpg,2,0,0,0,2,,test
0560435_as-0083591.jpg,0,1,1,1,3,,train
0560436_as-0083591.jpg,1,1,1,1,4,,train
0560437_as-0083591.jpg,1,1,2,1,5,,train
0560441_sc-186614.jpg,2,0,1,1,4,,train
0560442_sc-186614.jpg,3,0,1,1,5,,train
0560443_sc-186614.jpg,3,0,1,1,5,,train
0560445_as-7957084.jpg,1,0,0,0,1,,train
0560446_sc-1021544.jpg,1,0,1,0,2,,val
0560447_sc-166189.jpg,1,0,1,0,2,,val
0560448_sc-166189.jpg,0,0,1,1,2,,test
0560449_sc-166189.jpg,3,0,0,0,3,,train
0560450_sc-166189.jpg,2,0,0,0,2,,train
0560451_sc-166189.jpg,2,0,0,1,3,,train
0560452_as-2897913.jpg,0,0,1,0,1,,train
0560453_as-3256718.jpg,5,3,0,0,8,,train
0560454_as-7042873.jpg,2,0,1,1,4,,train
0560456_as-0064637.jpg,2,0,0,0,2,,train
0560457_as-0064637.jpg,0,0,1,0,1,,val
0560458_sc-228036.jpg,5,0,0,0,5,,val
0560459_sc-228036.jpg,3,0,0,0,3,,test
0560460_sc-228036.jpg,3,1,2,0,6,,train
0560461_sc-228036.jpg,2,1,2,0,5,,train
0560462_sc-228036.jpg,0,1,2,0,3,,train
0560463_sc-228036.jpg,1,0,0,0,1,,train
0560464_sc-228036.jpg,1,0,0,0,1,,train
0560465_as-3231835.jpg,1,0,0,0,1,,train
0560468_as-0072425.jpg,2,1,1,1,5,,train
0560469_as-0072425.jpg,1,0,1,1,3,,val
0560470_as-0072425.jpg,0,1,1,1,3,,val
0560471_as-0072425.jpg,1,0,0,0,1,,test
0560472_sc-108387.jpg,1,0,0,0,1,,train
0560473_sc-108387.jpg,1,0,1,0,2,,train
0560475_sc-108387.jpg,1,0,0,0,1,,train
0560476_sc-108387.jpg,1,0,1,0,2,,train
0560477_sc-230412.jpg,0,2,1,0,3,,train
0560478_sc-230412.jpg,0,2,2,0,4,,train
0560479_sc-230412.jpg,0,3,2,0,5,,train
0560480_sc-230412.jpg,6,1,3,0,10,,val
0560481_sc-230412.jpg,1,2,2,0,5,,val
0560482_as-3220015.jpg,5,0,0,0,5,,test
0560483_sc-118878.jpg,1,0,0,0,1,,train
0560484_sc-118878.jpg,1,0,0,0,1,,train
0560485_sc-118878.jpg,1,0,0,0,1,,train
0560486_sc-118878.jpg,1,0,0,0,1,,train
0560487_sc-118878.jpg,1,0,0,0,1,,train
0560488_as-7037186.jpg,1,0,0,0,1,,train
0560490_sc-192489.jpg,1,1,1,0,3,,train
0560493_sc-202782.jpg,4,1,0,0,5,,val
0560494_sc-202782.jpg,4,1,1,0,6,,val
0560495_sc-202782.jpg,2,0,0,0,2,,test
0560496_sc-202782.jpg,3,1,0,0,4,,train
0560497_sc-202782.jpg,3,1,1,0,5,,train
0560498_sc-202782.jpg,2,2,1,0,5,,train
0560499_sc-202782.jpg,2,1,1,0,4,,train
0560500_sc-202782.jpg,2,1,0,0,3,,train
0560501_sc-202782.jpg,1,1,0,0,2,,train
0560502_sc-202782.jpg,1,0,1,0,2,,train
0560503_sc-202782.jpg,5,0,0,0,5,,val
0560504_sc-202782.jpg,4,1,0,0,5,,val
0560505_sc-202782.jpg,2,0,1,0,3,,test
0560506_sc-202782.jpg,2,0,1,0,3,,train
0560508_as-3267072.jpg,1,0,1,0,2,,train
0560509_sc-143014.jpg,2,0,0,0,2,,train
0560510_sc-143014.jpg,0,0,0,1,1,,train
0560511_sc-143014.jpg,0,0,0,1,1,,train
0560512_sc-143014.jpg,1,0,0,1,2,,train
0560513_sc-143014.jpg,2,0,0,0,2,,train
0560514_sc-143014.jpg,1,0,0,0,1,,val
0560515_sc-143014.jpg,1,0,0,1,2,,val
0560516_sc-143014.jpg,1,0,0,0,1,,test
0560517_as-2544096.jpg,1,0,0,0,1,,train
0560518_as-3306651.jpg,2,0,2,0,4,,train
0560520_sc-221732.jpg,1,1,1,0,3,,train
0560521_sc-221732.jpg,3,1,1,0,5,,train
0560523_as-0074971.jpg,1,1,2,1,5,,train
0560524_as-0074971.jpg,1,0,0,0,1,,train
0560526_as-0074971.jpg,1,0,0,0,1,,train
0560527_sc-122857.jpg,1,0,0,0,1,,val
0560528_sc-122857.jpg,2,0,0,0,2,,val
0560529_sc-122857.jpg,5,0,0,0,5,,test
0560531_sc-122857.jpg,6,0,0,0,6,,train
0560532_sc-213864.jpg,1,0,0,2,3,,train
0560533_sc-213864.jpg,1,0,0,0,1,,train
0560534_sc-213864.jpg,2,0,0,0,2,,train
0560535_sc-225793.jpg,3,0,4,1,8,,train
0560536_sc-225793.jpg,2,0,2,1,5,,train
0560537_as-3146401.jpg,1,0,0,0,1,,train
0560539_as-0047894.jpg,1,0,1,0,2,,val
0560540_as-0047894.jpg,1,0,1,0,2,,val
0560541_as-0047894.jpg,1,0,0,0,1,,test
0560542_as-0047894.jpg,1,0,0,0,1,,train
0560543_as-0047894.jpg,1,0,0,0,1,,train
0560544_as-0047894.jpg,0,0,0,1,1,,train
0560545_as-0047894.jpg,1,0,0,0,1,,train
0560546_as-0047894.jpg,1,0,0,0,1,,train
0560547_as-0047894.jpg,1,0,0,0,1,,train
0560548_as-0047894.jpg,1,0,0,0,1,,train
0560551_as-0077483.jpg,0,0,0,1,1,,val
0560552_as-0077483.jpg,1,0,0,1,2,,val
0560553_as-0077483.jpg,1,0,0,1,2,,test
0560554_as-3385896.jpg,2,0,0,0,2,,train
0560555_as-0008756.jpg,1,0,0,0,1,,train
0560556_as-0008756.jpg,1,0,0,0,1,,train
0560559_as-0048157.jpg,0,1,3,0,4,,train
0560560_as-0048157.jpg,2,1,1,0,4,,train
0560561_as-0048157.jpg,0,2,1,0,3,,train
0560562_as-0048157.jpg,1,1,2,0,4,,train
0560563_as-0048157.jpg,0,0,1,0,1,,val
0560564_as-3090706.jpg,4,0,1,2,7,,val
0560565_as-3080800.jpg,2,0,0,0,2,,test
0560566_sc-1004505.jpg,2,2,0,0,4,,train
0560567_sc-1004505.jpg,5,2,0,0,7,,train
0560568_sc-1004505.jpg,3,0,0,0,3,,train
0560569_sc-1004505.jpg,2,0,0,0,2,,train
0560570_sc-1004505.jpg,3,0,0,0,3,,train
0560571_sc-1004505.jpg,4,0,0,0,4,,train
0560572_sc-1004505.jpg,3,0,0,0,3,,train
0560573_as-2991145.jpg,2,0,0,0,2,,val
0560574_sc-116260.jpg,2,0,0,1,3,,val
0560575_sc-116260.jpg,1,0,0,1,2,,test
0560576_sc-116260.jpg,1,0,0,1,2,,train
0560578_sc-116260.jpg,2,0,0,1,3,,train
0560579_as-3112627.jpg,1,0,1,0,2,,train
0560580_sc-221946.jpg,0,0,1,0,1,,train
0560581_sc-221946.jpg,2,0,2,0,4,,train
0560582_sc-221946.jpg,0,1,1,0,2,,train
0560583_sc-196562.jpg,2,0,0,1,3,,train
0560584_sc-196562.jpg,0,0,0,1,1,,val
0560587_sc-196562.jpg,1,0,0,1,2,,val
0560588_sc-196562.jpg,1,1,0,0,2,,test
0560591_sc-154636.jpg,2,0,0,0,2,,train
0560592_sc-154636.jpg,2,0,0,0,2,,train
0560593_as-0055302.jpg,2,1,3,1,7,,train
0560597_as-0055302.jpg,0,0,1,0,1,,train
0560598_sc-1041598.jpg,4,0,0,0,4,,train
0560599_sc-1041598.jpg,5,0,1,0,6,,train
0560600_sc-1041598.jpg,1,0,0,0,1,,train
0560602_sc-169882.jpg,6,0,2,1,9,,val
0560603_sc-169882.jpg,2,0,1,1,4,,val
0560604_sc-169882.jpg,5,0,1,1,7,,test
0560605_sc-180611.jpg,1,0,0,1,2,,train
0560606_sc-180611.jpg,1,0,0,1,2,,train
0560607_as-0035042.jpg,1,0,0,0,1,,train
0560608_sc-1000719.jpg,1,0,0,0,1,,train
0560609_sc-1000719.jpg,1,0,0,0,1,,train
0560610_sc-196355.jpg,3,0,0,0,3,,train
0560611_sc-196355.jpg,1,0,0,0,1,,train
0560613_sc-216924.jpg,2,0,0,0,2,,val
0560614_sc-216924.jpg,1,0,0,0,1,,val
0560615_sc-1026434.jpg,1,0,0,0,1,,test
0560617_sc-150074.jpg,1,0,0,0,1,,train
0560619_as-2835513.jpg,2,0,0,0,2,,train
0560622_as-0058903.jpg,4,0,0,1,5,,train
0560623_as-0058903.jpg,2,0,0,0,2,,train
0560624_as-0058903.jpg,1,0,0,0,1,,train
0560625_as-0058903.jpg,1,0,0,0,1,,train
0560626_as-0058903.jpg,4,0,0,0,4,,train
0560627_as-0058903.jpg,2,0,1,0,3,,val
0560628_as-0058903.jpg,1,0,1,0,2,,val
0560632_as-0085063.jpg,3,1,2,0,6,,test
0560633_as-0085063.jpg,4,2,0,0,6,,train
0560634_as-0085063.jpg,6,2,1,0,9,,train
0560635_as-0085063.jpg,4,3,1,0,8,,train
0560636_as-2779142.jpg,2,0,0,0,2,,train
0560638_as-9080973.jpg,4,0,0,0,4,,train
0560639_sc-1034185.jpg,3,0,0,0,3,,train
0560640_sc-1034185.jpg,3,0,0,0,3,,train
0560642_sc-191781.jpg,5,0,0,1,6,,val
0560643_sc-191781.jpg,3,1,2,1,7,,val
0560644_sc-191781.jpg,3,1,1,1,6,,test
0560645_sc-191781.jpg,1,0,0,0,1,,train
0560646_sc-191781.jpg,3,0,0,0,3,,train
0560647_sc-191781.jpg,6,0,0,0,6,,train
0560648_sc-191781.jpg,6,1,2,0,9,,train
0560649_sc-191781.jpg,2,1,2,0,5,,train
0560650_as-2820535.jpg,0,1,0,0,1,,train
0560651_as-3153941.jpg,1,0,1,1,3,,train
0560652_as-2593277.jpg,2,0,0,0,2,,val
0560653_as-0073942.jpg,1,0,0,0,1,,val
0560654_as-0073942.jpg,2,0,0,0,2,,test
0560655_as-0073942.jpg,1,0,0,0,1,,train
0560656_as-0098894.jpg,1,0,0,1,2,,train
0560657_as-0098894.jpg,1,0,0,1,2,,train
0560658_sc-1030810.jpg,1,0,1,0,2,,train
0560659_sc-1030810.jpg,1,0,1,1,3,,train
0560660_as-7521810.jpg,0,0,2,0,2,,train
0560661_as-0098502.jpg,1,1,0,1,3,,train
0560662_as-0098502.jpg,0,1,0,1,2,,val
0560663_as-0098502.jpg,4,1,0,1,6,,val
0560664_as-0050755.jpg,0,0,0,1,1,,test
0560666_as-0050755.jpg,1,0,0,0,1,,train
0560667_as-7098712.jpg,1,0,0,0,1,,train
0560668_sc-145991.jpg,1,0,0,1,2,,train
0560669_sc-145991.jpg,4,0,0,1,5,,train
0560671_sc-145991.jpg,1,0,0,1,2,,train
0560672_sc-145991.jpg,1,0,0,1,2,,train
0560674_as-3150158.jpg,1,0,0,0,1,,train
0560675_sc-201241.jpg,1,0,0,0,1,,val
0560676_sc-201241.jpg,1,0,0,0,1,,val
0560677_sc-201241.jpg,2,0,1,2,5,,test
0560678_sc-201241.jpg,3,0,1,1,5,,train
0560679_sc-201241.jpg,2,0,0,0,2,,train
0560680_as-0048149.jpg,1,0,0,0,1,,train
0560681_as-0048149.jpg,1,0,0,0,1,,train
0560682_as-0048149.jpg,1,0,1,0,2,,train
0560683_as-0048149.jpg,1,0,1,0,2,,train
0560684_as-0048149.jpg,1,0,1,0,2,,train
0560685_sc-161707.jpg,1,0,2,0,3,,val
0560686_sc-161707.jpg,1,0,2,0,3,,val
0560687_sc-161707.jpg,1,0,2,0,3,,test
0560689_sc-161707.jpg,1,0,2,0,3,,train
0560690_sc-161707.jpg,1,0,1,0,2,,train
0560691_sc-1033984.jpg,8,0,1,0,9,,train
0560693_sc-1033984.jpg,3,0,1,0,4,,train
0560694_as-0004354.jpg,2,0,1,0,3,,train
0560695_as-0004354.jpg,2,0,0,0,2,,train
0560696_as-0004354.jpg,3,0,1,0,4,,train
0560697_as-0004354.jpg,2,0,0,0,2,,val
0560698_as-0004354.jpg,4,0,0,0,4,,val
0560700_sc-1028305.jpg,2,0,0,1,3,,test
0560701_sc-1028305.jpg,1,0,0,1,2,,train
0560702_sc-1028305.jpg,1,0,0,0,1,,train
0560703_sc-1028305.jpg,2,0,0,0,2,,train
0560704_sc-1028305.jpg,2,0,1,1,4,,train
0560705_sc-1028305.jpg,2,0,0,1,3,,train
0560708_as-0097628.jpg,1,0,0,0,1,,train
0560709_as-0097628.jpg,0,0,1,0,1,,train
0560710_as-0097628.jpg,0,0,1,0,1,,val
0560712_as-3410831.jpg,1,0,0,0,1,,val
0560713_as-0086985.jpg,0,2,3,0,5,,test
0560715_as-0059929.jpg,6,1,0,0,7,,train
0560717_sc-1002554.jpg,1,0,0,0,1,,train
0560720_as-0069578.jpg,6,2,2,1,11,,train
0560721_as-0069578.jpg,3,0,3,0,6,,train
0560722_as-0069578.jpg,2,0,0,1,3,,train
0560723_as-0069578.jpg,0,0,1,0,1,,train
0560724_as-0074112.jpg,1,0,0,0,1,,train
0560725_as-0074112.jpg,1,0,0,0,1,,val
0560726_as-0074112.jpg,1,0,1,0,2,,val
0560728_as-0074112.jpg,2,1,2,1,6,,test
0560729_as-0074112.jpg,2,1,1,1,5,,train
0560730_as-0074112.jpg,1,0,0,0,1,,train
0560731_as-0074112.jpg,4,0,0,0,4,,train
0560734_sc-1014791.jpg,1,0,0,0,1,,train
0560735_sc-1030253.jpg,3,0,0,0,3,,train
0560736_sc-1030253.jpg,0,1,0,0,1,,train
0560737_sc-1030253.jpg,0,1,1,0,2,,train
0560738_sc-1030253.jpg,1,0,1,0,2,,val
0560739_sc-1021137.jpg,2,1,1,0,4,,val
0560740_as-7123190.jpg,2,0,1,1,4,,test
0560741_as-3032038.jpg,1,0,0,1,2,,train
0560742_sc-139966.jpg,1,1,0,0,2,,train
0560743_sc-139966.jpg,2,0,0,0,2,,train
0560744_sc-139966.jpg,1,0,0,0,1,,train
0560745_sc-139966.jpg,1,0,0,0,1,,train
0560747_as-2987229.jpg,1,1,0,1,3,,train
0560748_as-3018592.jpg,2,0,0,0,2,,train
0560749_as-2536304.jpg,1,0,1,0,2,,val
0560750_as-2813315.jpg,1,0,1,1,3,,val
0560751_as-3324630.jpg,1,0,0,1,2,,test
0560752_as-2940916.jpg,1,0,1,0,2,,train
0560753_sc-168601.jpg,1,0,0,0,1,,train
0560754_sc-168601.jpg,2,0,0,0,2,,train
0560755_sc-168601.jpg,2,0,0,0,2,,train
0560756_sc-168601.jpg,2,0,0,0,2,,train
0560757_sc-168601.jpg,1,0,1,0,2,,train
0560758_sc-168601.jpg,1,0,0,0,1,,train
0560759_sc-168601.jpg,1,0,0,0,1,,val
0560761_as-0005194.jpg,2,0,0,0,2,,val
0560762_as-0005194.jpg,1,0,0,0,1,,test
0560763_as-0005194.jpg,1,0,0,0,1,,train
0560765_sc-120282.jpg,3,0,0,1,4,,train
0560766_sc-120282.jpg,6,0,0,0,6,,train
0560767_sc-120282.jpg,5,0,0,2,7,,train
0560768_sc-120282.jpg,6,0,1,1,8,,train
0560769_sc-120282.jpg,12,0,0,1,13,,train
0560770_sc-120282.jpg,1,0,0,1,2,,train
0560771_sc-120282.jpg,2,0,0,1,3,,val
0560774_as-2922427.jpg,2,0,0,0,2,,val
0560775_sc-1040534.jpg,10,0,0,0,10,,test
0560776_sc-1040534.jpg,1,0,1,0,2,,train
0560777_sc-181561.jpg,0,0,1,0,1,,train
0560778_sc-181561.jpg,1,0,1,0,2,,train
0560779_sc-181561.jpg,1,0,2,0,3,,train
0560782_as-0086761.jpg,0,1,0,0,1,,train
0560786_as-0086015.jpg,2,1,0,1,4,,train
0560787_sc-152591.jpg,2,1,1,0,4,,train
0560788_sc-152591.jpg,2,1,1,0,4,,val
0560790_sc-152591.jpg,2,1,0,0,3,,val
0560791_sc-152591.jpg,4,0,0,0,4,,test
0560794_as-0084428.jpg,1,0,1,0,2,,train
0560795_as-0084428.jpg,1,0,0,1,2,,train
0560796_sc-181732.jpg,1,0,0,0,1,,train
0560797_as-3032450.jpg,0,0,1,0,1,,train
0560798_as-7449929.jpg,7,0,1,0,8,,train
0560799_as-7449929.jpg,1,0,0,0,1,,train
0560800_as-9065623.jpg,4,0,0,0,4,,train
0560801_as-3373546.jpg,3,0,0,0,3,,val
0560802_as-3132066.jpg,1,0,0,0,1,,val
0560803_as-3105775.jpg,3,0,1,0,4,,test
0560804_as-3348283.jpg,2,0,0,0,2,,train
0560805_as-2931725.jpg,2,0,1,0,3,,train
0560806_sc-221905.jpg,2,0,0,0,2,,train
0560807_sc-221905.jpg,9,0,0,0,9,,train
0560808_sc-221905.jpg,2,0,0,0,2,,train
0560809_sc-221905.jpg,2,0,0,0,2,,train
0560810_sc-221905.jpg,2,0,0,0,2,,train
0560811_sc-221905.jpg,1,0,0,0,1,,val
0560812_as-0037134.jpg,2,0,0,0,2,,val
0560813_as-0037134.jpg,2,0,0,0,2,,test
0560814_as-0037134.jpg,2,0,0,0,2,,train
0560815_as-0037134.jpg,2,0,0,0,2,,train
0560816_sc-206650.jpg,8,1,1,2,12,,train
0560817_as-0000517.jpg,1,0,0,0,1,,train
0560818_as-3107080.jpg,1,0,1,0,2,,train
0560819_as-2580900.jpg,0,0,1,0,1,,train
0560820_as-2792684.jpg,1,0,0,0,1,,train
0560821_as-2619603.jpg,1,0,0,0,1,,val
0560822_as-7007059.jpg,0,0,0,2,2,,val
0560823_as-2570823.jpg,3,0,0,0,3,,test
0560824_sc-214469.jpg,3,0,0,1,4,,train
0560825_sc-214469.jpg,1,0,0,0,1,,train
0560826_sc-214469.jpg,1,0,0,0,1,,train
0560827_sc-214469.jpg,1,0,0,0,1,,train
0560828_sc-214469.jpg,1,0,0,0,1,,train
0560829_sc-214469.jpg,1,0,0,0,1,,train
0560831_as-2694287.jpg,1,0,0,1,2,,train
0560832_as-0002444.jpg,2,0,0,0,2,,val
0560833_as-0002444.jpg,2,0,0,0,2,,val
0560835_as-0002444.jpg,1,0,0,0,1,,test
0560836_as-0046838.jpg,1,0,0,0,1,,train
0560837_as-0046838.jpg,1,0,0,0,1,,train
0560838_as-2776068.jpg,2,0,0,0,2,,train
0560841_sc-196237.jpg,2,0,0,0,2,,train
0560842_sc-196237.jpg,1,0,0,0,1,,train
0560843_sc-196237.jpg,1,0,0,0,1,,train
0560844_sc-196237.jpg,2,0,0,0,2,,train
0560845_sc-196237.jpg,3,0,0,0,3,,val
0560847_sc-131581.jpg,2,0,0,0,2,,val
0560848_sc-131581.jpg,3,0,0,0,3,,test
0560849_sc-131581.jpg,2,0,0,0,2,,train
0560850_sc-131581.jpg,3,0,0,0,3,,train
0560851_sc-131581.jpg,3,0,0,0,3,,train
0560852_sc-131581.jpg,3,0,0,0,3,,train
0560855_as-0030812.jpg,1,0,0,1,2,,train
0560856_as-0030812.jpg,1,0,0,0,1,,train
0560857_as-0030812.jpg,2,0,0,0,2,,train
0560858_as-0030812.jpg,1,0,0,1,2,,val
0560859_as-2521298.jpg,3,0,0,1,4,,val
0560860_as-0031709.jpg,0,0,1,0,1,,test
0560861_as-0031709.jpg,1,0,1,0,2,,train
0560862_as-0031709.jpg,2,0,0,0,2,,train
0560863_as-0031709.jpg,2,0,0,0,2,,train
0560866_sc-114458.jpg,4,2,2,1,9,,train
0560867_sc-1025053.jpg,1,0,1,0,2,,train
0560868_sc-1025053.jpg,2,0,0,0,2,,train
0560869_sc-1025053.jpg,11,0,0,0,11,,train
0560870_sc-1025053.jpg,1,0,1,0,2,,val
0560873_as-3134550.jpg,0,1,0,0,1,,val
0560874_as-3125077.jpg,1,0,0,0,1,,test
0560875_as-0013782.jpg,1,0,0,0,1,,train
0560876_as-0013782.jpg,1,0,0,0,1,,train
0560877_sc-1005555.jpg,3,0,0,0,3,,train
0560878_sc-1005555.jpg,3,0,0,0,3,,train
0560880_sc-1000012.jpg,2,0,0,1,3,,train
0560881_sc-220234.jpg,15,2,2,1,20,,train
0560882_sc-220234.jpg,9,2,3,0,14,,train
0560883_sc-220234.jpg,2,0,0,0,2,,val
0560884_sc-220234.jpg,11,2,3,1,17,,val
0560885_sc-220234.jpg,8,1,3,0,12,,test
0560886_sc-220234.jpg,12,3,2,1,18,,train
0560887_as-0045851.jpg,1,0,0,0,1,,train
0560888_as-0045851.jpg,1,0,0,0,1,,train
0560889_as-0045851.jpg,1,0,0,0,1,,train
0560890_as-0045851.jpg,1,0,0,0,1,,train
0560891_as-0041559.jpg,1,0,0,0,1,,train
0560892_as-0041559.jpg,1,0,0,0,1,,train
0560893_as-0041559.jpg,2,0,0,0,2,,val
0560895_sc-128967.jpg,6,0,0,0,6,,val
0560898_as-0068667.jpg,3,0,0,0,3,,test
0560899_as-0068667.jpg,5,0,0,0,5,,train
0560900_as-0068667.jpg,2,0,0,0,2,,train
0560901_as-0068667.jpg,3,0,0,1,4,,train
0560902_as-0068667.jpg,3,0,0,0,3,,train
0560903_as-0068667.jpg,3,0,0,0,3,,train
0560904_sc-1020574.jpg,4,0,0,0,4,,train
0560905_sc-1020574.jpg,4,0,0,0,4,,train
0560906_sc-1020574.jpg,1,0,0,0,1,,val
0560907_sc-1020574.jpg,1,0,0,0,1,,val
0560908_sc-1020574.jpg,3,0,0,0,3,,test
0560909_sc-1020574.jpg,1,0,0,0,1,,train
0560911_as-3327757.jpg,2,0,1,0,3,,train
0560913_as-2833759.jpg,2,0,0,0,2,,train
0560917_as-0015701.jpg,0,0,1,0,1,,train
0560918_as-0015701.jpg,0,2,2,0,4,,train
0560919_as-0015701.jpg,1,0,0,0,1,,train
0560920_as-0015701.jpg,0,1,0,0,1,,train
0560921_sc-135321.jpg,0,1,0,0,1,,val
0560922_sc-178370.jpg,4,1,0,0,5,,val
0560924_as-0092302.jpg,0,1,0,0,1,,test
0560929_sc-139019.jpg,1,0,0,0,1,,train
0560931_sc-139019.jpg,5,0,0,0,5,,train
0560932_sc-139019.jpg,2,0,0,0,2,,train
0560933_sc-139019.jpg,1,0,0,0,1,,train
0560934_as-3255768.jpg,1,0,0,0,1,,train
0560935_as-3428529.jpg,1,0,0,0,1,,train
0560936_as-3428529.jpg,2,1,1,0,4,,train
0560937_as-2553655.jpg,1,0,0,0,1,,val
0560938_as-3405704.jpg,0,0,1,0,1,,val
0560939_as-2559341.jpg,2,0,0,0,2,,test
0560942_as-0063332.jpg,1,0,0,0,1,,train
0560943_as-0063332.jpg,0,1,0,0,1,,train
0560944_as-0063332.jpg,1,1,0,0,2,,train
0560945_as-0063332.jpg,1,1,0,0,2,,train
0560946_as-0063332.jpg,0,0,1,0,1,,train
0560947_as-0063332.jpg,0,1,0,0,1,,train
0560948_as-7686256.jpg,1,0,0,0,1,,train
0560949_sc-211682.jpg,5,0,0,0,5,,val
0560950_sc-211682.jpg,3,0,0,0,3,,val
0560951_sc-226720.jpg,1,0,0,1,2,,test
0560952_as-0038239.jpg,0,1,0,0,1,,train
0560954_as-0038239.jpg,1,1,0,0,2,,train
0560956_as-0038239.jpg,1,1,1,1,4,,train
0560957_as-0038239.jpg,1,1,1,1,4,,train
0560958_as-0038239.jpg,1,0,1,0,2,,train
0560959_as-0038239.jpg,0,1,1,1,3,,train
0560960_as-0038239.jpg,1,1,1,1,4,,train
0560961_as-0038239.jpg,1,0,1,1,3,,val
0560962_sc-120829.jpg,1,0,0,0,1,,val
0560963_sc-120829.jpg,1,0,0,0,1,,test
0560964_sc-120829.jpg,1,0,0,0,1,,train
0560965_as-3099303.jpg,4,2,1,0,7,,train
0560966_as-3099303.jpg,2,1,0,0,3,,train
0560967_as-2891032.jpg,4,0,0,0,4,,train
0560969_sc-1029300.jpg,2,0,0,0,2,,train
0560970_sc-1029300.jpg,2,0,0,0,2,,train
0560973_as-0014285.jpg,3,2,1,0,6,,train
0560974_as-0014285.jpg,1,0,2,0,3,,val
0560975_as-0014285.jpg,2,0,1,0,3,,val
0560976_as-0014285.jpg,1,0,0,0,1,,test
0560977_sc-195469.jpg,1,1,0,0,2,,train
0560979_sc-195469.jpg,1,1,1,0,3,,train
0560980_sc-195469.jpg,0,1,0,0,1,,train
0560981_sc-195469.jpg,0,1,0,0,1,,train
0560982_as-3071986.jpg,3,0,0,0,3,,train
0560983_sc-105425.jpg,3,0,0,0,3,,train
0560984_sc-105425.jpg,5,0,0,2,7,,train
0560985_sc-105425.jpg,1,0,0,1,2,,val
0560986_sc-105425.jpg,5,0,2,1,8,,val
0560987_sc-105425.jpg,4,0,1,0,5,,test
0560988_sc-191147.jpg,2,1,0,0,3,,train
0560989_as-0071298.jpg,1,0,0,0,1,,train
0560990_as-0071298.jpg,1,0,0,0,1,,train
0560991_as-0071298.jpg,1,0,0,0,1,,train
0560992_as-0071298.jpg,1,0,0,1,2,,train
0560993_as-0071298.jpg,1,0,0,0,1,,train
0560994_as-0071298.jpg,1,0,0,0,1,,train
0560995_as-3113723.jpg,1,0,0,2,3,,val
0560996_as-3017856.jpg,2,0,0,0,2,,val
0560997_as-2742965.jpg,1,0,0,0,1,,test
0560998_sc-153035.jpg,1,0,1,1,3,,train
0561000_sc-205416.jpg,1,0,0,0,1,,train
0561001_sc-205416.jpg,1,0,2,0,3,,train
0561002_sc-205416.jpg,2,0,1,0,3,,train
0561003_sc-205416.jpg,7,0,0,1,8,,train
0561004_sc-205416.jpg,3,0,1,0,4,,train
0561005_sc-205416.jpg,2,0,0,0,2,,train
0561006_sc-205416.jpg,1,0,0,0,1,,val
0561007_as-2852281.jpg,1,0,0,1,2,,val
0561008_as-0025537.jpg,2,0,0,0,2,,test
0561010_sc-132653.jpg,2,0,0,0,2,,train
0561011_sc-132653.jpg,3,0,2,0,5,,train
0561012_sc-132653.jpg,2,0,0,0,2,,train
0561013_sc-132653.jpg,2,0,2,1,5,,train
0561014_sc-132653.jpg,3,0,1,1,5,,train
0561015_sc-132653.jpg,3,0,0,1,4,,train
0561016_sc-132653.jpg,4,0,2,1,7,,train
0561017_sc-132653.jpg,2,0,0,1,3,,val
0561018_sc-132653.jpg,1,0,1,1,3,,val
0561019_sc-132653.jpg,2,0,0,1,3,,test
0561020_as-0055093.jpg,1,0,0,0,1,,train
0561022_as-0055093.jpg,1,0,0,0,1,,train
0561023_as-0055093.jpg,1,0,1,0,2,,train
0561024_as-7705691.jpg,1,0,2,0,3,,train
0561026_sc-1039530.jpg,3,2,1,1,7,,train
0561027_sc-1039530.jpg,4,1,2,1,8,,train
0561028_sc-1039530.jpg,2,2,1,1,6,,train
0561030_sc-1039530.jpg,2,0,0,1,3,,val
0561031_sc-1039530.jpg,0,1,1,0,2,,val
0561032_sc-168282.jpg,1,1,0,0,2,,test
0561035_sc-230555.jpg,2,0,0,1,3,,train
0561036_sc-1015986.jpg,2,0,0,0,2,,train
0561038_as-7585221.jpg,2,0,1,1,4,,train
0561041_as-0022284.jpg,2,0,0,0,2,,train
0561042_as-0022284.jpg,1,0,0,0,1,,train
0561043_as-9011845.jpg,2,1,0,0,3,,train
0561045_as-0061329.jpg,3,0,1,1,5,,train
0561046_as-0069090.jpg,3,0,0,0,3,,val
0561047_as-0069090.jpg,3,0,1,1,5,,val
0561048_as-0069090.jpg,1,0,0,0,1,,test
0561049_as-0069090.jpg,1,0,0,0,1,,train
0561050_as-0069090.jpg,0,1,0,0,1,,train
0561051_as-0069090.jpg,1,0,0,0,1,,train
0561053_as-0069090.jpg,0,1,0,0,1,,train
0561054_as-0087943.jpg,11,3,2,2,18,,train
0561055_as-0087943.jpg,14,2,1,1,18,,train
0561056_as-0087943.jpg,1,0,1,0,2,,train
0561059_as-0016098.jpg,1,0,0,0,1,,val
0561061_as-0016098.jpg,1,1,0,0,2,,val
0561062_as-0016098.jpg,1,1,1,0,3,,test
0561063_sc-214134.jpg,1,1,0,0,2,,train
0561064_sc-1022827.jpg,1,0,0,0,1,,train
0561065_sc-1022827.jpg,1,0,0,0,1,,train
0561066_sc-1022827.jpg,1,0,0,0,1,,train
0561067_sc-1022827.jpg,1,0,0,0,1,,train
0561069_as-2881745.jpg,5,0,1,0,6,,train
0561070_as-0041301.jpg,2,0,0,0,2,,train
0561071_as-0041301.jpg,2,0,0,0,2,,val
0561072_as-0041301.jpg,2,0,0,0,2,,val
0561074_sc-146247.jpg,1,0,0,0,1,,test
0561075_sc-146247.jpg,1,0,0,0,1,,train
0561076_as-0080241.jpg,4,2,1,0,7,,train
0561077_as-0080241.jpg,2,2,0,0,4,,train
0561078_as-0080241.jpg,4,1,0,0,5,,train
0561079_as-0080241.jpg,3,1,1,0,5,,train
0561080_as-2653945.jpg,2,0,1,0,3,,train
0561084_as-0012757.jpg,1,2,1,0,4,,train
0561085_as-0012757.jpg,0,1,0,0,1,,val
0561086_as-0012757.jpg,0,1,0,0,1,,val
0561087_sc-145187.jpg,1,0,0,0,1,,test
0561088_sc-145187.jpg,2,1,0,0,3,,train
0561089_sc-145187.jpg,0,1,0,0,1,,train
0561090_sc-145187.jpg,1,1,0,0,2,,train
0561092_as-0047727.jpg,2,0,0,0,2,,train
0561093_as-0047727.jpg,2,0,0,0,2,,train
0561094_as-0047727.jpg,2,1,0,0,3,,train
0561095_as-0047727.jpg,0,0,0,1,1,,train
0561096_as-0047727.jpg,2,0,0,1,3,,val
0561097_as-0047727.jpg,1,0,0,1,2,,val
0561098_as-0047727.jpg,2,0,0,1,3,,test
0561099_as-0047727.jpg,2,0,0,1,3,,train
0561100_sc-202817.jpg,0,1,0,0,1,,train
0561101_sc-202817.jpg,0,1,0,0,1,,train
0561102_as-0049255.jpg,3,0,0,0,3,,train
0561103_as-0049255.jpg,3,0,0,0,3,,train
0561104_as-0049255.jpg,1,0,0,0,1,,train
0561105_as-0049255.jpg,2,0,0,0,2,,train
0561106_as-0049255.jpg,2,0,0,0,2,,val
0561107_as-7796389.jpg,4,0,0,0,4,,val
0561108_sc-224939.jpg,1,1,0,0,2,,test
0561109_sc-224939.jpg,0,1,0,0,1,,train
0561110_sc-192039.jpg,5,0,0,1,6,,train
0561111_sc-192039.jpg,5,0,0,1,6,,train
0561112_sc-192039.jpg,10,0,0,0,10,,train
0561113_sc-192039.jpg,1,0,1,0,2,,train
0561114_as-3174238.jpg,2,0,0,0,2,,train
0561115_sc-213383.jpg,1,0,0,0,1,,train
0561116_sc-213383.jpg,4,0,1,0,5,,val
0561117_sc-213383.jpg,4,0,1,0,5,,val
0561118_sc-143952.jpg,10,2,0,1,13,,test
0561119_sc-193130.jpg,1,1,0,0,2,,train
0561120_sc-193130.jpg,2,0,0,1,3,,train
0561122_as-0041998.jpg,0,0,1,0,1,,train
0561123_as-0041998.jpg,1,0,1,0,2,,train
0561125_as-0041998.jpg,0,1,1,0,2,,train
0561126_as-0032998.jpg,1,0,0,0,1,,train
0561127_as-0032998.jpg,1,0,0,2,3,,train
0561128_sc-211072.jpg,4,0,0,0,4,,val
0561129_as-2926567.jpg,1,0,0,0,1,,val
0561131_as-0048014.jpg,5,0,1,0,6,,test
0561132_as-0048014.jpg,0,0,1,0,1,,train
0561133_as-0048014.jpg,1,0,1,0,2,,train
0561134_as-0028729.jpg,1,0,0,0,1,,train
0561135_as-0028729.jpg,1,0,0,0,1,,train
0561136_as-0028729.jpg,1,0,0,0,1,,train
0561137_as-0028729.jpg,1,0,0,0,1,,train
0561138_sc-225514.jpg,1,0,0,0,1,,train
0561139_sc-225514.jpg,1,0,0,0,1,,val
0561140_sc-225514.jpg,2,0,0,0,2,,val
0561141_as-3193302.jpg,2,0,1,0,3,,test
0561142_sc-1017598.jpg,2,0,0,0,2,,train
0561143_sc-1017598.jpg,1,0,0,0,1,,train
0561144_sc-1017598.jpg,2,0,0,0,2,,train
0561146_as-0048840.jpg,2,1,0,0,3,,train
0561147_as-2862435.jpg,1,0,0,0,1,,train
0561148_as-2862435.jpg,3,1,0,0,4,,train
0561149_as-0036243.jpg,0,0,1,0,1,,train
0561150_as-0036243.jpg,0,0,1,0,1,,val
0561151_as-0036243.jpg,1,0,0,0,1,,val
0561152_as-0036243.jpg,2,0,0,0,2,,test
0561153_as-0036243.jpg,2,0,0,0,2,,train
0561154_as-0036243.jpg,2,0,0,0,2,,train
0561155_as-0023445.jpg,2,0,1,0,3,,train
0561156_as-0023445.jpg,0,1,0,0,1,,train
0561157_as-3351535.jpg,1,1,0,0,2,,train
0561158_as-0061386.jpg,1,0,0,0,1,,train
0561159_as-0061386.jpg,1,0,0,0,1,,train
0561160_sc-230232.jpg,1,0,2,0,3,,val
0561161_sc-230232.jpg,1,0,1,1,3,,val
0561162_sc-230232.jpg,1,0,2,1,4,,test
0561163_sc-230232.jpg,2,1,1,1,5,,train
0561164_sc-230232.jpg,5,0,0,0,5,,train
0561165_sc-230232.jpg,0,1,1,0,2,,train
0561166_sc-230232.jpg,2,1,0,0,3,,train
0561167_sc-230232.jpg,1,0,0,0,1,,train
0561168_sc-166360.jpg,1,0,0,0,1,,train
0561169_sc-166360.jpg,1,0,0,0,1,,train
0561170_sc-125555.jpg,1,0,1,0,2,,val
0561172_as-0097773.jpg,2,0,1,1,4,,val
0561173_as-0097773.jpg,4,0,1,1,6,,test
0561178_as-2709902.jpg,3,0,0,0,3,,train
0561179_sc-214131.jpg,5,0,0,0,5,,train
0561180_sc-202319.jpg,4,0,1,1,6,,train
0561181_sc-202319.jpg,3,0,1,0,4,,train
0561182_sc-167271.jpg,2,2,2,1,7,,train
0561183_sc-167271.jpg,4,2,2,1,9,,train
0561186_sc-167271.jpg,2,0,1,0,3,,train
0561187_sc-167271.jpg,1,0,1,0,2,,val
0561188_sc-167271.jpg,1,1,2,0,4,,val
0561189_sc-167271.jpg,2,1,1,1,5,,test
0561190_as-3438215.jpg,1,0,2,1,4,,train
0561191_sc-167689.jpg,1,0,0,0,1,,train
0561192_sc-167689.jpg,1,0,0,0,1,,train
0561194_sc-167689.jpg,3,0,0,0,3,,train
0561195_sc-167689.jpg,2,1,0,0,3,,train
0561196_sc-155336.jpg,1,0,0,0,1,,train
0561197_sc-155336.jpg,1,0,0,0,1,,train
0561198_as-2770108.jpg,5,0,0,0,5,,val
0561200_sc-214561.jpg,1,0,1,1,3,,val
0561201_sc-214561.jpg,0,0,1,0,1,,test
0561202_as-0027270.jpg,1,0,0,0,1,,train
0561204_as-0027270.jpg,1,0,0,0,1,,train
0561205_as-0027270.jpg,1,0,0,0,1,,train
0561207_as-0055546.jpg,0,0,1,0,1,,train
0561208_as-9063235.jpg,2,0,1,1,4,,train
0561209_as-0031826.jpg,4,2,2,0,8,,train
0561210_as-2787566.jpg,1,2,4,1,8,,train
0561211_sc-115765.jpg,4,0,0,0,4,,val
0561213_as-0057358.jpg,3,0,0,0,3,,val
0561214_as-0057358.jpg,3,0,1,0,4,,test
0561215_as-0057358.jpg,4,0,0,0,4,,train
0561217_as-2888570.jpg,2,0,0,0,2,,train
0561219_sc-210881.jpg,0,1,0,0,1,,train
0561220_sc-170453.jpg,3,0,0,1,4,,train
0561221_as-0093162.jpg,2,0,1,0,3,,train
0561222_as-0093162.jpg,2,0,1,0,3,,train
0561223_as-0093162.jpg,3,0,1,0,4,,train
0561224_as-0093162.jpg,2,0,1,0,3,,val
0561226_as-0093162.jpg,3,0,1,0,4,,val
0561230_sc-170126.jpg,3,1,0,0,4,,test
0561231_sc-170126.jpg,2,1,0,0,3,,train
0561232_as-0063633.jpg,0,1,1,0,2,,train
0561233_as-0063633.jpg,1,0,1,0,2,,train
0561234_as-0063633.jpg,0,0,1,0,1,,train
0561235_as-0063633.jpg,3,1,1,0,5,,train
0561236_as-0063633.jpg,3,1,1,0,5,,train
0561237_as-0063633.jpg,2,1,2,0,5,,train
0561238_as-0063633.jpg,3,2,2,1,8,,val
0561242_as-0063633.jpg,1,0,1,0,2,,val
0561243_as-0063633.jpg,1,0,0,0,1,,test
0561244_as-0034177.jpg,2,0,1,0,3,,train
0561245_as-0034177.jpg,2,1,0,1,4,,train
0561246_as-0034177.jpg,2,0,1,1,4,,train
0561247_as-0034177.jpg,0,0,0,1,1,,train
0561250_as-0033737.jpg,1,0,0,1,2,,train
0561251_as-0033737.jpg,3,0,0,0,3,,train
0561252_as-7858204.jpg,0,1,0,0,1,,train
0561253_sc-178197.jpg,1,1,0,0,2,,val
0561254_as-3448983.jpg,1,0,1,0,2,,val
0561255_sc-108814.jpg,2,0,0,0,2,,test
0561256_sc-108814.jpg,1,0,0,0,1,,train
0561257_sc-117047.jpg,2,1,0,0,3,,train
0561258_sc-117047.jpg,1,1,0,0,2,,train
0561259_sc-154271.jpg,0,0,1,0,1,,train
0561266_as-0017673.jpg,0,0,1,0,1,,train
0561267_as-0017673.jpg,0,0,1,0,1,,train
0561268_as-0017673.jpg,1,0,1,0,2,,train
0561269_as-0017673.jpg,1,0,1,0,2,,val
0561270_as-0017673.jpg,0,0,1,0,1,,val
0561271_as-7153559.jpg,1,0,0,0,1,,test
0561272_as-2978455.jpg,1,0,0,0,1,,train
0561273_sc-122948.jpg,1,0,0,0,1,,train
0561274_sc-122948.jpg,1,0,0,0,1,,train
0561275_sc-122948.jpg,1,0,0,0,1,,train
0561276_sc-122948.jpg,2,0,0,0,2,,train
0561277_sc-122948.jpg,1,0,0,0,1,,train
0561281_as-0057348.jpg,1,0,0,0,1,,train
0561282_as-0057348.jpg,1,0,1,1,3,,val
0561283_as-0057348.jpg,1,1,0,0,2,,val
0561284_as-0057348.jpg,1,1,0,0,2,,test
0561285_as-0030664.jpg,1,0,0,1,2,,train
0561287_sc-155121.jpg,2,0,1,1,4,,train
0561288_sc-155121.jpg,0,0,1,0,1,,train
0561289_sc-215319.jpg,4,2,2,0,8,,train
0561290_sc-215319.jpg,3,2,1,0,6,,train
0561291_sc-215319.jpg,4,2,1,1,8,,train
0561292_sc-215319.jpg,4,2,2,0,8,,train
0561293_as-7406053.jpg,0,0,1,0,1,,val
0561294_sc-1031563.jpg,1,0,0,0,1,,val
0561296_sc-1010500.jpg,2,0,0,0,2,,test
0561298_sc-1010500.jpg,4,0,0,1,5,,train
0561299_sc-1010500.jpg,2,0,0,0,2,,train
0561300_as-2716528.jpg,0,2,2,1,5,,train
0561301_sc-120849.jpg,0,0,1,0,1,,train
0561302_sc-120849.jpg,0,1,0,0,1,,train
0561303_sc-120849.jpg,1,1,1,0,3,,train
0561304_sc-192214.jpg,1,0,0,0,1,,train
0561305_sc-192214.jpg,1,0,0,0,1,,val
0561306_sc-200502.jpg,3,0,0,0,3,,val
0561307_sc-200502.jpg,0,1,0,0,1,,test
0561309_as-7127091.jpg,1,2,1,0,4,,train
0561311_as-2835779.jpg,1,0,0,1,2,,train
0561313_as-0004728.jpg,2,1,0,0,3,,train
0561314_as-0004728.jpg,2,1,0,0,3,,train
0561315_sc-214495.jpg,0,0,1,0,1,,train
0561318_as-0007435.jpg,2,0,0,0,2,,train
0561319_as-0007435.jpg,2,0,0,0,2,,train
0561320_as-0007435.jpg,2,0,0,0,2,,val
0561321_as-0007435.jpg,2,0,0,0,2,,val
0561322_as-0007435.jpg,2,0,0,0,2,,test
0561323_as-0007435.jpg,1,0,0,0,1,,train
0561324_as-0007435.jpg,1,0,0,0,1,,train
0561329_sc-110602.jpg,2,0,1,1,4,,train
0561330_sc-110602.jpg,2,0,0,1,3,,train
0561331_sc-110602.jpg,4,0,1,0,5,,train
0561332_sc-110602.jpg,0,0,1,0,1,,train
0561333_as-7255105.jpg,1,0,0,0,1,,train
0561334_as-0095773.jpg,1,1,0,0,2,,val
0561335_sc-1032536.jpg,1,0,0,0,1,,val
0561336_sc-1021511.jpg,2,0,1,1,4,,test
0561337_sc-1021511.jpg,2,0,2,0,4,,train
0561338_sc-1021511.jpg,1,1,0,0,2,,train
0561339_sc-187963.jpg,1,0,0,0,1,,train
0561340_sc-187963.jpg,0,0,0,1,1,,train
0561342_as-3427726.jpg,1,1,0,0,2,,train
0561343_sc-215358.jpg,2,0,0,0,2,,train
0561344_sc-215358.jpg,2,0,0,0,2,,train
0561345_sc-215358.jpg,3,0,0,0,3,,val
0561346_sc-215358.jpg,1,0,0,0,1,,val
0561347_sc-215358.jpg,3,0,0,0,3,,test
0561348_sc-215358.jpg,1,0,0,0,1,,train
0561349_sc-215358.jpg,2,0,0,0,2,,train
0561350_sc-215358.jpg,1,0,0,0,1,,train
0561351_sc-215358.jpg,3,0,0,0,3,,train
0561352_sc-215358.jpg,2,0,0,0,2,,train
0561353_sc-215358.jpg,1,0,0,0,1,,train
0561354_as-0042353.jpg,1,0,0,0,1,,train
0561355_as-0042353.jpg,1,0,0,0,1,,val
0561357_sc-203126.jpg,3,1,2,1,7,,val
0561358_sc-203126.jpg,1,2,5,1,9,,test
0561359_sc-203126.jpg,4,2,4,1,11,,train
0561360_sc-203126.jpg,4,0,0,0,4,,train
0561362_as-0056614.jpg,0,0,0,2,2,,train
0561363_as-0056614.jpg,0,0,1,1,2,,train
0561364_as-0056614.jpg,1,0,2,1,4,,train
0561365_as-0056614.jpg,0,0,2,0,2,,train
0561367_as-0014294.jpg,3,0,0,0,3,,train
0561368_as-0014294.jpg,4,0,2,0,6,,val
0561369_as-0014294.jpg,4,0,0,0,4,,val
0561370_as-0014294.jpg,4,0,1,0,5,,test
0561371_sc-119371.jpg,1,0,1,0,2,,train
0561372_sc-119371.jpg,2,0,1,0,3,,train
0561373_sc-119371.jpg,1,0,1,0,2,,train
0561374_sc-119371.jpg,1,0,1,0,2,,train
0561375_sc-119371.jpg,1,0,1,0,2,,train
0561376_sc-119371.jpg,2,0,1,0,3,,train
0561377_sc-119371.jpg,2,0,0,0,2,,train
0561378_sc-206164.jpg,1,1,0,1,3,,val
0561379_sc-206164.jpg,1,1,0,0,2,,val
0561380_sc-206164.jpg,1,0,0,0,1,,test
0561381_sc-206164.jpg,1,1,0,0,2,,train
0561382_sc-206164.jpg,1,0,0,1,2,,train
0561383_as-3305940.jpg,1,0,0,0,1,,train
0561384_as-3262514.jpg,1,0,0,0,1,,train
0561385_as-7723327.jpg,2,0,0,0,2,,train
0561386_sc-174754.jpg,1,0,0,0,1,,train
0561387_sc-174754.jpg,1,0,0,0,1,,train
0561389_sc-174754.jpg,1,0,0,0,1,,val
0561391_sc-110938.jpg,2,0,1,1,4,,val
0561392_sc-110938.jpg,2,0,1,1,4,,test
0561393_sc-110938.jpg,1,0,0,1,2,,train
0561394_sc-110938.jpg,1,0,0,1,2,,train
0561395_sc-110938.jpg,1,0,0,1,2,,train
0561396_sc-110938.jpg,1,0,0,0,1,,train
0561399_as-0077060.jpg,5,1,2,2,10,,train
0561400_as-0077060.jpg,4,1,2,1,8,,train
0561401_as-0077060.jpg,2,1,2,1,6,,train
0561402_as-2841276.jpg,3,0,1,0,4,,val
0561403_sc-173208.jpg,2,0,1,0,3,,val
0561404_sc-173208.jpg,2,0,0,0,2,,test
0561405_sc-173208.jpg,1,0,1,0,2,,train
0561406_sc-136671.jpg,1,1,1,0,3,,train
0561407_sc-136671.jpg,1,1,1,0,3,,train
0561408_sc-136671.jpg,2,1,0,0,3,,train
0561409_sc-136671.jpg,0,1,0,0,1,,train
0561410_sc-136671.jpg,2,1,1,0,4,,train
0561412_as-0031524.jpg,1,0,0,1,2,,train
0561414_sc-1000771.jpg,1,1,0,0,2,,val
0561415_sc-1000771.jpg,1,0,1,0,2,,val
0561416_sc-1000771.jpg,1,0,1,0,2,,test
0561417_sc-1000771.jpg,1,0,0,0,1,,train
0561418_sc-207932.jpg,8,2,1,2,13,,train
0561419_sc-207932.jpg,5,2,2,1,10,,train
0561420_sc-207932.jpg,3,1,2,2,8,,train
0561421_sc-207932.jpg,4,2,2,2,10,,train
0561422_sc-207932.jpg,2,0,1,0,3,,train
0561423_sc-207932.jpg,1,0,0,0,1,,train
0561424_sc-1012518.jpg,1,0,1,1,3,,val
0561425_sc-1012518.jpg,1,0,1,1,3,,val
0561426_as-0092223.jpg,4,0,0,0,4,,test
0561427_as-0092223.jpg,4,0,0,0,4,,train
0561428_as-0092223.jpg,4,0,0,0,4,,train
0561434_as-0092223.jpg,1,0,1,2,4,,train
0561435_as-0092223.jpg,1,0,1,2,4,,train
0561436_as-0092223.jpg,1,0,1,2,4,,train
0561437_as-0092223.jpg,1,0,1,2,4,,train
0561438_as-0092223.jpg,0,0,1,2,3,,train
0561440_as-0092223.jpg,1,0,0,0,1,,val
0561441_as-0092223.jpg,1,0,0,0,1,,val
0561442_sc-123305.jpg,1,0,0,1,2,,test
0561443_sc-123305.jpg,1,0,0,1,2,,train
0561444_sc-123305.jpg,1,0,0,1,2,,train
0561445_sc-123305.jpg,2,0,0,1,3,,train
0561446_as-3126472.jpg,5,0,1,1,7,,train
0561449_sc-102991.jpg,2,0,0,0,2,,train
0561450_sc-102991.jpg,2,0,0,0,2,,train
0561451_sc-102991.jpg,2,0,0,0,2,,train
0561452_sc-1022524.jpg,1,0,0,0,1,,val
0561454_as-3180752.jpg,1,0,0,0,1,,val
0561456_as-3225819.jpg,4,1,0,0,5,,test
0561457_as-2528202.jpg,2,0,0,1,3,,train
0561458_as-2711585.jpg,2,0,1,0,3,,train
0561459_as-0013823.jpg,1,0,0,1,2,,train
0561460_as-0013823.jpg,1,0,0,1,2,,train
0561462_sc-1032075.jpg,1,0,0,1,2,,train
0561463_sc-1032075.jpg,1,0,0,0,1,,train
0561464_as-0059566.jpg,1,0,0,0,1,,train
0561465_as-2920597.jpg,1,0,0,1,2,,val
0561466_as-0082726.jpg,1,0,0,0,1,,val
0561467_sc-200582.jpg,1,0,0,0,1,,test
0561469_sc-205457.jpg,1,0,0,0,1,,train
0561470_as-0032970.jpg,1,1,0,0,2,,train
0561471_as-0032970.jpg,1,1,1,1,4,,train
0561472_as-0032970.jpg,1,0,0,1,2,,train
0561473_as-0032970.jpg,0,0,1,0,1,,train
0561474_as-0032970.jpg,2,1,0,0,3,,train
0561475_as-0032970.jpg,0,0,1,0,1,,train
0561476_as-0032970.jpg,0,0,1,0,1,,val
0561477_as-0032970.jpg,0,0,1,0,1,,val
0561478_as-0032970.jpg,1,0,0,0,1,,test
0561480_sc-1003609.jpg,2,0,1,2,5,,train
0561481_sc-1003609.jpg,4,0,1,1,6,,train
0561482_sc-1003609.jpg,1,0,1,2,4,,train
0561484_sc-1003609.jpg,2,0,0,1,3,,train
0561485_sc-1003338.jpg,1,1,0,0,2,,train
0561487_sc-1003338.jpg,1,1,0,0,2,,train
0561488_sc-135104.jpg,3,0,1,0,4,,train
0561489_sc-1002117.jpg,1,0,0,1,2,,val
0561490_sc-195738.jpg,0,1,0,0,1,,val
0561491_as-0097246.jpg,1,1,2,0,4,,test
0561492_as-0097246.jpg,1,0,0,0,1,,train
0561493_as-0097246.jpg,0,0,1,0,1,,train
0561495_as-0009363.jpg,0,1,0,0,1,,train
0561496_sc-201417.jpg,1,0,1,0,2,,train
0561497_sc-201417.jpg,1,0,1,0,2,,train
0561498_sc-201417.jpg,2,0,0,0,2,,train
0561499_sc-201417.jpg,2,0,0,0,2,,train
0561500_sc-207684.jpg,0,1,0,0,1,,val
0561501_sc-207684.jpg,2,2,5,1,10,,val
0561502_sc-207684.jpg,0,1,0,0,1,,test
0561503_sc-207684.jpg,5,2,3,3,13,,train
0561504_sc-207684.jpg,1,0,4,3,8,,train
0561505_sc-207684.jpg,2,1,0,0,3,,train
0561506_sc-207684.jpg,3,1,1,0,5,,train
0561507_sc-207684.jpg,8,1,4,3,16,,train
0561508_sc-207684.jpg,5,0,1,1,7,,train
0561509_sc-207684.jpg,6,0,1,2,9,,train
0561510_sc-207684.jpg,9,1,1,5,16,,val
0561511_sc-207684.jpg,5,0,1,3,9,,val
0561512_sc-207684.jpg,8,0,1,1,10,,test
0561513_sc-207684.jpg,9,0,1,1,11,,train
0561514_sc-207684.jpg,4,0,1,1,6,,train
0561515_sc-207684.jpg,2,1,1,1,5,,train
0561516_sc-207684.jpg,3,0,0,0,3,,train
0561517_sc-207684.jpg,1,0,0,0,1,,train
0561518_sc-229407.jpg,2,0,0,0,2,,train
0561519_sc-229407.jpg,1,0,0,0,1,,train
0561520_sc-229407.jpg,1,0,0,1,2,,val
0561521_sc-229407.jpg,1,0,1,1,3,,val
0561522_sc-229407.jpg,3,0,1,0,4,,test
0561523_sc-229407.jpg,1,0,1,1,3,,train
0561525_as-0066536.jpg,3,0,1,0,4,,train
0561527_sc-135964.jpg,0,0,1,0,1,,train
0561528_sc-135964.jpg,0,0,1,0,1,,train
0561529_sc-135964.jpg,1,0,0,0,1,,train
0561530_sc-135964.jpg,2,0,0,0,2,,train
0561531_sc-135964.jpg,1,1,0,1,3,,train
0561532_sc-135964.jpg,2,1,0,0,3,,val
0561533_sc-135964.jpg,0,0,1,0,1,,val
0561534_sc-135964.jpg,1,0,0,0,1,,test
0561535_as-2960371.jpg,0,0,1,0,1,,train
0561536_as-2960371.jpg,2,0,0,0,2,,train
0561537_as-0031078.jpg,3,0,0,1,4,,train
0561539_as-2794037.jpg,5,0,1,2,8,,train
0561540_as-2598838.jpg,3,2,0,0,5,,train
0561541_sc-1039299.jpg,5,0,0,0,5,,train
0561542_sc-1039299.jpg,3,0,0,0,3,,train
0561543_as-0094451.jpg,1,0,0,0,1,,val
0561544_as-0031496.jpg,1,0,0,0,1,,val
0561546_sc-1041574.jpg,1,0,0,0,1,,test
0561547_sc-1041574.jpg,2,0,0,0,2,,train
0561548_sc-115862.jpg,2,0,1,0,3,,train
0561549_sc-202828.jpg,1,1,0,0,2,,train
0561550_sc-202828.jpg,1,1,0,0,2,,train
0561551_sc-202828.jpg,1,0,0,0,1,,train
0561553_sc-197523.jpg,0,1,0,0,1,,train
0561554_sc-1016841.jpg,4,0,0,0,4,,train
0561555_sc-1016841.jpg,2,0,0,0,2,,val
0561556_sc-1016841.jpg,5,0,0,0,5,,val
0561557_as-0050781.jpg,4,0,0,0,4,,test
0561558_as-0050781.jpg,3,0,0,0,3,,train
0561559_as-0050781.jpg,4,0,1,0,5,,train
0561561_sc-182165.jpg,1,0,0,0,1,,train
0561563_sc-124903.jpg,5,0,0,0,5,,train
0561564_sc-124903.jpg,3,0,0,0,3,,train
0561565_sc-124903.jpg,2,0,0,0,2,,train
0561566_as-0060392.jpg,0,1,0,2,3,,train
0561567_as-0060392.jpg,1,1,1,3,6,,val
0561568_as-0060392.jpg,2,1,1,1,5,,val
0561569_as-0060392.jpg,0,0,1,0,1,,test
0561570_as-0060392.jpg,0,0,3,0,3,,train
0561571_as-0060392.jpg,3,1,0,1,5,,train
0561572_as-0060392.jpg,0,0,2,1,3,,train
0561573_as-0060392.jpg,4,1,0,1,6,,train
0561574_as-0060392.jpg,0,0,1,0,1,,train
0561575_as-0060392.jpg,0,0,1,0,1,,train
0561576_as-0060392.jpg,0,0,1,1,2,,train
0561577_as-0060392.jpg,0,0,2,0,2,,val
0561578_as-3006073.jpg,3,1,1,1,6,,val
0561579_as-0062541.jpg,1,0,0,0,1,,test
0561580_as-0062311.jpg,3,0,0,0,3,,train
0561581_as-0062311.jpg,2,0,0,0,2,,train
0561582_as-0062311.jpg,1,0,0,0,1,,train
0561583_sc-199371.jpg,2,0,0,1,3,,train
0561584_sc-199371.jpg,3,0,0,1,4,,train
0561585_as-0093562.jpg,1,0,0,1,2,,train
0561586_sc-1013464.jpg,2,0,0,0,2,,train
0561587_sc-1013464.jpg,1,0,0,0,1,,val
0561588_sc-1013464.jpg,1,0,0,0,1,,val
0561589_sc-161903.jpg,2,0,1,2,5,,test
0561591_sc-104043.jpg,1,0,0,1,2,,train
0561592_sc-104043.jpg,1,0,0,0,1,,train
0561593_sc-151700.jpg,1,0,0,0,1,,train
0561594_sc-151700.jpg,1,0,0,0,1,,train
0561595_sc-151700.jpg,1,0,0,0,1,,train
0561596_sc-151700.jpg,1,0,0,0,1,,train
0561597_as-0048548.jpg,3,0,0,0,3,,train
0561598_as-0048548.jpg,6,0,0,0,6,,val
0561599_as-0048548.jpg,5,0,0,0,5,,val
0561600_as-0048548.jpg,8,0,1,0,9,,test
0561601_as-0048548.jpg,9,0,1,0,10,,train
0561602_as-0048548.jpg,2,0,2,0,4,,train
0561603_as-0048548.jpg,4,0,1,0,5,,train
0561604_as-0048548.jpg,0,1,2,0,3,,train
0561605_as-0048548.jpg,0,0,1,0,1,,train
0561606_as-0048548.jpg,0,0,1,0,1,,train
0561607_as-0048548.jpg,6,0,2,0,8,,train
0561610_sc-219699.jpg,0,2,1,0,3,,val
0561611_sc-219699.jpg,4,0,0,0,4,,val
0561612_sc-219699.jpg,1,1,1,0,3,,test
0561613_sc-220896.jpg,4,0,2,1,7,,train
0561615_as-3033310.jpg,2,0,0,0,2,,train
0561616_as-3177669.jpg,1,0,1,0,2,,train
0561617_as-2615455.jpg,2,0,2,1,5,,train
0561618_as-0091047.jpg,3,0,0,0,3,,train
0561620_sc-1021962.jpg,5,0,0,0,5,,train
0561621_sc-1021962.jpg,2,0,0,0,2,,train
0561622_sc-1021962.jpg,1,0,0,0,1,,val
0561623_sc-1021962.jpg,4,0,0,0,4,,val
0561624_sc-1021962.jpg,2,0,0,0,2,,test
0561625_sc-1021962.jpg,1,0,0,0,1,,train
0561626_as-0026376.jpg,1,0,0,0,1,,train
0561627_as-0026376.jpg,0,0,1,0,1,,train
0561628_as-0026376.jpg,1,0,0,0,1,,train
0561629_as-0026376.jpg,4,0,0,0,4,,train
0561630_sc-112679.jpg,1,0,0,0,1,,train
0561631_sc-112679.jpg,1,0,0,0,1,,train
0561632_sc-112679.jpg,1,0,0,0,1,,val
0561633_as-0043212.jpg,1,0,0,0,1,,val
0561634_as-0043212.jpg,0,0,0,1,1,,test
0561635_as-0043212.jpg,1,0,0,0,1,,train
0561636_as-7687064.jpg,1,0,1,0,2,,train
0561637_sc-161038.jpg,0,3,2,0,5,,train
0561639_sc-161038.jpg,0,1,2,0,3,,train
0561640_sc-161038.jpg,4,2,2,4,12,,train
0561641_sc-161038.jpg,1,2,2,4,9,,train
0561642_sc-161038.jpg,2,0,0,1,3,,train
0561644_sc-161038.jpg,6,2,1,2,11,,val
0561645_sc-161038.jpg,5,0,2,2,9,,val
0561646_sc-161038.jpg,2,1,0,1,4,,test
0561647_sc-161038.jpg,1,0,0,0,1,,train
0561648_sc-110459.jpg,1,0,0,0,1,,train
0561650_sc-110459.jpg,4,0,0,0,4,,train
0561651_as-0086007.jpg,3,1,1,0,5,,train
0561652_as-0086007.jpg,1,1,1,0,3,,train
0561653_as-0086007.jpg,1,0,0,0,1,,train
0561654_as-0086007.jpg,0,2,0,0,2,,train
0561655_as-0086007.jpg,2,1,1,0,4,,val
0561657_sc-214722.jpg,3,0,3,1,7,,val
0561658_sc-214722.jpg,0,0,3,0,3,,test
0561659_sc-214722.jpg,2,1,1,1,5,,train
0561660_sc-214722.jpg,0,0,1,0,1,,train
0561661_as-0056957.jpg,0,0,1,0,1,,train
0561662_as-0056957.jpg,0,0,1,1,2,,train
0561663_as-0041312.jpg,0,2,2,1,5,,train
0561664_as-0041312.jpg,0,2,2,1,5,,train
0561665_as-0041312.jpg,3,2,2,1,8,,train
0561668_as-0041312.jpg,3,2,2,2,9,,val
0561669_as-0041312.jpg,1,1,2,3,7,,val
0561676_as-0067530.jpg,1,0,0,0,1,,test
0561677_as-9051180.jpg,1,0,0,0,1,,train
0561678_sc-189204.jpg,4,0,0,0,4,,train
0561679_as-3097979.jpg,1,0,0,0,1,,train
0561680_as-0010659.jpg,3,0,0,0,3,,train
0561681_sc-199455.jpg,1,0,1,1,3,,train
0561682_sc-1014547.jpg,0,2,0,0,2,,train
0561684_sc-1014547.jpg,0,1,0,0,1,,train
0561685_sc-1014547.jpg,0,1,0,0,1,,val
0561686_sc-148171.jpg,1,0,1,1,3,,val
0561687_as-3177399.jpg,1,0,2,0,3,,test
0561690_sc-217131.jpg,1,0,1,1,3,,train
0561691_sc-217131.jpg,1,0,1,1,3,,train
0561692_as-0083669.jpg,0,1,0,0,1,,train
0561693_as-0083669.jpg,2,0,0,0,2,,train
0561694_sc-1018028.jpg,1,0,0,0,1,,train
0561695_sc-117258.jpg,6,1,0,0,7,,train
0561697_sc-117258.jpg,7,1,0,0,8,,train
0561698_sc-117258.jpg,2,1,0,0,3,,val
0561699_as-7212975.jpg,1,0,0,0,1,,val
0561700_sc-198478.jpg,1,0,1,0,2,,test
0561702_sc-198478.jpg,3,0,0,0,3,,train
0561703_sc-198478.jpg,1,0,1,0,2,,train
0561704_sc-198478.jpg,1,2,1,0,4,,train
0561705_sc-198478.jpg,2,2,1,0,5,,train
0561707_sc-198478.jpg,2,0,0,0,2,,train
0561708_sc-198478.jpg,1,0,1,0,2,,train
0561709_sc-1010896.jpg,1,0,0,0,1,,train
0561712_sc-1010896.jpg,1,0,0,0,1,,val
0561713_sc-1010896.jpg,1,0,0,0,1,,val
0561714_sc-1010896.jpg,1,0,0,0,1,,test
0561717_as-0060808.jpg,1,0,0,0,1,,train
0561718_as-0060808.jpg,1,0,0,0,1,,train
0561719_sc-226177.jpg,2,1,0,0,3,,train
0561720_as-2762516.jpg,1,0,1,0,2,,train
0561721_as-2762516.jpg,2,0,0,0,2,,train
0561722_as-9024416.jpg,2,0,1,0,3,,train
0561727_as-0093869.jpg,1,1,1,0,3,,train
0561728_as-0093869.jpg,1,1,1,1,4,,val
0561729_as-0093869.jpg,8,0,0,0,8,,val
0561730_as-2830481.jpg,0,0,0,1,1,,test
0561731_as-2830481.jpg,2,1,0,0,3,,train
0561732_as-3100468.jpg,3,0,0,0,3,,train
0561733_sc-141121.jpg,1,0,0,0,1,,train
0561734_as-0010098.jpg,0,0,1,1,2,,train
0561735_as-0010098.jpg,2,1,0,0,3,,train
0561736_as-0059749.jpg,1,0,0,0,1,,train
0561737_sc-218776.jpg,1,0,0,0,1,,train
0561739_sc-179448.jpg,1,0,1,0,2,,val
0561740_sc-179448.jpg,1,0,0,0,1,,val
0561741_sc-179448.jpg,3,0,0,0,3,,test
0561744_sc-179448.jpg,1,0,0,0,1,,train
0561745_sc-179448.jpg,1,0,0,0,1,,train
0561746_as-3240063.jpg,1,0,0,0,1,,train
0561750_as-2588776.jpg,0,2,1,0,3,,train
0561752_sc-110954.jpg,2,0,0,0,2,,train
0561754_sc-110954.jpg,2,0,1,1,4,,train
0561758_sc-170720.jpg,1,0,0,0,1,,train
0561759_sc-214474.jpg,4,0,0,1,5,,val
0561760_sc-214474.jpg,5,0,0,1,6,,val
0561761_sc-214474.jpg,5,0,0,0,5,,test
0561762_sc-214474.jpg,4,0,0,0,4,,train
0561763_sc-119238.jpg,2,0,1,0,3,,train
0561764_sc-117631.jpg,2,1,0,0,3,,train
0561765_as-2539393.jpg,1,0,1,0,2,,train
0561766_as-3447371.jpg,2,0,0,0,2,,train
0561767_sc-137117.jpg,2,0,0,1,3,,train
0561768_sc-137117.jpg,1,0,0,1,2,,train
0561769_as-7323732.jpg,2,0,0,2,4,,val
0561775_as-3312956.jpg,1,0,0,0,1,,val
0561776_as-2969209.jpg,3,0,1,2,6,,test
0561778_as-0051635.jpg,1,0,0,1,2,,train
0561779_as-0051635.jpg,1,0,0,1,2,,train
0561780_as-0051635.jpg,1,0,1,0,2,,train
0561781_as-0051635.jpg,1,0,0,0,1,,train
0561782_as-0051635.jpg,1,0,1,0,2,,train
0561783_as-3320159.jpg,3,1,0,1,5,,train
0561784_as-3320159.jpg,2,2,0,0,4,,train
0561785_sc-220139.jpg,1,0,0,0,1,,val
0561786_sc-220139.jpg,2,0,0,0,2,,val
0561787_sc-136865.jpg,1,0,0,0,1,,test
0561788_sc-192176.jpg,2,0,0,1,3,,train
0561789_sc-192176.jpg,1,0,0,1,2,,train
0561792_as-2941703.jpg,1,0,0,0,1,,train
0561796_sc-1026228.jpg,1,1,0,0,2,,train
0561799_sc-1026228.jpg,3,2,1,1,7,,train
0561800_sc-1026228.jpg,1,1,1,2,5,,train
0561801_sc-1026228.jpg,2,1,0,1,4,,train
0561802_as-0071103.jpg,0,0,0,1,1,,val
0561804_as-0071103.jpg,1,1,1,1,4,,val
0561805_as-0071103.jpg,1,1,1,2,5,,test
0561806_as-0071103.jpg,1,1,1,0,3,,train
0561807_as-0071103.jpg,1,1,1,1,4,,train
0561808_as-0071103.jpg,1,1,1,0,3,,train
0561809_as-0071103.jpg,1,0,0,0,1,,train
0561810_as-0071103.jpg,1,1,0,0,2,,train
0561814_as-0004871.jpg,5,0,0,1,6,,train
0561815_as-0004871.jpg,3,0,0,1,4,,train
0561816_as-0004871.jpg,1,0,0,0,1,,val
0561817_as-0004871.jpg,3,0,0,0,3,,val
0561818_as-0004871.jpg,0,0,0,1,1,,test
0561820_as-0073322.jpg,1,0,0,0,1,,train
0561821_as-0073322.jpg,1,0,0,0,1,,train
0561822_as-0073322.jpg,1,0,0,0,1,,train
0561823_as-7021350.jpg,1,0,0,0,1,,train
0561824_as-2588414.jpg,1,0,0,0,1,,train
0561825_as-0027091.jpg,3,0,0,0,3,,train
0561826_as-0027091.jpg,2,0,0,0,2,,train
0561827_sc-216223.jpg,1,0,0,1,2,,val
0561828_sc-216223.jpg,0,0,1,0,1,,val
0561829_sc-216223.jpg,1,0,0,1,2,,test
0561830_sc-216223.jpg,3,0,0,1,4,,train
0561831_sc-216223.jpg,2,0,0,1,3,,train
0561832_sc-216223.jpg,2,0,1,1,4,,train
0561833_as-2955899.jpg,3,0,0,0,3,,train
0561836_as-0021886.jpg,8,0,7,4,19,,train
0561837_as-0021886.jpg,11,0,6,2,19,,train
0561838_as-0021886.jpg,5,0,4,2,11,,train
0561839_as-0021886.jpg,15,0,8,4,27,,val
0561840_as-0021886.jpg,2,0,0,1,3,,val
0561841_as-0021886.jpg,14,1,12,7,34,,test
0561842_as-0029044.jpg,1,0,0,0,1,,train
0561843_sc-205235.jpg,2,0,1,0,3,,train
0561844_sc-205235.jpg,1,0,1,0,2,,train
0561845_sc-205235.jpg,1,0,1,1,3,,train
0561846_sc-205235.jpg,1,1,0,0,2,,train
0561847_sc-171131.jpg,0,1,0,0,1,,train
0561849_sc-1011816.jpg,2,1,1,2,6,,train
0561850_sc-1011816.jpg,4,1,1,1,7,,val
0561851_sc-1011816.jpg,1,1,0,0,2,,val
0561852_sc-1011816.jpg,2,1,0,1,4,,test
0561854_sc-129764.jpg,1,0,0,0,1,,train
0561855_sc-129764.jpg,7,0,0,0,7,,train
0561857_as-0058390.jpg,0,0,1,0,1,,train
0561858_as-3405810.jpg,3,1,1,1,6,,train
0561859_as-0057411.jpg,2,0,0,0,2,,train
0561860_as-0057411.jpg,2,0,0,0,2,,train
0561861_as-0057411.jpg,1,0,0,0,1,,train
0561862_as-0057411.jpg,2,0,0,0,2,,val
0561863_as-0071170.jpg,0,0,1,1,2,,val
0561864_as-0071170.jpg,1,0,2,0,3,,test
0561865_as-0071170.jpg,1,0,1,1,3,,train
0561866_as-0071170.jpg,1,1,0,0,2,,train
0561867_sc-214122.jpg,11,0,1,0,12,,train
0561868_sc-214122.jpg,1,0,1,1,3,,train
0561869_sc-214122.jpg,4,0,0,0,4,,train
0561870_sc-214122.jpg,9,0,1,0,10,,train
0561871_sc-214122.jpg,7,0,1,0,8,,train
0561872_sc-214122.jpg,10,0,1,0,11,,val
0561873_sc-214122.jpg,7,0,1,0,8,,val
0561874_sc-214122.jpg,4,0,0,0,4,,test
0561875_sc-214122.jpg,7,0,1,0,8,,train
0561876_sc-214122.jpg,4,0,1,0,5,,train
0561877_sc-214122.jpg,4,0,0,0,4,,train
0561878_sc-214122.jpg,3,0,0,0,3,,train
0561879_sc-214122.jpg,6,0,1,0,7,,train
0561880_sc-214122.jpg,2,0,1,0,3,,train
0561881_sc-214122.jpg,2,0,1,0,3,,train
0561882_sc-214122.jpg,5,0,0,0,5,,val
0561883_sc-214122.jpg,3,0,0,0,3,,val
0561884_sc-214122.jpg,2,0,0,0,2,,test
0561885_sc-214122.jpg,3,0,0,0,3,,train
0561886_sc-214122.jpg,1,0,0,0,1,,train
0561887_sc-206707.jpg,4,0,0,0,4,,train
0561888_sc-206707.jpg,1,0,0,0,1,,train
0561889_sc-206707.jpg,1,0,0,0,1,,train
0561890_sc-206707.jpg,1,0,0,0,1,,train
0561892_sc-206707.jpg,1,0,0,0,1,,train
0561894_sc-206707.jpg,1,0,0,0,1,,val
0561895_sc-206707.jpg,2,0,0,0,2,,val
0561896_sc-206707.jpg,1,0,0,0,1,,test
0561902_as-9081528.jpg,2,0,0,0,2,,train
0561903_as-0014195.jpg,1,0,0,0,1,,train
0561904_sc-1028057.jpg,3,0,0,0,3,,train
0561905_sc-1028057.jpg,4,0,0,1,5,,train
0561906_sc-1028057.jpg,7,0,0,1,8,,train
0561907_sc-1028057.jpg,6,0,0,0,6,,train
0561908_sc-181979.jpg,0,1,0,0,1,,train
0561909_as-7753514.jpg,2,2,0,1,5,,val
0561910_as-3444497.jpg,3,0,0,0,3,,val
0561911_as-0042224.jpg,0,0,2,0,2,,test
0561912_as-0042224.jpg,0,1,5,3,9,,train
0561913_as-0042224.jpg,0,1,1,1,3,,train
0561914_as-0042224.jpg,0,1,2,1,4,,train
0561915_as-0042224.jpg,0,0,1,0,1,,train
0561916_as-0042224.jpg,0,0,1,0,1,,train
0561917_as-0042224.jpg,0,0,2,0,2,,train
0561918_as-0042224.jpg,0,0,2,0,2,,train
0561920_as-0042224.jpg,0,1,0,1,2,,val
0561921_as-0042224.jpg,0,0,2,1,3,,val
0561922_as-0042224.jpg,1,0,0,0,1,,test
0561923_as-0042224.jpg,1,0,0,0,1,,train
0561924_as-0042224.jpg,1,0,0,0,1,,train
0561925_as-3365554.jpg,4,2,4,1,11,,train
0561927_as-0024978.jpg,1,0,0,1,2,,train
0561928_as-2797127.jpg,1,0,0,0,1,,train
0561929_as-0056059.jpg,2,1,0,1,4,,train
0561931_as-0056059.jpg,1,1,1,1,4,,train
0561932_as-0056059.jpg,1,1,1,1,4,,val
0561934_sc-138987.jpg,2,1,2,1,6,,val
0561935_sc-138987.jpg,1,1,1,1,4,,test
0561936_sc-138987.jpg,2,0,1,1,4,,train
0561937_sc-138987.jpg,2,0,1,1,4,,train
0561938_sc-138987.jpg,3,1,1,1,6,,train
0561939_as-2994783.jpg,4,1,0,0,5,,train
0561940_as-0018619.jpg,3,1,2,0,6,,train
0561942_as-3009582.jpg,3,0,0,0,3,,train
0561943_sc-1034526.jpg,2,0,0,0,2,,train
0561944_as-0054065.jpg,1,0,0,0,1,,val
0561945_as-0054065.jpg,1,0,0,0,1,,val
0561946_as-0054065.jpg,2,0,0,0,2,,test
0561947_as-3325030.jpg,5,0,1,0,6,,train
0561948_sc-136142.jpg,1,0,0,1,2,,train
0561949_sc-136142.jpg,1,0,0,1,2,,train
0561950_sc-124667.jpg,0,0,1,0,1,,train
0561952_sc-185611.jpg,5,1,3,2,11,,train
0561953_sc-185611.jpg,5,1,2,1,9,,train
0561954_sc-185611.jpg,2,0,1,0,3,,train
0561955_sc-185611.jpg,2,0,0,2,4,,val
0561956_as-7913097.jpg,3,0,2,1,6,,val
0561957_as-0042754.jpg,1,1,0,0,2,,test
0561958_as-9086228.jpg,0,1,0,1,2,,train
0561960_as-0039430.jpg,3,0,0,1,4,,train
0561961_as-0039430.jpg,3,0,0,1,4,,train
0561963_sc-1022924.jpg,2,0,0,0,2,,train
0561964_sc-1022924.jpg,1,0,0,0,1,,train
0561966_sc-1022924.jpg,1,0,0,0,1,,train
0561967_sc-130568.jpg,1,2,0,0,3,,train
0561969_sc-130568.jpg,1,1,0,1,3,,val
0561970_sc-130568.jpg,1,2,0,2,5,,val
0561971_as-0056369.jpg,1,0,0,1,2,,test
0561972_as-0056369.jpg,1,0,1,1,3,,train
0561973_as-0056369.jpg,1,0,1,1,3,,train
0561974_as-0056369.jpg,1,0,0,1,2,,train
0561975_as-0056369.jpg,2,0,0,1,3,,train
0561976_as-0053103.jpg,1,0,0,0,1,,train
0561977_as-0053103.jpg,2,0,1,0,3,,train
0561978_as-0053103.jpg,1,0,0,0,1,,train
0561979_as-0053103.jpg,1,0,0,0,1,,val
0561980_as-0053103.jpg,3,0,0,0,3,,val
0561981_as-0053103.jpg,2,0,0,0,2,,test
0561982_sc-139568.jpg,2,1,0,0,3,,train
0561984_as-0071512.jpg,1,0,1,0,2,,train
0561985_as-0071512.jpg,1,0,1,0,2,,train
0561986_as-0071512.jpg,1,0,1,0,2,,train
0561987_as-0071512.jpg,1,0,1,0,2,,train
0561988_as-0071512.jpg,1,0,1,0,2,,train
0561991_as-0002180.jpg,3,2,2,0,7,,train
0561992_as-2871143.jpg,1,0,0,0,1,,val
0561993_as-9005648.jpg,3,0,0,0,3,,val
0561997_sc-105993.jpg,6,0,0,0,6,,test
0561998_sc-105993.jpg,3,0,0,1,4,,train
0561999_sc-105993.jpg,2,0,0,0,2,,train
0562000_as-0056104.jpg,1,0,0,0,1,,train
0562001_as-0056104.jpg,1,0,0,0,1,,train
0562002_as-0056104.jpg,1,0,0,0,1,,train
0562003_sc-1028829.jpg,3,1,0,0,4,,train
0562004_sc-1028829.jpg,2,0,0,0,2,,train
0562005_sc-1028829.jpg,2,1,0,1,4,,val
0562007_as-0055177.jpg,1,0,1,0,2,,val
0562008_as-0055177.jpg,2,1,0,0,3,,test
0562010_sc-130900.jpg,1,0,0,0,1,,train
0562013_sc-187258.jpg,5,0,0,1,6,,train
0562014_sc-187258.jpg,7,0,0,1,8,,train
0562015_as-2957644.jpg,2,0,0,1,3,,train
0562016_as-0016811.jpg,2,0,0,2,4,,train
0562017_as-0016811.jpg,1,0,0,2,3,,train
0562018_as-0016811.jpg,1,0,0,0,1,,train
0562019_as-0016811.jpg,1,0,0,2,3,,val
0562020_as-0016811.jpg,0,0,0,1,1,,val
0562021_as-0016811.jpg,0,0,0,1,1,,test
0562022_as-0016811.jpg,2,0,0,1,3,,train
0562025_as-0037665.jpg,1,0,0,0,1,,train
0562027_as-0037665.jpg,3,0,0,0,3,,train
0562028_as-0037665.jpg,3,1,2,0,6,,train
0562029_as-3090176.jpg,2,0,0,1,3,,train
0562030_sc-216320.jpg,1,0,0,0,1,,train
0562031_sc-216320.jpg,1,0,0,0,1,,train
0562032_as-7098224.jpg,1,0,0,0,1,,val
0562034_as-0004312.jpg,3,0,1,0,4,,val
0562035_as-0039499.jpg,2,1,0,0,3,,test
0562036_as-0065969.jpg,1,0,0,1,2,,train
0562037_as-3185979.jpg,4,2,1,0,7,,train
0562041_as-0016724.jpg,1,0,0,0,1,,train
0562044_as-2921350.jpg,2,0,0,0,2,,train
0562046_as-0074145.jpg,2,0,0,0,2,,train
0562047_as-0074145.jpg,2,0,0,0,2,,train
0562048_as-3207195.jpg,2,0,0,0,2,,train
0562049_as-3207195.jpg,0,0,1,0,1,,val
0562050_sc-121863.jpg,1,0,0,0,1,,val
0562051_as-0054761.jpg,1,0,0,0,1,,test
0562052_as-0054761.jpg,1,0,0,0,1,,train
0562053_as-0054761.jpg,1,0,0,1,2,,train
0562054_as-0054761.jpg,1,0,0,0,1,,train
0562055_as-0025588.jpg,1,0,0,0,1,,train
0562056_as-0025588.jpg,1,0,0,0,1,,train
0562057_as-0025588.jpg,1,1,0,1,3,,train
0562058_sc-215013.jpg,1,0,0,0,1,,train
0562059_sc-215013.jpg,1,0,1,0,2,,val
0562060_sc-215013.jpg,1,0,0,0,1,,val
0562062_sc-215013.jpg,1,0,0,0,1,,test
0562063_sc-215013.jpg,1,0,0,0,1,,train
0562065_sc-215013.jpg,1,0,0,0,1,,train
0562066_sc-215013.jpg,1,0,0,0,1,,train
0562067_sc-215013.jpg,1,0,0,0,1,,train
0562068_sc-215013.jpg,1,0,0,1,2,,train
0562069_sc-215013.jpg,1,0,0,0,1,,train
0562070_sc-215013.jpg,1,0,0,0,1,,train
0562071_sc-215013.jpg,1,0,0,0,1,,val
0562072_sc-201341.jpg,1,0,0,0,1,,val
0562073_sc-201341.jpg,10,0,0,1,11,,test
0562074_sc-201341.jpg,13,0,0,0,13,,train
0562075_sc-201341.jpg,6,0,0,1,7,,train
0562076_as-2629889.jpg,1,0,0,0,1,,train
0562077_as-3384250.jpg,1,0,0,1,2,,train
0562078_as-7072062.jpg,1,0,0,0,1,,train
0562079_sc-1004877.jpg,2,0,1,0,3,,train
0562080_as-2589439.jpg,4,0,1,0,5,,train
0562081_as-2891916.jpg,1,0,0,0,1,,val
0562082_as-7347350.jpg,4,0,0,2,6,,val
0562083_sc-150305.jpg,2,1,1,0,4,,test
0562084_sc-150305.jpg,1,0,0,0,1,,train
0562086_as-0016735.jpg,1,0,0,0,1,,train
0562087_as-0009057.jpg,1,0,0,1,2,,train
0562088_as-0009057.jpg,3,0,0,1,4,,train
0562089_as-0009057.jpg,1,0,0,0,1,,train
0562090_as-0009057.jpg,2,0,0,0,2,,train
0562091_as-0009057.jpg,1,0,0,0,1,,train
0562093_as-3180003.jpg,2,0,0,0,2,,val
0562094_sc-148951.jpg,4,1,1,0,6,,val
0562095_sc-148951.jpg,3,1,1,0,5,,test
0562096_as-3350321.jpg,2,0,0,0,2,,train
0562097_sc-1020925.jpg,4,0,1,0,5,,train
0562098_sc-1020925.jpg,2,0,0,0,2,,train
0562099_sc-1020925.jpg,3,0,1,0,4,,train
0562100_as-2778641.jpg,1,0,0,0,1,,train
0562103_as-0053371.jpg,0,0,1,0,1,,train
0562104_as-0053371.jpg,1,0,0,0,1,,train
0562106_as-0053371.jpg,1,0,0,2,3,,val
0562107_as-0053371.jpg,1,0,0,1,2,,val
0562108_as-0053371.jpg,1,0,0,1,2,,test
0562109_as-0053371.jpg,1,0,0,0,1,,train
0562110_as-2570378.jpg,4,1,0,0,5,,train
0562111_sc-1000108.jpg,1,0,0,0,1,,train
0562112_as-0033183.jpg,3,0,0,0,3,,train
0562114_sc-168640.jpg,3,0,1,1,5,,train
0562115_as-2609092.jpg,2,0,0,0,2,,train
0562116_as-2735492.jpg,4,0,0,0,4,,train
0562117_as-2950703.jpg,1,0,1,1,3,,val
0562120_sc-1021007.jpg,1,0,0,0,1,,val
0562122_as-0085924.jpg,0,0,0,1,1,,test
0562123_as-0085924.jpg,2,2,0,0,4,,train
0562126_as-0085924.jpg,0,0,0,1,1,,train
0562128_as-0085924.jpg,0,0,0,1,1,,train
0562129_as-0085924.jpg,0,0,0,1,1,,train
0562130_as-0085924.jpg,0,0,0,1,1,,train
0562133_as-2762122.jpg,2,0,1,0,3,,train
0562134_as-2762122.jpg,4,0,0,0,4,,train
0562136_sc-169991.jpg,0,0,1,0,1,,val
0562137_as-0019407.jpg,2,1,2,2,7,,val
0562138_as-0019407.jpg,2,0,0,1,3,,test
0562141_as-7736804.jpg,1,0,0,0,1,,train
0562142_as-7488420.jpg,1,0,1,0,2,,train
0562145_as-0008614.jpg,2,0,0,1,3,,train
0562146_as-0008614.jpg,1,0,0,1,2,,train
0562147_as-0008614.jpg,2,0,0,1,3,,train
0562148_as-0008614.jpg,1,0,0,0,1,,train
0562149_sc-214019.jpg,2,0,0,0,2,,train
0562150_sc-214019.jpg,4,0,0,0,4,,val
0562151_sc-214019.jpg,2,0,0,0,2,,val
0562152_sc-214019.jpg,2,0,1,0,3,,test
0562153_as-0004504.jpg,4,1,0,0,5,,train
0562154_as-0004504.jpg,1,0,0,0,1,,train
0562156_sc-213052.jpg,4,1,0,0,5,,train
0562157_sc-213052.jpg,3,0,0,0,3,,train
0562158_sc-213052.jpg,4,0,0,0,4,,train
0562159_as-2663700.jpg,3,2,2,2,9,,train
0562161_sc-167231.jpg,1,0,0,0,1,,train
0562162_sc-167231.jpg,1,0,0,0,1,,val
0562163_sc-120663.jpg,6,1,0,0,7,,val
0562164_as-2784278.jpg,1,0,0,0,1,,test
0562166_sc-131390.jpg,2,0,0,1,3,,train
0562167_sc-131390.jpg,5,0,1,4,10,,train
0562168_as-7082284.jpg,2,0,2,0,4,,train
0562169_as-7495777.jpg,4,0,1,0,5,,train
0562170_sc-201124.jpg,2,0,0,1,3,,train
0562171_sc-201124.jpg,1,0,0,0,1,,train
0562172_sc-201124.jpg,1,0,1,0,2,,train
0562173_sc-201124.jpg,1,0,0,0,1,,val
0562176_sc-157409.jpg,1,1,0,0,2,,val
0562178_as-0027122.jpg,7,1,1,1,10,,test
0562179_as-0027122.jpg,2,1,0,0,3,,train
0562180_as-0027122.jpg,2,0,0,0,2,,train
0562181_as-0027122.jpg,5,0,1,1,7,,train
0562184_as-2760985.jpg,1,0,0,1,2,,train
0562186_as-0060760.jpg,1,0,0,0,1,,train
0562188_sc-172700.jpg,1,1,0,0,2,,train
0562189_sc-172700.jpg,1,1,1,0,3,,train
0562190_sc-172700.jpg,1,1,0,0,2,,val
0562191_sc-1037940.jpg,1,2,0,0,3,,val
0562192_sc-1037940.jpg,1,0,2,0,3,,test
0562194_sc-1029962.jpg,5,0,0,1,6,,train
0562195_sc-1029962.jpg,4,0,0,0,4,,train
0562196_as-0097700.jpg,3,0,0,0,3,,train
0562197_as-0097700.jpg,5,0,0,0,5,,train
0562200_as-0071933.jpg,0,1,4,0,5,,train
0562202_as-0071933.jpg,0,1,0,0,1,,train
0562203_as-0071933.jpg,0,1,1,1,3,,train
0562204_sc-199569.jpg,2,0,0,0,2,,val
0562206_sc-199569.jpg,2,3,0,0,5,,val
0562207_sc-199569.jpg,2,3,0,0,5,,test
0562208_as-2915472.jpg,3,0,2,1,6,,train
0562209_sc-203183.jpg,2,0,1,0,3,,train
0562210_sc-156599.jpg,1,0,0,0,1,,train
0562211_sc-156599.jpg,3,0,0,0,3,,train
0562212_sc-156599.jpg,1,0,0,0,1,,train
0562213_as-7568392.jpg,1,0,1,1,3,,train
0562214_as-3132650.jpg,2,1,0,0,3,,train
0562215_as-0071118.jpg,3,0,0,0,3,,val
0562216_as-0071118.jpg,1,0,0,0,1,,val
0562217_as-0071118.jpg,1,0,0,0,1,,test
0562218_as-0071118.jpg,1,1,0,0,2,,train
0562219_as-0071118.jpg,1,1,0,0,2,,train
0562220_as-0038002.jpg,1,0,0,0,1,,train
0562221_as-0038002.jpg,1,1,0,0,2,,train
0562222_as-0038002.jpg,1,0,0,0,1,,train
0562223_as-2991489.jpg,1,0,1,1,3,,train
0562225_sc-121353.jpg,1,0,0,0,1,,train
0562226_as-0060837.jpg,1,0,0,0,1,,val
0562228_as-0060837.jpg,1,0,0,0,1,,val
0562229_as-0060837.jpg,4,0,0,0,4,,test
0562230_sc-208272.jpg,2,0,0,0,2,,train
0562231_sc-208272.jpg,4,0,0,0,4,,train
0562232_sc-208272.jpg,2,0,0,0,2,,train
0562233_sc-165022.jpg,2,0,0,0,2,,train
0562234_as-2961374.jpg,1,0,0,0,1,,train
0562235_as-2780624.jpg,1,0,0,0,1,,train
0562236_as-3287995.jpg,5,0,0,0,5,,train
0562237_as-3381886.jpg,7,0,0,0,7,,val
0562240_as-0048235.jpg,2,1,0,0,3,,val
0562241_as-0048235.jpg,1,1,0,0,2,,test
0562242_as-0048235.jpg,2,1,0,0,3,,train
0562243_as-0048235.jpg,1,0,1,0,2,,train
0562244_as-9081939.jpg,3,5,1,1,10,,train
0562245_as-2739419.jpg,2,0,0,0,2,,train
0562246_sc-1028621.jpg,4,0,0,0,4,,train
0562247_sc-1028621.jpg,2,0,0,0,2,,train
0562249_sc-128193.jpg,2,0,0,0,2,,train
0562250_as-2978067.jpg,1,1,1,1,4,,val
0562251_as-2789350.jpg,0,2,1,0,3,,val
0562252_sc-154598.jpg,1,0,0,1,2,,test
0562253_sc-154598.jpg,1,0,0,2,3,,train
0562254_sc-154598.jpg,1,0,0,2,3,,train
0562255_sc-1037669.jpg,1,0,0,0,1,,train
0562256_sc-1037669.jpg,2,3,1,0,6,,train
0562257_sc-1037669.jpg,1,2,1,0,4,,train
0562258_sc-1037669.jpg,2,1,1,0,4,,train
0562260_as-3293361.jpg,1,0,2,1,4,,train
0562262_as-0040447.jpg,0,2,0,0,2,,val
0562263_as-0040447.jpg,0,1,0,0,1,,val
0562264_as-0040447.jpg,0,1,0,0,1,,test
0562265_as-0040447.jpg,0,1,0,0,1,,train
0562266_as-0040447.jpg,1,0,0,0,1,,train
0562267_as-0040447.jpg,1,0,0,0,1,,train
0562268_as-0040447.jpg,1,0,0,0,1,,train
0562269_as-0040447.jpg,1,0,1,0,2,,train
0562270_as-0040447.jpg,0,0,1,0,1,,train
0562271_as-0040447.jpg,0,2,0,0,2,,train
0562272_as-0040447.jpg,0,0,1,0,1,,val
0562273_as-0040447.jpg,0,2,0,0,2,,val
0562274_as-0040447.jpg,2,1,1,0,4,,test
0562280_sc-219208.jpg,3,0,1,0,4,,train
0562281_sc-219208.jpg,1,0,1,0,2,,train
0562282_sc-219208.jpg,2,0,0,0,2,,train
0562283_sc-219208.jpg,2,0,0,0,2,,train
0562285_sc-192606.jpg,1,1,0,0,2,,train
0562287_as-2523476.jpg,2,0,1,0,3,,train
0562289_as-0076140.jpg,1,0,0,1,2,,train
0562290_as-0076140.jpg,1,0,3,1,5,,val
0562293_as-3152834.jpg,0,0,1,0,1,,val
0562296_as-0058073.jpg,2,0,0,2,4,,test
0562297_as-0058073.jpg,0,0,0,2,2,,train
0562299_sc-1004232.jpg,2,1,0,0,3,,train
0562302_sc-130753.jpg,1,0,0,0,1,,train
0562304_as-0083846.jpg,3,0,0,0,3,,train
0562305_as-0083846.jpg,2,0,0,0,2,,train
0562306_as-0083846.jpg,1,0,0,0,1,,train
0562308_as-0061922.jpg,2,0,0,0,2,,train
0562311_as-7847542.jpg,1,0,0,0,1,,val
0562313_sc-1034905.jpg,0,1,1,0,2,,val
0562314_sc-132524.jpg,1,0,0,1,2,,test
0562315_sc-132524.jpg,1,0,0,0,1,,train
0562316_sc-201880.jpg,0,1,0,0,1,,train
0562319_as-0056553.jpg,1,0,0,0,1,,train
0562320_as-0056553.jpg,1,1,1,1,4,,train
0562322_as-0056553.jpg,1,0,0,1,2,,train
0562323_as-0056553.jpg,1,0,0,0,1,,train
0562324_as-0056553.jpg,1,0,1,1,3,,train
0562325_sc-106863.jpg,3,0,0,0,3,,val
0562326_sc-106863.jpg,5,0,0,0,5,,val
0562327_sc-106863.jpg,4,0,0,0,4,,test
0562328_sc-1021306.jpg,0,0,1,0,1,,train
0562329_sc-1021306.jpg,0,0,1,0,1,,train
0562330_sc-1021306.jpg,0,0,1,0,1,,train
0562331_as-0056798.jpg,1,0,0,0,1,,train
0562332_sc-222103.jpg,1,1,0,0,2,,train
0562333_sc-222103.jpg,1,0,0,0,1,,train
0562335_as-0094344.jpg,6,0,0,0,6,,train
0562336_sc-144114.jpg,0,0,0,1,1,,val
0562338_as-0002807.jpg,1,1,0,0,2,,val
0562340_as-2567636.jpg,1,0,0,0,1,,test
0562343_sc-115842.jpg,1,0,0,1,2,,train
0562344_as-0021869.jpg,3,0,0,0,3,,train
0562345_as-0021869.jpg,6,0,0,0,6,,train
0562347_as-0067692.jpg,4,0,0,0,4,,train
0562348_as-0067692.jpg,2,0,0,0,2,,train
0562349_as-0067692.jpg,3,0,0,0,3,,train
0562350_as-7818981.jpg,1,0,0,1,2,,train
0562351_sc-209875.jpg,3,0,3,0,6,,val
0562352_sc-209875.jpg,3,0,1,0,4,,val
0562353_sc-209875.jpg,6,0,1,0,7,,test
0562354_sc-209875.jpg,5,0,0,0,5,,train
0562355_sc-209875.jpg,1,0,1,0,2,,train
0562356_sc-209875.jpg,3,0,0,0,3,,train
0562357_as-0025287.jpg,2,0,0,0,2,,train
0562358_as-0025287.jpg,1,0,0,0,1,,train
0562359_as-2558950.jpg,2,0,0,0,2,,train
0562360_sc-156629.jpg,1,0,0,1,2,,train
0562361_as-2627802.jpg,2,0,0,0,2,,val
0562362_as-2884696.jpg,1,0,0,0,1,,val
0562364_sc-130629.jpg,3,1,0,0,4,,test
0562366_as-0011282.jpg,0,0,1,1,2,,train
0562368_as-0011282.jpg,0,0,2,0,2,,train
0562369_as-3347923.jpg,1,0,0,0,1,,train
0562371_sc-128483.jpg,11,0,0,0,11,,train
0562372_as-3325058.jpg,1,0,0,1,2,,train
0562374_sc-1027398.jpg,1,2,2,0,5,,train
0562381_as-0038755.jpg,1,0,0,0,1,,train
0562383_as-3312074.jpg,1,0,0,1,2,,val
0562384_as-3368561.jpg,2,0,1,0,3,,val
0562385_sc-198879.jpg,3,0,0,0,3,,test
0562387_sc-198879.jpg,1,0,0,0,1,,train
0562389_sc-198879.jpg,3,0,0,0,3,,train
0562390_sc-198879.jpg,2,0,0,0,2,,train
0562391_as-0097566.jpg,0,0,1,1,2,,train
0562392_sc-1008807.jpg,2,0,0,0,2,,train
0562393_sc-1008807.jpg,5,0,0,0,5,,train
0562394_sc-1008807.jpg,1,0,1,0,2,,train
0562395_as-2955436.jpg,1,0,0,0,1,,val
0562397_as-0033330.jpg,3,0,0,0,3,,val
0562398_sc-169755.jpg,5,1,2,0,8,,test
0562399_sc-169755.jpg,7,0,0,0,7,,train
0562400_sc-169755.jpg,6,0,1,0,7,,train
0562401_sc-169755.jpg,3,0,0,0,3,,train
0562403_sc-193795.jpg,1,1,0,1,3,,train
0562404_sc-193795.jpg,4,0,0,0,4,,train
0562405_sc-193795.jpg,1,0,0,0,1,,train
0562406_sc-193795.jpg,3,0,0,0,3,,train
0562407_sc-193795.jpg,1,1,0,1,3,,val
0562408_sc-193795.jpg,2,0,0,0,2,,val
0562409_sc-193795.jpg,4,0,0,0,4,,test
0562410_sc-193795.jpg,4,0,0,0,4,,train
0562411_sc-158644.jpg,4,0,0,1,5,,train
0562412_sc-158644.jpg,4,0,0,1,5,,train
0562414_sc-158644.jpg,2,0,0,0,2,,train
0562415_sc-158644.jpg,1,0,0,0,1,,train
0562416_sc-158644.jpg,3,0,0,0,3,,train
0562418_sc-199325.jpg,4,0,0,0,4,,train
0562419_sc-199325.jpg,2,0,0,0,2,,val
0562420_as-2577916.jpg,1,0,0,0,1,,val
0562421_sc-1033371.jpg,0,0,1,0,1,,test
0562422_sc-118724.jpg,1,0,0,0,1,,train
0562423_sc-118724.jpg,1,0,0,0,1,,train
0562424_sc-178560.jpg,0,1,1,0,2,,train
0562425_sc-1013596.jpg,0,1,0,0,1,,train
0562426_as-0061857.jpg,1,0,0,0,1,,train
0562427_as-0061857.jpg,6,0,0,0,6,,train
0562431_as-0022176.jpg,3,0,2,1,6,,train
0562432_as-0022176.jpg,0,1,0,0,1,,val
0562433_as-0022176.jpg,3,0,0,0,3,,val
0562435_as-3343839.jpg,0,0,1,1,2,,test
0562436_sc-208393.jpg,3,0,0,0,3,,train
0562437_sc-208393.jpg,5,0,0,0,5,,train
0562438_sc-208393.jpg,3,0,0,0,3,,train
0562439_sc-208393.jpg,3,0,0,0,3,,train
0562440_sc-208393.jpg,2,0,0,0,2,,train
0562441_sc-208393.jpg,3,0,0,0,3,,train
0562442_sc-208393.jpg,3,0,0,0,3,,train
0562443_as-9017882.jpg,1,0,0,0,1,,val
0562444_sc-1016865.jpg,2,0,0,0,2,,val
0562445_as-3246253.jpg,5,1,2,1,9,,test
0562447_as-0000772.jpg,3,0,0,0,3,,train
0562449_as-0029577.jpg,1,0,0,0,1,,train
0562450_as-0029577.jpg,0,1,0,0,1,,train
0562451_as-0029577.jpg,0,1,1,1,3,,train
0562454_as-2876235.jpg,2,0,1,0,3,,train
0562456_as-2629275.jpg,3,0,0,0,3,,train
0562457_as-3416679.jpg,1,0,0,0,1,,train
0562458_as-3390661.jpg,1,0,0,0,1,,val
0562459_as-7072723.jpg,1,0,0,0,1,,val
0562460_as-2910577.jpg,2,0,0,0,2,,test
0562461_as-2910577.jpg,1,0,0,0,1,,train
0562462_as-0041260.jpg,1,0,1,1,3,,train
0562463_as-0041260.jpg,2,0,0,2,4,,train
0562464_as-0041260.jpg,1,1,1,1,4,,train
0562465_as-0041260.jpg,1,1,1,1,4,,train
0562466_as-0041260.jpg,0,0,0,1,1,,train
0562467_as-0041260.jpg,2,1,0,1,4,,train
0562468_as-0041260.jpg,2,0,2,1,5,,val
0562469_as-0041260.jpg,4,1,0,1,6,,val
0562471_as-0006716.jpg,1,0,0,0,1,,test
0562472_as-0006716.jpg,1,0,0,0,1,,train
0562473_as-0006716.jpg,1,0,0,0,1,,train
0562474_as-2762773.jpg,1,0,0,0,1,,train
0562475_sc-1032878.jpg,1,0,1,0,2,,train
0562476_sc-1032878.jpg,0,0,1,0,1,,train
0562477_sc-155573.jpg,1,0,0,0,1,,train
0562478_sc-155573.jpg,1,0,0,0,1,,train
0562481_sc-163646.jpg,1,1,0,1,3,,val
0562483_sc-225039.jpg,1,0,1,1,3,,val
0562484_sc-225039.jpg,3,0,1,1,5,,test
0562485_sc-225039.jpg,2,0,1,1,4,,train
0562486_sc-225039.jpg,3,0,1,1,5,,train
0562487_sc-225039.jpg,3,0,1,1,5,,train
0562488_as-9058561.jpg,2,0,0,0,2,,train
0562489_as-7493604.jpg,2,3,1,1,7,,train
0562490_sc-1000102.jpg,1,0,0,1,2,,train
0562491_sc-1000102.jpg,1,0,0,1,2,,train
0562492_sc-1000102.jpg,2,0,0,1,3,,val
0562493_sc-1000102.jpg,1,0,0,1,2,,val
0562494_sc-1000102.jpg,1,0,0,1,2,,test
0562498_as-0040993.jpg,3,0,0,1,4,,train
0562499_as-0040993.jpg,3,0,0,1,4,,train
0562500_as-0040993.jpg,1,0,0,0,1,,train
0562502_as-7722508.jpg,1,0,0,1,2,,train
0562503_sc-103897.jpg,2,0,0,0,2,,train
0562505_as-9013977.jpg,2,0,0,0,2,,train
0562508_as-0059645.jpg,1,1,0,0,2,,train
0562509_as-0059645.jpg,1,0,0,0,1,,val
0562510_as-0059645.jpg,1,0,0,0,1,,val
0562511_sc-1010206.jpg,0,1,0,0,1,,test
0562512_sc-1010206.jpg,0,1,0,0,1,,train
0562513_as-0084432.jpg,1,0,0,0,1,,train
0562515_as-0084432.jpg,2,0,0,2,4,,train
0562516_as-0084432.jpg,3,1,0,2,6,,train
0562517_as-0084432.jpg,2,2,0,2,6,,train
0562519_sc-112260.jpg,2,1,1,1,5,,train
0562520_sc-112260.jpg,2,1,1,1,5,,train
0562521_sc-112260.jpg,1,0,0,0,1,,val
0562522_as-0080955.jpg,1,0,1,1,3,,val
0562523_as-0080955.jpg,1,0,1,1,3,,test
0562524_as-0080955.jpg,3,0,1,1,5,,train
0562526_as-0081680.jpg,1,0,0,1,2,,train
0562527_as-0081680.jpg,1,0,0,2,3,,train
0562528_as-0081680.jpg,2,0,0,1,3,,train
0562529_as-0081680.jpg,1,0,0,1,2,,train
0562530_as-0081680.jpg,1,0,0,1,2,,train
0562531_as-0061806.jpg,0,1,1,0,2,,train
0562532_as-0061806.jpg,0,0,2,0,2,,val
0562533_as-0061806.jpg,0,0,2,0,2,,val
0562534_as-0061806.jpg,0,1,1,0,2,,test
0562535_as-0061806.jpg,1,0,0,0,1,,train
0562536_as-0061806.jpg,1,1,0,0,2,,train
0562537_as-0061806.jpg,1,1,1,0,3,,train
0562540_as-2940783.jpg,1,0,0,0,1,,train
0562541_as-2992874.jpg,5,0,1,1,7,,train
0562542_as-3375995.jpg,2,0,0,0,2,,train
0562543_sc-209461.jpg,5,0,0,1,6,,train
0562544_sc-209461.jpg,3,0,0,0,3,,val
0562545_sc-209461.jpg,2,0,0,1,3,,val
0562546_as-0072968.jpg,2,0,1,0,3,,test
0562547_as-3114914.jpg,4,0,0,0,4,,train
0562549_as-0072175.jpg,1,0,0,0,1,,train
0562550_as-0072175.jpg,2,0,0,0,2,,train
0562552_sc-1041535.jpg,1,0,0,0,1,,train
0562553_sc-1041535.jpg,1,0,1,0,2,,train
0562554_sc-1041535.jpg,2,0,0,0,2,,train
0562556_sc-1041535.jpg,6,0,0,0,6,,train
0562558_sc-225317.jpg,3,0,2,0,5,,val
0562559_sc-225317.jpg,3,0,1,0,4,,val
0562560_sc-225317.jpg,2,0,2,0,4,,test
0562561_sc-225317.jpg,2,0,0,0,2,,train
0562562_as-0020684.jpg,0,0,0,1,1,,train
0562564_as-2571761.jpg,1,0,0,0,1,,train
0562565_as-0066299.jpg,1,0,0,0,1,,train
0562567_as-0083064.jpg,1,0,0,0,1,,train
0562568_as-0083064.jpg,0,1,0,0,1,,train
0562570_sc-1037216.jpg,2,3,3,0,8,,train
0562571_sc-1037216.jpg,5,3,2,0,10,,val
0562573_sc-107049.jpg,1,1,0,0,2,,val
0562575_sc-107049.jpg,3,2,0,0,5,,test
0562576_sc-107049.jpg,2,1,0,0,3,,train
0562577_sc-107049.jpg,2,0,0,0,2,,train
0562578_sc-1035939.jpg,1,1,1,0,3,,train
0562579_sc-1035939.jpg,6,3,6,0,15,,train
0562580_sc-1035939.jpg,3,0,2,0,5,,train
0562582_sc-1035939.jpg,3,0,1,0,4,,train
0562584_as-0090051.jpg,2,1,1,0,4,,train
0562585_as-0090051.jpg,4,1,0,0,5,,val
0562586_as-0090051.jpg,5,0,0,0,5,,val
0562587_as-0090051.jpg,5,0,1,0,6,,test
0562589_sc-132222.jpg,0,0,1,0,1,,train
0562590_sc-132222.jpg,0,0,1,0,1,,train
0562592_sc-132222.jpg,1,0,1,0,2,,train
0562593_sc-132222.jpg,1,0,0,0,1,,train
0562594_sc-132222.jpg,1,0,0,0,1,,train
0562595_as-0028261.jpg,2,0,0,1,3,,train
0562596_as-0025918.jpg,1,0,2,1,4,,train
0562597_as-0025918.jpg,4,0,1,0,5,,val
0562598_as-0025918.jpg,3,0,2,0,5,,val
0562599_as-0025918.jpg,1,0,2,1,4,,test
0562600_as-0025918.jpg,3,0,2,0,5,,train
0562601_as-0025918.jpg,2,0,1,0,3,,train
0562602_as-3082755.jpg,3,0,0,0,3,,train
0562603_sc-189559.jpg,2,0,0,0,2,,train
0562605_sc-189559.jpg,3,0,0,1,4,,train
0562606_as-3261854.jpg,0,0,1,0,1,,train
0562607_as-2828015.jpg,1,0,0,0,1,,train
0562610_as-0086577.jpg,1,1,4,2,8,,val
0562613_as-0086577.jpg,0,0,2,1,3,,val
0562614_as-0004541.jpg,1,0,3,1,5,,test
0562616_sc-1020023.jpg,3,0,1,1,5,,train
0562617_sc-1020023.jpg,1,2,0,0,3,,train
0562618_sc-1020023.jpg,4,0,0,1,5,,train
0562619_sc-1020023.jpg,1,0,0,0,1,,train
0562620_sc-1020023.jpg,1,0,0,0,1,,train
0562622_sc-181911.jpg,1,1,0,0,2,,train
0562623_as-2635526.jpg,2,0,0,0,2,,train
0562624_as-3091484.jpg,2,0,0,0,2,,val
0562625_sc-146875.jpg,5,0,0,0,5,,val
0562626_sc-146875.jpg,1,0,0,1,2,,test
0562627_sc-146875.jpg,1,0,0,0,1,,train
0562628_as-3040495.jpg,1,0,2,0,3,,train
0562630_sc-107394.jpg,4,0,1,4,9,,train
0562632_sc-187855.jpg,2,0,0,0,2,,train
0562633_as-3010280.jpg,0,0,2,1,3,,train
0562634_sc-1002480.jpg,1,2,0,0,3,,train
0562635_sc-1002480.jpg,1,0,0,1,2,,train
0562636_sc-1002480.jpg,1,0,0,2,3,,val
0562637_sc-223836.jpg,6,1,1,1,9,,val
0562638_as-0037624.jpg,4,0,0,1,5,,test
0562639_as-0037624.jpg,0,1,0,0,1,,train
0562640_as-0037624.jpg,4,1,0,1,6,,train
0562641_as-0037624.jpg,4,0,0,0,4,,train
0562643_sc-112407.jpg,3,1,0,0,4,,train
0562644_sc-112407.jpg,2,1,0,0,3,,train
0562646_as-0034273.jpg,9,0,0,0,9,,train
0562647_as-7610193.jpg,2,0,0,0,2,,train
0562648_as-3404138.jpg,4,0,0,0,4,,val
0562649_sc-109853.jpg,2,0,0,0,2,,val
0562650_sc-109853.jpg,2,0,0,0,2,,test
0562651_as-3447497.jpg,2,0,1,1,4,,train
0562652_sc-165569.jpg,1,0,0,0,1,,train
0562654_as-0020862.jpg,1,0,0,0,1,,train
0562655_as-2522931.jpg,1,0,0,0,1,,train
0562656_sc-108006.jpg,3,0,0,1,4,,train
0562657_sc-108006.jpg,5,1,0,0,6,,train
0562658_as-2949874.jpg,4,1,1,3,9,,train
0562659_as-3411880.jpg,1,0,0,0,1,,val
0562660_as-0010109.jpg,1,0,0,0,1,,val
0562661_as-0010109.jpg,1,0,0,0,1,,test
0562662_as-0010109.jpg,1,0,0,0,1,,train
0562663_as-0010109.jpg,2,0,0,0,2,,train
0562664_as-0010109.jpg,1,0,0,0,1,,train
0562666_sc-166477.jpg,3,0,1,1,5,,train
0562667_sc-166477.jpg,2,0,0,0,2,,train
0562669_sc-166477.jpg,2,0,0,0,2,,train
0562671_sc-166477.jpg,4,0,1,1,6,,train
0562672_sc-166477.jpg,3,1,1,1,6,,val
0562673_sc-1037252.jpg,2,1,0,0,3,,val
0562674_sc-1037252.jpg,3,1,0,0,4,,test
0562675_sc-1037252.jpg,3,1,0,0,4,,train
0562676_sc-1037252.jpg,2,1,0,0,3,,train
0562677_sc-202097.jpg,1,0,0,1,2,,train
0562678_sc-202097.jpg,3,0,0,0,3,,train
0562679_sc-202097.jpg,2,0,0,0,2,,train
0562680_sc-202097.jpg,2,0,0,0,2,,train
0562681_sc-202097.jpg,2,0,0,0,2,,train
0562682_sc-202097.jpg,1,0,0,0,1,,val
0562683_sc-202097.jpg,2,0,0,0,2,,val
0562684_sc-202097.jpg,7,0,0,0,7,,test
0562685_sc-202097.jpg,9,0,0,0,9,,train
0562688_sc-1020674.jpg,2,0,0,1,3,,train
0562691_sc-171474.jpg,1,0,1,0,2,,train
0562692_sc-171474.jpg,2,0,1,0,3,,train
0562693_sc-171474.jpg,2,0,0,0,2,,train
0562695_sc-203875.jpg,1,0,0,0,1,,train
0562696_sc-1029181.jpg,4,0,0,0,4,,train
0562697_sc-1029181.jpg,3,0,1,0,4,,val
0562698_sc-221501.jpg,6,3,1,0,10,,val
0562700_as-3256916.jpg,0,1,1,0,2,,test
0562701_as-0046019.jpg,2,2,1,0,5,,train
0562702_as-0046019.jpg,2,2,1,0,5,,train
0562705_as-7438981.jpg,0,0,1,0,1,,train
0562706_sc-134812.jpg,0,1,0,0,1,,train
0562707_as-0063851.jpg,1,0,0,0,1,,train
0562708_as-0063851.jpg,1,0,0,0,1,,train
0562709_as-0063851.jpg,2,0,0,0,2,,train
0562710_as-0063851.jpg,6,0,0,0,6,,val
0562711_as-0063851.jpg,2,1,0,0,3,,val
0562712_as-0063851.jpg,2,1,1,0,4,,test
0562713_as-0063851.jpg,3,1,1,0,5,,train
0562714_as-0063851.jpg,2,0,0,0,2,,train
0562715_as-0063851.jpg,2,0,0,0,2,,train
0562716_as-0063851.jpg,2,0,0,0,2,,train
0562717_as-0063851.jpg,3,1,1,0,5,,train
0562718_as-0063851.jpg,3,0,0,0,3,,train
0562719_as-0063851.jpg,2,1,1,0,4,,train
0562720_as-0063851.jpg,6,0,1,0,7,,val
0562721_as-0063851.jpg,2,0,0,0,2,,val
0562722_as-0063851.jpg,1,0,0,0,1,,test
0562723_as-0063851.jpg,1,0,0,0,1,,train
0562724_sc-171691.jpg,1,0,0,0,1,,train
0562725_sc-171691.jpg,1,0,0,0,1,,train
0562726_as-3011548.jpg,1,0,0,0,1,,train
0562727_as-3088516.jpg,4,0,0,1,5,,train
0562728_sc-175387.jpg,1,0,0,1,2,,train
0562732_sc-149246.jpg,1,0,0,0,1,,train
0562733_sc-149246.jpg,1,0,0,0,1,,val
0562734_as-9099085.jpg,2,0,0,0,2,,val
0562735_sc-160360.jpg,0,0,1,0,1,,test
0562736_as-0019107.jpg,1,0,0,0,1,,train
0562738_sc-192674.jpg,2,0,0,0,2,,train
0562739_sc-192674.jpg,1,0,0,0,1,,train
0562741_as-2611529.jpg,4,0,0,0,4,,train
0562742_sc-1032864.jpg,4,0,2,1,7,,train
0562743_as-0001608.jpg,2,0,1,0,3,,train
0562744_as-0001608.jpg,3,0,1,0,4,,train
0562745_sc-115406.jpg,3,0,0,1,4,,val
0562746_sc-115406.jpg,2,0,0,1,3,,val
0562747_sc-115406.jpg,2,0,0,1,3,,test
0562748_sc-115406.jpg,2,0,0,2,4,,train
0562749_as-9071950.jpg,2,0,0,0,2,,train
0562750_sc-1027798.jpg,6,0,0,0,6,,train
0562751_sc-1027798.jpg,4,0,0,0,4,,train
0562752_sc-129339.jpg,1,0,0,0,1,,train
0562753_sc-129339.jpg,2,0,0,0,2,,train
0562754_as-0013530.jpg,1,1,0,0,2,,train
0562755_as-0013530.jpg,1,0,0,0,1,,val
0562756_as-0013530.jpg,0,1,0,0,1,,val
0562757_as-0013530.jpg,3,0,0,0,3,,test
0562758_as-0013530.jpg,4,0,0,0,4,,train
0562759_as-0013530.jpg,1,0,0,0,1,,train
0562760_as-2500249.jpg,4,0,0,0,4,,train
0562761_sc-1033911.jpg,3,0,0,0,3,,train
0562762_sc-1033911.jpg,0,0,0,1,1,,train
0562763_sc-1033911.jpg,3,0,0,0,3,,train
0562766_as-0076468.jpg,4,0,1,1,6,,train
0562767_as-0076468.jpg,2,0,1,1,4,,val
0562768_as-0076468.jpg,3,1,2,1,7,,val
0562769_as-0076468.jpg,6,2,1,1,10,,test
0562770_as-0076468.jpg,1,1,0,1,3,,train
0562772_sc-140921.jpg,1,0,0,1,2,,train
0562773_sc-140921.jpg,1,0,0,1,2,,train
0562774_sc-140921.jpg,1,0,1,1,3,,train
0562775_sc-140921.jpg,0,0,1,0,1,,train
0562776_sc-140921.jpg,0,0,1,0,1,,train
0562778_sc-148888.jpg,2,0,0,1,3,,train
0562780_sc-148888.jpg,1,1,0,0,2,,val
0562781_sc-148888.jpg,2,0,0,1,3,,val
0562782_sc-148888.jpg,1,0,0,1,2,,test
0562783_sc-230191.jpg,1,0,0,1,2,,train
0562784_sc-230191.jpg,1,0,0,0,1,,train
0562785_sc-230191.jpg,1,0,0,0,1,,train
0562786_as-3061540.jpg,0,0,1,0,1,,train
0562788_as-7820751.jpg,1,0,0,0,1,,train
0562789_as-2559737.jpg,1,2,0,0,3,,train
0562791_sc-119392.jpg,3,0,0,0,3,,train
0562793_sc-1025352.jpg,4,0,1,0,5,,val
0562794_sc-1025352.jpg,6,1,0,0,7,,val
0562795_sc-214022.jpg,1,0,1,1,3,,test
0562796_sc-214022.jpg,1,0,0,0,1,,train
0562797_sc-214022.jpg,1,0,1,1,3,,train
0562798_sc-214022.jpg,1,0,1,1,3,,train
0562799_sc-214022.jpg,1,0,1,1,3,,train
0562800_sc-214022.jpg,1,0,1,2,4,,train
0562801_sc-186824.jpg,2,0,0,0,2,,train
0562802_sc-1018516.jpg,1,0,0,1,2,,train
0562804_as-0005236.jpg,7,0,0,0,7,,val
0562806_as-0058998.jpg,1,0,0,0,1,,val
0562807_sc-1012040.jpg,1,0,0,0,1,,test
0562808_sc-1012040.jpg,3,0,0,0,3,,train
0562809_sc-1012040.jpg,2,0,0,0,2,,train
0562810_sc-1012040.jpg,1,0,0,0,1,,train
0562811_sc-1012040.jpg,4,0,0,0,4,,train
0562812_sc-1012040.jpg,0,1,0,0,1,,train
0562813_sc-1012040.jpg,1,0,0,0,1,,train
0562814_as-3069909.jpg,1,0,0,0,1,,train
0562815_sc-1037214.jpg,0,0,0,1,1,,val
0562816_sc-1037214.jpg,0,0,0,1,1,,val
0562817_sc-1037214.jpg,1,0,0,0,1,,test
0562818_sc-1037214.jpg,1,0,0,0,1,,train
0562819_sc-124240.jpg,1,1,0,0,2,,train
0562820_sc-124240.jpg,0,0,1,0,1,,train
0562821_sc-124240.jpg,1,0,1,0,2,,train
0562822_sc-124240.jpg,7,1,1,0,9,,train
0562823_as-0074649.jpg,2,0,0,0,2,,train
0562825_as-0074649.jpg,2,0,0,0,2,,train
0562826_as-3228534.jpg,2,0,0,0,2,,val
0562828_sc-142112.jpg,1,0,0,0,1,,val
0562829_sc-142112.jpg,3,0,0,0,3,,test
0562832_sc-1004172.jpg,1,0,1,0,2,,train
0562833_sc-1004172.jpg,2,0,1,0,3,,train
0562834_sc-1030071.jpg,3,3,4,2,12,,train
0562836_sc-1030071.jpg,2,1,2,0,5,,train
0562837_sc-1030071.jpg,3,3,3,0,9,,train
0562838_sc-1030071.jpg,5,1,1,1,8,,train
0562839_sc-1030071.jpg,2,3,4,1,10,,train
0562840_sc-1030071.jpg,1,0,2,1,4,,val
0562841_sc-1030071.jpg,2,0,3,1,6,,val
0562842_sc-1030071.jpg,1,0,1,0,2,,test
0562844_sc-1030071.jpg,1,2,1,1,5,,train
0562845_sc-224229.jpg,1,0,1,1,3,,train
0562846_as-0003981.jpg,3,0,0,1,4,,train
0562847_as-0003981.jpg,4,0,0,0,4,,train
0562850_sc-1009600.jpg,2,0,0,0,2,,train
0562851_sc-124574.jpg,4,0,0,0,4,,train
0562856_as-0001613.jpg,5,0,0,1,6,,train
0562857_as-0001613.jpg,5,0,0,1,6,,val
0562861_sc-1039298.jpg,1,0,0,1,2,,val
0562862_sc-1039298.jpg,1,0,0,1,2,,test
0562863_as-3152640.jpg,1,0,1,1,3,,train
0562867_as-0016886.jpg,0,0,0,3,3,,train
0562868_as-0016886.jpg,0,0,0,4,4,,train
0562869_as-0016886.jpg,0,0,0,3,3,,train
0562870_as-0016886.jpg,0,0,0,1,1,,train
0562871_as-0016886.jpg,0,0,0,3,3,,train
0562872_as-0016886.jpg,1,0,0,1,2,,train
0562873_sc-1035381.jpg,1,0,0,0,1,,val
0562874_sc-1035381.jpg,6,0,0,0,6,,val
0562875_sc-1035381.jpg,7,0,0,0,7,,test
0562876_sc-1035381.jpg,5,0,0,0,5,,train
0562877_as-7263046.jpg,2,0,1,1,4,,train
0562878_sc-170630.jpg,1,1,0,1,3,,train
0562879_sc-107502.jpg,1,0,0,1,2,,train
0562880_sc-1039083.jpg,4,1,0,2,7,,train
0562881_sc-1039083.jpg,2,2,0,1,5,,train
0562883_sc-1039083.jpg,2,1,0,1,4,,train
0562885_as-3121585.jpg,5,0,1,0,6,,val
0562886_as-3121585.jpg,3,0,1,1,5,,val
0562887_as-3264030.jpg,1,0,0,0,1,,test
0562888_sc-189102.jpg,1,0,1,0,2,,train
0562889_sc-189102.jpg,1,0,1,0,2,,train
0562890_sc-189102.jpg,1,0,0,0,1,,train
0562891_sc-189102.jpg,1,1,0,0,2,,train
0562892_sc-189102.jpg,1,1,1,0,3,,train
0562893_sc-1035277.jpg,2,0,1,0,3,,train
0562894_sc-1035277.jpg,3,0,1,0,4,,train
0562895_sc-1035277.jpg,1,0,1,0,2,,val
0562896_sc-1035277.jpg,2,0,1,0,3,,val
0562897_sc-1035277.jpg,1,0,1,0,2,,test
0562898_sc-1035277.jpg,1,0,3,1,5,,train
0562900_sc-1035277.jpg,1,0,1,1,3,,train
0562901_sc-179391.jpg,2,0,0,0,2,,train
0562902_sc-179391.jpg,2,0,0,0,2,,train
0562903_sc-179391.jpg,2,0,0,0,2,,train
0562904_sc-179391.jpg,2,0,0,0,2,,train
0562905_sc-179391.jpg,1,0,0,0,1,,train
0562906_sc-179391.jpg,3,0,0,0,3,,val
0562907_as-7668683.jpg,3,0,0,0,3,,val
0562909_as-0075367.jpg,1,1,2,0,4,,test
0562910_as-0075367.jpg,3,0,1,2,6,,train
0562911_as-0075367.jpg,1,0,0,0,1,,train
0562912_as-0075367.jpg,2,0,1,2,5,,train
0562913_sc-145793.jpg,2,0,0,1,3,,train
0562914_sc-145793.jpg,2,0,0,1,3,,train
0562915_as-0022169.jpg,1,0,2,0,3,,train
0562922_sc-202975.jpg,2,0,1,0,3,,train
0562923_sc-202975.jpg,4,1,0,0,5,,val
0562924_sc-202975.jpg,2,0,1,1,4,,val
0562926_sc-162618.jpg,1,0,1,1,3,,test
0562927_sc-162618.jpg,2,0,1,1,4,,train
0562928_as-2824067.jpg,2,0,1,0,3,,train
0562929_as-0001233.jpg,1,0,0,0,1,,train
0562932_as-0054366.jpg,0,0,1,0,1,,train
0562933_as-0054366.jpg,1,0,1,0,2,,train
0562934_as-0054366.jpg,2,0,1,0,3,,train
0562935_sc-174151.jpg,1,0,0,0,1,,train
0562936_sc-174151.jpg,2,0,0,0,2,,val
0562937_sc-216424.jpg,1,0,0,0,1,,val
0562938_as-3019797.jpg,2,1,0,0,3,,test
0562939_as-0030015.jpg,4,0,1,0,5,,train
0562940_as-0030015.jpg,1,0,1,0,2,,train
0562942_as-0048795.jpg,0,0,0,1,1,,train
0562943_as-0048795.jpg,0,0,0,1,1,,train
0562944_as-0048795.jpg,0,0,0,1,1,,train
0562945_as-0048795.jpg,0,1,0,0,1,,train
0562946_as-0008724.jpg,1,0,0,0,1,,train
0562947_as-0052371.jpg,2,0,0,0,2,,val
0562948_as-0052371.jpg,2,0,0,0,2,,val
0562949_as-0052371.jpg,2,0,0,0,2,,test
0562950_as-0052371.jpg,2,0,0,0,2,,train
0562952_as-0052371.jpg,0,1,0,0,1,,train
0562956_as-0052371.jpg,1,1,1,0,3,,train
0562957_as-0052371.jpg,1,1,1,0,3,,train
0562958_sc-208115.jpg,2,0,0,1,3,,train
0562959_sc-208115.jpg,1,0,0,1,2,,train
0562960_sc-208115.jpg,1,0,0,0,1,,train
0562962_sc-208115.jpg,3,0,0,0,3,,val
0562963_sc-167077.jpg,1,0,0,1,2,,val
0562964_sc-167077.jpg,1,0,0,1,2,,test
0562965_sc-167077.jpg,1,0,0,1,2,,train
0562966_as-3477545.jpg,1,0,0,0,1,,train
0562968_sc-1038694.jpg,3,0,1,0,4,,train
0562969_sc-1038694.jpg,3,0,1,0,4,,train
0562971_sc-1038694.jpg,1,0,0,0,1,,train
0562972_sc-1038694.jpg,1,0,0,0,1,,train
0562973_sc-1038694.jpg,1,0,0,0,1,,train
0562974_sc-1038694.jpg,1,0,0,0,1,,val
0562975_sc-1038694.jpg,1,0,1,0,2,,val
0562976_sc-1038694.jpg,1,0,0,0,1,,test
0562978_sc-1038694.jpg,2,0,0,0,2,,train
0562982_as-0021334.jpg,2,0,0,1,3,,train
0562983_as-0021334.jpg,1,0,0,0,1,,train
0562984_as-0021334.jpg,3,0,0,1,4,,train
0562985_sc-210264.jpg,1,0,0,0,1,,train
0562986_sc-210264.jpg,2,0,1,0,3,,train
0562987_sc-210264.jpg,13,0,0,0,13,,train
0562988_sc-210264.jpg,1,0,0,0,1,,val
0562989_sc-105807.jpg,1,0,0,0,1,,val
0562990_as-0030002.jpg,1,0,0,0,1,,test
0562991_as-0030002.jpg,2,0,0,0,2,,train
0562994_sc-148733.jpg,5,0,0,0,5,,train
0562995_sc-148733.jpg,7,0,0,0,7,,train
0562997_sc-186279.jpg,1,0,2,0,3,,train
0562998_sc-186279.jpg,2,0,1,1,4,,train
0563001_sc-186279.jpg,4,3,2,1,10,,train
0563002_sc-186279.jpg,5,1,2,0,8,,train
0563003_sc-186279.jpg,10,2,2,1,15,,val
0563004_sc-186279.jpg,2,0,2,1,5,,val
0563006_as-0012275.jpg,2,0,1,0,3,,test
0563007_as-0012275.jpg,2,0,1,1,4,,train
0563008_as-0012275.jpg,3,0,1,0,4,,train
0563009_as-0012275.jpg,1,0,0,0,1,,train
0563011_sc-1005982.jpg,1,0,0,0,1,,train
0563012_sc-1005982.jpg,2,0,0,0,2,,train
0563013_sc-1005982.jpg,1,0,0,0,1,,train
0563014_sc-1005982.jpg,1,0,0,0,1,,train
0563016_as-0020635.jpg,1,0,0,0,1,,val
0563017_sc-1023692.jpg,1,0,0,0,1,,val
0563018_sc-144545.jpg,1,1,1,0,3,,test
0563019_sc-144545.jpg,1,1,1,1,4,,train
0563020_sc-144545.jpg,1,1,0,0,2,,train
0563021_sc-229146.jpg,5,0,0,0,5,,train
0563022_as-0021130.jpg,1,1,0,0,2,,train
0563023_as-0021130.jpg,0,1,1,0,2,,train
0563024_as-0021130.jpg,0,1,1,0,2,,train
0563027_as-0096618.jpg,1,0,0,0,1,,train
0563028_as-0096618.jpg,1,0,0,0,1,,val
0563029_as-0096618.jpg,1,0,0,0,1,,val
0563030_as-0096618.jpg,1,0,0,0,1,,test
0563034_sc-1040041.jpg,2,0,1,2,5,,train
0563036_sc-1040041.jpg,3,0,1,0,4,,train
0563038_sc-1040041.jpg,3,0,1,1,5,,train
0563039_as-0014238.jpg,0,0,0,1,1,,train
0563040_as-0014238.jpg,3,0,0,1,4,,train
0563041_sc-187079.jpg,3,0,0,3,6,,train
0563042_sc-187079.jpg,4,0,0,2,6,,train
0563043_sc-187079.jpg,5,0,0,2,7,,val
0563046_as-0059642.jpg,1,0,0,0,1,,val
0563047_as-7923713.jpg,2,0,0,0,2,,test
0563051_as-0028139.jpg,5,0,1,1,7,,train
0563053_as-2620991.jpg,0,1,2,2,5,,train
0563054_as-0044105.jpg,1,0,0,0,1,,train
0563055_sc-181567.jpg,2,2,1,0,5,,train
0563056_sc-181567.jpg,1,0,1,0,2,,train
0563059_sc-141619.jpg,4,0,0,0,4,,train
0563060_sc-141619.jpg,2,0,0,0,2,,train
0563061_sc-141619.jpg,3,0,0,0,3,,val
0563062_sc-228379.jpg,1,0,0,0,1,,val
0563063_sc-1018049.jpg,1,0,0,1,2,,test
0563065_as-0018480.jpg,1,0,0,0,1,,train
0563066_as-0018480.jpg,3,0,0,0,3,,train
0563067_as-0018480.jpg,1,0,0,0,1,,train
0563068_as-0018480.jpg,1,0,0,0,1,,train
0563069_sc-131498.jpg,3,0,0,4,7,,train
0563070_sc-131498.jpg,5,0,2,1,8,,train
0563071_sc-131498.jpg,6,0,1,0,7,,train
0563072_sc-131498.jpg,1,0,1,0,2,,val
0563073_sc-131498.jpg,2,0,0,0,2,,val
0563074_sc-131498.jpg,2,0,1,0,3,,test
0563075_sc-131498.jpg,5,0,2,1,8,,train
0563076_sc-131498.jpg,5,0,0,1,6,,train
0563077_as-2860559.jpg,1,1,1,1,4,,train
0563078_as-0003744.jpg,4,0,1,1,6,,train
0563079_sc-120126.jpg,1,0,0,2,3,,train
0563080_sc-120126.jpg,1,0,0,2,3,,train
0563082_sc-174305.jpg,2,0,1,0,3,,train
0563083_as-0036050.jpg,1,0,0,0,1,,val
0563084_as-0036050.jpg,2,0,0,0,2,,val
0563085_as-0036050.jpg,1,0,1,0,2,,test
0563086_as-0036050.jpg,1,0,1,0,2,,train
0563087_as-0036050.jpg,2,0,0,0,2,,train
0563088_sc-1036741.jpg,1,0,0,0,1,,train
0563090_sc-1036741.jpg,2,0,0,0,2,,train
0563091_sc-1036741.jpg,2,0,0,0,2,,train
0563092_sc-1036741.jpg,1,0,0,0,1,,train
0563096_as-0027233.jpg,0,0,1,0,1,,train
0563097_as-0027233.jpg,1,0,0,1,2,,val
0563100_sc-131078.jpg,6,0,0,0,6,,val
0563101_as-3013602.jpg,17,0,3,0,20,,test
0563103_as-0036588.jpg,0,1,0,0,1,,train
0563104_as-0036588.jpg,6,1,1,2,10,,train
0563105_as-0036588.jpg,6,2,1,0,9,,train
0563106_as-2612054.jpg,1,0,0,0,1,,train
0563107_as-3093873.jpg,2,2,1,1,6,,train
0563108_sc-162861.jpg,1,0,0,0,1,,train
0563109_sc-162861.jpg,1,0,0,0,1,,train
0563110_sc-127871.jpg,0,10,0,0,10,,val
0563111_sc-127871.jpg,0,0,1,0,1,,val
0563112_sc-127871.jpg,1,1,0,0,2,,test
0563114_sc-167873.jpg,7,0,0,0,7,,train
0563115_sc-167873.jpg,5,0,0,0,5,,train
0563117_as-0016190.jpg,1,1,0,0,2,,train
0563119_as-0016190.jpg,4,1,0,0,5,,train
0563120_as-0016190.jpg,2,2,0,0,4,,train
0563121_as-0016190.jpg,1,0,1,0,2,,train
0563122_as-3046090.jpg,0,2,3,0,5,,train
0563125_as-0040475.jpg,1,0,1,1,3,,val
0563127_as-0040475.jpg,3,0,1,1,5,,val
0563128_as-0040475.jpg,3,0,1,1,5,,test
0563129_as-0040475.jpg,1,0,2,0,3,,train
0563131_sc-146185.jpg,1,1,0,0,2,,train
0563132_sc-146185.jpg,1,0,0,0,1,,train
0563133_sc-146185.jpg,1,1,0,0,2,,train
0563134_sc-213731.jpg,1,0,1,0,2,,train
0563135_sc-213731.jpg,1,0,1,0,2,,train
0563136_as-0029254.jpg,2,0,1,1,4,,train
0563138_as-0010333.jpg,0,1,0,0,1,,val
0563139_as-0010333.jpg,0,0,1,0,1,,val
0563140_as-0010333.jpg,1,0,0,0,1,,test
0563141_as-0010333.jpg,1,1,0,0,2,,train
0563143_as-2537345.jpg,1,0,0,0,1,,train
0563144_as-2537345.jpg,0,1,1,0,2,,train
0563145_sc-103872.jpg,1,0,0,0,1,,train
0563146_sc-103872.jpg,2,0,0,0,2,,train
0563148_as-0097165.jpg,0,0,0,1,1,,train
0563149_as-0097165.jpg,2,0,0,1,3,,train
0563150_as-0097165.jpg,2,0,0,1,3,,val
0563151_as-0097165.jpg,3,0,0,1,4,,val
0563153_sc-196146.jpg,3,0,1,0,4,,test
0563154_sc-196146.jpg,5,0,1,0,6,,train
0563155_sc-196146.jpg,3,0,1,0,4,,train
0563156_sc-196146.jpg,5,0,1,0,6,,train
0563157_sc-196146.jpg,4,0,0,2,6,,train
0563158_sc-196146.jpg,3,0,0,2,5,,train
0563159_sc-196146.jpg,3,0,0,2,5,,train
0563160_sc-196146.jpg,3,0,0,1,4,,train
0563161_sc-196146.jpg,4,0,0,1,5,,val
0563162_sc-196146.jpg,1,0,0,2,3,,val
0563163_sc-196146.jpg,5,0,0,0,5,,test
0563164_sc-196146.jpg,2,0,1,0,3,,train
0563166_as-0033551.jpg,2,0,1,0,3,,train
0563168_as-3054123.jpg,0,0,2,0,2,,train
0563170_as-2778588.jpg,2,0,0,2,4,,train
0563174_as-0063443.jpg,3,0,0,0,3,,train
0563175_as-0063443.jpg,2,0,0,0,2,,train
0563177_as-3049489.jpg,2,0,0,2,4,,train
0563178_as-3158715.jpg,1,0,0,1,2,,val
0563179_sc-128349.jpg,2,0,0,0,2,,val
0563180_sc-128349.jpg,7,0,0,0,7,,test
0563181_sc-128349.jpg,5,0,0,0,5,,train
0563182_sc-128349.jpg,3,0,0,0,3,,train
0563183_sc-128349.jpg,2,0,0,0,2,,train
0563184_sc-128349.jpg,2,0,0,0,2,,train
0563185_sc-128349.jpg,2,0,0,0,2,,train
0563186_as-0074431.jpg,3,1,2,0,6,,train
0563187_as-0074431.jpg,5,2,0,0,7,,train
0563188_as-0074431.jpg,2,0,2,1,5,,val
0563189_as-0074431.jpg,2,0,2,1,5,,val
0563190_as-0074431.jpg,1,0,0,0,1,,test
0563191_as-0074431.jpg,3,1,0,0,4,,train
0563192_as-0074431.jpg,3,1,3,0,7,,train
0563194_sc-1041110.jpg,1,0,0,0,1,,train
0563196_sc-150575.jpg,1,1,1,1,4,,train
0563198_sc-150575.jpg,1,1,1,1,4,,train
0563199_sc-150575.jpg,2,1,0,1,4,,train
0563200_as-3037942.jpg,4,0,0,0,4,,train
0563201_as-2817996.jpg,2,0,2,0,4,,val
0563202_as-0098339.jpg,3,0,0,0,3,,val
0563203_as-0098339.jpg,0,1,1,0,2,,test
0563204_as-0098339.jpg,2,1,1,0,4,,train
0563205_as-0098339.jpg,1,1,1,0,3,,train
0563206_as-0098339.jpg,2,2,2,0,6,,train
0563207_as-0009312.jpg,1,1,0,0,2,,train
0563208_as-0009312.jpg,1,1,0,0,2,,train
0563209_as-0009312.jpg,2,1,0,0,3,,train
0563210_as-2789627.jpg,0,0,0,1,1,,train
0563211_sc-165667.jpg,11,0,2,0,13,,val
0563212_sc-165667.jpg,0,0,1,0,1,,val
0563213_sc-165667.jpg,11,0,1,1,13,,test
0563214_sc-165667.jpg,10,0,1,2,13,,train
0563215_sc-165667.jpg,12,0,0,0,12,,train
0563216_as-0059714.jpg,1,0,0,0,1,,train
0563217_as-0001483.jpg,2,0,0,0,2,,train
0563219_as-0086458.jpg,1,1,2,0,4,,train
0563220_as-0086458.jpg,1,1,3,0,5,,train
0563221_as-0086458.jpg,0,0,2,0,2,,train
0563222_sc-152803.jpg,1,0,0,0,1,,val
0563224_sc-1037909.jpg,2,0,0,0,2,,val
0563225_sc-126962.jpg,0,0,2,0,2,,test
0563226_sc-126962.jpg,0,0,1,0,1,,train
0563227_sc-126962.jpg,0,1,1,1,3,,train
0563229_as-0047679.jpg,6,0,2,0,8,,train
0563230_as-0047679.jpg,3,0,1,0,4,,train
0563231_as-0047679.jpg,2,0,0,0,2,,train
0563232_as-0047679.jpg,1,0,1,0,2,,train
0563233_as-0047679.jpg,1,0,1,0,2,,train
0563235_as-0047679.jpg,2,0,2,0,4,,val
0563236_as-0047679.jpg,2,0,2,0,4,,val
0563237_as-0047679.jpg,0,0,1,0,1,,test
0563238_as-0047679.jpg,2,0,1,0,3,,train
0563239_as-0047679.jpg,1,0,2,0,3,,train
0563240_as-0047679.jpg,2,0,0,0,2,,train
0563241_as-0047679.jpg,3,0,1,0,4,,train
0563242_as-0047679.jpg,1,0,0,0,1,,train
0563243_as-0047679.jpg,1,0,0,0,1,,train
0563244_as-3414980.jpg,1,0,0,0,1,,train
0563247_as-0014707.jpg,1,1,0,0,2,,val
0563248_as-0014707.jpg,0,1,0,1,2,,val
0563249_as-0014707.jpg,0,1,0,1,2,,test
0563250_sc-106064.jpg,4,1,0,0,5,,train
0563252_as-0019895.jpg,5,0,0,0,5,,train
0563253_as-0019895.jpg,7,0,0,0,7,,train
0563254_as-0019895.jpg,5,0,0,0,5,,train
0563256_as-0019895.jpg,2,0,0,0,2,,train
0563259_sc-162312.jpg,2,0,1,0,3,,train
0563260_sc-162312.jpg,2,0,0,0,2,,train
0563264_as-0074395.jpg,5,0,1,1,7,,val
0563265_as-0074395.jpg,1,0,1,1,3,,val
0563266_as-0074395.jpg,1,0,0,0,1,,test
0563267_as-0074395.jpg,2,0,0,0,2,,train
0563268_as-0074395.jpg,1,0,0,0,1,,train
0563271_as-0074395.jpg,2,0,1,1,4,,train
0563272_as-0074395.jpg,2,0,1,1,4,,train
0563273_as-0074395.jpg,1,0,0,0,1,,train
0563274_as-0074395.jpg,1,0,2,1,4,,train
0563275_as-0074395.jpg,1,0,1,1,3,,train
0563276_as-3106950.jpg,3,2,2,2,9,,val
0563277_sc-163496.jpg,2,0,1,1,4,,val
0563278_sc-163496.jpg,1,0,1,1,3,,test
0563279_sc-163496.jpg,2,0,1,1,4,,train
0563281_as-0060459.jpg,1,0,0,0,1,,train
0563284_as-2875665.jpg,1,0,1,0,2,,train
0563285_sc-1037399.jpg,1,0,0,0,1,,train
0563286_sc-1037399.jpg,2,0,0,0,2,,train
0563287_sc-1037399.jpg,1,0,0,0,1,,train
0563288_sc-1037399.jpg,2,0,0,0,2,,train
0563289_sc-1037399.jpg,2,0,0,0,2,,val
0563290_sc-1037399.jpg,2,0,0,0,2,,val
0563291_as-3341034.jpg,3,0,0,0,3,,test
0563293_sc-1033957.jpg,2,0,0,0,2,,train
0563294_sc-1033957.jpg,2,0,0,0,2,,train
0563295_as-3478931.jpg,0,0,1,0,1,,train
0563296_as-3306924.jpg,4,0,1,0,5,,train
0563299_sc-197581.jpg,2,0,1,1,4,,train
0563301_sc-197581.jpg,4,7,1,0,12,,train
0563302_sc-197581.jpg,3,3,2,0,8,,train
0563303_sc-197581.jpg,2,3,2,0,7,,val
0563305_sc-197581.jpg,2,0,2,0,4,,val
0563306_sc-197581.jpg,1,0,2,0,3,,test
0563308_sc-197581.jpg,3,1,3,0,7,,train
0563309_sc-197581.jpg,4,0,1,1,6,,train
0563310_sc-197581.jpg,1,0,2,0,3,,train
0563311_sc-197581.jpg,1,0,2,0,3,,train
0563313_as-0053064.jpg,0,0,0,1,1,,train
0563314_as-0053064.jpg,0,0,0,1,1,,train
0563315_as-0053064.jpg,1,0,0,0,1,,train
0563316_as-0053064.jpg,0,1,0,0,1,,val
0563317_as-0053064.jpg,2,1,0,0,3,,val
0563318_as-0053064.jpg,0,0,0,1,1,,test
0563319_as-2931010.jpg,1,0,0,0,1,,train
0563320_sc-114953.jpg,2,0,0,1,3,,train
0563321_as-0081747.jpg,1,0,0,0,1,,train
0563322_as-0081747.jpg,1,0,0,0,1,,train
0563323_as-0081747.jpg,1,0,0,0,1,,train
0563324_as-0081747.jpg,1,0,0,0,1,,train
0563325_as-0081747.jpg,1,0,0,0,1,,train
0563326_sc-1039513.jpg,3,0,2,0,5,,val
0563331_as-0079212.jpg,1,0,1,0,2,,val
0563332_as-0079212.jpg,1,0,1,0,2,,test
0563335_as-0037198.jpg,2,0,0,0,2,,train
0563336_as-0037198.jpg,1,0,1,1,3,,train
0563337_as-0037198.jpg,1,0,1,1,3,,train
0563338_as-0037198.jpg,0,0,1,0,1,,train
0563339_as-0037198.jpg,1,0,1,1,3,,train
0563340_as-0037198.jpg,2,0,1,1,4,,train
0563341_as-0051983.jpg,1,0,0,0,1,,train
0563342_as-0051983.jpg,1,0,0,0,1,,val
0563343_as-0051983.jpg,3,0,0,0,3,,val
0563344_as-0051983.jpg,1,0,0,0,1,,test
0563345_as-0051983.jpg,2,0,0,0,2,,train
0563346_as-7990208.jpg,2,0,0,1,3,,train
0563347_sc-141504.jpg,1,0,0,2,3,,train
0563348_sc-141504.jpg,1,0,0,1,2,,train
0563349_sc-141504.jpg,1,0,0,3,4,,train
0563350_sc-141504.jpg,1,0,0,3,4,,train
0563351_sc-214492.jpg,2,1,1,0,4,,train
0563352_sc-1025236.jpg,2,0,0,0,2,,val
0563353_sc-1025236.jpg,4,0,0,0,4,,val
0563354_sc-1025236.jpg,1,0,0,0,1,,test
0563355_sc-203777.jpg,4,0,0,0,4,,train
0563356_sc-203777.jpg,5,0,1,0,6,,train
0563358_as-7597238.jpg,0,1,0,0,1,,train
0563360_sc-1018536.jpg,2,0,0,0,2,,train
0563361_sc-1018536.jpg,3,0,0,0,3,,train
0563363_as-0046015.jpg,1,0,1,0,2,,train
0563364_as-0046015.jpg,0,0,1,0,1,,train
0563365_as-0046015.jpg,1,0,1,0,2,,val
0563366_as-0046015.jpg,1,0,1,0,2,,val
0563367_as-0046015.jpg,1,0,1,0,2,,test
0563368_as-7373393.jpg,0,0,0,1,1,,train
0563369_as-2571658.jpg,2,0,0,1,3,,train
0563370_sc-190367.jpg,0,0,1,0,1,,train
0563374_sc-190367.jpg,2,0,1,0,3,,train
0563375_sc-190367.jpg,1,0,1,0,2,,train
0563376_sc-190367.jpg,1,0,1,0,2,,train
0563377_as-0089476.jpg,0,0,1,0,1,,train
0563378_as-0089476.jpg,3,2,0,0,5,,val
0563379_as-0089476.jpg,1,1,0,0,2,,val
0563380_as-0047194.jpg,1,2,1,0,4,,test
0563381_as-0047194.jpg,1,0,0,0,1,,train
0563382_as-0047194.jpg,1,0,1,0,2,,train
0563383_as-0047194.jpg,2,0,0,0,2,,train
0563384_as-0047194.jpg,2,1,0,0,3,,train
0563385_as-0047194.jpg,3,0,0,0,3,,train
0563388_sc-1022186.jpg,1,3,3,0,7,,train
0563390_as-2814202.jpg,1,0,0,0,1,,train
0563392_as-0058082.jpg,1,0,0,0,1,,val
0563393_as-0058082.jpg,0,0,1,0,1,,val
0563394_as-0058082.jpg,2,0,0,0,2,,test
0563397_as-0081805.jpg,2,2,0,1,5,,train
0563398_sc-219385.jpg,0,1,0,0,1,,train
0563399_sc-120792.jpg,3,1,0,0,4,,train
0563400_sc-120792.jpg,2,1,0,0,3,,train
0563401_as-2873487.jpg,1,0,0,0,1,,train
0563402_as-3454898.jpg,1,0,0,1,2,,train
0563403_sc-1037367.jpg,4,0,1,0,5,,train
0563404_sc-1037367.jpg,2,0,0,0,2,,val
0563405_sc-1037367.jpg,1,0,0,0,1,,val
0563406_sc-1037367.jpg,4,0,0,0,4,,test
0563408_sc-1039979.jpg,3,0,0,0,3,,train
0563409_as-0041063.jpg,0,0,1,0,1,,train
0563414_as-0041063.jpg,2,0,1,1,4,,train
0563415_as-0041063.jpg,5,0,0,0,5,,train
0563418_as-0041063.jpg,1,0,1,1,3,,train
0563419_as-0007797.jpg,1,0,0,1,2,,train
0563420_as-0007797.jpg,1,0,0,1,2,,train
0563421_as-0007797.jpg,1,0,0,1,2,,val
0563422_sc-149531.jpg,0,1,1,0,2,,val
0563423_sc-149531.jpg,0,1,0,0,1,,test
0563424_as-7747998.jpg,5,3,3,0,11,,train
0563425_as-0037494.jpg,2,1,1,1,5,,train
0563426_as-0037494.jpg,5,0,1,1,7,,train
0563427_as-0037494.jpg,1,0,0,0,1,,train
0563428_as-0037494.jpg,1,0,0,0,1,,train
0563429_as-0037494.jpg,1,0,0,0,1,,train
0563431_as-0037494.jpg,3,0,2,1,6,,train
0563432_as-0037494.jpg,2,0,1,1,4,,val
0563434_as-0037494.jpg,3,0,0,0,3,,val
0563435_as-0037494.jpg,1,0,3,1,5,,test
0563439_as-0093064.jpg,0,1,1,0,2,,train
0563440_as-0093064.jpg,1,1,0,0,2,,train
0563441_as-0093064.jpg,1,1,1,0,3,,train
0563442_as-0093064.jpg,1,1,0,0,2,,train
0563444_sc-208064.jpg,3,0,1,0,4,,train
0563445_sc-208064.jpg,2,0,1,0,3,,train
0563446_sc-208064.jpg,3,0,0,0,3,,train
0563447_sc-1012387.jpg,1,0,0,0,1,,val
0563448_sc-1012387.jpg,2,0,0,1,3,,val
0563449_sc-1012387.jpg,1,0,0,1,2,,test
0563452_as-0076062.jpg,0,1,0,1,2,,train
0563453_as-0076062.jpg,0,1,0,0,1,,train
0563455_as-3024313.jpg,1,0,0,1,2,,train
0563456_sc-211690.jpg,1,0,0,0,1,,train
0563457_sc-211690.jpg,4,2,1,0,7,,train
0563458_sc-211690.jpg,7,2,0,0,9,,train
0563459_sc-211690.jpg,1,0,0,0,1,,train
0563464_as-0015177.jpg,1,0,0,0,1,,val
0563466_sc-1027256.jpg,2,0,1,1,4,,val
0563467_sc-1027256.jpg,1,0,1,1,3,,test
0563468_sc-1027256.jpg,1,0,1,1,3,,train
0563469_as-0029427.jpg,1,0,0,0,1,,train
0563470_as-0029427.jpg,1,0,0,0,1,,train
0563471_as-0029427.jpg,1,0,0,0,1,,train
0563472_as-0029427.jpg,1,0,0,0,1,,train
0563473_as-0029427.jpg,1,1,0,0,2,,train
0563474_as-7332203.jpg,4,0,1,1,6,,train
0563476_as-0059505.jpg,1,0,0,0,1,,val
0563477_as-0059505.jpg,4,0,0,0,4,,val
0563478_sc-142810.jpg,3,0,1,0,4,,test
0563479_sc-142810.jpg,2,0,1,0,3,,train
0563480_sc-142810.jpg,2,0,1,0,3,,train
0563483_as-0010585.jpg,1,0,0,0,1,,train
0563484_as-0010585.jpg,1,0,0,0,1,,train
0563487_as-0010585.jpg,2,1,1,1,5,,train
0563489_as-0010585.jpg,1,1,0,1,3,,train
0563491_as-0010585.jpg,1,0,1,1,3,,train
0563492_as-7441309.jpg,4,1,0,1,6,,val
0563493_as-2510626.jpg,0,1,0,0,1,,val
0563494_sc-104380.jpg,2,1,2,0,5,,test
0563495_sc-104380.jpg,2,1,1,0,4,,train
0563496_sc-104380.jpg,1,1,1,0,3,,train
0563497_sc-104380.jpg,3,2,1,0,6,,train
0563498_sc-104380.jpg,1,2,1,0,4,,train
0563500_sc-104380.jpg,1,0,0,0,1,,train
0563501_as-3483466.jpg,0,0,0,1,1,,train
0563502_sc-229126.jpg,2,0,0,0,2,,train
0563503_sc-229126.jpg,2,0,0,0,2,,val
0563504_sc-229126.jpg,1,0,0,0,1,,val
0563505_sc-229126.jpg,1,0,0,0,1,,test
0563507_as-0043241.jpg,2,0,1,0,3,,train
0563508_as-0043241.jpg,5,0,1,0,6,,train
0563509_as-0057776.jpg,3,0,0,0,3,,train
0563510_as-0057776.jpg,4,0,0,0,4,,train
0563511_sc-191082.jpg,3,0,0,0,3,,train
0563512_sc-191082.jpg,2,0,0,1,3,,train
0563513_sc-191082.jpg,1,0,1,0,2,,train
0563516_sc-191082.jpg,3,0,0,0,3,,val
0563517_sc-191082.jpg,1,0,0,1,2,,val
0563518_as-0025629.jpg,3,0,0,0,3,,test
0563519_as-0025629.jpg,3,0,0,0,3,,train
0563520_as-0025629.jpg,1,0,0,0,1,,train
0563521_sc-1023150.jpg,1,1,0,0,2,,train
0563523_sc-1038792.jpg,2,1,2,1,6,,train
0563524_sc-108133.jpg,8,1,0,0,9,,train
0563526_sc-108133.jpg,3,0,0,0,3,,train
0563529_as-0059462.jpg,1,1,0,0,2,,train
0563531_as-7861022.jpg,2,0,1,1,4,,val
0563532_as-2565429.jpg,1,0,0,0,1,,val
0563535_sc-1040227.jpg,4,0,0,0,4,,test
0563536_as-3429458.jpg,2,1,1,0,4,,train
0563537_as-0042294.jpg,2,1,1,0,4,,train
0563538_as-0042294.jpg,3,1,2,0,6,,train
0563541_as-0042294.jpg,1,0,1,0,2,,train
0563542_as-0042294.jpg,1,0,1,0,2,,train
0563543_sc-137671.jpg,1,0,1,1,3,,train
0563545_sc-137671.jpg,1,0,1,1,3,,train
0563547_sc-137671.jpg,1,0,1,0,2,,val
0563548_sc-137671.jpg,1,0,1,0,2,,val
0563549_sc-137671.jpg,1,0,1,1,3,,test
0563550_as-3214614.jpg,2,0,1,0,3,,train
0563551_sc-208881.jpg,3,1,1,0,5,,train
0563552_sc-208881.jpg,4,0,0,0,4,,train
0563553_as-2802041.jpg,1,0,0,0,1,,train
0563554_as-3228618.jpg,2,0,0,0,2,,train
0563555_as-2742978.jpg,5,0,0,0,5,,train
0563556_as-0062904.jpg,3,0,0,0,3,,train
0563557_as-0062904.jpg,7,0,1,1,9,,val
0563558_as-0062904.jpg,2,0,0,2,4,,val
0563559_as-0062904.jpg,1,0,0,1,2,,test
0563560_as-0062904.jpg,3,0,0,0,3,,train
0563561_as-0062904.jpg,3,0,0,0,3,,train
0563562_as-0062904.jpg,2,0,0,0,2,,train
0563563_sc-1028077.jpg,1,0,0,0,1,,train
0563564_sc-1028077.jpg,0,0,1,0,1,,train
0563565_sc-1028077.jpg,1,0,0,0,1,,train
0563566_as-7712557.jpg,0,0,1,0,1,,train
0563567_as-2760132.jpg,0,0,1,0,1,,val
0563568_as-0072173.jpg,1,0,0,0,1,,val
0563569_as-0072173.jpg,1,0,0,0,1,,test
0563570_as-0072173.jpg,1,0,0,0,1,,train
0563571_as-0072173.jpg,1,0,0,0,1,,train
0563572_as-0072173.jpg,1,0,1,1,3,,train
0563573_as-0072173.jpg,1,0,1,1,3,,train
0563574_sc-1035012.jpg,0,1,0,0,1,,train
0563575_sc-1035012.jpg,0,0,1,0,1,,train
0563576_sc-1035012.jpg,0,0,1,0,1,,train
0563577_sc-1035012.jpg,0,0,1,0,1,,val
0563578_as-0073401.jpg,4,1,0,0,5,,val
0563579_sc-120082.jpg,1,0,0,0,1,,test
0563580_as-0034828.jpg,0,1,0,0,1,,train
0563581_as-0034828.jpg,4,0,0,0,4,,train
0563583_as-0034828.jpg,1,1,0,0,2,,train
0563589_as-0078009.jpg,0,1,0,0,1,,train
0563590_as-0078009.jpg,0,1,0,0,1,,train
0563591_as-2637474.jpg,1,0,0,0,1,,train
0563593_as-0066971.jpg,2,0,0,1,3,,train
0563594_sc-230399.jpg,1,0,0,0,1,,val
0563595_as-3456532.jpg,1,0,0,0,1,,val
0563596_as-0009064.jpg,3,0,0,0,3,,test
0563597_sc-112916.jpg,1,0,0,0,1,,train
0563599_sc-112916.jpg,1,0,0,0,1,,train
0563600_as-7928141.jpg,5,1,2,2,10,,train
0563601_as-0020032.jpg,2,0,0,0,2,,train
0563602_as-0020032.jpg,2,0,0,0,2,,train
0563603_as-0020032.jpg,2,0,0,0,2,,train
0563604_as-3182824.jpg,1,0,0,0,1,,train
0563605_as-3262460.jpg,2,0,0,0,2,,val
0563607_sc-219826.jpg,1,0,0,0,1,,val
0563608_sc-106957.jpg,7,0,4,1,12,,test
0563609_sc-210558.jpg,2,0,0,0,2,,train
0563610_sc-210558.jpg,2,0,2,0,4,,train
0563611_sc-210558.jpg,2,0,1,1,4,,train
0563612_sc-210558.jpg,6,0,0,0,6,,train
0563613_sc-210558.jpg,1,0,0,0,1,,train
0563614_sc-210558.jpg,5,0,0,0,5,,train
0563617_as-0083666.jpg,0,0,2,0,2,,train
0563619_as-0083666.jpg,0,0,1,1,2,,val
0563624_as-0091249.jpg,0,0,1,0,1,,val
0563626_as-0091249.jpg,2,0,1,1,4,,test
0563627_as-2693703.jpg,1,0,1,0,2,,train
0563628_as-0086022.jpg,0,0,0,3,3,,train
0563630_as-0086022.jpg,0,0,0,2,2,,train
0563631_as-0086022.jpg,0,0,0,3,3,,train
0563632_as-3223515.jpg,0,3,2,0,5,,train
0563633_sc-156247.jpg,1,0,1,0,2,,train
0563634_sc-156247.jpg,2,0,1,0,3,,train
0563635_sc-156247.jpg,1,2,1,0,4,,val
0563636_as-7724967.jpg,1,1,0,0,2,,val
0563637_as-3009485.jpg,1,0,1,0,2,,test
0563638_sc-209942.jpg,4,0,0,0,4,,train
0563639_sc-209942.jpg,2,0,0,0,2,,train
0563640_sc-196039.jpg,3,0,0,0,3,,train
0563641_sc-196039.jpg,3,0,0,0,3,,train
0563642_sc-196039.jpg,2,0,0,0,2,,train
0563643_sc-196039.jpg,3,0,0,0,3,,train
0563644_sc-196039.jpg,4,0,0,1,5,,train
0563645_sc-196039.jpg,4,0,0,1,5,,val
0563646_sc-196039.jpg,2,0,0,1,3,,val
0563647_as-0001436.jpg,5,1,0,0,6,,test
0563648_as-0001436.jpg,3,1,0,0,4,,train
0563649_as-0001436.jpg,1,1,0,0,2,,train
0563650_as-0001436.jpg,1,0,0,0,1,,train
0563651_as-0001436.jpg,1,0,0,0,1,,train
0563652_as-0001436.jpg,1,0,0,0,1,,train
0563653_sc-199066.jpg,5,0,1,0,6,,train
0563654_sc-199066.jpg,4,0,1,0,5,,train
0563655_sc-199066.jpg,2,0,1,0,3,,val
0563656_as-2508064.jpg,5,0,2,0,7,,val
0563657_sc-133559.jpg,1,0,1,1,3,,test
0563659_sc-205473.jpg,2,1,0,0,3,,train
0563660_sc-197946.jpg,2,0,1,0,3,,train
0563661_sc-197946.jpg,2,0,0,0,2,,train
0563662_sc-197946.jpg,1,0,0,0,1,,train
0563663_as-0080578.jpg,1,0,0,0,1,,train
0563664_as-0080578.jpg,1,0,0,0,1,,train
0563665_as-2657644.jpg,1,0,0,0,1,,train
0563666_as-2500592.jpg,4,0,0,0,4,,val
0563667_as-0001071.jpg,1,0,0,0,1,,val
0563668_as-0001071.jpg,1,0,0,0,1,,test
0563669_as-0037873.jpg,2,0,0,1,3,,train
0563671_as-0037873.jpg,1,0,0,1,2,,train
0563672_as-0037873.jpg,1,0,0,0,1,,train
0563673_as-0037873.jpg,0,1,0,0,1,,train
0563674_as-0037873.jpg,1,0,0,1,2,,train
0563677_as-0037873.jpg,1,0,0,0,1,,train
0563678_as-0037873.jpg,2,0,0,1,3,,train
0563679_as-0037873.jpg,2,0,0,0,2,,val
0563680_as-2540134.jpg,7,0,0,0,7,,val
0563681_as-7880652.jpg,1,2,0,1,4,,test
0563682_sc-229569.jpg,1,0,0,0,1,,train
0563683_as-2616654.jpg,4,2,1,1,8,,train
0563684_sc-208696.jpg,3,0,0,0,3,,train
0563685_as-2565436.jpg,0,1,1,0,2,,train
0563686_sc-1007160.jpg,2,0,0,0,2,,train
0563687_sc-1007160.jpg,3,0,0,0,3,,train
0563688_sc-1007160.jpg,3,0,0,0,3,,train
0563690_sc-1010248.jpg,4,0,0,0,4,,val
0563691_sc-1010248.jpg,6,0,0,0,6,,val
0563692_sc-174812.jpg,1,0,1,0,2,,test
0563693_sc-174812.jpg,5,0,0,0,5,,train
0563694_sc-174812.jpg,5,0,0,0,5,,train
0563695_sc-174812.jpg,3,0,0,0,3,,train
0563697_as-3425662.jpg,4,0,1,1,6,,train
0563701_sc-165796.jpg,3,0,0,0,3,,train
0563702_as-0011425.jpg,1,0,0,0,1,,train
0563703_as-3332427.jpg,2,1,1,0,4,,train
0563704_sc-1011999.jpg,1,0,0,0,1,,val
0563705_sc-1011999.jpg,1,0,0,0,1,,val
0563706_sc-1011999.jpg,1,0,0,0,1,,test
0563707_sc-1011999.jpg,2,0,0,0,2,,train
0563708_sc-1011999.jpg,2,0,0,0,2,,train
0563709_sc-1011999.jpg,1,0,0,0,1,,train
0563710_sc-1011999.jpg,2,0,0,0,2,,train
0563712_sc-185728.jpg,1,0,1,0,2,,train
0563713_sc-222213.jpg,3,0,0,0,3,,train
0563714_sc-222213.jpg,5,0,0,0,5,,train
0563715_as-0052088.jpg,1,0,2,2,5,,val
0563717_as-0050752.jpg,3,1,1,1,6,,val
0563718_sc-141109.jpg,1,0,0,0,1,,test
0563720_sc-1029293.jpg,1,3,0,1,5,,train
0563721_sc-1029293.jpg,1,2,0,1,4,,train
0563722_sc-1029293.jpg,1,2,0,1,4,,train
0563723_sc-1029293.jpg,1,0,0,0,1,,train
0563724_sc-1029293.jpg,1,2,0,1,4,,train
0563727_as-0020600.jpg,2,0,3,0,5,,train
0563728_as-0020600.jpg,2,0,0,0,2,,train
0563729_as-0020600.jpg,1,0,1,0,2,,val
0563730_as-0020600.jpg,0,0,2,0,2,,val
0563732_sc-142509.jpg,3,0,0,0,3,,test
0563733_sc-142509.jpg,3,0,0,0,3,,train
0563734_sc-142509.jpg,1,0,0,0,1,,train
0563735_sc-142509.jpg,2,0,0,0,2,,train
0563736_sc-142509.jpg,2,0,0,0,2,,train
0563737_sc-212452.jpg,1,0,1,1,3,,train
0563738_sc-212452.jpg,1,0,1,1,3,,train
0563739_as-2563795.jpg,0,0,1,0,1,,train
0563740_as-7840910.jpg,3,0,2,1,6,,val
0563741_as-3450877.jpg,6,0,0,0,6,,val
0563742_sc-178234.jpg,1,0,2,1,4,,test
0563743_as-2721300.jpg,2,1,1,0,4,,train
0563744_sc-229128.jpg,5,2,3,0,10,,train
0563745_sc-229128.jpg,1,0,2,2,5,,train
0563746_sc-229128.jpg,2,0,1,2,5,,train
0563747_sc-229128.jpg,3,0,1,0,4,,train
0563748_sc-229128.jpg,4,2,2,0,8,,train
0563749_sc-229128.jpg,4,1,1,0,6,,train
0563750_sc-229128.jpg,1,1,1,0,3,,val
0563751_sc-229128.jpg,2,0,1,1,4,,val
0563752_as-3443036.jpg,2,2,0,0,4,,test
0563753_as-2970011.jpg,4,0,0,0,4,,train
0563754_sc-109003.jpg,1,0,0,0,1,,train
0563755_as-5460173.jpg,2,2,1,1,6,,train
0563756_sc-199203.jpg,3,1,0,0,4,,train
0563758_sc-152161.jpg,1,0,1,1,3,,train
0563759_sc-152161.jpg,1,0,1,1,3,,train
0563760_sc-152161.jpg,1,0,1,1,3,,train
0563763_as-0024773.jpg,6,0,0,0,6,,val
0563764_as-0024773.jpg,2,0,0,0,2,,val
0563765_sc-103728.jpg,1,1,0,0,2,,test
0563766_sc-103728.jpg,1,1,0,0,2,,train
0563767_as-3327229.jpg,1,1,1,0,3,,train
0563769_as-0010665.jpg,4,0,1,1,6,,train
0563770_sc-222077.jpg,6,0,0,0,6,,train
0563771_sc-222077.jpg,5,0,0,0,5,,train
0563772_sc-222077.jpg,6,0,0,0,6,,train
0563773_sc-222077.jpg,6,0,0,0,6,,train
0563774_sc-222077.jpg,4,0,0,0,4,,val
0563775_sc-222077.jpg,6,0,0,0,6,,val
0563776_as-0013626.jpg,6,0,0,0,6,,test
0563777_as-4670453.jpg,3,0,1,0,4,,train
0563778_as-3173632.jpg,4,0,0,0,4,,train
0563779_sc-112341.jpg,4,1,0,0,5,,train
0563780_sc-217637.jpg,4,1,1,0,6,,train
0563781_sc-217637.jpg,2,1,1,1,5,,train
0563782_sc-217637.jpg,2,2,1,2,7,,train
0563783_sc-217637.jpg,4,0,0,0,4,,train
0563784_sc-217637.jpg,3,0,0,1,4,,val
0563788_sc-163633.jpg,2,0,1,0,3,,val
0563789_sc-163633.jpg,1,0,2,1,4,,test
0563790_as-0098462.jpg,1,0,0,0,1,,train
0563791_as-0098462.jpg,1,0,0,0,1,,train
0563792_as-0098462.jpg,1,0,0,0,1,,train
0563793_as-0098462.jpg,6,0,0,0,6,,train
0563794_as-3167665.jpg,2,0,1,1,4,,train
0563797_sc-204713.jpg,8,0,0,0,8,,train
0563798_sc-204713.jpg,4,0,0,0,4,,train
0563799_sc-204713.jpg,10,0,0,0,10,,val
0563800_sc-204713.jpg,7,0,0,0,7,,val
0563801_sc-204713.jpg,4,0,0,0,4,,test
0563802_sc-204713.jpg,1,0,0,0,1,,train
0563803_sc-204713.jpg,1,0,0,0,1,,train
0563804_sc-204713.jpg,1,0,0,0,1,,train
0563805_sc-204713.jpg,1,0,0,0,1,,train
0563807_sc-134067.jpg,2,0,1,2,5,,train
0563808_sc-134067.jpg,3,0,1,1,5,,train
0563809_sc-134067.jpg,2,0,1,3,6,,train
0563810_sc-134067.jpg,3,0,0,1,4,,val
0563811_sc-134067.jpg,2,0,0,2,4,,val
0563812_as-3314324.jpg,1,0,1,0,2,,test
0563813_sc-226269.jpg,1,1,1,0,3,,train
0563816_sc-154101.jpg,4,1,0,0,5,,train
0563817_sc-189160.jpg,1,0,0,0,1,,train
0563818_sc-189160.jpg,2,0,0,0,2,,train
0563819_sc-189160.jpg,1,0,0,0,1,,train
0563820_sc-189160.jpg,2,0,0,0,2,,train
0563821_sc-189160.jpg,2,0,0,0,2,,train
0563822_sc-189160.jpg,1,0,0,0,1,,val
0563823_sc-189160.jpg,0,0,0,1,1,,val
0563824_as-0083855.jpg,1,0,1,0,2,,test
0563825_as-0083855.jpg,1,0,1,0,2,,train
0563826_as-0083855.jpg,1,0,0,0,1,,train
0563827_as-0083855.jpg,1,0,0,0,1,,train
0563828_sc-216722.jpg,0,1,0,0,1,,train
0563829_sc-216722.jpg,0,1,0,0,1,,train
0563830_sc-216722.jpg,2,0,1,1,4,,train
0563831_sc-169338.jpg,1,3,1,0,5,,train
0563832_sc-169338.jpg,1,3,1,0,5,,val
0563833_sc-169338.jpg,1,1,2,0,4,,val
0563836_sc-168467.jpg,2,0,0,0,2,,test
0563837_sc-168467.jpg,2,0,0,0,2,,train
0563838_sc-168467.jpg,2,0,0,0,2,,train
0563839_sc-168467.jpg,3,0,0,0,3,,train
0563840_as-0052428.jpg,2,0,1,1,4,,train
0563842_as-0052428.jpg,5,0,1,2,8,,train
0563843_as-0052428.jpg,3,0,1,2,6,,train
0563844_as-0052428.jpg,2,0,0,0,2,,train
0563845_as-0052428.jpg,1,1,1,2,5,,val
0563846_as-0052428.jpg,2,1,0,1,4,,val
0563847_as-0052428.jpg,1,1,1,2,5,,test
0563848_as-0052428.jpg,4,0,1,1,6,,train
0563849_as-2953373.jpg,1,0,0,0,1,,train
0563850_sc-1025568.jpg,1,0,1,1,3,,train
0563851_sc-1025568.jpg,1,0,1,1,3,,train
0563852_sc-1025568.jpg,1,0,1,1,3,,train
0563853_sc-1025568.jpg,1,0,1,1,3,,train
0563856_sc-1025568.jpg,1,0,1,1,3,,train
0563857_sc-1025568.jpg,1,0,0,0,1,,val
0563858_sc-1025568.jpg,1,0,0,0,1,,val
0563859_sc-1025568.jpg,1,0,0,0,1,,test
0563860_sc-1025568.jpg,1,0,0,1,2,,train
0563861_sc-1025568.jpg,1,0,0,0,1,,train
0563862_sc-1025568.jpg,1,0,0,0,1,,train
0563863_sc-1025568.jpg,1,0,0,1,2,,train
0563864_sc-1025568.jpg,1,0,1,1,3,,train
0563865_sc-1025568.jpg,1,0,0,1,2,,train
0563866_sc-1025568.jpg,1,0,1,1,3,,train
0563867_sc-1025568.jpg,1,0,1,1,3,,val
0563868_as-3385005.jpg,2,0,0,0,2,,val
0563869_as-3186163.jpg,6,0,1,0,7,,test
0563872_as-0008465.jpg,0,1,1,1,3,,train
0563874_as-0008465.jpg,1,1,1,1,4,,train
0563875_as-0008465.jpg,1,0,0,0,1,,train
0563876_as-0008465.jpg,2,1,1,1,5,,train
0563877_as-0097377.jpg,0,0,1,0,1,,train
0563879_as-0097377.jpg,0,0,1,0,1,,train
0563881_as-0058618.jpg,2,0,0,0,2,,train
0563882_as-0058618.jpg,7,1,0,0,8,,val
0563883_sc-1039976.jpg,2,0,0,0,2,,val
0563884_sc-1039976.jpg,1,0,0,0,1,,test
0563886_sc-1039976.jpg,1,0,0,0,1,,train
0563888_as-3432912.jpg,1,0,0,0,1,,train
0563890_as-0069650.jpg,4,0,1,1,6,,train
0563891_as-0069650.jpg,1,0,1,2,4,,train
0563892_as-0069650.jpg,2,0,1,1,4,,train
0563893_as-0069650.jpg,3,1,0,0,4,,train
0563894_sc-1041092.jpg,2,0,0,0,2,,train
0563895_sc-1041092.jpg,3,0,0,2,5,,val
0563897_sc-1041092.jpg,0,0,0,1,1,,val
0563899_sc-1041092.jpg,2,0,0,2,4,,test
0563900_sc-168995.jpg,1,1,0,0,2,,train
0563901_sc-168995.jpg,1,1,0,0,2,,train
0563902_as-0083679.jpg,1,0,0,1,2,,train
0563903_as-0083679.jpg,1,0,0,1,2,,train
0563904_as-0083679.jpg,1,0,0,1,2,,train
0563905_as-2575242.jpg,2,0,0,1,3,,train
0563906_as-5328436.jpg,0,0,1,1,2,,train
0563907_as-7154772.jpg,2,0,0,1,3,,val
0563908_sc-1019130.jpg,2,0,0,0,2,,val
0563911_as-7923659.jpg,2,0,1,1,4,,test
0563912_as-0077167.jpg,1,0,0,1,2,,train
0563913_as-0077167.jpg,1,0,1,1,3,,train
0563914_as-0077167.jpg,1,0,0,0,1,,train
0563915_as-0013596.jpg,0,0,1,0,1,,train
0563916_as-0013596.jpg,0,0,1,0,1,,train
0563917_as-0013596.jpg,0,0,1,0,1,,train
0563918_as-0013596.jpg,0,0,1,0,1,,train
0563919_as-0013596.jpg,0,0,1,0,1,,val
0563920_as-7005895.jpg,2,0,1,0,3,,val
0563921_sc-141021.jpg,2,0,0,0,2,,test
0563922_sc-141021.jpg,4,0,0,0,4,,train
0563923_sc-141021.jpg,1,0,1,0,2,,train
0563924_sc-219886.jpg,2,0,1,0,3,,train
0563925_sc-219886.jpg,3,0,2,0,5,,train
0563926_as-7387457.jpg,0,0,1,0,1,,train
0563932_as-0040799.jpg,4,0,0,0,4,,train
0563935_as-0094229.jpg,1,1,1,1,4,,train
0563936_as-0094229.jpg,1,0,1,1,3,,val
0563937_as-0094229.jpg,3,0,0,0,3,,val
0563938_as-0094229.jpg,2,0,0,0,2,,test
0563939_as-0094229.jpg,0,1,1,0,2,,train
0563940_as-0094229.jpg,1,0,2,0,3,,train
0563941_sc-1025350.jpg,19,2,0,0,21,,train
0563942_sc-1025350.jpg,7,0,1,0,8,,train
0563943_sc-1025350.jpg,0,0,3,0,3,,train
0563944_as-0022046.jpg,2,0,0,0,2,,train
0563945_as-0022046.jpg,2,0,2,0,4,,train
0563946_as-9093895.jpg,3,0,0,0,3,,val
0563948_as-0021415.jpg,3,1,2,0,6,,val
0563949_as-0021415.jpg,4,1,3,0,8,,test
0563950_as-0021415.jpg,2,0,4,0,6,,train
0563952_as-0099126.jpg,1,0,0,1,2,,train
0563953_as-0099126.jpg,1,0,0,1,2,,train
0563954_as-0099126.jpg,1,0,1,1,3,,train
0563955_as-0099126.jpg,2,0,1,1,4,,train
0563956_as-2858708.jpg,2,0,0,0,2,,train
0563957_as-9044357.jpg,1,0,0,0,1,,train
0563959_as-2513948.jpg,1,0,0,0,1,,val
0563960_sc-202665.jpg,4,1,0,0,5,,val
0563961_sc-202665.jpg,2,1,0,0,3,,test
0563962_as-3378487.jpg,1,0,1,0,2,,train
0563963_sc-204985.jpg,1,0,1,0,2,,train
0563964_sc-204985.jpg,2,0,1,0,3,,train
0563965_sc-204985.jpg,2,2,1,0,5,,train
0563966_sc-204985.jpg,2,2,0,0,4,,train
0563967_sc-204985.jpg,1,0,3,0,4,,train
0563968_sc-204985.jpg,0,0,1,0,1,,train
0563969_as-3384696.jpg,0,0,1,0,1,,val
0563971_as-0051030.jpg,1,0,0,0,1,,val
0563972_sc-162880.jpg,1,0,0,0,1,,test
0563973_sc-162880.jpg,2,0,0,0,2,,train
0563974_sc-162880.jpg,1,0,0,0,1,,train
0563975_as-3099648.jpg,0,1,0,0,1,,train
0563977_as-0079374.jpg,2,0,0,0,2,,train
0563978_as-0079374.jpg,1,0,0,0,1,,train
0563979_as-0079374.jpg,0,0,1,0,1,,train
0563980_as-0029859.jpg,1,2,0,0,3,,train
0563982_as-0029859.jpg,1,2,0,0,3,,val
0563983_as-0029859.jpg,1,2,0,0,3,,val
0563984_as-0030012.jpg,1,0,0,0,1,,test
0563985_as-0030012.jpg,0,0,0,1,1,,train
0563986_as-0030012.jpg,1,0,0,1,2,,train
0563987_as-0030012.jpg,0,0,0,1,1,,train
0563988_as-0030012.jpg,1,0,0,0,1,,train
0563989_as-0030012.jpg,1,0,0,0,1,,train
0563991_as-0077691.jpg,1,0,0,0,1,,train
0563992_as-0077691.jpg,1,0,0,0,1,,train
0563993_as-2849185.jpg,2,1,1,0,4,,val
0563994_as-7010179.jpg,1,0,1,0,2,,val
0563997_as-0050753.jpg,1,1,2,0,4,,test
0563998_as-0050753.jpg,1,0,2,0,3,,train
0563999_as-0050753.jpg,2,0,0,0,2,,train
0564000_as-0050753.jpg,1,1,1,0,3,,train
0564001_sc-134173.jpg,0,0,1,0,1,,train
0564002_sc-134173.jpg,2,0,0,0,2,,train
0564004_sc-134173.jpg,3,0,0,0,3,,train
0564005_as-3331976.jpg,1,0,1,0,2,,train
0564006_as-0035912.jpg,2,0,0,0,2,,val
0564007_as-0035912.jpg,1,0,0,0,1,,val
0564008_as-0035912.jpg,3,0,1,1,5,,test
0564009_as-0035912.jpg,4,0,1,1,6,,train
0564010_as-0035912.jpg,2,1,0,0,3,,train
0564011_as-0035912.jpg,2,0,0,1,3,,train
0564012_as-0035912.jpg,6,1,1,1,9,,train
0564013_as-0035912.jpg,4,0,1,1,6,,train
0564016_sc-155043.jpg,1,0,1,1,3,,train
0564017_sc-155043.jpg,1,0,1,1,3,,train
0564018_sc-155043.jpg,1,0,1,1,3,,val
0564019_sc-1036579.jpg,1,0,1,0,2,,val
0564020_sc-1036579.jpg,1,0,0,0,1,,test
0564021_sc-1036579.jpg,1,0,1,0,2,,train
0564022_sc-173743.jpg,3,0,0,1,4,,train
0564023_sc-173743.jpg,2,0,0,1,3,,train
0564024_as-0063143.jpg,0,0,0,1,1,,train
0564025_as-0063143.jpg,0,0,0,1,1,,train
0564026_as-7274446.jpg,1,0,1,0,2,,train
0564027_sc-126656.jpg,4,3,0,0,7,,train
0564028_sc-126656.jpg,5,0,0,1,6,,val
0564029_sc-126656.jpg,7,0,1,1,9,,val
0564030_sc-126656.jpg,9,0,1,1,11,,test
0564031_sc-126656.jpg,2,0,1,1,4,,train
0564032_sc-126656.jpg,6,0,1,0,7,,train
0564033_sc-126656.jpg,8,0,0,0,8,,train
0564035_sc-126656.jpg,1,0,0,1,2,,train
0564037_sc-126656.jpg,10,2,1,0,13,,train
0564038_sc-126656.jpg,3,2,0,0,5,,train
0564039_sc-126656.jpg,1,0,1,0,2,,train
0564040_sc-126656.jpg,5,0,0,1,6,,val
0564041_sc-211851.jpg,1,0,0,0,1,,val
0564042_sc-211851.jpg,1,0,0,0,1,,test
0564043_sc-208507.jpg,4,0,0,0,4,,train
0564044_sc-208507.jpg,2,0,0,0,2,,train
0564045_sc-208507.jpg,2,0,0,0,2,,train
0564046_sc-208507.jpg,1,0,0,0,1,,train
0564047_sc-208507.jpg,1,0,0,0,1,,train
0564049_as-0008155.jpg,2,0,0,0,2,,train
0564051_as-0008155.jpg,2,0,0,0,2,,train
0564052_as-3018772.jpg,5,0,0,0,5,,val
0564053_sc-1027288.jpg,3,0,1,0,4,,val
0564054_sc-1027288.jpg,2,0,1,0,3,,test
0564055_as-0020072.jpg,2,1,0,0,3,,train
0564056_as-0020072.jpg,3,0,0,0,3,,train
0564057_as-0020072.jpg,2,0,0,0,2,,train
0564058_as-0039600.jpg,3,0,0,0,3,,train
0564059_as-0039600.jpg,1,0,0,1,2,,train
0564061_as-3342046.jpg,3,0,1,2,6,,train
0564062_as-0054934.jpg,1,0,0,0,1,,train
0564063_as-0054934.jpg,1,0,0,0,1,,val
0564064_as-0054934.jpg,1,0,0,0,1,,val
0564065_sc-135348.jpg,2,0,0,0,2,,test
0564066_sc-135348.jpg,1,0,0,0,1,,train
0564067_sc-135348.jpg,2,0,0,0,2,,train
0564068_as-2600405.jpg,1,0,0,1,2,,train
0564069_as-2765349.jpg,2,0,0,0,2,,train
0564070_as-7566386.jpg,0,1,1,0,2,,train
0564071_as-9037934.jpg,2,0,0,0,2,,train
0564074_as-0053159.jpg,1,0,0,0,1,,train
0564075_as-0053159.jpg,1,0,0,0,1,,val
0564076_as-0053159.jpg,1,0,0,0,1,,val
0564077_as-0053159.jpg,1,0,0,0,1,,test
0564079_as-0046559.jpg,2,1,0,0,3,,train
0564080_as-0046559.jpg,2,1,0,0,3,,train
0564082_as-0074323.jpg,1,0,0,0,1,,train
0564083_as-0074323.jpg,1,0,0,0,1,,train
0564084_sc-154189.jpg,4,0,0,0,4,,train
0564086_as-3064336.jpg,0,1,2,0,3,,train
0564087_sc-173383.jpg,3,0,0,0,3,,train
0564088_as-2853925.jpg,3,0,0,0,3,,val
0564089_as-2661845.jpg,1,0,0,0,1,,val
0564090_sc-205960.jpg,3,0,0,0,3,,test
0564092_sc-1025544.jpg,4,0,1,1,6,,train
0564093_sc-1025544.jpg,6,0,0,0,6,,train
0564094_sc-1025544.jpg,3,0,0,0,3,,train
0564096_as-9093571.jpg,0,0,1,0,1,,train
0564097_as-7934505.jpg,1,0,0,1,2,,train
0564099_sc-119457.jpg,6,0,1,0,7,,train
0564100_sc-119457.jpg,9,0,0,1,10,,train
0564101_sc-119457.jpg,6,0,1,1,8,,val
0564102_sc-119457.jpg,5,0,1,0,6,,val
0564103_sc-217963.jpg,4,0,0,0,4,,test
0564105_sc-109668.jpg,1,1,0,0,2,,train
0564106_sc-163172.jpg,2,0,0,0,2,,train
0564108_sc-129028.jpg,1,2,0,0,3,,train
0564109_as-7375725.jpg,2,0,0,0,2,,train
0564111_as-0070061.jpg,2,0,2,0,4,,train
0564112_as-0070061.jpg,1,0,2,0,3,,train
0564113_as-0070061.jpg,1,0,2,0,3,,train
0564114_sc-136885.jpg,0,0,1,0,1,,val
0564116_sc-136885.jpg,1,0,0,0,1,,val
0564118_sc-136885.jpg,2,1,1,0,4,,test
0564119_sc-136885.jpg,0,0,1,1,2,,train
0564120_sc-136885.jpg,0,0,1,1,2,,train
0564121_sc-136885.jpg,1,0,0,0,1,,train
0564122_sc-136885.jpg,2,0,0,0,2,,train
0564124_as-0013867.jpg,2,0,0,1,3,,train
0564125_as-0013867.jpg,3,0,0,1,4,,train
0564126_as-0013867.jpg,8,0,0,1,9,,train
0564127_as-0013867.jpg,7,0,0,1,8,,val
0564128_as-0013867.jpg,5,0,0,1,6,,val
0564129_as-0013867.jpg,4,0,0,0,4,,test
0564131_as-0046984.jpg,1,0,0,0,1,,train
0564132_as-0046984.jpg,1,0,0,0,1,,train
0564133_as-0046984.jpg,3,0,0,1,4,,train
0564134_as-0046984.jpg,2,0,0,0,2,,train
0564135_as-0046984.jpg,3,0,0,0,3,,train
0564136_as-2958262.jpg,1,0,0,0,1,,train
0564137_as-7612925.jpg,1,0,1,1,3,,train
0564139_sc-206453.jpg,4,0,1,0,5,,val
0564140_sc-222840.jpg,2,0,0,0,2,,val
0564141_as-9092991.jpg,0,0,1,0,1,,test
0564142_as-0055172.jpg,1,0,0,0,1,,train
0564143_as-0055172.jpg,2,0,0,0,2,,train
0564144_as-0055172.jpg,1,0,0,0,1,,train
0564145_as-0055172.jpg,3,0,0,0,3,,train
0564146_as-4699146.jpg,1,0,0,0,1,,train
0564147_sc-190906.jpg,2,0,0,2,4,,train
0564148_sc-190906.jpg,0,0,0,2,2,,train
0564149_as-0064250.jpg,1,0,0,0,1,,val
0564152_as-0064250.jpg,3,0,0,0,3,,val
0564153_sc-220373.jpg,2,0,0,0,2,,test
0564155_as-0079145.jpg,2,0,0,0,2,,train
0564156_as-0079145.jpg,4,0,1,0,5,,train
0564158_as-0079145.jpg,1,0,0,0,1,,train
0564160_as-0079145.jpg,9,0,0,1,10,,train
0564161_as-0079145.jpg,3,0,1,1,5,,train
0564162_as-0079145.jpg,6,0,0,0,6,,train
0564163_as-0079145.jpg,1,0,0,0,1,,train
0564166_sc-192621.jpg,3,1,0,0,4,,val
0564167_sc-1038385.jpg,8,0,0,2,10,,val
0564168_sc-1038385.jpg,8,0,0,2,10,,test
0564169_sc-1038385.jpg,3,0,0,0,3,,train
0564170_sc-1038385.jpg,11,0,0,0,11,,train
0564171_sc-1038385.jpg,5,0,0,1,6,,train
0564172_sc-1038385.jpg,4,0,0,3,7,,train
0564173_as-7202598.jpg,1,1,2,1,5,,train
0564174_as-2898578.jpg,2,0,0,0,2,,train
0564175_as-0069367.jpg,3,0,0,0,3,,train
0564176_as-2887458.jpg,5,0,0,0,5,,val
0564177_sc-216646.jpg,5,1,4,0,10,,val
0564178_sc-216646.jpg,3,1,1,0,5,,test
0564179_sc-216646.jpg,4,1,2,0,7,,train
0564180_sc-216646.jpg,2,1,1,0,4,,train
0564181_sc-214957.jpg,0,0,1,0,1,,train
0564182_sc-214957.jpg,4,1,4,1,10,,train
0564183_sc-214957.jpg,3,1,1,1,6,,train
0564184_sc-214957.jpg,3,1,1,1,6,,train
0564185_sc-214957.jpg,7,1,4,1,13,,train
0564186_sc-214957.jpg,4,1,4,1,10,,val
0564188_sc-1023167.jpg,2,1,1,1,5,,val
0564189_sc-1023167.jpg,1,2,2,0,5,,test
0564190_sc-1023167.jpg,4,1,1,1,7,,train
0564192_sc-1023167.jpg,0,1,1,0,2,,train
0564194_sc-1023167.jpg,0,0,2,2,4,,train
0564195_sc-1023167.jpg,0,0,1,2,3,,train
0564196_sc-1023167.jpg,0,0,1,2,3,,train
0564197_as-2866219.jpg,1,0,0,0,1,,train
0564199_as-3094318.jpg,3,0,0,0,3,,train
0564200_sc-1027538.jpg,1,0,0,0,1,,val
0564201_sc-1027538.jpg,3,0,1,0,4,,val
0564202_sc-1027538.jpg,3,0,1,0,4,,test
0564203_sc-1027538.jpg,2,0,0,0,2,,train
0564204_sc-1027538.jpg,4,0,1,0,5,,train
0564205_sc-1027538.jpg,1,0,0,0,1,,train
0564206_sc-1027538.jpg,1,0,0,0,1,,train
0564207_sc-183675.jpg,1,0,0,0,1,,train
0564208_sc-183675.jpg,1,0,0,0,1,,train
0564210_sc-103648.jpg,1,0,0,0,1,,train
0564211_sc-103648.jpg,1,0,0,0,1,,val
0564212_as-3331093.jpg,2,0,0,0,2,,val
0564213_sc-156418.jpg,2,0,1,0,3,,test
0564214_sc-156418.jpg,2,0,2,0,4,,train
0564216_as-3058176.jpg,1,1,1,0,3,,train
0564217_as-9045144.jpg,0,0,1,0,1,,train
0564218_sc-110545.jpg,2,0,0,0,2,,train
0564219_sc-110545.jpg,2,0,0,0,2,,train
0564220_sc-110545.jpg,2,3,0,0,5,,train
0564221_sc-110545.jpg,2,3,0,0,5,,train
0564222_sc-110545.jpg,1,0,0,0,1,,val
0564223_as-2822393.jpg,0,1,0,0,1,,val
0564224_as-2873470.jpg,0,3,1,0,4,,test
0564225_sc-189972.jpg,1,0,0,1,2,,train
0564226_sc-189972.jpg,1,0,0,1,2,,train
0564227_sc-128249.jpg,1,0,0,0,1,,train
0564229_sc-128249.jpg,1,0,1,0,2,,train
0564230_sc-128249.jpg,0,0,1,0,1,,train
0564231_as-0002628.jpg,3,2,0,2,7,,train
0564232_sc-1024827.jpg,1,2,1,2,6,,train
0564233_sc-1024827.jpg,0,2,1,2,5,,val
0564234_sc-1024827.jpg,1,2,1,2,6,,val
0564236_sc-163283.jpg,1,1,0,0,2,,test
0564237_as-0011816.jpg,2,0,0,0,2,,train
0564238_as-0011816.jpg,1,0,0,0,1,,train
0564239_sc-1005367.jpg,1,0,0,0,1,,train
0564240_sc-1005367.jpg,1,0,0,0,1,,train
0564241_sc-1005367.jpg,1,0,0,0,1,,train
0564242_sc-179791.jpg,6,0,0,0,6,,train
0564243_as-3373413.jpg,2,0,1,0,3,,train
0564244_as-3483253.jpg,1,0,0,0,1,,val
0564245_sc-162705.jpg,1,0,0,1,2,,val
0564246_sc-162705.jpg,1,0,0,1,2,,test
0564247_sc-162705.jpg,1,0,0,1,2,,train
0564248_sc-162705.jpg,1,0,0,1,2,,train
0564249_sc-162705.jpg,2,0,0,1,3,,train
0564253_as-0020825.jpg,1,0,0,1,2,,train
0564254_as-0020825.jpg,1,0,0,1,2,,train
0564255_as-0020825.jpg,0,1,0,1,2,,train
0564256_as-7805250.jpg,1,0,0,0,1,,train
0564257_as-9035156.jpg,4,0,2,1,7,,val
0564258_as-3258398.jpg,1,1,0,0,2,,val
0564259_sc-218089.jpg,1,0,0,0,1,,test
0564260_sc-218089.jpg,2,0,1,0,3,,train
0564261_sc-218089.jpg,1,0,1,0,2,,train
0564262_sc-218089.jpg,1,0,0,0,1,,train
0564263_sc-218089.jpg,1,0,0,0,1,,train
0564264_sc-218089.jpg,2,0,1,0,3,,train
0564265_sc-218089.jpg,1,0,0,0,1,,train
0564266_sc-218089.jpg,1,0,0,0,1,,train
0564267_sc-218089.jpg,1,1,0,0,2,,val
0564268_sc-218089.jpg,1,0,0,0,1,,val
0564269_sc-218089.jpg,1,0,0,0,1,,test
0564270_sc-218089.jpg,0,0,0,1,1,,train
0564271_sc-218089.jpg,1,0,0,0,1,,train
0564272_sc-214571.jpg,1,0,0,0,1,,train
0564273_as-2551611.jpg,3,2,0,0,5,,train
0564274_as-0001094.jpg,1,0,0,0,1,,train
0564275_as-0001094.jpg,1,0,0,0,1,,train
0564276_sc-1020797.jpg,0,0,1,0,1,,train
0564277_sc-1020797.jpg,3,0,0,0,3,,val
0564278_sc-1020797.jpg,1,0,1,1,3,,val
0564280_sc-1020797.jpg,5,0,1,0,6,,test
0564282_sc-109011.jpg,2,0,0,0,2,,train
0564283_as-0074150.jpg,1,0,0,0,1,,train
0564284_as-0074150.jpg,5,1,0,0,6,,train
0564285_as-0074150.jpg,1,1,0,0,2,,train
0564287_as-0074150.jpg,1,2,0,0,3,,train
0564288_as-0074150.jpg,1,2,0,0,3,,train
0564289_as-0074150.jpg,2,1,0,0,3,,train
0564291_as-0074150.jpg,5,0,0,0,5,,val
0564292_as-0074150.jpg,3,1,0,0,4,,val
0564293_as-0074150.jpg,0,1,0,0,1,,test
0564294_sc-1022536.jpg,0,1,0,0,1,,train
0564295_sc-1022536.jpg,0,1,0,0,1,,train
0564296_as-2522518.jpg,3,0,0,0,3,,train
0564297_as-0099240.jpg,0,1,1,0,2,,train
0564298_as-0099240.jpg,0,1,0,0,1,,train
0564299_as-7482817.jpg,1,0,2,1,4,,train
0564300_as-7226919.jpg,1,0,1,0,2,,train
0564301_as-3476663.jpg,2,0,0,0,2,,val
0564302_sc-125376.jpg,4,0,0,0,4,,val
0564304_as-0046932.jpg,1,1,1,1,4,,test
0564305_as-0046932.jpg,1,1,0,0,2,,train
0564306_as-0046932.jpg,2,0,1,0,3,,train
0564307_as-0046932.jpg,1,1,0,0,2,,train
0564308_as-0046932.jpg,1,0,1,0,2,,train
0564309_as-0046932.jpg,2,0,1,0,3,,train
0564310_as-0046932.jpg,2,0,1,0,3,,train
0564311_as-0046932.jpg,1,0,1,0,2,,train
0564312_as-0046932.jpg,3,0,0,0,3,,val
0564313_as-0046932.jpg,5,0,0,0,5,,val
0564314_as-0046932.jpg,5,0,0,0,5,,test
0564315_as-0046932.jpg,5,0,0,0,5,,train
0564317_as-0046932.jpg,1,0,0,0,1,,train
0564318_as-0046932.jpg,1,0,0,0,1,,train
0564320_as-0092479.jpg,1,0,0,0,1,,train
0564321_as-0092479.jpg,2,0,0,0,2,,train
0564322_as-0092479.jpg,2,0,0,1,3,,train
0564323_as-0092479.jpg,2,0,0,1,3,,train
0564324_as-0092479.jpg,2,0,0,1,3,,val
0564325_as-2828053.jpg,0,0,1,0,1,,val
0564326_as-0041146.jpg,1,1,0,0,2,,test
0564329_sc-205120.jpg,1,0,0,0,1,,train
0564330_sc-205120.jpg,1,0,1,0,2,,train
0564331_sc-205120.jpg,1,0,0,0,1,,train
0564333_as-0044778.jpg,1,0,1,0,2,,train
0564334_as-0044778.jpg,0,0,1,0,1,,train
0564336_as-2744503.jpg,3,0,0,0,3,,train
0564337_as-0034893.jpg,6,0,2,0,8,,train
0564338_as-0034893.jpg,5,0,1,0,6,,val
0564339_as-9080050.jpg,1,4,1,1,7,,val
0564340_sc-1031365.jpg,2,0,1,0,3,,test
0564341_sc-1031365.jpg,1,0,1,0,2,,train
0564343_sc-124738.jpg,3,0,0,0,3,,train
0564346_sc-124738.jpg,2,0,0,1,3,,train
0564347_sc-124738.jpg,1,0,0,1,2,,train
0564348_sc-124738.jpg,2,0,0,2,4,,train
0564349_sc-124738.jpg,3,0,0,2,5,,train
0564350_sc-124738.jpg,1,0,0,1,2,,train
0564351_sc-124738.jpg,3,0,0,1,4,,val
0564352_sc-124738.jpg,2,0,0,0,2,,val
0564353_sc-124738.jpg,2,0,0,3,5,,test
0564354_sc-124738.jpg,1,0,0,0,1,,train
0564355_sc-124738.jpg,2,0,0,0,2,,train
0564356_sc-124738.jpg,2,0,0,0,2,,train
0564357_sc-227109.jpg,7,2,5,1,15,,train
0564358_sc-227109.jpg,1,0,2,1,4,,train
0564359_sc-227109.jpg,2,0,2,0,4,,train
0564360_sc-217439.jpg,1,0,2,0,3,,train
0564362_sc-223723.jpg,6,2,3,0,11,,val
0564363_sc-223723.jpg,1,0,1,0,2,,val
0564364_sc-106741.jpg,0,1,0,0,1,,test
0564365_sc-106741.jpg,0,2,0,0,2,,train
0564366_sc-106741.jpg,2,2,0,0,4,,train
0564367_sc-106741.jpg,2,2,0,0,4,,train
0564369_as-0050912.jpg,3,0,0,1,4,,train
0564370_as-3470378.jpg,1,0,1,0,2,,train
0564372_sc-130630.jpg,1,1,1,1,4,,train
0564373_sc-130630.jpg,1,0,1,0,2,,train
0564374_sc-218921.jpg,4,1,0,1,6,,val
0564375_as-3152244.jpg,1,0,2,1,4,,val
0564377_as-0073635.jpg,1,0,0,0,1,,test
0564378_as-0073635.jpg,2,3,2,0,7,,train
0564379_as-0073635.jpg,1,3,1,0,5,,train
0564380_as-0073635.jpg,2,4,0,1,7,,train
0564381_sc-126421.jpg,1,0,0,0,1,,train
0564382_sc-224262.jpg,3,0,0,1,4,,train
0564383_sc-224262.jpg,5,0,1,0,6,,train
0564384_as-2726691.jpg,0,0,0,1,1,,train
0564385_as-0029744.jpg,0,0,0,1,1,,val
0564386_as-0029744.jpg,1,0,0,1,2,,val
0564387_as-0029744.jpg,2,0,0,1,3,,test
0564388_as-3247847.jpg,4,0,0,0,4,,train
0564389_as-3066491.jpg,1,0,0,0,1,,train
0564392_as-0075387.jpg,3,0,0,1,4,,train
0564393_as-0075387.jpg,1,0,0,1,2,,train
0564394_as-0075387.jpg,2,0,1,0,3,,train
0564395_as-0075387.jpg,0,0,1,0,1,,train
0564401_sc-145920.jpg,3,0,0,0,3,,train
0564402_sc-145920.jpg,1,0,0,2,3,,val
0564403_sc-145920.jpg,1,0,1,0,2,,val
0564404_sc-145920.jpg,1,0,0,2,3,,test
0564405_sc-145920.jpg,1,0,0,2,3,,train
0564406_sc-145920.jpg,1,0,0,1,2,,train
0564408_sc-145920.jpg,0,0,1,0,1,,train
0564409_sc-145920.jpg,2,0,0,0,2,,train
0564410_sc-145920.jpg,2,0,0,0,2,,train
0564411_sc-145920.jpg,2,0,0,0,2,,train
0564412_sc-145920.jpg,3,0,1,0,4,,train
0564413_sc-145920.jpg,1,0,1,0,2,,val
0564414_sc-145920.jpg,0,1,0,0,1,,val
0564415_sc-209024.jpg,4,0,0,0,4,,test
0564416_sc-209024.jpg,3,0,1,1,5,,train
0564417_sc-209024.jpg,2,0,0,0,2,,train
0564418_sc-209024.jpg,2,0,0,0,2,,train
0564419_sc-209024.jpg,2,0,1,0,3,,train
0564420_as-0030586.jpg,2,0,0,0,2,,train
0564421_as-0043441.jpg,1,0,1,1,3,,train
0564422_as-0043441.jpg,1,0,1,1,3,,train
0564423_as-7164423.jpg,0,0,1,0,1,,val
0564424_sc-159699.jpg,2,0,1,0,3,,val
0564425_sc-159699.jpg,2,0,1,0,3,,test
0564426_sc-159699.jpg,0,0,1,0,1,,train
0564427_as-3437247.jpg,5,0,0,0,5,,train
0564428_sc-209115.jpg,4,0,0,0,4,,train
0564429_sc-209115.jpg,2,0,1,0,3,,train
0564430_sc-209115.jpg,1,0,1,2,4,,train
0564431_sc-209115.jpg,1,0,1,2,4,,train
0564432_sc-209115.jpg,2,0,0,0,2,,train
0564433_sc-209115.jpg,1,0,0,0,1,,val
0564434_sc-209115.jpg,3,0,1,0,4,,val
0564437_as-0093681.jpg,4,0,0,0,4,,test
0564438_as-0093681.jpg,3,0,0,0,3,,train
0564439_as-0093681.jpg,2,0,0,0,2,,train
0564441_as-7504738.jpg,1,1,0,0,2,,train
0564442_sc-162348.jpg,2,0,0,0,2,,train
0564443_as-3369094.jpg,9,0,0,1,10,,train
0564444_as-3369094.jpg,1,0,0,1,2,,train
0564445_as-2999465.jpg,4,0,0,0,4,,train
0564446_sc-201938.jpg,3,0,1,1,5,,val
0564447_sc-201938.jpg,3,0,0,1,4,,val
0564448_sc-201938.jpg,1,0,0,1,2,,test
0564449_as-7967682.jpg,4,0,0,0,4,,train
0564451_as-0059575.jpg,1,0,0,0,1,,train
0564452_as-0059575.jpg,1,0,0,0,1,,train
0564455_as-0098399.jpg,3,1,1,0,5,,train
0564460_as-0017844.jpg,1,0,2,1,4,,train
0564461_as-0017844.jpg,1,0,1,1,3,,train
0564462_as-0017844.jpg,1,0,1,1,3,,train
0564463_as-0017844.jpg,1,0,1,1,3,,val
0564464_as-0017844.jpg,1,0,1,1,3,,val
0564465_as-0017844.jpg,1,0,0,0,1,,test
0564466_as-0017844.jpg,1,0,0,0,1,,train
0564467_as-0017844.jpg,2,0,1,1,4,,train
0564468_sc-173276.jpg,1,0,0,0,1,,train
0564469_sc-173276.jpg,0,0,0,1,1,,train
0564470_sc-173276.jpg,1,0,0,1,2,,train
0564471_sc-193463.jpg,1,0,0,0,1,,train
0564473_sc-193463.jpg,1,0,0,0,1,,train
0564474_sc-167628.jpg,1,0,0,0,1,,val
0564475_as-3416448.jpg,2,0,0,0,2,,val
0564476_as-2956984.jpg,1,0,0,0,1,,test
0564477_as-2956984.jpg,1,0,2,0,3,,train
0564478_as-3142488.jpg,1,0,0,0,1,,train
0564479_sc-1023989.jpg,1,0,0,0,1,,train
0564480_sc-201152.jpg,0,1,0,0,1,,train
0564481_sc-218340.jpg,1,0,0,1,2,,train
0564482_sc-218340.jpg,3,0,0,1,4,,train
0564483_sc-1014642.jpg,2,0,0,0,2,,train
0564484_sc-1014642.jpg,3,0,0,0,3,,val
0564486_as-2850334.jpg,4,0,1,0,5,,val
0564487_sc-151373.jpg,1,0,0,0,1,,test
0564488_sc-1029684.jpg,7,0,1,1,9,,train
0564489_sc-1029684.jpg,3,0,1,1,5,,train
0564491_sc-1029684.jpg,6,0,0,0,6,,train
0564492_sc-1029684.jpg,1,0,0,1,2,,train
0564493_sc-1029684.jpg,3,0,0,0,3,,train
0564494_sc-1029684.jpg,6,0,1,1,8,,train
0564495_sc-1029684.jpg,3,0,1,1,5,,train
0564496_sc-1029684.jpg,1,0,0,0,1,,val
0564497_sc-1029684.jpg,2,0,0,2,4,,val
0564498_sc-1029684.jpg,8,0,0,1,9,,test
0564502_as-0001668.jpg,2,0,0,0,2,,train
0564503_as-0001668.jpg,1,1,2,1,5,,train
0564505_as-0095558.jpg,6,0,0,0,6,,train
0564506_as-0095558.jpg,2,0,0,1,3,,train
0564507_as-0095558.jpg,3,0,0,1,4,,train
0564509_as-9077849.jpg,2,0,0,0,2,,train
0564510_sc-209374.jpg,6,0,0,0,6,,train
0564511_sc-209374.jpg,1,0,0,0,1,,val
0564512_sc-209374.jpg,1,0,0,0,1,,val
0564513_sc-154380.jpg,1,0,0,0,1,,test
0564515_sc-198913.jpg,2,0,0,0,2,,train
0564516_sc-198913.jpg,2,0,1,0,3,,train
0564517_sc-198913.jpg,1,0,0,0,1,,train
0564518_sc-198913.jpg,1,0,0,0,1,,train
0564519_sc-198913.jpg,2,0,1,0,3,,train
0564521_as-0068630.jpg,3,0,1,0,4,,train
0564522_as-0068630.jpg,1,0,1,0,2,,train
0564523_as-0068630.jpg,2,0,1,0,3,,val
0564524_as-0089880.jpg,5,0,1,1,7,,val
0564525_as-0089880.jpg,4,0,0,1,5,,test
0564526_as-0089880.jpg,3,0,0,0,3,,train
0564528_as-0004210.jpg,2,0,0,0,2,,train
0564529_sc-225547.jpg,5,0,0,0,5,,train
0564530_sc-225547.jpg,2,1,1,0,4,,train
0564531_sc-225547.jpg,3,1,1,1,6,,train
0564532_sc-225547.jpg,2,1,1,3,7,,train
0564533_sc-225547.jpg,0,1,0,0,1,,train
0564534_sc-225547.jpg,0,1,2,0,3,,val
0564535_sc-225547.jpg,3,0,0,1,4,,val
0564536_sc-225547.jpg,5,0,1,0,6,,test
0564537_sc-225547.jpg,9,0,1,0,10,,train
0564538_sc-225547.jpg,3,0,0,1,4,,train
0564539_sc-225547.jpg,3,0,1,0,4,,train
0564540_sc-225547.jpg,5,0,0,0,5,,train
0564541_sc-140124.jpg,5,0,0,0,5,,train
0564542_sc-140124.jpg,4,0,0,0,4,,train
0564543_as-3145446.jpg,1,0,2,0,3,,train
0564544_as-0013692.jpg,1,0,0,1,2,,val
0564545_as-0013692.jpg,1,0,0,1,2,,val
0564546_as-3203121.jpg,0,0,1,0,1,,test
0564547_sc-1021526.jpg,2,0,0,0,2,,train
0564548_sc-1021526.jpg,2,0,0,0,2,,train
0564549_sc-1021526.jpg,2,0,0,0,2,,train
0564550_as-2815425.jpg,0,0,1,0,1,,train
0564551_as-2863381.jpg,0,0,1,1,2,,train
0564552_as-9070357.jpg,1,0,0,0,1,,train
0564553_sc-190807.jpg,2,0,0,0,2,,train
0564556_sc-190807.jpg,1,0,0,0,1,,val
0564557_as-2881994.jpg,0,0,1,0,1,,val
0564558_sc-105037.jpg,0,0,2,0,2,,test
0564559_sc-105037.jpg,12,1,0,0,13,,train
0564560_sc-105037.jpg,4,0,0,0,4,,train
0564561_sc-1001282.jpg,2,0,0,0,2,,train
0564562_sc-1001282.jpg,1,0,0,0,1,,train
0564563_sc-1001282.jpg,2,0,0,0,2,,train
0564564_sc-1001282.jpg,0,1,0,0,1,,train
0564565_sc-1001282.jpg,3,0,1,0,4,,train
0564566_sc-105732.jpg,3,1,1,0,5,,val
0564567_sc-105732.jpg,2,1,1,0,4,,val
0564568_sc-105732.jpg,2,0,1,0,3,,test
0564569_sc-105732.jpg,1,0,0,0,1,,train
0564570_as-9072771.jpg,2,0,0,0,2,,train
0564571_as-0029083.jpg,2,1,0,0,3,,train
0564572_as-0029083.jpg,3,0,0,0,3,,train
0564574_as-0039647.jpg,1,0,0,1,2,,train
0564575_as-0039647.jpg,1,0,1,1,3,,train
0564576_as-0039647.jpg,1,0,1,1,3,,train
0564578_as-0039647.jpg,1,0,1,1,3,,val
0564580_as-7785630.jpg,1,0,0,0,1,,val
0564581_as-9046584.jpg,4,0,1,1,6,,test
0564582_as-0076058.jpg,1,0,0,1,2,,train
0564583_sc-120608.jpg,1,1,0,1,3,,train
0564584_sc-120608.jpg,1,1,0,1,3,,train
0564585_sc-120608.jpg,1,1,0,1,3,,train
0564586_sc-120608.jpg,1,1,0,1,3,,train
0564587_sc-120608.jpg,1,1,0,1,3,,train
0564588_sc-120608.jpg,1,2,0,2,5,,train
0564590_sc-1035091.jpg,4,0,0,0,4,,val
0564591_sc-1035091.jpg,4,0,1,0,5,,val
0564592_sc-1005279.jpg,2,0,1,2,5,,test
0564593_sc-1005279.jpg,2,0,1,1,4,,train
0564594_sc-1005279.jpg,3,0,2,0,5,,train
0564595_sc-1005279.jpg,2,0,0,0,2,,train
0564596_as-0007422.jpg,4,0,1,3,8,,train
0564597_as-0007422.jpg,5,0,1,2,8,,train
0564598_as-0007422.jpg,2,0,0,1,3,,train
0564599_as-0007422.jpg,2,0,0,1,3,,train
0564600_as-0007422.jpg,5,0,0,0,5,,val
0564601_as-0007422.jpg,6,0,1,0,7,,val
0564602_as-0007422.jpg,6,0,1,2,9,,test
0564603_as-0007422.jpg,2,0,0,1,3,,train
0564604_as-0007422.jpg,3,1,1,2,7,,train
0564609_as-0007422.jpg,7,0,0,0,7,,train
0564611_sc-170175.jpg,1,0,0,0,1,,train
0564612_sc-170175.jpg,0,1,0,0,1,,train
0564613_sc-170175.jpg,1,0,1,0,2,,train
0564614_sc-170175.jpg,1,0,0,0,1,,train
0564615_sc-181417.jpg,2,1,2,0,5,,val
0564616_sc-181417.jpg,0,1,1,0,2,,val
0564617_sc-225155.jpg,1,0,0,0,1,,test
0564619_sc-225847.jpg,1,0,0,1,2,,train
0564620_sc-225847.jpg,1,0,0,1,2,,train
0564621_as-0002369.jpg,1,0,0,0,1,,train
0564622_as-0002369.jpg,2,0,0,0,2,,train
0564623_as-0002369.jpg,0,1,0,1,2,,train
0564625_sc-158215.jpg,4,0,1,0,5,,train
0564626_as-3172658.jpg,0,0,1,0,1,,train
0564627_sc-223213.jpg,1,0,0,0,1,,val
0564628_sc-223213.jpg,1,0,0,0,1,,val
0564629_sc-161080.jpg,1,0,0,0,1,,test
0564630_sc-161080.jpg,1,0,0,0,1,,train
0564631_sc-161080.jpg,1,0,0,0,1,,train
0564634_sc-130638.jpg,1,0,1,0,2,,train
0564635_sc-130638.jpg,1,0,0,0,1,,train
0564636_sc-130638.jpg,3,0,0,0,3,,train
0564637_sc-130638.jpg,1,0,1,0,2,,train
0564638_sc-121465.jpg,4,0,0,1,5,,train
0564640_sc-206211.jpg,1,1,0,0,2,,val
0564641_sc-206211.jpg,1,0,0,0,1,,val
0564642_sc-206211.jpg,1,0,0,0,1,,test
0564643_sc-206211.jpg,1,0,0,0,1,,train
0564646_as-2599432.jpg,4,1,0,1,6,,train
0564647_sc-163738.jpg,1,0,0,0,1,,train
0564648_as-2676075.jpg,0,1,0,0,1,,train
0564651_sc-122094.jpg,2,0,1,3,6,,train
0564652_sc-122094.jpg,1,0,1,1,3,,train
0564653_sc-122094.jpg,1,0,1,2,4,,train
0564654_sc-122094.jpg,1,0,1,1,3,,val
0564655_sc-1006784.jpg,3,0,0,1,4,,val
0564656_sc-1006784.jpg,1,1,0,1,3,,test
0564658_sc-130631.jpg,2,0,0,0,2,,train
0564660_as-0099133.jpg,1,2,0,0,3,,train
0564661_as-0099133.jpg,2,4,1,1,8,,train
0564662_as-0099133.jpg,1,1,1,0,3,,train
0564664_sc-128143.jpg,2,0,1,0,3,,train
0564665_sc-128143.jpg,2,1,1,0,4,,train
0564666_sc-1025348.jpg,4,0,0,0,4,,train
0564667_sc-1025348.jpg,7,0,0,0,7,,val
0564668_sc-1025348.jpg,1,0,1,1,3,,val
0564669_sc-1025348.jpg,1,0,0,0,1,,test
0564670_sc-1025348.jpg,3,0,1,1,5,,train
0564673_as-0081109.jpg,1,1,0,1,3,,train
0564674_as-0081109.jpg,1,1,0,1,3,,train
0564675_as-0008338.jpg,1,0,1,0,2,,train
0564676_as-0008338.jpg,1,0,1,1,3,,train
0564677_as-0008338.jpg,3,0,1,1,5,,train
0564678_as-0008338.jpg,1,0,1,1,3,,train
0564679_as-0008338.jpg,1,0,1,1,3,,val
0564681_as-0008338.jpg,1,0,0,0,1,,val
0564683_as-0008338.jpg,1,0,0,0,1,,test
0564684_as-0008338.jpg,1,0,0,0,1,,train
0564685_as-0008338.jpg,2,0,0,0,2,,train
0564686_as-0008338.jpg,4,0,0,1,5,,train
0564687_as-0008338.jpg,3,0,0,1,4,,train
0564688_as-0008338.jpg,2,0,0,1,3,,train
0564689_as-0008338.jpg,1,1,0,1,3,,train
0564690_as-0008338.jpg,1,1,0,1,3,,train
0564693_as-0008338.jpg,1,2,1,1,5,,val
0564695_as-0008338.jpg,2,0,0,0,2,,val
0564696_as-0008338.jpg,6,0,1,1,8,,test
0564697_as-0008338.jpg,1,0,1,1,3,,train
0564698_as-0008338.jpg,1,0,1,1,3,,train
0564699_as-0008338.jpg,1,0,0,1,2,,train
0564700_as-0008338.jpg,1,0,0,1,2,,train
0564701_as-0008338.jpg,1,0,0,1,2,,train
0564702_as-0008338.jpg,1,0,0,1,2,,train
0564703_as-0008338.jpg,2,0,1,1,4,,train
0564704_as-0008338.jpg,0,0,0,1,1,,val
0564705_as-0008338.jpg,0,0,0,1,1,,val
0564706_as-0008338.jpg,1,0,0,0,1,,test
0564709_as-0055775.jpg,1,0,0,0,1,,train
0564710_as-0055775.jpg,1,0,0,0,1,,train
0564712_sc-1006288.jpg,1,1,0,0,2,,train
0564714_sc-176632.jpg,11,1,2,0,14,,train
0564715_sc-176632.jpg,10,1,1,0,12,,train
0564716_as-0035059.jpg,2,2,0,0,4,,train
0564717_as-0035059.jpg,5,1,0,0,6,,train
0564719_sc-146877.jpg,2,0,1,0,3,,val
0564720_as-0073748.jpg,1,1,0,0,2,,val
0564723_as-0035236.jpg,0,0,1,0,1,,test
0564726_sc-213466.jpg,1,0,0,1,2,,train
0564727_sc-213466.jpg,1,0,0,1,2,,train
0564728_sc-213466.jpg,1,0,0,1,2,,train
0564729_sc-213466.jpg,2,0,0,0,2,,train
0564730_sc-213466.jpg,2,0,0,0,2,,train
0564731_as-0045136.jpg,1,0,0,1,2,,train
0564732_as-0045136.jpg,0,0,0,1,1,,train
0564734_sc-1001999.jpg,4,0,0,1,5,,val
0564735_sc-1001999.jpg,3,0,0,1,4,,val
0564736_as-2971823.jpg,2,1,0,0,3,,test
0564737_sc-164349.jpg,2,0,0,0,2,,train
0564738_sc-164349.jpg,1,0,0,0,1,,train
0564739_sc-164349.jpg,1,0,0,0,1,,train
0564740_as-0047763.jpg,2,2,0,0,4,,train
0564741_as-0047763.jpg,2,1,0,0,3,,train
0564742_as-0047763.jpg,1,0,0,0,1,,train
0564743_as-0047763.jpg,1,1,0,0,2,,train
0564744_as-0047763.jpg,1,1,0,0,2,,val
0564745_as-0047763.jpg,1,0,0,0,1,,val
0564746_as-0047763.jpg,2,0,0,0,2,,test
0564747_as-0047763.jpg,1,0,0,0,1,,train
0564748_as-0047763.jpg,1,0,0,0,1,,train
0564749_as-0047763.jpg,1,0,0,0,1,,train
0564750_as-0047763.jpg,1,0,0,0,1,,train
0564751_as-0047763.jpg,2,0,0,0,2,,train
0564752_as-0047763.jpg,1,0,0,0,1,,train
0564753_as-0047763.jpg,2,0,0,0,2,,train
0564754_sc-1031854.jpg,1,1,2,0,4,,val
0564755_sc-1031854.jpg,1,0,1,0,2,,val
0564756_sc-1031854.jpg,1,0,1,0,2,,test
0564757_as-7757191.jpg,1,0,0,0,1,,train
0564760_as-0039910.jpg,2,0,1,1,4,,train
0564761_as-0039910.jpg,1,0,1,1,3,,train
0564762_as-0039910.jpg,1,0,0,0,1,,train
0564763_sc-204342.jpg,1,0,1,0,2,,train
0564764_sc-204342.jpg,1,1,0,0,2,,train
0564765_as-3146615.jpg,1,0,0,1,2,,train
0564766_as-0049105.jpg,0,1,0,0,1,,val
0564767_as-0049105.jpg,0,1,0,0,1,,val
0564768_as-0077933.jpg,0,3,2,1,6,,test
0564771_as-0077933.jpg,1,0,0,0,1,,train
0564772_as-0077933.jpg,1,0,1,0,2,,train
0564775_as-0077933.jpg,2,2,2,0,6,,train
0564776_as-0077933.jpg,1,1,2,0,4,,train
0564777_as-0077933.jpg,0,2,2,1,5,,train
0564778_as-0077933.jpg,0,1,0,1,2,,train
0564779_as-0077933.jpg,3,0,1,0,4,,train
0564780_as-0077933.jpg,2,0,1,0,3,,val
0564782_as-0007278.jpg,0,0,0,1,1,,val
0564783_sc-151419.jpg,1,0,0,0,1,,test
0564784_sc-151419.jpg,2,0,0,0,2,,train
0564785_sc-151419.jpg,2,0,0,0,2,,train
0564787_sc-125375.jpg,1,0,1,0,2,,train
0564788_sc-125375.jpg,3,0,1,0,4,,train
0564789_sc-125375.jpg,3,1,1,0,5,,train
0564790_sc-125375.jpg,2,0,0,0,2,,train
0564791_sc-125375.jpg,3,0,0,0,3,,train
0564792_sc-125375.jpg,3,0,0,0,3,,val
0564793_sc-125375.jpg,5,0,0,0,5,,val
0564795_as-7753012.jpg,1,0,0,0,1,,test
0564796_as-2538461.jpg,1,0,0,0,1,,train
0564797_sc-158627.jpg,4,0,0,0,4,,train
0564798_sc-158627.jpg,1,0,0,0,1,,train
0564799_sc-158627.jpg,2,0,0,0,2,,train
0564800_sc-158627.jpg,4,1,0,0,5,,train
0564801_sc-158627.jpg,4,1,0,0,5,,train
0564803_as-0074857.jpg,0,0,1,0,1,,train
0564804_as-2737517.jpg,0,0,1,1,2,,val
0564805_as-7345817.jpg,1,0,0,0,1,,val
0564806_sc-181905.jpg,3,0,1,0,4,,test
0564807_sc-181905.jpg,2,0,2,0,4,,train
0564809_sc-181905.jpg,3,0,1,1,5,,train
0564810_sc-181905.jpg,4,0,1,0,5,,train
0564811_sc-119970.jpg,2,0,0,0,2,,train
0564812_sc-119970.jpg,1,1,0,0,2,,train
0564813_as-0010297.jpg,4,0,0,0,4,,train
0564814_as-0010297.jpg,2,0,0,0,2,,train
0564815_as-2775760.jpg,1,1,0,0,2,,val
0564816_as-3308887.jpg,0,0,2,0,2,,val
0564817_sc-128373.jpg,1,0,0,0,1,,test
0564818_sc-128373.jpg,1,0,0,0,1,,train
0564819_sc-128373.jpg,1,1,0,0,2,,train
0564821_sc-1035164.jpg,1,0,0,0,1,,train
0564822_sc-1035164.jpg,4,0,0,1,5,,train
0564823_as-0029216.jpg,2,0,0,1,3,,train
0564824_as-0029216.jpg,2,0,0,1,3,,train
0564825_as-0029216.jpg,2,0,0,1,3,,train
0564827_sc-221246.jpg,1,0,1,0,2,,val
0564828_sc-221246.jpg,4,0,1,0,5,,val
0564829_sc-221246.jpg,0,1,0,0,1,,test
0564830_sc-221246.jpg,0,1,0,0,1,,train
0564831_sc-207165.jpg,2,0,0,0,2,,train
0564832_as-0046217.jpg,1,0,0,0,1,,train
0564833_as-0046217.jpg,1,0,0,0,1,,train
0564834_as-0046217.jpg,1,0,0,0,1,,train
0564835_as-0046217.jpg,2,0,0,0,2,,train
0564836_as-0046217.jpg,3,0,0,2,5,,train
0564839_sc-175044.jpg,2,0,1,1,4,,val
0564840_sc-175044.jpg,1,0,0,0,1,,val
0564841_sc-175044.jpg,1,0,0,1,2,,test
0564842_sc-175044.jpg,2,0,0,1,3,,train
0564843_sc-175044.jpg,2,0,0,1,3,,train
0564844_sc-175044.jpg,1,0,0,1,2,,train
0564845_sc-175044.jpg,2,0,0,1,3,,train
0564846_sc-173140.jpg,3,0,0,0,3,,train
0564847_as-2736155.jpg,2,1,0,0,3,,train
0564849_as-0002408.jpg,0,1,0,0,1,,train
0564850_as-0002408.jpg,0,2,0,0,2,,val
0564851_as-7709071.jpg,1,0,0,0,1,,val
0564852_as-3314378.jpg,0,1,1,1,3,,test
0564855_sc-183390.jpg,2,0,0,0,2,,train
0564856_sc-183390.jpg,2,0,0,0,2,,train
0564857_as-3047802.jpg,2,0,0,0,2,,train
0564858_as-2592807.jpg,3,0,0,0,3,,train
0564860_as-0067561.jpg,1,0,0,0,1,,train
0564861_as-2782527.jpg,4,3,0,1,8,,train
0564862_as-0080700.jpg,0,0,2,0,2,,train
0564863_as-0080700.jpg,0,1,2,0,3,,val
0564865_sc-1040664.jpg,3,0,1,0,4,,val
0564866_as-7766154.jpg,1,1,1,0,3,,test
0564867_sc-118785.jpg,1,0,0,0,1,,train
0564868_sc-118785.jpg,1,0,0,0,1,,train
0564869_as-7397377.jpg,2,0,0,0,2,,train
0564870_as-3398614.jpg,5,0,0,0,5,,train
0564871_as-3399969.jpg,1,0,0,0,1,,train
0564874_sc-110273.jpg,1,1,1,0,3,,train
0564875_sc-110273.jpg,2,0,1,0,3,,train
0564876_as-2931559.jpg,1,0,1,2,4,,val
0564877_as-0069592.jpg,5,1,0,0,6,,val
0564878_as-3483001.jpg,2,0,0,0,2,,test
0564881_sc-173285.jpg,6,0,0,0,6,,train
0564882_sc-173285.jpg,10,0,0,0,10,,train
0564885_as-0045547.jpg,4,0,0,0,4,,train
0564886_as-0045547.jpg,5,0,0,0,5,,train
0564887_as-0045547.jpg,3,0,0,0,3,,train
0564888_as-0045547.jpg,6,0,0,0,6,,train
0564889_as-0045547.jpg,3,0,0,0,3,,train
0564890_as-0045547.jpg,1,0,0,0,1,,val
0564891_as-0045547.jpg,6,0,0,0,6,,val
0564892_as-0045547.jpg,3,0,0,0,3,,test
0564893_sc-1038647.jpg,3,0,0,0,3,,train
0564894_sc-1038647.jpg,0,0,1,0,1,,train
0564895_sc-1038647.jpg,3,0,0,0,3,,train
0564896_sc-1038647.jpg,4,0,0,0,4,,train
0564897_sc-1038647.jpg,1,0,0,0,1,,train
0564898_as-9056593.jpg,3,2,1,0,6,,train
0564901_as-0061956.jpg,3,0,1,1,5,,train
0564902_as-0061956.jpg,3,0,0,1,4,,val
0564903_as-0061956.jpg,5,0,1,1,7,,val
0564904_as-0061956.jpg,3,0,1,1,5,,test
0564905_as-0061956.jpg,2,0,1,1,4,,train
0564906_as-0061956.jpg,1,0,0,1,2,,train
0564907_as-0061956.jpg,1,0,0,1,2,,train
0564908_as-0061956.jpg,1,0,0,1,2,,train
0564910_as-0061956.jpg,2,0,1,2,5,,train
0564911_as-0061956.jpg,1,0,1,1,3,,train
0564912_as-0061956.jpg,1,0,0,1,2,,train
0564915_as-0061956.jpg,2,0,0,1,3,,val
0564916_as-0061956.jpg,1,0,0,1,2,,val
0564917_as-0061956.jpg,1,0,0,1,2,,test
0564918_as-2988732.jpg,0,0,2,0,2,,train
0564920_as-0065933.jpg,1,1,0,0,2,,train
0564921_sc-223228.jpg,6,1,0,1,8,,train
0564922_sc-223228.jpg,5,0,0,1,6,,train
0564923_sc-223228.jpg,5,0,0,1,6,,train
0564924_sc-223228.jpg,6,0,0,1,7,,train
0564925_sc-223228.jpg,0,0,1,0,1,,train
0564926_sc-223228.jpg,1,0,0,0,1,,val
0564927_sc-223228.jpg,3,0,0,0,3,,val
0564928_sc-223228.jpg,9,0,0,1,10,,test
0564929_sc-223228.jpg,5,0,0,1,6,,train
0564930_sc-223228.jpg,8,0,0,1,9,,train
0564931_sc-223228.jpg,4,0,0,1,5,,train
0564932_sc-223228.jpg,2,0,0,1,3,,train
0564933_sc-223228.jpg,1,0,0,0,1,,train
0564934_sc-223228.jpg,1,0,0,0,1,,train
0564935_as-0061613.jpg,1,0,0,0,1,,train
0564936_as-0061613.jpg,1,0,0,0,1,,val
0564937_as-0023613.jpg,0,1,1,0,2,,val
0564938_as-0023613.jpg,0,1,2,0,3,,test
0564939_as-0023613.jpg,0,1,1,0,2,,train
0564940_as-0023613.jpg,1,0,1,1,3,,train
0564941_as-0023613.jpg,1,0,0,0,1,,train
0564942_sc-228618.jpg,1,0,0,1,2,,train
0564943_sc-228618.jpg,1,0,0,1,2,,train
0564944_sc-228618.jpg,1,1,0,0,2,,train
0564945_sc-228618.jpg,1,0,0,1,2,,train
0564946_sc-228618.jpg,1,0,0,1,2,,val
0564947_sc-228618.jpg,2,0,0,1,3,,val
0564948_sc-228618.jpg,1,0,0,0,1,,test
0564949_sc-224819.jpg,5,1,2,1,9,,train
0564950_sc-224819.jpg,4,1,3,1,9,,train
0564951_sc-224819.jpg,4,0,1,1,6,,train
0564952_sc-224819.jpg,1,0,0,1,2,,train
0564953_sc-224819.jpg,4,1,1,1,7,,train
0564954_sc-224819.jpg,2,1,1,0,4,,train
0564955_sc-224819.jpg,1,0,0,0,1,,train
0564958_sc-162921.jpg,1,2,0,0,3,,val
0564960_sc-192821.jpg,3,0,0,0,3,,val
0564961_sc-192821.jpg,2,0,0,0,2,,test
0564962_sc-115622.jpg,0,1,0,0,1,,train
0564963_sc-115622.jpg,0,1,0,0,1,,train
0564964_sc-115622.jpg,0,1,0,0,1,,train
0564965_sc-229836.jpg,0,0,0,1,1,,train
0564966_sc-229836.jpg,0,0,0,1,1,,train
0564967_sc-229836.jpg,0,0,0,1,1,,train
0564968_sc-172984.jpg,3,1,0,0,4,,train
0564970_as-7369825.jpg,0,2,0,0,2,,val
0564973_sc-204230.jpg,1,1,0,0,2,,val
0564976_sc-143871.jpg,8,2,1,1,12,,test
0564978_as-0054414.jpg,7,0,0,0,7,,train
0564979_as-0054414.jpg,9,0,1,0,10,,train
0564980_as-3000386.jpg,4,0,0,1,5,,train
0564983_as-0045213.jpg,3,0,0,0,3,,train
0564984_as-0045213.jpg,1,0,0,0,1,,train
0564985_as-0045213.jpg,2,0,0,0,2,,train
0564986_as-0045213.jpg,1,0,0,0,1,,train
0564987_as-0045213.jpg,1,0,0,0,1,,val
0564988_sc-136058.jpg,2,0,0,1,3,,val
0564989_as-3277450.jpg,1,0,0,0,1,,test
0564990_sc-225739.jpg,1,1,0,0,2,,train
0564991_sc-178669.jpg,0,0,1,0,1,,train
0564993_as-0016201.jpg,2,1,1,0,4,,train
0564994_as-0016201.jpg,5,0,0,0,5,,train
0564996_as-0016201.jpg,1,1,1,1,4,,train
0564997_as-0016201.jpg,2,0,0,0,2,,train
0564998_as-2829629.jpg,1,0,0,1,2,,train
0564999_sc-1035261.jpg,0,0,1,0,1,,val
0565001_as-0004924.jpg,3,1,1,1,6,,val
0565002_as-0004924.jpg,0,0,1,0,1,,test
0565003_as-0004924.jpg,3,1,0,1,5,,train
0565004_as-2706441.jpg,1,0,0,0,1,,train
0565005_sc-1026790.jpg,2,0,0,0,2,,train
0565006_sc-211956.jpg,1,0,1,2,4,,train
0565007_sc-211956.jpg,0,0,1,2,3,,train
0565008_sc-211956.jpg,1,0,0,1,2,,train
0565009_sc-211956.jpg,2,0,0,0,2,,train
0565010_as-7870496.jpg,0,0,1,0,1,,val
0565011_sc-133621.jpg,3,0,0,0,3,,val
0565012_sc-133621.jpg,2,0,0,0,2,,test
0565013_sc-133621.jpg,2,0,0,0,2,,train
0565014_sc-133621.jpg,1,0,0,0,1,,train
0565017_as-0008174.jpg,1,0,1,1,3,,train
0565018_as-0008174.jpg,2,0,0,0,2,,train
0565019_as-0008174.jpg,2,0,0,0,2,,train
0565020_as-0008174.jpg,2,0,0,0,2,,train
0565021_as-0008174.jpg,1,0,0,0,1,,train
0565022_as-0008174.jpg,2,0,0,0,2,,val
0565023_as-0008174.jpg,3,0,0,0,3,,val
0565024_as-0008174.jpg,2,0,0,0,2,,test
0565025_as-3492892.jpg,1,0,0,0,1,,train
0565026_as-3473096.jpg,5,0,0,0,5,,train
0565028_sc-197754.jpg,2,0,1,0,3,,train
0565029_sc-197754.jpg,0,0,1,0,1,,train
0565031_sc-197754.jpg,4,0,0,0,4,,train
0565032_sc-197754.jpg,2,0,1,0,3,,train
0565033_sc-197754.jpg,3,0,0,0,3,,train
0565034_sc-197754.jpg,1,0,0,0,1,,val
0565035_sc-197754.jpg,2,0,0,0,2,,val
0565036_sc-228097.jpg,0,1,1,0,2,,test
0565039_as-2655390.jpg,0,0,0,1,1,,train
0565040_as-0090362.jpg,3,0,0,0,3,,train
0565041_as-0090362.jpg,1,0,0,0,1,,train
0565042_as-0090362.jpg,1,0,0,0,1,,train
0565044_as-3131759.jpg,2,0,0,0,2,,train
0565045_as-2947106.jpg,2,0,0,0,2,,train
0565046_as-7045311.jpg,1,0,0,0,1,,train
0565047_sc-1006041.jpg,1,0,0,0,1,,val
0565048_as-3011294.jpg,0,0,1,0,1,,val
0565049_as-0082365.jpg,3,0,0,0,3,,test
0565050_as-0082365.jpg,1,0,0,0,1,,train
0565051_as-0082365.jpg,1,0,0,0,1,,train
0565052_as-7092307.jpg,1,0,0,0,1,,train
0565053_sc-219333.jpg,1,0,0,1,2,,train
0565054_as-2870903.jpg,1,0,0,0,1,,train
0565055_as-2717064.jpg,1,0,0,0,1,,train
0565057_as-0048546.jpg,1,0,0,0,1,,train
0565058_as-0048546.jpg,6,0,0,0,6,,val
0565059_as-0048546.jpg,3,0,0,0,3,,val
0565061_as-0031547.jpg,1,1,1,1,4,,test
0565062_as-0031547.jpg,3,0,0,0,3,,train
0565063_as-0031547.jpg,2,1,1,1,5,,train
0565065_as-0060963.jpg,1,0,0,1,2,,train
0565066_as-0060963.jpg,4,1,0,0,5,,train
0565067_as-0060963.jpg,2,1,0,0,3,,train
0565069_as-2949373.jpg,2,0,1,0,3,,train
0565070_sc-1028234.jpg,1,1,0,0,2,,train
0565071_sc-1028234.jpg,1,1,0,0,2,,val
0565072_sc-1028234.jpg,1,1,0,0,2,,val
0565073_sc-1028234.jpg,1,1,0,0,2,,test
0565074_as-5236049.jpg,1,1,1,0,3,,train
0565076_as-0050243.jpg,0,0,0,1,1,,train
0565077_as-0050243.jpg,0,0,0,1,1,,train
0565078_as-0050243.jpg,0,0,0,1,1,,train
0565079_as-0050243.jpg,0,0,0,1,1,,train
0565080_as-3182573.jpg,2,0,0,0,2,,train
0565083_sc-109950.jpg,1,1,0,0,2,,train
0565084_sc-109950.jpg,1,1,0,0,2,,val
0565085_sc-109950.jpg,1,1,0,0,2,,val
0565086_sc-109950.jpg,1,1,0,0,2,,test
0565089_as-0079313.jpg,1,0,0,1,2,,train
0565092_as-0053273.jpg,2,0,0,0,2,,train
0565093_as-0053273.jpg,1,0,0,0,1,,train
0565095_as-0087184.jpg,2,1,1,1,5,,train
0565096_sc-223855.jpg,1,0,0,0,1,,train
0565097_sc-223855.jpg,3,0,1,0,4,,train
0565098_sc-223855.jpg,3,0,1,0,4,,train
0565099_sc-223855.jpg,3,1,0,0,4,,val
0565100_as-2866419.jpg,2,0,0,0,2,,val
0565101_as-2996523.jpg,1,3,1,0,5,,test
0565102_as-7425977.jpg,1,0,0,0,1,,train
0565104_sc-104251.jpg,1,0,1,0,2,,train
0565105_sc-104251.jpg,1,0,1,0,2,,train
0565106_sc-104251.jpg,1,0,1,0,2,,train
0565108_sc-1002854.jpg,1,0,1,0,2,,train
0565110_as-3233617.jpg,0,1,0,0,1,,train
0565112_as-7032597.jpg,1,2,0,0,3,,train
0565114_as-0088737.jpg,1,0,0,0,1,,val
0565115_as-0088737.jpg,1,0,0,0,1,,val
0565117_as-0088737.jpg,1,0,0,0,1,,test
0565120_as-0088737.jpg,1,1,0,0,2,,train
0565121_as-0088737.jpg,0,1,0,0,1,,train
0565122_sc-1035433.jpg,2,0,1,1,4,,train
0565123_sc-1035433.jpg,0,0,2,1,3,,train
0565124_sc-177084.jpg,1,0,0,0,1,,train
0565126_sc-154332.jpg,1,0,0,0,1,,train
0565127_sc-154332.jpg,0,0,1,0,1,,train
0565128_sc-154332.jpg,1,0,0,0,1,,val
0565129_sc-154332.jpg,1,0,0,0,1,,val
0565130_sc-1032549.jpg,1,0,0,1,2,,test
0565131_sc-1032549.jpg,1,0,0,1,2,,train
0565132_sc-198941.jpg,6,0,0,1,7,,train
0565133_sc-198941.jpg,8,0,0,1,9,,train
0565134_sc-198941.jpg,3,1,0,0,4,,train
0565135_sc-198941.jpg,10,1,0,0,11,,train
0565136_sc-198941.jpg,6,0,0,0,6,,train
0565137_sc-1012810.jpg,2,0,0,0,2,,train
0565138_sc-1012810.jpg,5,0,0,0,5,,val
0565139_sc-207570.jpg,3,0,0,0,3,,val
0565140_sc-207570.jpg,1,0,0,0,1,,test
0565141_as-0015188.jpg,0,0,0,1,1,,train
0565142_as-0015188.jpg,1,0,0,1,2,,train
0565143_as-0015188.jpg,0,0,0,1,1,,train
0565145_sc-133792.jpg,1,0,0,1,2,,train
0565146_sc-133792.jpg,1,0,0,2,3,,train
0565147_sc-133792.jpg,1,0,0,2,3,,train
0565148_sc-1033562.jpg,1,0,2,0,3,,train
0565149_sc-1033562.jpg,1,0,0,0,1,,val
0565151_sc-1033562.jpg,2,0,1,0,3,,val
0565153_sc-1033562.jpg,2,0,0,0,2,,test
0565154_as-3393303.jpg,1,0,0,0,1,,train
0565155_sc-149755.jpg,2,1,0,0,3,,train
0565157_sc-149755.jpg,3,1,0,0,4,,train
0565158_sc-1036879.jpg,0,1,2,0,3,,train
0565161_sc-1036879.jpg,0,1,3,1,5,,train
0565164_sc-1036879.jpg,0,1,0,0,1,,train
0565165_sc-1036879.jpg,2,3,0,0,5,,train
0565166_sc-1036879.jpg,1,1,0,3,5,,val
0565168_as-0001179.jpg,1,0,0,0,1,,val
0565170_as-0001988.jpg,3,0,0,0,3,,test
0565174_as-0070551.jpg,1,2,1,1,5,,train
0565175_as-0070551.jpg,1,0,1,0,2,,train
0565177_as-0010016.jpg,6,1,1,1,9,,train
0565178_as-0010016.jpg,4,1,1,2,8,,train
0565181_as-0010016.jpg,4,1,1,1,7,,train
0565182_as-0010016.jpg,2,0,0,0,2,,train
0565183_sc-1036556.jpg,1,0,0,2,3,,train
0565184_as-2663293.jpg,2,0,2,0,4,,val
0565185_sc-117284.jpg,6,0,0,0,6,,val
0565186_sc-117284.jpg,2,0,0,0,2,,test
0565187_sc-117284.jpg,7,0,0,0,7,,train
0565189_sc-177799.jpg,3,1,0,1,5,,train
0565190_as-0059303.jpg,1,0,0,1,2,,train
0565191_as-0059303.jpg,1,0,0,0,1,,train
0565193_as-0059303.jpg,2,0,0,0,2,,train
0565195_as-0059303.jpg,1,0,0,0,1,,train
0565196_as-0064520.jpg,1,0,0,0,1,,train
0565199_as-0064520.jpg,1,0,0,0,1,,val
0565200_as-0064520.jpg,1,0,0,0,1,,val
0565202_sc-128392.jpg,2,0,0,0,2,,test
0565203_as-0072901.jpg,1,0,0,0,1,,train
0565204_as-0072901.jpg,1,0,0,0,1,,train
0565205_as-0053722.jpg,2,0,0,1,3,,train
0565206_as-0053722.jpg,3,0,0,0,3,,train
0565207_as-0053722.jpg,9,0,0,0,9,,train
0565208_as-0053722.jpg,2,0,0,0,2,,train
0565209_as-0053722.jpg,2,0,0,0,2,,train
0565210_as-7085667.jpg,2,0,0,0,2,,val
0565211_sc-183511.jpg,0,0,1,0,1,,val
0565212_sc-183511.jpg,0,0,1,0,1,,test
0565213_sc-183511.jpg,1,0,2,1,4,,train
0565214_sc-183511.jpg,3,0,1,2,6,,train
0565215_sc-183511.jpg,3,0,0,0,3,,train
0565216_sc-183511.jpg,3,0,1,4,8,,train
0565217_sc-183511.jpg,1,0,1,0,2,,train
0565218_sc-183511.jpg,5,0,0,0,5,,train
0565219_sc-215216.jpg,0,1,2,3,6,,train
0565220_sc-215216.jpg,0,1,4,2,7,,val
0565221_sc-215216.jpg,0,1,2,1,4,,val
0565223_as-0041127.jpg,2,0,0,0,2,,test
0565224_as-0041127.jpg,2,0,0,0,2,,train
0565225_as-0041127.jpg,1,0,1,0,2,,train
0565226_as-0041127.jpg,1,0,1,0,2,,train
0565227_as-0041127.jpg,1,0,1,0,2,,train
0565228_sc-197922.jpg,2,0,0,0,2,,train
0565229_as-7710254.jpg,1,0,0,0,1,,train
0565232_sc-175986.jpg,1,0,0,0,1,,train
0565233_sc-175986.jpg,1,0,0,0,1,,val
0565236_sc-135687.jpg,1,0,0,0,1,,val
0565237_as-7096292.jpg,3,2,2,0,7,,test
0565239_sc-113591.jpg,2,0,0,0,2,,train
0565240_sc-113591.jpg,1,0,0,0,1,,train
0565241_sc-113591.jpg,2,0,0,0,2,,train
0565242_sc-130052.jpg,3,0,0,1,4,,train
0565243_as-2799740.jpg,5,0,2,1,8,,train
0565244_as-2657608.jpg,2,0,0,0,2,,train
0565245_sc-156145.jpg,4,1,0,0,5,,train
0565246_as-3424729.jpg,3,0,0,0,3,,val
0565247_as-3337588.jpg,1,0,0,0,1,,val
0565248_sc-138235.jpg,1,0,0,0,1,,test
0565249_sc-138235.jpg,1,0,1,1,3,,train
0565250_sc-138235.jpg,1,0,0,2,3,,train
0565251_as-7724541.jpg,2,3,0,0,5,,train
0565253_as-0018415.jpg,1,0,0,0,1,,train
0565254_as-2701113.jpg,1,0,0,0,1,,train
0565255_as-7471862.jpg,2,0,0,0,2,,train
0565257_sc-128745.jpg,1,0,0,0,1,,train
0565258_sc-185830.jpg,2,0,0,3,5,,val
0565259_sc-185830.jpg,2,0,0,3,5,,val
0565260_sc-185830.jpg,3,0,0,3,6,,test
0565261_sc-139968.jpg,5,0,0,0,5,,train
0565262_sc-139968.jpg,9,0,0,0,9,,train
0565263_sc-139968.jpg,2,0,0,0,2,,train
0565265_sc-139968.jpg,2,0,0,0,2,,train
0565266_sc-190726.jpg,4,0,0,1,5,,train
0565267_sc-190726.jpg,2,0,0,2,4,,train
0565270_sc-190726.jpg,2,0,1,1,4,,train
0565271_sc-221024.jpg,1,0,0,0,1,,val
0565272_sc-221024.jpg,2,0,0,1,3,,val
0565274_sc-221024.jpg,2,0,0,0,2,,test
0565275_sc-221024.jpg,1,0,0,0,1,,train
0565276_sc-221024.jpg,1,0,0,0,1,,train
0565278_sc-115444.jpg,1,0,0,1,2,,train
0565279_as-9091510.jpg,2,0,0,0,2,,train
0565280_as-7661475.jpg,0,1,0,0,1,,train
0565281_as-2897195.jpg,0,0,1,0,1,,train
0565282_as-0045372.jpg,1,0,0,0,1,,train
0565283_as-0045372.jpg,3,0,0,0,3,,val
0565284_as-0045372.jpg,3,1,0,0,4,,val
0565285_as-0045372.jpg,2,0,0,0,2,,test
0565286_sc-207966.jpg,4,0,0,0,4,,train
0565289_sc-207966.jpg,3,0,0,0,3,,train
0565290_sc-162944.jpg,2,0,0,1,3,,train
0565292_sc-162944.jpg,1,0,0,1,2,,train
0565293_sc-162944.jpg,1,0,0,1,2,,train
0565294_as-7601705.jpg,5,0,3,1,9,,train
0565295_as-2727199.jpg,1,0,0,1,2,,train
0565298_sc-167098.jpg,4,0,0,0,4,,val
0565299_sc-167098.jpg,3,0,1,0,4,,val
0565300_sc-167098.jpg,2,0,1,0,3,,test
0565301_sc-167098.jpg,1,0,1,0,2,,train
0565302_sc-167098.jpg,2,0,1,0,3,,train
0565303_sc-167098.jpg,1,0,1,0,2,,train
0565305_as-7904252.jpg,1,0,0,1,2,,train
0565306_sc-103941.jpg,6,0,1,1,8,,train
0565307_sc-103941.jpg,9,0,1,1,11,,train
0565308_sc-103941.jpg,0,2,0,0,2,,train
0565309_sc-103941.jpg,4,2,0,0,6,,val
0565311_sc-157291.jpg,3,1,0,0,4,,val
0565314_sc-157291.jpg,0,1,0,0,1,,test
0565316_sc-157291.jpg,2,1,0,0,3,,train
0565320_as-0002495.jpg,4,0,0,0,4,,train
0565322_as-3408804.jpg,3,2,1,1,7,,train
0565324_sc-119595.jpg,5,2,2,1,10,,train
0565325_sc-119595.jpg,1,0,0,0,1,,train
0565326_sc-119595.jpg,2,0,0,0,2,,train
0565327_sc-119595.jpg,2,0,1,0,3,,train
0565328_sc-119595.jpg,3,1,1,1,6,,val
0565329_sc-119595.jpg,3,1,1,0,5,,val
0565330_sc-119595.jpg,7,1,3,0,11,,test
0565331_as-3117907.jpg,4,1,0,0,5,,train
0565332_sc-1019045.jpg,2,0,0,1,3,,train
0565333_as-2917282.jpg,1,0,1,1,3,,train
0565334_as-2932390.jpg,3,0,0,0,3,,train
0565335_sc-1041455.jpg,3,0,0,0,3,,train
0565336_sc-1041455.jpg,3,0,0,0,3,,train
0565339_as-3482698.jpg,5,1,0,1,7,,train
0565340_as-2848238.jpg,1,0,1,0,2,,val
0565341_sc-1028243.jpg,3,0,0,0,3,,val
0565342_sc-1028243.jpg,2,0,0,1,3,,test
0565344_sc-1028243.jpg,3,0,0,1,4,,train
0565345_sc-1028243.jpg,3,0,0,0,3,,train
0565346_sc-1028243.jpg,2,0,0,0,2,,train
0565349_as-7484532.jpg,1,0,0,1,2,,train
0565350_as-0006583.jpg,1,0,0,0,1,,train
0565354_as-0006583.jpg,1,0,0,0,1,,train
0565355_as-2722298.jpg,7,0,0,0,7,,train
0565356_sc-163863.jpg,2,0,0,0,2,,val
0565357_sc-163863.jpg,1,0,0,0,1,,val
0565359_as-7112903.jpg,1,0,0,0,1,,test
0565360_as-9092629.jpg,0,0,2,0,2,,train
0565361_as-3150193.jpg,4,1,1,1,7,,train
0565362_sc-151837.jpg,7,0,0,0,7,,train
0565365_as-2580902.jpg,1,0,0,0,1,,train
0565366_as-3324458.jpg,1,0,0,0,1,,train
0565367_sc-182487.jpg,1,0,0,1,2,,train
0565368_sc-182487.jpg,1,0,0,1,2,,train
0565369_as-9014658.jpg,3,0,0,0,3,,val
0565370_as-3392229.jpg,1,0,0,0,1,,val
0565371_as-3392229.jpg,0,0,0,1,1,,test
0565372_sc-109095.jpg,2,0,0,0,2,,train
0565373_sc-109095.jpg,4,0,0,0,4,,train
0565374_as-9040287.jpg,1,0,1,1,3,,train
0565375_as-9040287.jpg,1,0,1,0,2,,train
0565376_as-0043069.jpg,1,0,0,0,1,,train
0565377_as-0043069.jpg,1,1,0,0,2,,train
0565378_as-3275834.jpg,2,0,0,0,2,,train
0565379_sc-140108.jpg,1,0,0,1,2,,val
0565380_sc-140108.jpg,2,0,0,1,3,,val
0565381_sc-140108.jpg,6,0,0,1,7,,test
0565382_sc-211429.jpg,5,2,1,0,8,,train
0565383_sc-211429.jpg,3,0,0,0,3,,train
0565384_sc-1006953.jpg,0,1,0,0,1,,train
0565385_sc-1021688.jpg,1,0,0,0,1,,train
0565386_sc-173880.jpg,1,0,0,0,1,,train
0565387_as-0001463.jpg,0,0,1,0,1,,train
0565388_as-9009916.jpg,1,2,2,5,10,,train
0565390_as-0026362.jpg,1,0,1,0,2,,val
0565391_sc-174268.jpg,1,0,1,0,2,,val
0565392_sc-108051.jpg,1,0,0,0,1,,test
0565393_sc-1018308.jpg,1,0,1,1,3,,train
0565395_sc-1018308.jpg,7,0,0,0,7,,train
0565396_sc-1018308.jpg,3,0,0,1,4,,train
0565397_sc-1024307.jpg,1,0,0,0,1,,train
0565398_sc-1024307.jpg,1,0,0,0,1,,train
0565399_sc-1024307.jpg,1,0,0,0,1,,train
0565400_sc-1024307.jpg,1,0,0,0,1,,train
0565401_sc-1024307.jpg,1,0,0,0,1,,val
0565402_sc-105270.jpg,2,1,0,1,4,,val
0565403_sc-105270.jpg,1,1,0,1,3,,test
0565404_sc-1015700.jpg,2,1,0,0,3,,train
0565405_sc-1015700.jpg,0,1,1,0,2,,train
0565406_sc-1015700.jpg,1,0,2,0,3,,train
0565407_sc-1015700.jpg,1,0,3,0,4,,train
0565410_sc-1015700.jpg,0,0,1,0,1,,train
0565412_sc-120966.jpg,2,0,1,0,3,,train
0565413_sc-120966.jpg,2,0,0,0,2,,train
0565414_sc-120966.jpg,2,0,0,0,2,,val
0565415_sc-120966.jpg,2,0,0,0,2,,val
0565416_sc-120966.jpg,1,0,0,0,1,,test
0565417_sc-120966.jpg,0,0,1,0,1,,train
0565418_sc-204597.jpg,2,0,1,0,3,,train
0565419_sc-204597.jpg,1,0,1,0,2,,train
0565420_sc-229233.jpg,3,0,0,0,3,,train
0565421_as-0030101.jpg,1,0,0,0,1,,train
0565422_as-0030101.jpg,1,0,0,0,1,,train
0565423_as-0030101.jpg,1,0,0,0,1,,train
0565424_as-0030101.jpg,2,0,0,0,2,,val
0565425_as-0030101.jpg,1,0,0,0,1,,val
0565427_as-0084418.jpg,0,1,1,1,3,,test
0565428_as-0084418.jpg,1,1,1,1,4,,train
0565429_as-0084418.jpg,1,1,1,1,4,,train
0565430_as-0084418.jpg,1,0,0,0,1,,train
0565431_as-0084418.jpg,1,0,0,0,1,,train
0565432_as-0084418.jpg,1,0,0,0,1,,train
0565433_as-0084418.jpg,1,0,2,3,6,,train
0565434_as-0084418.jpg,1,0,1,1,3,,train
0565435_as-0084418.jpg,1,0,2,1,4,,val
0565436_as-0084418.jpg,3,0,0,0,3,,val
0565437_as-0084418.jpg,1,0,0,0,1,,test
0565438_as-0084418.jpg,1,1,1,0,3,,train
0565439_as-0084418.jpg,1,1,1,0,3,,train
0565440_as-0084418.jpg,1,0,0,0,1,,train
0565441_as-3079872.jpg,0,0,1,0,1,,train
0565443_sc-140516.jpg,2,0,0,1,3,,train
0565444_sc-140516.jpg,3,0,0,1,4,,train
0565445_sc-140516.jpg,3,0,0,1,4,,train
0565446_sc-115272.jpg,2,2,0,1,5,,val
0565447_sc-115272.jpg,2,0,0,1,3,,val
0565448_sc-115272.jpg,0,0,1,0,1,,test
0565449_sc-115272.jpg,1,0,1,1,3,,train
0565450_sc-115272.jpg,0,0,0,1,1,,train
0565451_sc-115272.jpg,1,0,0,0,1,,train
0565452_sc-115272.jpg,1,0,0,1,2,,train
0565453_sc-115272.jpg,2,0,0,0,2,,train
0565456_as-0044692.jpg,0,0,1,2,3,,train
0565458_sc-111876.jpg,2,0,1,0,3,,train
0565459_sc-111876.jpg,2,0,1,1,4,,val
0565460_sc-111876.jpg,1,0,0,0,1,,val
0565461_sc-111876.jpg,1,0,0,0,1,,test
0565462_sc-111876.jpg,2,0,1,0,3,,train
0565463_sc-111876.jpg,2,0,1,1,4,,train
0565464_sc-111876.jpg,3,0,1,0,4,,train
0565465_sc-139079.jpg,1,0,1,0,2,,train
0565466_sc-139079.jpg,1,0,1,0,2,,train
0565467_as-3200645.jpg,1,1,1,0,3,,train
0565468_sc-186325.jpg,3,1,1,1,6,,train
0565470_as-7240193.jpg,1,1,1,0,3,,val
0565472_as-0015135.jpg,2,0,0,0,2,,val
0565473_as-0015135.jpg,3,2,0,0,5,,test
0565474_as-0015135.jpg,2,1,0,1,4,,train
0565475_as-0015135.jpg,4,0,0,0,4,,train
0565476_as-0015135.jpg,1,0,0,1,2,,train
0565477_as-0015135.jpg,1,0,0,0,1,,train
0565478_sc-132065.jpg,1,0,0,2,3,,train
0565479_sc-132065.jpg,1,0,0,2,3,,train
0565480_sc-225045.jpg,1,0,0,0,1,,train
0565481_sc-225045.jpg,2,0,0,0,2,,val
0565482_sc-225045.jpg,1,0,0,0,1,,val
0565483_sc-225045.jpg,1,0,0,0,1,,test
0565484_sc-225045.jpg,1,0,0,0,1,,train
0565485_sc-225045.jpg,2,0,0,0,2,,train
0565486_sc-225045.jpg,1,0,0,0,1,,train
0565487_sc-1029368.jpg,1,1,0,0,2,,train
0565488_sc-125620.jpg,3,1,0,1,5,,train
0565489_sc-125620.jpg,3,0,0,1,4,,train
0565490_sc-125620.jpg,2,1,0,1,4,,train
0565491_sc-221969.jpg,1,1,1,0,3,,val
0565492_as-3486246.jpg,2,0,1,0,3,,val
0565493_as-0022878.jpg,1,0,0,0,1,,test
0565494_sc-143007.jpg,1,0,0,1,2,,train
0565495_sc-143007.jpg,2,0,0,0,2,,train
0565496_sc-143007.jpg,1,0,0,1,2,,train
0565499_as-0005311.jpg,1,0,0,0,1,,train
0565501_sc-229289.jpg,2,0,1,0,3,,train
0565502_sc-1039508.jpg,2,0,1,0,3,,train
0565503_sc-1039508.jpg,1,2,0,0,3,,train
0565506_sc-1023373.jpg,1,0,0,0,1,,val
0565507_as-2679785.jpg,3,0,0,0,3,,val
0565509_sc-114251.jpg,2,0,0,0,2,,test
0565510_sc-114251.jpg,1,0,0,0,1,,train
0565511_sc-114251.jpg,1,0,0,0,1,,train
0565512_sc-114251.jpg,1,0,0,0,1,,train
0565513_as-0001011.jpg,3,0,0,0,3,,train
0565514_as-0001011.jpg,2,0,0,0,2,,train
0565515_as-2722772.jpg,2,0,0,0,2,,train
0565516_sc-135736.jpg,5,0,0,0,5,,train
0565517_sc-135736.jpg,1,0,0,1,2,,val
0565518_sc-135736.jpg,2,0,0,0,2,,val
0565519_sc-135736.jpg,1,0,0,0,1,,test
0565520_sc-135736.jpg,1,0,0,1,2,,train
0565521_sc-135736.jpg,2,0,0,0,2,,train
0565522_as-3281699.jpg,0,1,0,0,1,,train
0565526_sc-172264.jpg,1,0,0,0,1,,train
0565528_sc-106982.jpg,0,1,0,0,1,,train
0565533_sc-169795.jpg,3,0,0,0,3,,train
0565534_sc-169795.jpg,3,0,1,0,4,,train
0565537_sc-150669.jpg,3,0,0,0,3,,val
0565538_sc-150669.jpg,2,0,0,0,2,,val
0565539_sc-150669.jpg,5,0,0,0,5,,test
0565541_as-0058249.jpg,2,2,0,0,4,,train
0565542_as-0062419.jpg,4,0,0,0,4,,train
0565543_as-0062419.jpg,5,0,0,0,5,,train
0565545_as-0062419.jpg,6,0,0,0,6,,train
0565546_as-0062419.jpg,1,0,0,0,1,,train
0565548_as-3078326.jpg,2,1,1,1,5,,train
0565555_as-2722480.jpg,1,0,1,1,3,,train
0565556_sc-186790.jpg,1,0,1,1,3,,val
0565557_sc-186790.jpg,2,0,1,1,4,,val
0565558_sc-186790.jpg,1,0,1,0,2,,test
0565559_sc-186790.jpg,2,0,0,0,2,,train
0565560_sc-186790.jpg,0,0,2,1,3,,train
0565561_sc-186790.jpg,1,0,1,1,3,,train
0565562_as-0063628.jpg,3,0,0,1,4,,train
0565563_as-0063628.jpg,8,0,0,2,10,,train
0565564_sc-226247.jpg,1,0,2,0,3,,train
0565565_sc-226247.jpg,1,0,1,0,2,,train
0565566_sc-224461.jpg,1,0,1,0,2,,val
0565567_sc-224461.jpg,1,0,1,0,2,,val
0565568_sc-224461.jpg,1,0,1,0,2,,test
0565569_sc-224461.jpg,3,0,1,0,4,,train
0565570_sc-224461.jpg,2,0,0,0,2,,train
0565571_sc-224461.jpg,5,0,0,0,5,,train
0565572_sc-224461.jpg,5,0,0,0,5,,train
0565573_as-9042269.jpg,1,0,0,0,1,,train
0565574_as-0022782.jpg,3,1,0,0,4,,train
0565575_as-0022782.jpg,2,1,0,0,3,,train
0565576_sc-1028047.jpg,1,0,1,0,2,,val
0565577_sc-1028047.jpg,2,0,0,0,2,,val
0565578_sc-1028047.jpg,1,0,1,0,2,,test
0565579_sc-1028047.jpg,5,0,0,0,5,,train
0565581_sc-107538.jpg,2,0,1,0,3,,train
0565582_as-2553501.jpg,1,0,0,0,1,,train
0565583_as-2877609.jpg,0,1,1,0,2,,train
0565586_sc-211619.jpg,3,0,2,0,5,,train
0565587_sc-211619.jpg,0,0,2,0,2,,train
0565588_sc-211619.jpg,3,0,1,0,4,,train
0565590_sc-1031048.jpg,2,0,0,1,3,,val
0565591_as-0015955.jpg,1,0,0,0,1,,val
0565592_as-0015955.jpg,2,0,0,1,3,,test
0565593_as-0015955.jpg,2,0,0,0,2,,train
0565594_as-0015955.jpg,1,0,0,0,1,,train
0565595_as-0015955.jpg,1,0,0,0,1,,train
0565596_as-2821699.jpg,4,0,1,1,6,,train
0565598_sc-203664.jpg,7,0,0,1,8,,train
0565601_as-0020972.jpg,2,0,0,0,2,,train
0565602_as-0020972.jpg,1,0,1,0,2,,train
0565603_as-0020972.jpg,1,0,1,0,2,,val
0565605_as-0092701.jpg,3,0,2,2,7,,val
0565606_as-0092701.jpg,1,0,1,2,4,,test
0565607_sc-1013954.jpg,3,0,1,0,4,,train
0565608_sc-1013954.jpg,1,0,0,0,1,,train
0565609_sc-1013954.jpg,2,0,0,0,2,,train
0565610_as-0045402.jpg,1,1,2,0,4,,train
0565611_as-0045402.jpg,1,0,1,1,3,,train
0565613_as-0045402.jpg,0,0,1,0,1,,train
0565614_as-0045402.jpg,0,1,0,0,1,,train
0565615_as-0045402.jpg,1,0,0,0,1,,val
0565616_as-0045402.jpg,1,0,0,0,1,,val
0565617_as-0045402.jpg,1,0,0,0,1,,test
0565618_as-0045402.jpg,2,0,0,1,3,,train
0565619_as-7219249.jpg,0,1,0,0,1,,train
0565620_sc-184747.jpg,1,1,0,0,2,,train
0565621_sc-1019009.jpg,1,0,0,1,2,,train
0565622_sc-1019009.jpg,1,0,0,1,2,,train
0565623_sc-1019009.jpg,2,0,1,1,4,,train
0565624_sc-199460.jpg,6,0,0,0,6,,train
0565625_sc-199460.jpg,1,0,0,0,1,,val
0565626_sc-199460.jpg,1,0,0,0,1,,val
0565627_sc-199460.jpg,1,0,0,0,1,,test
0565628_as-0010677.jpg,3,0,0,0,3,,train
0565629_sc-114033.jpg,0,1,0,0,1,,train
0565630_sc-114033.jpg,0,0,1,0,1,,train
0565631_sc-114033.jpg,3,0,0,0,3,,train
0565632_as-0068424.jpg,1,0,0,0,1,,train
0565634_sc-130732.jpg,0,1,0,0,1,,train
0565635_sc-130732.jpg,1,1,0,0,2,,train
0565637_sc-228115.jpg,2,0,0,0,2,,val
0565638_sc-228115.jpg,2,0,0,0,2,,val
0565639_sc-1008648.jpg,1,3,2,0,6,,test
0565641_sc-1008648.jpg,1,4,1,1,7,,train
0565642_as-2858528.jpg,1,0,0,0,1,,train
0565644_as-0005185.jpg,4,0,0,0,4,,train
0565645_as-0005185.jpg,3,0,0,0,3,,train
0565646_sc-197472.jpg,3,1,0,0,4,,train
0565647_as-7397275.jpg,1,0,1,0,2,,train
0565648_sc-206570.jpg,1,0,0,0,1,,train
0565649_sc-206570.jpg,2,0,0,0,2,,val
0565650_sc-206570.jpg,2,0,0,0,2,,val
0565651_sc-191523.jpg,2,0,1,1,4,,test
0565652_sc-191523.jpg,6,0,0,0,6,,train
0565653_sc-191523.jpg,1,0,0,0,1,,train
0565654_sc-191523.jpg,1,0,0,0,1,,train
0565655_sc-191523.jpg,2,0,0,0,2,,train
0565657_sc-191523.jpg,0,0,1,0,1,,train
0565658_sc-191523.jpg,6,0,2,1,9,,train
0565659_sc-191523.jpg,1,0,1,0,2,,train
0565660_sc-191523.jpg,0,1,0,0,1,,val
0565662_as-0031029.jpg,1,0,0,0,1,,val
0565663_as-0031029.jpg,1,0,0,0,1,,test
0565664_sc-1037968.jpg,1,0,0,2,3,,train
0565665_sc-1037968.jpg,2,0,0,1,3,,train
0565666_sc-181720.jpg,2,0,0,0,2,,train
0565667_as-0049424.jpg,4,0,1,1,6,,train
0565668_as-0049424.jpg,2,0,1,0,3,,train
0565669_as-0049424.jpg,1,0,1,0,2,,train
0565670_as-0049424.jpg,1,0,0,0,1,,train
0565672_sc-135191.jpg,1,0,0,1,2,,val
0565673_sc-135191.jpg,1,0,1,1,3,,val
0565674_sc-135191.jpg,1,0,0,1,2,,test
0565677_as-0061782.jpg,2,0,1,1,4,,train
0565678_as-0061782.jpg,2,0,2,1,5,,train
0565679_as-0061782.jpg,1,0,2,1,4,,train
0565680_as-0061782.jpg,1,0,2,0,3,,train
0565681_as-0061782.jpg,1,0,1,0,2,,train
0565682_as-0061782.jpg,0,0,1,0,1,,train
0565683_as-0060594.jpg,7,2,0,2,11,,train
0565684_as-0060594.jpg,5,4,0,0,9,,val
0565685_sc-121808.jpg,2,0,0,1,3,,val
0565686_sc-121808.jpg,1,0,0,0,1,,test
0565687_sc-121808.jpg,1,0,0,0,1,,train
0565688_as-3449138.jpg,2,1,0,0,3,,train
0565689_sc-216023.jpg,2,0,0,1,3,,train
0565690_sc-216023.jpg,3,0,0,0,3,,train
0565691_as-9049278.jpg,1,0,0,0,1,,train
0565692_as-5219079.jpg,1,0,0,0,1,,train
0565693_sc-111877.jpg,3,1,2,1,7,,train
0565694_sc-111877.jpg,2,1,1,1,5,,val
0565695_sc-132061.jpg,0,1,0,0,1,,val
0565696_sc-132061.jpg,0,1,0,0,1,,test
0565697_sc-132061.jpg,1,1,0,0,2,,train
0565700_sc-1036681.jpg,9,0,0,1,10,,train
0565701_sc-1036681.jpg,6,0,0,0,6,,train
0565702_sc-1036681.jpg,4,0,0,0,4,,train
0565703_sc-1036681.jpg,6,0,0,0,6,,train
0565705_sc-1036681.jpg,6,0,0,1,7,,train
0565707_as-3480602.jpg,2,0,4,1,7,,train
0565709_as-2725867.jpg,1,0,2,2,5,,val
0565712_as-3157908.jpg,2,0,0,0,2,,val
0565713_as-2712832.jpg,0,2,0,2,4,,test
0565714_sc-135682.jpg,1,1,0,1,3,,train
0565717_as-0078801.jpg,1,1,0,1,3,,train
0565718_as-0078801.jpg,1,1,0,0,2,,train
0565719_as-0078801.jpg,5,0,0,1,6,,train
0565720_as-0078801.jpg,1,0,0,0,1,,train
0565726_sc-1013369.jpg,4,1,0,0,5,,train
0565727_sc-1013369.jpg,4,3,0,0,7,,train
0565728_sc-1013369.jpg,1,1,0,0,2,,val
0565729_sc-1013369.jpg,2,1,0,0,3,,val
0565730_sc-1013369.jpg,7,2,0,0,9,,test
0565731_sc-200500.jpg,2,0,0,0,2,,train
0565732_sc-200500.jpg,2,0,0,0,2,,train
0565733_sc-200500.jpg,3,1,0,0,4,,train
0565734_as-2748900.jpg,0,1,1,0,2,,train
0565735_sc-199291.jpg,3,1,0,0,4,,train
0565736_sc-199291.jpg,0,1,0,0,1,,train
0565737_sc-199291.jpg,1,1,0,0,2,,train
0565738_as-0085982.jpg,2,0,0,0,2,,val
0565739_as-0085982.jpg,1,0,0,0,1,,val
0565740_as-0085982.jpg,2,0,0,0,2,,test
0565741_as-7829300.jpg,2,0,0,1,3,,train
0565745_sc-226882.jpg,2,0,0,0,2,,train
0565746_sc-226882.jpg,0,0,1,0,1,,train
0565748_sc-154391.jpg,6,0,0,0,6,,train
0565749_sc-154391.jpg,1,1,1,0,3,,train
0565750_sc-154391.jpg,1,1,1,0,3,,train
0565751_sc-166971.jpg,2,0,0,0,2,,train
0565752_as-0021968.jpg,1,0,0,0,1,,val
0565753_as-0021968.jpg,1,0,0,0,1,,val
0565754_as-0021968.jpg,2,0,0,0,2,,test
0565758_as-3485195.jpg,1,0,0,0,1,,train
0565759_sc-138831.jpg,1,0,0,0,1,,train
0565760_as-0050459.jpg,1,0,0,0,1,,train
0565761_as-0050459.jpg,1,0,0,0,1,,train
0565762_sc-167838.jpg,1,0,1,1,3,,train
0565764_sc-167838.jpg,1,0,1,1,3,,train
0565765_sc-209765.jpg,0,1,0,0,1,,train
0565766_sc-209765.jpg,1,0,0,0,1,,val
0565767_sc-209765.jpg,1,0,0,0,1,,val
0565768_sc-209765.jpg,1,0,0,0,1,,test
0565769_as-3040577.jpg,2,0,0,0,2,,train
0565770_as-0097170.jpg,1,0,0,0,1,,train
0565771_as-0097170.jpg,2,0,0,0,2,,train
0565772_as-0097170.jpg,2,0,0,0,2,,train
0565773_sc-202688.jpg,7,0,0,1,8,,train
0565775_sc-202688.jpg,1,0,0,1,2,,train
0565776_sc-202688.jpg,3,0,0,1,4,,train
0565777_sc-206109.jpg,4,0,2,0,6,,val
0565778_sc-206109.jpg,3,0,1,0,4,,val
0565779_sc-206109.jpg,1,0,1,2,4,,test
0565780_sc-206109.jpg,1,0,1,1,3,,train
0565781_sc-206109.jpg,4,0,1,2,7,,train
0565782_sc-206109.jpg,3,0,2,3,8,,train
0565783_sc-206109.jpg,3,0,1,2,6,,train
0565784_sc-110897.jpg,7,0,1,1,9,,train
0565785_sc-110897.jpg,7,0,0,0,7,,train
0565786_sc-110897.jpg,4,1,1,1,7,,train
0565787_sc-110897.jpg,7,0,0,1,8,,val
0565789_sc-110897.jpg,2,0,0,0,2,,val
0565791_sc-110897.jpg,1,0,1,1,3,,test
0565793_sc-110897.jpg,8,0,0,0,8,,train
0565795_sc-110897.jpg,8,0,0,0,8,,train
0565796_sc-110897.jpg,7,0,0,0,7,,train
0565797_sc-110897.jpg,8,0,0,2,10,,train
0565798_sc-177454.jpg,3,0,0,0,3,,train
0565799_sc-177454.jpg,3,0,0,0,3,,train
0565800_sc-177454.jpg,3,0,0,0,3,,train
0565802_sc-219380.jpg,5,0,1,0,6,,val
0565803_sc-219380.jpg,4,0,0,0,4,,val
0565804_sc-219380.jpg,3,0,0,0,3,,test
0565805_sc-219380.jpg,1,0,0,0,1,,train
0565807_as-0018843.jpg,1,0,0,0,1,,train
0565808_sc-147616.jpg,6,2,3,0,11,,train
0565809_sc-147616.jpg,1,0,0,0,1,,train
0565810_sc-147616.jpg,1,0,1,0,2,,train
0565814_sc-1021071.jpg,2,0,1,1,4,,train
0565816_as-7756919.jpg,2,0,2,0,4,,train
0565817_sc-165976.jpg,1,0,0,0,1,,val
0565819_as-0084706.jpg,1,0,0,0,1,,val
0565820_as-0084706.jpg,6,0,3,0,9,,test
0565821_sc-158408.jpg,2,0,1,1,4,,train
0565822_sc-158408.jpg,2,0,1,1,4,,train
0565823_as-0024306.jpg,0,1,0,0,1,,train
0565824_as-0024306.jpg,0,1,0,0,1,,train
0565825_sc-148050.jpg,10,0,2,1,13,,train
0565826_sc-148050.jpg,4,0,0,0,4,,train
0565827_sc-148050.jpg,8,0,0,0,8,,train
0565828_sc-148050.jpg,4,1,1,0,6,,val
0565829_as-7509454.jpg,1,0,0,1,2,,val
0565831_as-0054114.jpg,1,0,0,1,2,,test
0565832_as-0054114.jpg,1,0,0,1,2,,train
0565833_as-0054114.jpg,2,0,0,1,3,,train
0565834_sc-1029331.jpg,7,0,0,0,7,,train
0565836_sc-1029331.jpg,2,0,0,0,2,,train
0565837_as-7939559.jpg,2,0,0,0,2,,train
0565838_as-2543625.jpg,1,0,2,0,3,,train
0565839_as-3438423.jpg,0,3,0,2,5,,train
0565842_as-0078241.jpg,4,0,1,1,6,,val
0565843_as-0078241.jpg,12,0,0,0,12,,val
0565848_as-0015476.jpg,0,1,0,1,2,,test
0565849_as-0015476.jpg,0,0,1,0,1,,train
0565850_as-0015476.jpg,0,0,1,0,1,,train
0565851_as-0015476.jpg,0,1,0,0,1,,train
0565853_as-0015476.jpg,1,0,1,0,2,,train
0565855_as-0069097.jpg,1,1,0,1,3,,train
0565857_as-7406713.jpg,2,2,1,1,6,,train
0565858_sc-156677.jpg,0,0,0,1,1,,train
0565859_as-0027943.jpg,2,1,1,1,5,,val
0565860_as-0027943.jpg,1,0,1,0,2,,val
0565861_as-0027943.jpg,1,0,1,1,3,,test
0565862_as-0027943.jpg,1,0,0,1,2,,train
0565863_as-0027943.jpg,2,1,1,0,4,,train
0565864_sc-164287.jpg,1,0,0,1,2,,train
0565865_sc-164287.jpg,2,0,0,1,3,,train
0565866_sc-164287.jpg,2,0,0,1,3,,train
0565867_as-2944311.jpg,0,0,1,0,1,,train
0565868_sc-138105.jpg,3,0,2,1,6,,train
0565870_sc-138105.jpg,2,0,1,1,4,,val
0565871_sc-138105.jpg,2,0,3,1,6,,val
0565872_sc-138105.jpg,1,0,0,1,2,,test
0565873_as-0059349.jpg,2,0,0,1,3,,train
0565879_sc-211189.jpg,0,1,1,0,2,,train
0565880_sc-211189.jpg,0,1,1,0,2,,train
0565881_sc-211189.jpg,0,1,1,0,2,,train
0565882_sc-211189.jpg,1,0,0,1,2,,train
0565883_sc-211189.jpg,2,0,0,3,5,,train
0565884_sc-211189.jpg,2,0,0,3,5,,train
0565885_sc-211189.jpg,1,0,0,1,2,,val
0565886_sc-211189.jpg,2,1,0,2,5,,val
0565887_sc-211189.jpg,2,0,0,0,2,,test
0565888_sc-211189.jpg,1,0,0,0,1,,train
0565889_sc-211189.jpg,1,0,0,0,1,,train
0565890_sc-211189.jpg,1,0,0,1,2,,train
0565891_sc-211189.jpg,0,1,1,0,2,,train
0565892_sc-211189.jpg,1,1,1,0,3,,train
0565893_sc-211189.jpg,4,0,0,2,6,,train
0565894_sc-211189.jpg,4,1,1,1,7,,train
0565895_sc-211189.jpg,1,0,0,1,2,,val
0565896_sc-211189.jpg,1,0,1,1,3,,val
0565897_sc-211189.jpg,1,0,0,0,1,,test
0565898_sc-211189.jpg,1,0,0,1,2,,train
0565899_sc-211189.jpg,1,0,0,1,2,,train
0565900_as-2542765.jpg,3,0,0,1,4,,train
0565901_as-3389708.jpg,1,0,0,0,1,,train
0565902_sc-1028298.jpg,1,0,0,0,1,,train
0565904_sc-1028298.jpg,5,0,0,0,5,,train
0565905_sc-1028298.jpg,6,0,0,0,6,,train
0565906_as-0041436.jpg,2,4,3,1,10,,val
0565908_as-0041436.jpg,2,0,2,1,5,,val
0565909_as-0041436.jpg,1,2,0,0,3,,test
0565910_as-0041436.jpg,0,2,2,0,4,,train
0565911_as-0041436.jpg,0,2,2,0,4,,train
0565912_as-0041436.jpg,0,0,2,0,2,,train
0565913_as-3304484.jpg,3,0,0,0,3,,train
0565914_as-3224711.jpg,1,0,0,0,1,,train
0565915_as-7458706.jpg,1,0,0,1,2,,train
0565916_as-2780981.jpg,5,1,0,0,6,,train
0565918_as-0018934.jpg,0,1,0,0,1,,val
0565920_as-3068488.jpg,0,5,2,1,8,,val
0565921_sc-213285.jpg,1,0,0,1,2,,test
0565922_sc-154490.jpg,1,3,0,0,4,,train
0565923_sc-207522.jpg,0,1,0,0,1,,train
0565924_sc-207522.jpg,0,2,0,0,2,,train
0565925_as-0061840.jpg,3,0,1,0,4,,train
0565928_sc-1032006.jpg,7,0,0,0,7,,train
0565930_sc-129888.jpg,1,0,0,0,1,,train
0565931_sc-129888.jpg,3,0,0,0,3,,train
0565933_sc-129888.jpg,1,0,0,0,1,,val
0565934_sc-129888.jpg,2,0,0,0,2,,val
0565935_sc-129888.jpg,3,0,0,0,3,,test
0565936_sc-118935.jpg,3,0,0,0,3,,train
0565937_sc-118935.jpg,1,0,1,0,2,,train
0565938_sc-1009877.jpg,2,0,0,0,2,,train
0565939_as-7084102.jpg,2,0,2,2,6,,train
0565942_sc-1006952.jpg,1,0,0,0,1,,train
0565943_sc-1006952.jpg,1,0,1,1,3,,train
0565944_sc-1006952.jpg,2,0,0,0,2,,train
0565945_sc-1006952.jpg,2,0,0,0,2,,val
0565947_sc-1006952.jpg,2,0,0,0,2,,val
0565948_sc-1006952.jpg,3,0,1,1,5,,test
0565950_as-0056754.jpg,1,0,0,0,1,,train
0565951_as-0056754.jpg,1,0,0,0,1,,train
0565952_as-0056754.jpg,1,0,0,0,1,,train
0565953_as-0056754.jpg,1,0,0,0,1,,train
0565954_as-0056754.jpg,2,0,0,0,2,,train
0565956_sc-161985.jpg,6,0,0,0,6,,train
0565957_sc-161985.jpg,6,0,0,1,7,,train
0565958_sc-161985.jpg,3,0,0,0,3,,val
0565959_sc-161985.jpg,1,0,0,0,1,,val
0565960_sc-161985.jpg,2,0,0,0,2,,test
0565961_sc-161985.jpg,2,0,0,0,2,,train
0565962_as-2615145.jpg,1,0,0,0,1,,train
0565964_as-3003833.jpg,2,0,0,0,2,,train
0565965_as-3050818.jpg,1,0,0,0,1,,train
0565966_sc-181601.jpg,3,0,0,0,3,,train
0565967_as-0045447.jpg,4,0,0,0,4,,train
0565968_as-0045447.jpg,8,0,0,0,8,,train
0565969_as-0045447.jpg,4,0,0,0,4,,val
0565970_as-0045447.jpg,5,0,0,0,5,,val
0565971_as-0045447.jpg,8,0,0,0,8,,test
0565972_sc-111558.jpg,2,0,0,2,4,,train
0565973_sc-198563.jpg,1,0,0,0,1,,train
0565974_sc-198563.jpg,1,0,0,0,1,,train
0565975_sc-198563.jpg,1,0,1,0,2,,train
0565976_sc-198563.jpg,0,1,0,0,1,,train
0565977_sc-198563.jpg,0,1,0,0,1,,train
0565978_sc-198563.jpg,3,0,1,0,4,,train
0565979_sc-198563.jpg,1,0,1,0,2,,val
0565984_as-0091638.jpg,2,0,0,0,2,,val
0565985_as-0091638.jpg,3,0,0,0,3,,test
0565986_as-0091638.jpg,3,0,0,0,3,,train
0565987_as-0091638.jpg,3,0,0,0,3,,train
0565988_as-0091638.jpg,0,0,1,0,1,,train
0565989_as-0091638.jpg,0,0,1,0,1,,train
0565990_as-0091638.jpg,0,0,1,0,1,,train
0565991_as-0091638.jpg,0,0,1,0,1,,train
0565992_as-3290291.jpg,1,0,1,0,2,,train
0565993_as-0027621.jpg,0,0,1,0,1,,val
0565994_as-0027621.jpg,2,0,1,0,3,,val
0565995_sc-1016214.jpg,4,0,0,0,4,,test
0565998_sc-102972.jpg,1,0,0,0,1,,train
0565999_sc-102972.jpg,2,0,0,1,3,,train
0566000_sc-1033270.jpg,6,0,0,0,6,,train
0566001_as-2610624.jpg,2,0,2,1,5,,train
0566002_as-3388974.jpg,2,0,0,1,3,,train
0566003_as-0060904.jpg,6,0,0,0,6,,train
0566005_as-0060904.jpg,5,0,0,1,6,,train
0566006_as-0060904.jpg,1,0,0,0,1,,val
0566007_as-0060904.jpg,7,0,0,1,8,,val
0566008_as-0060904.jpg,4,0,0,0,4,,test
0566009_as-0060904.jpg,4,0,0,1,5,,train
0566010_as-3339662.jpg,1,0,0,0,1,,train
0566011_as-0031906.jpg,0,0,1,0,1,,train
0566012_as-0031906.jpg,1,1,1,0,3,,train
0566013_as-0031906.jpg,1,1,1,0,3,,train
0566014_as-0031906.jpg,1,0,1,0,2,,train
0566016_as-7831271.jpg,2,2,0,1,5,,train
0566017_sc-148032.jpg,6,0,0,1,7,,val
0566019_sc-148032.jpg,11,0,0,1,12,,val
0566020_sc-148032.jpg,5,0,0,0,5,,test
0566021_sc-148032.jpg,3,0,0,0,3,,train
0566022_sc-148032.jpg,9,1,0,1,11,,train
0566023_as-2717936.jpg,0,1,0,0,1,,train
0566024_as-7498827.jpg,1,0,0,0,1,,train
0566025_sc-212713.jpg,1,0,0,0,1,,train
0566027_sc-133221.jpg,2,0,0,0,2,,train
0566028_sc-133221.jpg,2,0,0,0,2,,train
0566029_sc-133221.jpg,0,0,1,0,1,,val
0566030_sc-133221.jpg,3,0,0,0,3,,val
0566031_sc-1033613.jpg,2,0,0,0,2,,test
0566033_sc-1033613.jpg,4,0,1,0,5,,train
0566034_sc-1033613.jpg,1,0,0,1,2,,train
0566035_sc-170605.jpg,0,0,1,0,1,,train
0566036_sc-170605.jpg,5,2,1,0,8,,train
0566038_sc-170605.jpg,6,1,0,0,7,,train
0566040_sc-170605.jpg,2,0,0,0,2,,train
0566041_sc-170605.jpg,3,0,0,1,4,,train
0566042_sc-170605.jpg,3,0,0,1,4,,val
0566043_sc-170605.jpg,1,0,1,0,2,,val
0566045_sc-170605.jpg,5,0,0,0,5,,test
0566046_sc-170605.jpg,1,0,1,0,2,,train
0566047_sc-170605.jpg,1,0,1,0,2,,train
0566050_sc-170605.jpg,2,0,1,0,3,,train
0566051_sc-204630.jpg,2,0,0,0,2,,train
0566053_sc-204630.jpg,2,0,0,0,2,,train
0566054_sc-204630.jpg,2,0,0,0,2,,train
0566055_sc-204630.jpg,4,0,1,1,6,,train
0566056_sc-204630.jpg,2,0,0,1,3,,val
0566057_sc-204630.jpg,2,0,0,1,3,,val
0566058_sc-204630.jpg,5,0,0,0,5,,test
0566059_sc-204630.jpg,4,0,0,0,4,,train
0566060_sc-204630.jpg,1,0,0,1,2,,train
0566061_sc-204630.jpg,1,0,0,1,2,,train
0566064_sc-1020136.jpg,1,0,0,0,1,,train
0566065_as-7650531.jpg,2,0,0,0,2,,train
0566066_as-7783152.jpg,1,0,0,0,1,,train
0566067_sc-163087.jpg,1,0,0,0,1,,train
0566068_sc-163087.jpg,1,0,0,0,1,,val
0566069_sc-163087.jpg,1,0,0,0,1,,val
0566070_sc-163087.jpg,1,0,0,0,1,,test
0566072_sc-163087.jpg,1,0,0,0,1,,train
0566073_sc-163087.jpg,3,0,0,0,3,,train
0566075_as-9044767.jpg,4,0,0,1,5,,train
0566077_as-0014178.jpg,1,0,1,0,2,,train
0566078_as-0014178.jpg,1,0,1,0,2,,train
0566079_as-0014178.jpg,1,0,1,0,2,,train
0566080_as-0014178.jpg,2,0,1,0,3,,train
0566081_as-0014178.jpg,0,0,1,0,1,,val
0566082_as-0014178.jpg,0,0,1,0,1,,val
0566083_as-0045152.jpg,1,0,1,1,3,,test
0566084_as-0045152.jpg,1,0,1,1,3,,train
0566085_sc-178550.jpg,5,0,0,1,6,,train
0566086_as-3332464.jpg,2,0,0,0,2,,train
0566087_as-0049619.jpg,7,0,0,0,7,,train
0566088_as-0049619.jpg,9,0,0,0,9,,train
0566089_as-0049619.jpg,6,0,0,0,6,,train
0566091_as-0072828.jpg,6,0,0,0,6,,train
0566092_as-0072828.jpg,1,0,0,1,2,,val
0566093_as-0072828.jpg,1,0,0,1,2,,val
0566094_as-2711131.jpg,0,0,0,2,2,,test
0566095_as-0036608.jpg,1,0,0,0,1,,train
0566096_as-0036608.jpg,3,0,1,0,4,,train
0566097_as-0036608.jpg,1,0,0,0,1,,train
0566098_as-0036608.jpg,1,0,1,0,2,,train
0566099_as-0036608.jpg,1,0,1,0,2,,train
0566100_as-0036608.jpg,2,0,1,0,3,,train
0566102_sc-128787.jpg,0,0,1,0,1,,train
0566103_sc-128787.jpg,1,0,0,0,1,,val
0566104_sc-128787.jpg,1,0,0,0,1,,val
0566105_sc-128787.jpg,1,0,0,0,1,,test
0566106_as-3008580.jpg,2,0,0,0,2,,train
0566110_as-0091018.jpg,1,0,1,0,2,,train
0566111_as-0091018.jpg,1,2,0,0,3,,train
0566113_as-0091018.jpg,0,0,1,0,1,,train
0566114_sc-193858.jpg,3,1,0,0,4,,train
0566115_sc-193858.jpg,2,0,1,0,3,,train
0566116_sc-193858.jpg,3,0,1,0,4,,train
0566118_sc-193858.jpg,3,0,0,0,3,,val
0566119_sc-193858.jpg,4,0,0,0,4,,val
0566120_sc-193858.jpg,4,1,1,0,6,,test
0566121_sc-193858.jpg,1,1,0,0,2,,train
0566122_sc-193858.jpg,5,0,0,0,5,,train
0566123_sc-193858.jpg,10,0,0,1,11,,train
0566124_as-0091633.jpg,3,1,0,0,4,,train
0566125_as-0091633.jpg,1,1,0,0,2,,train
0566127_as-0091633.jpg,1,1,0,1,3,,train
0566129_sc-1029594.jpg,1,0,1,0,2,,train
0566133_as-0015848.jpg,2,0,1,0,3,,val
0566134_as-0015848.jpg,3,0,1,0,4,,val
0566137_as-0015848.jpg,3,0,1,0,4,,test
0566139_as-0085280.jpg,3,0,0,0,3,,train
0566140_as-0085280.jpg,2,0,0,0,2,,train
0566143_as-0085280.jpg,1,0,0,1,2,,train
0566144_as-0085280.jpg,1,0,0,1,2,,train
0566148_as-3298327.jpg,3,0,0,0,3,,train
0566149_sc-212768.jpg,0,1,0,0,1,,train
0566150_sc-212768.jpg,3,0,1,0,4,,train
0566151_sc-212768.jpg,2,1,0,0,3,,val
0566153_sc-112632.jpg,1,0,1,0,2,,val
0566154_sc-112632.jpg,1,0,1,0,2,,test
0566155_as-9036980.jpg,1,0,0,0,1,,train
0566156_as-0031423.jpg,2,0,0,1,3,,train
0566157_as-0031423.jpg,1,0,0,0,1,,train
0566158_as-0031423.jpg,1,0,0,1,2,,train
0566160_as-0038788.jpg,4,0,1,0,5,,train
0566161_as-0038788.jpg,4,0,0,0,4,,train
0566162_as-0038788.jpg,2,0,0,0,2,,train
0566163_as-0038788.jpg,5,0,0,0,5,,val
0566165_as-0038788.jpg,4,2,1,0,7,,val
0566167_sc-1033413.jpg,0,1,0,0,1,,test
0566168_as-0081339.jpg,3,0,0,0,3,,train
0566169_as-0081339.jpg,4,0,0,0,4,,train
0566170_as-3204878.jpg,1,0,0,0,1,,train
0566171_sc-137468.jpg,1,2,1,0,4,,train
0566172_sc-137468.jpg,5,1,1,1,8,,train
0566174_sc-137468.jpg,2,1,1,1,5,,train
0566175_sc-137468.jpg,2,1,1,1,5,,train
0566177_as-0031832.jpg,1,0,0,1,2,,val
0566178_as-0031832.jpg,4,1,1,0,6,,val
0566179_as-0031832.jpg,1,0,2,0,3,,test
0566180_as-0031832.jpg,0,1,1,0,2,,train
0566181_as-0031832.jpg,3,1,1,0,5,,train
0566182_as-0031832.jpg,2,1,1,0,4,,train
0566184_as-0031832.jpg,1,1,1,2,5,,train
0566185_as-9022210.jpg,2,0,1,0,3,,train
0566186_as-4684073.jpg,0,0,1,1,2,,train
0566187_sc-1025339.jpg,4,0,1,1,6,,train
0566188_sc-1025339.jpg,4,0,1,1,6,,val
0566189_sc-1025339.jpg,2,0,1,0,3,,val
0566190_sc-1025339.jpg,2,0,1,1,4,,test
0566191_sc-1025339.jpg,5,0,1,1,7,,train
0566192_sc-1025339.jpg,3,0,1,1,5,,train
0566193_sc-1025339.jpg,2,0,1,0,3,,train
0566194_sc-1025339.jpg,0,0,1,1,2,,train
0566195_sc-1025339.jpg,4,0,0,0,4,,train
0566196_sc-1025339.jpg,1,0,0,0,1,,train
0566197_sc-1025339.jpg,1,0,0,0,1,,train
0566198_sc-1025339.jpg,0,0,1,1,2,,val
0566199_sc-1025339.jpg,1,0,0,0,1,,val
0566200_sc-208810.jpg,2,0,1,0,3,,test
0566201_as-2597727.jpg,1,1,0,1,3,,train
0566202_as-3369932.jpg,2,0,1,0,3,,train
0566203_sc-203951.jpg,2,1,0,0,3,,train
0566204_sc-149286.jpg,3,0,0,2,5,,train
0566205_as-0035694.jpg,1,0,0,0,1,,train
0566206_as-0035694.jpg,1,0,0,0,1,,train
0566207_as-0035694.jpg,1,0,0,0,1,,train
0566209_as-0035694.jpg,1,1,0,0,2,,val
0566211_sc-146346.jpg,0,1,0,0,1,,val
0566212_as-0035470.jpg,4,0,0,0,4,,test
0566213_as-0035470.jpg,5,0,0,0,5,,train
0566214_as-0035470.jpg,4,0,0,0,4,,train
0566217_sc-178228.jpg,2,0,0,0,2,,train
0566218_sc-178228.jpg,2,0,0,0,2,,train
0566219_sc-178228.jpg,2,0,0,0,2,,train
0566221_sc-178228.jpg,1,0,0,0,1,,train
0566222_sc-178228.jpg,1,0,0,0,1,,train
0566223_sc-178228.jpg,3,0,0,0,3,,val
0566224_sc-178228.jpg,1,0,0,0,1,,val
0566225_as-0048924.jpg,2,0,0,0,2,,test
0566226_as-0048924.jpg,1,1,0,0,2,,train
0566227_as-0048924.jpg,1,0,0,0,1,,train
0566228_as-0048924.jpg,0,1,0,0,1,,train
0566229_as-0048924.jpg,7,0,0,0,7,,train
0566230_as-0048924.jpg,1,1,0,0,2,,train
0566231_as-0048924.jpg,3,0,0,0,3,,train
0566233_as-0006128.jpg,2,0,1,1,4,,train
0566234_sc-192465.jpg,0,1,0,0,1,,val
0566235_sc-192465.jpg,1,0,0,0,1,,val
0566236_sc-192465.jpg,1,0,0,0,1,,test
0566237_sc-192465.jpg,2,0,0,0,2,,train
0566238_sc-192465.jpg,2,0,1,0,3,,train
0566239_sc-192465.jpg,2,0,1,0,3,,train
0566240_sc-192465.jpg,2,0,0,0,2,,train
0566241_sc-122730.jpg,1,0,2,1,4,,train
0566243_sc-122730.jpg,1,0,3,1,5,,train
0566244_sc-122730.jpg,0,0,3,1,4,,train
0566245_sc-122730.jpg,2,0,1,0,3,,val
0566246_as-9092355.jpg,1,2,0,0,3,,val
0566247_as-0054915.jpg,3,0,1,0,4,,test
0566248_as-0072648.jpg,2,0,1,0,3,,train
0566249_as-0072648.jpg,2,0,0,0,2,,train
0566251_as-0029602.jpg,1,0,0,0,1,,train
0566252_as-0029602.jpg,4,0,0,0,4,,train
0566253_as-0029602.jpg,4,0,2,1,7,,train
0566254_as-0029602.jpg,1,0,0,0,1,,train
0566255_as-0029602.jpg,4,0,1,0,5,,train
0566258_as-0029602.jpg,1,0,2,1,4,,val
0566259_as-0029602.jpg,5,0,0,0,5,,val
0566260_as-0029602.jpg,0,0,2,1,3,,test
0566262_as-2759335.jpg,1,0,0,0,1,,train
0566263_as-3226174.jpg,1,1,1,0,3,,train
0566264_as-0030798.jpg,2,0,0,1,3,,train
0566265_sc-173547.jpg,1,1,0,0,2,,train
0566269_sc-153521.jpg,7,1,0,0,8,,train
0566270_sc-153521.jpg,9,1,0,0,10,,train
0566273_sc-153521.jpg,9,1,0,0,10,,train
0566274_sc-153521.jpg,3,2,0,0,5,,val
0566275_sc-153521.jpg,1,0,0,0,1,,val
0566276_as-2611277.jpg,1,0,0,0,1,,test
0566278_sc-173998.jpg,0,0,0,1,1,,train
0566279_sc-173998.jpg,0,0,0,1,1,,train
0566280_sc-173998.jpg,1,0,0,0,1,,train
0566281_as-7763671.jpg,3,0,0,0,3,,train
0566282_sc-201665.jpg,4,1,1,0,6,,train
0566283_sc-201665.jpg,8,1,1,0,10,,train
0566284_as-7135411.jpg,0,0,1,0,1,,train
0566285_as-3417727.jpg,1,0,0,0,1,,val
0566286_as-7851307.jpg,1,1,0,1,3,,val
0566288_as-0020832.jpg,1,1,0,0,2,,test
0566289_as-0043223.jpg,1,3,1,0,5,,train
0566290_as-3306604.jpg,0,0,1,0,1,,train
0566291_as-3492265.jpg,1,0,0,1,2,,train
0566292_sc-208196.jpg,2,1,0,0,3,,train
0566293_sc-213695.jpg,0,1,0,0,1,,train
0566294_as-2626219.jpg,0,0,1,1,2,,train
0566295_sc-105339.jpg,1,0,0,0,1,,train
0566296_sc-105339.jpg,1,0,0,0,1,,val
0566297_sc-105339.jpg,1,0,0,0,1,,val
0566299_as-0073771.jpg,0,0,1,0,1,,test
0566300_sc-228832.jpg,3,2,1,0,6,,train
0566301_as-0092662.jpg,1,0,0,0,1,,train
0566302_as-0092662.jpg,2,0,0,0,2,,train
0566303_as-0092662.jpg,3,0,0,2,5,,train
0566304_as-0092662.jpg,5,0,0,0,5,,train
0566305_as-0092662.jpg,1,0,0,0,1,,train
0566308_as-0092662.jpg,1,0,1,0,2,,train
0566309_as-0092662.jpg,2,0,1,0,3,,val
0566310_as-0092662.jpg,0,0,2,0,2,,val
0566311_as-0092662.jpg,1,1,0,0,2,,test
0566312_as-0092662.jpg,1,2,0,0,3,,train
0566313_as-0092662.jpg,3,0,1,0,4,,train
0566314_as-0092662.jpg,0,3,0,0,3,,train
0566316_sc-105861.jpg,2,1,0,0,3,,train
0566317_sc-105861.jpg,2,1,0,0,3,,train
0566318_sc-105861.jpg,1,1,0,0,2,,train
0566319_as-7983698.jpg,2,1,1,1,5,,train
0566320_sc-139137.jpg,2,0,0,0,2,,val
0566321_sc-139137.jpg,1,0,0,0,1,,val
0566322_sc-139137.jpg,1,0,0,0,1,,test
0566323_sc-139137.jpg,1,0,0,0,1,,train
0566324_sc-174804.jpg,0,1,0,0,1,,train
0566325_as-5356217.jpg,0,1,0,0,1,,train
0566326_as-3036661.jpg,4,0,0,0,4,,train
0566328_sc-1007991.jpg,0,0,1,0,1,,train
0566331_sc-164121.jpg,3,0,2,1,6,,train
0566332_sc-164121.jpg,3,0,1,2,6,,train
0566334_as-2569370.jpg,1,0,0,0,1,,val
0566335_sc-219817.jpg,1,0,0,0,1,,val
0566336_sc-219817.jpg,2,0,0,0,2,,test
0566337_sc-219817.jpg,6,0,0,0,6,,train
0566338_sc-210980.jpg,2,1,1,1,5,,train
0566339_sc-210980.jpg,1,0,2,1,4,,train
0566340_sc-210980.jpg,2,1,2,1,6,,train
0566341_as-0084357.jpg,0,0,1,0,1,,train
0566342_as-0084357.jpg,0,0,1,0,1,,train
0566343_as-0084357.jpg,0,0,1,0,1,,train
0566344_as-0084357.jpg,0,0,1,0,1,,val
0566345_as-0084357.jpg,1,0,0,0,1,,val
0566346_as-2790551.jpg,2,2,2,1,7,,test
0566347_as-7866977.jpg,2,0,1,0,3,,train
0566348_as-7325017.jpg,3,0,0,0,3,,train
0566349_sc-201125.jpg,1,1,0,0,2,,train
0566350_sc-201125.jpg,1,1,0,0,2,,train
0566351_sc-201125.jpg,1,1,0,0,2,,train
0566355_as-0090740.jpg,0,0,2,0,2,,train
0566356_as-0062178.jpg,2,1,1,1,5,,train
0566357_as-0062178.jpg,4,3,2,1,10,,val
0566358_as-0062178.jpg,6,4,3,1,14,,val
0566359_as-0062178.jpg,4,3,2,1,10,,test
0566360_as-0062178.jpg,4,1,2,1,8,,train
0566361_as-0062178.jpg,1,1,0,1,3,,train
0566362_as-0062178.jpg,3,1,2,1,7,,train
0566364_as-2970955.jpg,1,0,0,0,1,,train
0566365_sc-1021075.jpg,2,0,0,0,2,,train
0566366_sc-1021075.jpg,6,0,1,0,7,,train
0566367_sc-1021075.jpg,2,0,1,0,3,,train
0566368_sc-1017737.jpg,1,0,0,0,1,,val
0566370_as-2537905.jpg,1,0,0,0,1,,val
0566371_as-3288376.jpg,0,0,1,0,1,,test
0566372_as-2664137.jpg,1,0,3,2,6,,train
0566373_sc-103403.jpg,1,1,0,0,2,,train
0566374_sc-103403.jpg,2,4,0,0,6,,train
0566376_sc-103403.jpg,1,1,0,0,2,,train
0566378_as-0026851.jpg,1,0,1,1,3,,train
0566379_as-0026851.jpg,1,0,2,1,4,,train
0566380_as-0026851.jpg,4,0,0,0,4,,train
0566381_as-0026851.jpg,9,0,0,0,9,,val
0566382_sc-142764.jpg,0,0,2,0,2,,val
0566384_sc-142764.jpg,1,0,2,0,3,,test
0566385_sc-1026198.jpg,2,0,0,1,3,,train
0566386_sc-1026198.jpg,2,0,1,1,4,,train
0566388_sc-1026198.jpg,5,0,0,1,6,,train
0566389_sc-1026198.jpg,4,0,0,1,5,,train
0566391_as-0022946.jpg,1,0,0,0,1,,train
0566392_as-0022946.jpg,1,0,0,0,1,,train
0566393_as-0022946.jpg,1,0,0,0,1,,train
0566394_as-0022946.jpg,1,0,0,0,1,,val
0566395_as-0022946.jpg,1,0,0,0,1,,val
0566397_sc-1022373.jpg,3,0,1,0,4,,test
0566399_as-0048527.jpg,1,1,1,0,3,,train
0566400_as-0048527.jpg,2,0,1,1,4,,train
0566401_as-0048527.jpg,0,1,1,0,2,,train
0566402_as-3446215.jpg,1,1,0,0,2,,train
0566406_as-0026788.jpg,3,0,2,1,6,,train
0566407_as-0026788.jpg,5,0,0,0,5,,train
0566408_as-0026788.jpg,5,0,0,0,5,,train
0566409_as-0026788.jpg,2,0,0,0,2,,val
0566410_as-2954525.jpg,1,0,2,0,3,,val
0566412_sc-177046.jpg,1,0,0,0,1,,test
0566413_sc-205253.jpg,2,1,0,0,3,,train
0566414_as-0034524.jpg,1,0,0,1,2,,train
0566415_as-0034524.jpg,1,0,0,1,2,,train
0566416_as-0034524.jpg,2,0,0,0,2,,train
0566417_as-0034524.jpg,3,0,0,0,3,,train
0566418_as-0034524.jpg,1,0,0,0,1,,train
0566419_as-0034524.jpg,2,0,0,2,4,,train
0566420_sc-134093.jpg,0,1,2,0,3,,val
0566421_sc-134093.jpg,0,1,1,0,2,,val
0566422_sc-134093.jpg,0,1,1,0,2,,test
0566423_sc-134093.jpg,1,1,0,0,2,,train
0566424_as-0073995.jpg,2,0,0,0,2,,train
0566425_sc-1029446.jpg,2,0,0,0,2,,train
0566426_sc-1029446.jpg,4,1,1,0,6,,train
0566427_sc-1029446.jpg,1,0,0,0,1,,train
0566428_as-3171234.jpg,0,2,0,0,2,,train
0566429_sc-1039779.jpg,3,0,0,0,3,,train
0566430_sc-1039779.jpg,2,0,0,0,2,,val
0566431_sc-121675.jpg,1,0,0,0,1,,val
0566432_as-0033846.jpg,1,0,0,0,1,,test
0566433_as-0033846.jpg,1,0,0,0,1,,train
0566434_as-0033846.jpg,2,0,0,0,2,,train
0566436_sc-126239.jpg,3,2,0,0,5,,train
0566437_sc-126239.jpg,3,2,0,0,5,,train
0566439_as-3194482.jpg,2,0,0,0,2,,train
0566441_sc-164468.jpg,1,0,0,0,1,,train
0566442_sc-164468.jpg,2,0,0,0,2,,train
0566443_as-2851530.jpg,1,0,0,0,1,,val
0566444_as-7404823.jpg,3,0,0,0,3,,val
0566445_sc-192601.jpg,8,2,2,0,12,,test
0566446_sc-192601.jpg,1,1,4,0,6,,train
0566449_sc-193533.jpg,0,1,1,0,2,,train
0566450_sc-193533.jpg,0,1,1,0,2,,train
0566451_sc-193533.jpg,0,1,0,0,1,,train
0566452_sc-193533.jpg,2,1,0,0,3,,train
0566453_sc-193533.jpg,1,1,0,0,2,,train
0566454_sc-193533.jpg,3,1,0,0,4,,train
0566456_sc-127033.jpg,1,0,1,0,2,,val
0566459_as-0070090.jpg,0,1,0,0,1,,val
0566460_as-0070090.jpg,1,0,0,0,1,,test
0566461_as-3033032.jpg,3,0,0,0,3,,train
0566462_sc-1026129.jpg,2,1,1,0,4,,train
0566463_sc-1019342.jpg,1,0,2,0,3,,train
0566464_sc-1019342.jpg,1,0,2,0,3,,train
0566465_sc-1019342.jpg,2,0,2,0,4,,train
0566467_sc-1019342.jpg,2,0,1,0,3,,train
0566468_as-3367416.jpg,2,1,2,0,5,,train
0566469_as-2830237.jpg,5,0,0,1,6,,val
0566470_sc-159262.jpg,1,1,0,0,2,,val
0566471_sc-110441.jpg,1,0,0,1,2,,test
0566472_as-0003021.jpg,3,0,0,2,5,,train
0566473_as-0003021.jpg,3,0,0,0,3,,train
0566474_as-0003021.jpg,3,0,0,0,3,,train
0566475_as-0003021.jpg,1,0,0,0,1,,train
0566476_as-0003021.jpg,2,0,0,0,2,,train
0566478_as-3219482.jpg,1,0,0,0,1,,train
0566479_as-3227574.jpg,0,0,0,1,1,,train
0566480_as-7065865.jpg,0,1,1,0,2,,val
0566481_as-7934244.jpg,1,0,0,0,1,,val
0566482_sc-126413.jpg,1,1,0,0,2,,test
0566484_as-0066522.jpg,1,3,2,1,7,,train
0566486_as-0006843.jpg,0,1,0,0,1,,train
0566487_as-0006843.jpg,1,0,0,0,1,,train
0566494_as-0006843.jpg,1,1,0,1,3,,train
0566495_as-0006843.jpg,2,1,0,0,3,,train
0566496_as-0006843.jpg,1,0,0,0,1,,train
0566497_as-0006843.jpg,2,1,0,1,4,,train
0566499_as-0011490.jpg,1,0,0,0,1,,val
0566500_as-0011490.jpg,1,0,0,0,1,,val
0566502_as-0088940.jpg,2,0,0,0,2,,test
0566504_as-0088940.jpg,2,0,0,0,2,,train
0566505_as-0088940.jpg,2,0,0,0,2,,train
0566507_sc-152843.jpg,1,0,1,1,3,,train
0566508_sc-152843.jpg,1,0,1,1,3,,train
0566509_as-3103216.jpg,1,0,0,0,1,,train
0566510_sc-114276.jpg,1,0,0,0,1,,train
0566511_sc-114276.jpg,1,0,0,0,1,,train
0566512_as-7306794.jpg,1,0,0,0,1,,val
0566513_sc-129286.jpg,0,0,1,1,2,,val
0566514_sc-129286.jpg,2,0,1,0,3,,test
0566515_sc-151600.jpg,3,1,2,0,6,,train
0566516_sc-151600.jpg,2,2,0,0,4,,train
0566521_as-0027770.jpg,3,1,1,0,5,,train
0566522_as-0027770.jpg,2,1,1,0,4,,train
0566523_as-0027770.jpg,1,0,0,0,1,,train
0566524_as-9071657.jpg,3,0,0,0,3,,train
0566525_as-9034601.jpg,2,0,1,0,3,,train
0566526_as-0033126.jpg,2,1,0,1,4,,val
0566527_as-0033126.jpg,1,1,0,1,3,,val
0566528_as-3460928.jpg,1,0,1,0,2,,test
0566530_as-0086770.jpg,1,0,0,0,1,,train
0566531_as-0086770.jpg,1,0,0,0,1,,train
0566532_as-0086770.jpg,2,0,0,0,2,,train
0566533_as-0086770.jpg,2,0,0,0,2,,train
0566534_as-0086770.jpg,2,0,0,0,2,,train
0566535_as-0086770.jpg,2,0,0,0,2,,train
0566536_as-0086770.jpg,1,0,0,0,1,,train
0566537_as-0086770.jpg,1,0,0,0,1,,val
0566538_as-0086770.jpg,1,0,0,0,1,,val
0566539_as-0059356.jpg,2,0,0,0,2,,test
0566540_as-0059356.jpg,1,0,0,0,1,,train
0566543_as-0059356.jpg,2,0,0,0,2,,train
0566544_as-7524888.jpg,0,0,0,1,1,,train
0566545_sc-207072.jpg,1,0,1,0,2,,train
0566547_as-0024237.jpg,3,0,0,0,3,,train
0566549_as-0024237.jpg,0,1,1,0,2,,train
0566550_as-0024237.jpg,2,0,0,4,6,,train
0566551_as-0024237.jpg,3,0,1,1,5,,val
0566552_as-0024237.jpg,1,0,1,0,2,,val
0566553_as-2956972.jpg,4,0,1,2,7,,test
0566555_as-0090926.jpg,4,0,1,1,6,,train
0566556_as-0090926.jpg,2,0,1,0,3,,train
0566557_as-0090926.jpg,1,0,0,0,1,,train
0566558_as-0090926.jpg,1,0,0,0,1,,train
0566559_as-0090926.jpg,1,0,0,0,1,,train
0566560_as-0068002.jpg,1,0,0,2,3,,train
0566561_sc-151020.jpg,7,0,0,0,7,,train
0566562_sc-151020.jpg,1,1,1,0,3,,val
0566563_sc-151020.jpg,4,0,0,0,4,,val
0566564_sc-151020.jpg,8,0,0,1,9,,test
0566565_sc-151020.jpg,6,0,0,0,6,,train
0566566_sc-151020.jpg,11,0,0,0,11,,train
0566567_sc-151020.jpg,8,0,2,1,11,,train
0566568_as-0080930.jpg,1,0,0,0,1,,train
0566569_as-0080930.jpg,1,0,0,0,1,,train
0566570_sc-124187.jpg,0,1,1,2,4,,train
0566571_sc-124187.jpg,7,0,1,4,12,,train
0566572_sc-124187.jpg,3,0,0,2,5,,val
0566573_sc-124187.jpg,3,0,0,0,3,,val
0566574_sc-124187.jpg,4,0,0,0,4,,test
0566575_sc-215251.jpg,2,1,0,0,3,,train
0566576_sc-134670.jpg,0,0,1,0,1,,train
0566577_sc-134670.jpg,1,0,1,0,2,,train
0566578_sc-134670.jpg,2,0,0,1,3,,train
0566579_sc-134670.jpg,0,0,1,1,2,,train
0566580_sc-174389.jpg,6,0,0,0,6,,train
0566581_as-0036053.jpg,1,0,0,1,2,,train
0566582_as-0036053.jpg,1,0,0,1,2,,val
0566583_sc-229388.jpg,1,0,1,1,3,,val
0566584_sc-229388.jpg,0,0,1,1,2,,test
0566585_sc-229388.jpg,1,0,1,1,3,,train
0566586_sc-1040258.jpg,1,0,0,1,2,,train
0566587_sc-1040258.jpg,3,0,0,0,3,,train
0566588_sc-1040258.jpg,4,0,0,0,4,,train
0566589_as-2873578.jpg,4,0,0,0,4,,train
0566592_as-3050608.jpg,0,0,1,0,1,,train
0566593_as-3407677.jpg,2,3,2,0,7,,train
0566594_as-3048925.jpg,0,0,1,0,1,,val
0566595_as-9059595.jpg,4,0,1,1,6,,val
0566596_sc-114186.jpg,2,0,1,0,3,,test
0566597_sc-152044.jpg,2,0,1,0,3,,train
0566598_sc-152044.jpg,2,1,2,0,5,,train
0566600_as-0035952.jpg,1,0,0,0,1,,train
0566601_as-0035952.jpg,1,0,0,0,1,,train
0566603_as-0035952.jpg,1,0,0,0,1,,train
0566604_sc-188562.jpg,1,0,0,1,2,,train
0566605_sc-188562.jpg,2,0,0,0,2,,train
0566607_sc-179462.jpg,5,0,0,1,6,,val
0566608_sc-179462.jpg,3,0,0,1,4,,val
0566611_as-0026982.jpg,3,1,1,1,6,,test
0566612_as-0026982.jpg,3,1,1,1,6,,train
0566613_as-0026982.jpg,2,2,0,0,4,,train
0566614_as-0026982.jpg,3,0,1,0,4,,train
0566615_as-0026982.jpg,1,0,0,0,1,,train
0566617_sc-124492.jpg,1,0,1,1,3,,train
0566618_as-2551374.jpg,1,1,1,0,3,,train
0566620_as-0026865.jpg,3,0,0,1,4,,train
0566622_as-0026865.jpg,5,0,0,1,6,,val
0566623_as-0026865.jpg,5,0,0,2,7,,val
0566624_as-0026865.jpg,10,0,0,1,11,,test
0566625_as-0026865.jpg,4,0,0,2,6,,train
0566626_as-0026865.jpg,2,0,0,1,3,,train
0566627_as-0026865.jpg,10,0,0,0,10,,train
0566628_as-0026865.jpg,4,0,0,1,5,,train
0566629_as-3321746.jpg,1,0,1,0,2,,train
0566631_sc-155310.jpg,4,0,0,0,4,,train
0566632_sc-131399.jpg,1,0,0,0,1,,train
0566634_sc-131399.jpg,1,0,0,0,1,,val
0566635_sc-124194.jpg,6,1,0,0,7,,val
0566636_sc-124194.jpg,3,0,0,0,3,,test
0566637_sc-124194.jpg,3,2,0,0,5,,train
0566638_sc-124194.jpg,7,2,0,0,9,,train
0566639_sc-124194.jpg,5,2,0,0,7,,train
0566640_sc-124194.jpg,3,0,0,0,3,,train
0566641_sc-124194.jpg,4,0,0,0,4,,train
0566642_sc-124194.jpg,2,0,1,0,3,,train
0566643_sc-124194.jpg,5,0,1,0,6,,train
0566644_sc-125899.jpg,1,1,0,0,2,,val
0566645_sc-1031375.jpg,1,1,2,0,4,,val
0566646_sc-1031375.jpg,1,1,0,0,2,,test
0566647_sc-1031375.jpg,1,0,2,0,3,,train
0566648_as-2981197.jpg,1,0,0,0,1,,train
0566649_as-7474619.jpg,1,0,0,0,1,,train
0566650_as-3244341.jpg,5,2,2,0,9,,train
0566651_sc-138201.jpg,1,0,1,0,2,,train
0566652_as-3291704.jpg,2,0,1,0,3,,train
0566653_as-3262190.jpg,0,1,0,0,1,,train
0566654_sc-205247.jpg,6,2,0,0,8,,val
0566655_sc-205247.jpg,7,2,2,0,11,,val
0566656_sc-205247.jpg,3,0,1,1,5,,test
0566657_sc-205247.jpg,5,0,0,0,5,,train
0566660_as-0073043.jpg,3,2,1,0,6,,train
0566663_as-0040000.jpg,1,0,2,0,3,,train
0566664_as-0040000.jpg,1,0,1,0,2,,train
0566665_as-0040000.jpg,1,0,0,0,1,,train
0566666_as-0040000.jpg,1,0,0,0,1,,train
0566667_as-0040000.jpg,5,0,0,0,5,,train
0566668_as-0040000.jpg,2,0,0,0,2,,val
0566669_as-0040000.jpg,2,0,0,0,2,,val
0566670_as-0040000.jpg,1,0,0,0,1,,test
0566671_sc-1030772.jpg,1,0,0,0,1,,train
0566672_sc-1030772.jpg,1,0,0,0,1,,train
0566673_sc-1030772.jpg,1,0,0,1,2,,train
0566674_sc-1030772.jpg,5,0,0,3,8,,train
0566675_sc-1030772.jpg,2,0,0,1,3,,train
0566676_as-0000936.jpg,3,2,0,0,5,,train
0566677_as-0000936.jpg,2,0,0,0,2,,train
0566678_as-0000936.jpg,2,1,0,0,3,,val
0566679_as-0091488.jpg,3,0,1,2,6,,val
0566680_as-0091488.jpg,1,0,1,1,3,,test
0566681_as-7251112.jpg,0,0,1,0,1,,train
0566682_sc-1010553.jpg,17,0,0,0,17,,train
0566683_sc-1010553.jpg,14,2,1,1,18,,train
0566684_sc-1010553.jpg,4,2,1,1,8,,train
0566685_sc-154208.jpg,1,0,0,0,1,,train
0566686_sc-154208.jpg,2,0,2,0,4,,train
0566687_sc-154208.jpg,2,0,1,1,4,,train
0566688_sc-154208.jpg,2,0,1,0,3,,val
0566689_sc-166083.jpg,0,1,1,1,3,,val
0566690_sc-166083.jpg,1,0,0,0,1,,test
0566691_sc-166083.jpg,1,1,0,0,2,,train
0566692_as-7259238.jpg,0,0,1,0,1,,train
0566693_as-3034722.jpg,2,0,0,0,2,,train
0566695_as-0057871.jpg,5,1,0,1,7,,train
0566696_as-0057871.jpg,4,1,0,0,5,,train
0566697_as-2881183.jpg,1,0,0,0,1,,train
0566698_sc-118649.jpg,3,0,0,0,3,,train
0566699_sc-118649.jpg,0,0,1,0,1,,val
0566700_as-0074680.jpg,1,6,1,0,8,,val
0566701_as-0074680.jpg,3,2,2,0,7,,test
0566704_as-0074680.jpg,1,3,2,0,6,,train
0566705_as-0074680.jpg,1,0,2,0,3,,train
0566709_as-0021067.jpg,1,0,1,1,3,,train
0566710_as-0021067.jpg,2,0,1,1,4,,train
0566711_as-0021067.jpg,1,0,0,1,2,,train
0566714_sc-150258.jpg,1,0,0,0,1,,train
0566715_sc-150258.jpg,1,0,0,0,1,,train
0566716_sc-150258.jpg,1,0,1,0,2,,val
0566717_sc-201469.jpg,3,0,0,0,3,,val
0566718_sc-201469.jpg,1,0,0,1,2,,test
0566719_sc-106559.jpg,1,0,1,0,2,,train
0566720_sc-1007643.jpg,2,0,0,0,2,,train
0566721_as-0062371.jpg,1,0,0,0,1,,train
0566724_sc-138228.jpg,0,1,0,0,1,,train
0566726_as-0041811.jpg,2,1,0,0,3,,train
0566727_as-0041811.jpg,1,1,0,0,2,,train
0566728_as-3196382.jpg,1,1,2,0,4,,train
0566729_as-2799096.jpg,1,1,0,0,2,,val
0566730_sc-126829.jpg,2,0,0,0,2,,val
0566731_sc-126829.jpg,1,0,0,0,1,,test
0566734_sc-1016824.jpg,2,1,1,0,4,,train
0566735_sc-1016824.jpg,3,1,0,0,4,,train
0566736_sc-1028359.jpg,1,0,1,1,3,,train
0566737_sc-1028359.jpg,1,0,1,1,3,,train
0566738_sc-223088.jpg,1,1,0,0,2,,train
0566739_sc-223088.jpg,1,0,0,0,1,,train
0566740_sc-223088.jpg,3,0,1,0,4,,train
0566741_sc-223088.jpg,1,0,0,0,1,,val
0566742_as-2811617.jpg,2,0,0,0,2,,val
0566743_as-3090489.jpg,4,0,0,0,4,,test
0566744_as-7823541.jpg,1,0,0,0,1,,train
0566746_as-0075952.jpg,1,1,3,2,7,,train
0566747_as-0075952.jpg,0,1,4,1,6,,train
0566749_as-0021849.jpg,0,1,0,1,2,,train
0566750_as-0021849.jpg,1,1,0,1,3,,train
0566751_as-0021849.jpg,2,1,1,1,5,,train
0566752_as-0021849.jpg,0,1,1,1,3,,train
0566753_as-0033544.jpg,3,1,0,0,4,,val
0566754_as-0033544.jpg,4,1,0,0,5,,val
0566755_as-0033544.jpg,5,0,0,0,5,,test
0566757_as-0033544.jpg,7,0,0,0,7,,train
0566758_as-0033544.jpg,3,1,1,1,6,,train
0566759_as-0033544.jpg,11,1,0,0,12,,train
0566760_as-0051479.jpg,1,0,0,0,1,,train
0566761_sc-140266.jpg,1,2,0,0,3,,train
0566762_sc-140266.jpg,0,2,0,0,2,,train
0566763_as-9022141.jpg,1,0,1,0,2,,train
0566766_as-0042017.jpg,0,4,2,0,6,,val
0566767_as-0042017.jpg,0,3,1,0,4,,val
0566768_as-0042017.jpg,0,6,3,0,9,,test
0566769_as-0042017.jpg,1,3,2,0,6,,train
0566771_as-3401171.jpg,2,0,0,0,2,,train
0566775_sc-180817.jpg,2,0,0,0,2,,train
0566776_sc-180817.jpg,9,0,0,0,9,,train
0566777_sc-180817.jpg,2,0,0,0,2,,train
0566779_sc-224963.jpg,2,0,0,0,2,,train
0566780_sc-224963.jpg,2,0,0,0,2,,train
0566781_as-0099713.jpg,1,0,0,1,2,,val
0566782_as-3169481.jpg,1,0,0,1,2,,val
0566786_as-0083632.jpg,1,0,0,0,1,,test
0566791_as-0083632.jpg,1,0,0,0,1,,train
0566792_as-0083632.jpg,1,0,0,0,1,,train
0566793_as-0083632.jpg,1,0,0,0,1,,train
0566794_as-7890682.jpg,1,0,0,0,1,,train
0566796_as-0043326.jpg,3,0,1,0,4,,train
0566797_as-0061159.jpg,1,0,0,0,1,,train
0566799_as-0061159.jpg,0,1,0,0,1,,train
0566800_as-0061159.jpg,1,0,1,0,2,,val
0566802_as-0061159.jpg,1,1,0,1,3,,val
0566803_as-0061159.jpg,0,1,0,1,2,,test
0566805_as-3364321.jpg,1,0,0,0,1,,train
0566807_as-0069560.jpg,2,0,0,0,2,,train
0566808_as-3046443.jpg,3,0,0,6,9,,train
0566810_as-0022198.jpg,1,0,1,1,3,,train
0566811_as-0022198.jpg,1,0,1,1,3,,train
0566812_as-0022198.jpg,1,0,0,1,2,,train
0566814_as-0094978.jpg,1,0,0,0,1,,train
0566815_as-0094978.jpg,2,0,0,0,2,,val
0566816_as-0094978.jpg,1,0,0,0,1,,val
0566817_as-0098726.jpg,2,0,0,0,2,,test
0566818_as-0098726.jpg,1,0,1,2,4,,train
0566819_as-3236398.jpg,4,0,0,0,4,,train
0566820_sc-209860.jpg,1,1,0,0,2,,train
0566821_sc-209860.jpg,3,2,0,0,5,,train
0566822_sc-209860.jpg,2,1,0,0,3,,train
0566823_sc-209860.jpg,3,2,1,0,6,,train
0566825_as-0085708.jpg,3,0,2,0,5,,train
0566827_sc-1021537.jpg,2,0,0,0,2,,val
0566828_sc-1021537.jpg,1,0,0,0,1,,val
0566829_sc-1021537.jpg,1,0,0,0,1,,test
0566830_as-2746317.jpg,1,0,0,0,1,,train
0566831_as-0018660.jpg,1,0,1,0,2,,train
0566832_as-0018660.jpg,1,0,1,0,2,,train
0566833_as-0018660.jpg,1,0,0,0,1,,train
0566834_as-0018660.jpg,1,0,0,0,1,,train
0566835_as-0018660.jpg,1,0,0,0,1,,train
0566837_sc-129967.jpg,0,0,3,0,3,,train
0566839_sc-129967.jpg,1,0,0,0,1,,val
0566840_as-0076900.jpg,1,1,0,0,2,,val
0566841_as-0076900.jpg,1,1,0,0,2,,test
0566842_as-0076900.jpg,1,1,0,0,2,,train
0566843_as-0076900.jpg,0,1,0,0,1,,train
0566845_as-0077568.jpg,1,0,0,1,2,,train
0566846_as-0077568.jpg,1,0,0,1,2,,train
0566847_sc-200087.jpg,4,0,0,0,4,,train
0566849_as-3293827.jpg,1,0,0,0,1,,train
0566850_sc-104594.jpg,1,0,0,0,1,,train
0566853_sc-158843.jpg,4,0,1,0,5,,val
0566854_sc-158843.jpg,1,0,1,0,2,,val
0566855_sc-158843.jpg,4,0,1,0,5,,test
0566856_sc-158843.jpg,3,0,1,0,4,,train
0566857_sc-158843.jpg,2,0,1,0,3,,train
0566858_sc-158843.jpg,1,0,1,0,2,,train
0566859_sc-158843.jpg,1,0,1,0,2,,train
0566860_sc-158843.jpg,1,0,1,0,2,,train
0566861_sc-174910.jpg,3,0,0,0,3,,train
0566863_sc-174910.jpg,2,0,0,0,2,,train
0566864_as-3251817.jpg,1,0,1,0,2,,val
0566865_as-7522431.jpg,2,0,1,0,3,,val
0566866_sc-166348.jpg,6,2,0,0,8,,test
0566869_sc-126974.jpg,2,0,0,0,2,,train
0566871_sc-126974.jpg,1,0,1,0,2,,train
0566872_sc-126974.jpg,2,0,0,0,2,,train
0566873_as-0071591.jpg,1,1,1,0,3,,train
0566874_as-0071591.jpg,1,0,0,0,1,,train
0566876_as-0071591.jpg,2,0,0,0,2,,train
0566877_as-0071591.jpg,1,1,1,0,3,,train
0566878_as-0071591.jpg,2,0,1,0,3,,val
0566879_sc-156202.jpg,1,0,0,0,1,,val
0566880_sc-156202.jpg,1,0,0,0,1,,test
0566881_sc-156202.jpg,1,0,0,0,1,,train
0566883_as-0017884.jpg,2,0,0,0,2,,train
0566884_as-0017884.jpg,2,0,0,0,2,,train
0566885_as-0017884.jpg,1,0,0,0,1,,train
0566886_sc-1039217.jpg,4,0,1,1,6,,train
0566887_sc-1039217.jpg,2,0,1,0,3,,train
0566888_sc-1039217.jpg,4,0,1,0,5,,train
0566889_sc-1022981.jpg,2,0,0,0,2,,val
0566890_sc-1022981.jpg,2,0,0,0,2,,val
0566892_sc-108407.jpg,4,0,1,1,6,,test
0566893_sc-108407.jpg,5,0,0,1,6,,train
0566894_sc-108407.jpg,0,0,1,1,2,,train
0566895_sc-108407.jpg,2,0,1,0,3,,train
0566896_sc-108407.jpg,2,0,0,1,3,,train
0566897_sc-108407.jpg,1,0,0,1,2,,train
0566898_sc-108407.jpg,4,1,0,0,5,,train
0566899_sc-108407.jpg,2,0,1,0,3,,train
0566900_sc-1028484.jpg,2,0,0,0,2,,val
0566902_sc-1028484.jpg,3,0,0,0,3,,val
0566903_sc-1028484.jpg,3,0,1,0,4,,test
0566904_sc-1028484.jpg,5,0,1,0,6,,train
0566905_sc-1028484.jpg,4,0,0,0,4,,train
0566907_as-0004880.jpg,0,0,1,0,1,,train
0566908_sc-129352.jpg,1,1,1,0,3,,train
0566909_sc-129352.jpg,1,0,0,0,1,,train
0566910_sc-123387.jpg,6,0,0,0,6,,train
0566911_sc-123387.jpg,5,0,0,0,5,,train
0566914_sc-130464.jpg,4,1,1,1,7,,val
0566915_sc-130464.jpg,2,1,1,1,5,,val
0566916_sc-130464.jpg,3,1,1,1,6,,test
0566917_sc-130464.jpg,3,0,0,0,3,,train
0566918_as-0081510.jpg,1,0,0,0,1,,train
0566919_as-0081510.jpg,1,0,0,0,1,,train
0566920_as-0081510.jpg,1,0,0,0,1,,train
0566922_as-0052087.jpg,1,0,0,1,2,,train
0566923_as-7622759.jpg,1,1,1,1,4,,train
0566925_as-0001311.jpg,6,0,1,0,7,,train
0566926_as-3121680.jpg,3,0,0,0,3,,val
0566927_as-3284062.jpg,4,1,1,1,7,,val
0566929_as-0021212.jpg,1,0,0,1,2,,test
0566930_as-0021212.jpg,0,0,2,0,2,,train
0566931_as-0021212.jpg,1,0,2,1,4,,train
0566933_as-0021212.jpg,3,0,0,0,3,,train
0566935_sc-1010616.jpg,1,0,1,0,2,,train
0566936_sc-1010616.jpg,2,0,1,0,3,,train
0566938_sc-1010616.jpg,2,0,1,1,4,,train
0566939_sc-224907.jpg,1,0,0,1,2,,train
0566940_sc-224907.jpg,1,0,1,0,2,,val
0566941_sc-224907.jpg,1,0,1,0,2,,val
0566942_sc-224907.jpg,0,0,0,1,1,,test
0566943_sc-224907.jpg,2,0,0,1,3,,train
0566944_sc-224907.jpg,2,0,0,0,2,,train
0566947_as-0047359.jpg,2,2,3,1,8,,train
0566949_as-0047359.jpg,2,2,2,1,7,,train
0566950_as-0047359.jpg,2,3,3,1,9,,train
0566951_as-0047359.jpg,2,2,1,0,5,,train
0566952_as-0047359.jpg,0,0,1,0,1,,train
0566953_as-0047359.jpg,1,0,1,0,2,,val
0566954_as-0047359.jpg,1,0,1,0,2,,val
0566956_as-0054942.jpg,5,3,0,0,8,,test
0566957_as-0054942.jpg,3,2,0,0,5,,train
0566958_as-0054942.jpg,5,3,0,0,8,,train
0566960_sc-140382.jpg,2,0,1,1,4,,train
0566964_as-0038180.jpg,2,0,1,1,4,,train
0566965_as-0038180.jpg,3,0,1,0,4,,train
0566966_as-0022807.jpg,2,0,0,0,2,,train
0566967_as-0022807.jpg,3,0,0,0,3,,train
0566968_as-0022807.jpg,2,0,1,0,3,,val
0566969_as-0088001.jpg,1,0,0,0,1,,val
0566971_sc-187793.jpg,1,0,0,1,2,,test
0566972_sc-187793.jpg,2,0,0,1,3,,train
0566974_as-0069832.jpg,4,0,0,0,4,,train
0566975_as-0069832.jpg,1,0,0,0,1,,train
0566976_as-0069832.jpg,1,0,0,0,1,,train
0566977_as-2953117.jpg,1,0,1,2,4,,train
0566978_sc-117729.jpg,0,1,0,0,1,,train
0566979_sc-117729.jpg,0,1,0,0,1,,train
0566980_sc-1027309.jpg,7,0,0,0,7,,val
0566982_as-3217886.jpg,2,0,0,0,2,,val
0566983_as-3217886.jpg,1,1,1,1,4,,test
0566984_sc-205579.jpg,2,0,0,1,3,,train
0566988_as-0010869.jpg,2,0,0,0,2,,train
0566989_sc-1029886.jpg,1,0,1,1,3,,train
0566990_sc-1029886.jpg,1,0,0,1,2,,train
0566992_as-0056377.jpg,1,0,0,0,1,,train
0566993_as-0056377.jpg,1,1,0,0,2,,train
0566995_as-0023250.jpg,0,0,1,0,1,,train
0566996_as-0023250.jpg,2,0,0,0,2,,val
0566997_as-0023250.jpg,1,0,0,0,1,,val
0566998_sc-188841.jpg,0,0,1,1,2,,test
0566999_sc-188841.jpg,0,0,1,1,2,,train
0567000_sc-188841.jpg,1,0,1,1,3,,train
0567001_sc-188841.jpg,3,0,1,1,5,,train
0567002_sc-188841.jpg,0,0,1,1,2,,train
0567003_as-7046056.jpg,1,0,0,0,1,,train
0567004_sc-223414.jpg,2,1,2,1,6,,train
0567005_sc-223414.jpg,3,1,2,1,7,,train
0567006_sc-223414.jpg,1,1,2,1,5,,val
0567007_sc-223414.jpg,0,0,1,0,1,,val
0567008_sc-223414.jpg,2,0,0,0,2,,test
0567009_sc-223414.jpg,2,0,0,0,2,,train
0567010_sc-223414.jpg,0,0,3,1,4,,train
0567011_sc-223414.jpg,1,0,1,0,2,,train
0567012_sc-223414.jpg,1,1,1,0,3,,train
0567013_sc-223414.jpg,0,0,3,1,4,,train
0567014_sc-223414.jpg,0,0,2,0,2,,train
0567015_sc-223414.jpg,0,0,1,0,1,,train
0567016_sc-223414.jpg,0,0,1,0,1,,val
0567017_sc-223414.jpg,0,0,2,1,3,,val
0567018_sc-223414.jpg,0,0,1,1,2,,test
0567019_sc-223414.jpg,0,0,1,0,1,,train
0567020_sc-223414.jpg,0,0,1,0,1,,train
0567021_sc-223414.jpg,0,0,1,0,1,,train
0567024_as-0095529.jpg,2,0,0,0,2,,train
0567025_as-7863851.jpg,0,0,1,0,1,,train
0567027_as-0084696.jpg,1,0,0,0,1,,train
0567028_sc-1019043.jpg,2,0,0,0,2,,train
0567029_sc-1019043.jpg,2,0,1,0,3,,val
0567030_sc-1019043.jpg,6,0,1,0,7,,val
0567031_sc-1019043.jpg,4,0,0,0,4,,test
0567032_sc-1019043.jpg,2,0,0,0,2,,train
0567033_as-2880926.jpg,2,0,0,0,2,,train
0567034_sc-170558.jpg,1,0,0,0,1,,train
0567035_sc-170558.jpg,5,0,0,0,5,,train
0567036_sc-170558.jpg,3,0,0,0,3,,train
0567038_as-0081134.jpg,1,2,1,0,4,,train
0567039_sc-194665.jpg,6,0,0,0,6,,train
0567040_sc-194665.jpg,9,0,0,0,9,,val
0567041_sc-194665.jpg,9,0,1,0,10,,val
0567042_sc-194665.jpg,6,0,0,0,6,,test
0567043_sc-194665.jpg,6,0,0,0,6,,train
0567044_as-9058998.jpg,1,0,0,0,1,,train
0567046_sc-110604.jpg,3,0,0,0,3,,train
0567047_sc-110604.jpg,3,0,0,0,3,,train
0567048_sc-110604.jpg,3,0,0,0,3,,train
0567049_sc-110604.jpg,1,0,0,0,1,,train
0567051_as-0099469.jpg,2,1,0,0,3,,train
0567053_as-2830776.jpg,1,0,0,0,1,,val
0567054_as-9031058.jpg,4,3,0,0,7,,val
0567055_sc-120303.jpg,0,1,0,0,1,,test
0567056_sc-120303.jpg,0,1,0,0,1,,train
0567058_sc-181462.jpg,2,1,0,0,3,,train
0567059_sc-181462.jpg,1,0,0,0,1,,train
0567060_sc-181462.jpg,5,0,0,0,5,,train
0567061_sc-181462.jpg,2,1,0,0,3,,train
0567063_sc-127046.jpg,4,0,0,0,4,,train
0567064_sc-127046.jpg,1,0,0,0,1,,train
0567067_as-0037846.jpg,0,1,0,0,1,,val
0567068_as-0037846.jpg,2,0,0,1,3,,val
0567069_as-7610187.jpg,1,0,0,0,1,,test
0567070_sc-187601.jpg,1,1,1,0,3,,train
0567071_sc-187601.jpg,0,0,2,1,3,,train
0567073_sc-187601.jpg,1,0,0,2,3,,train
0567074_sc-187601.jpg,6,2,2,1,11,,train
0567075_sc-187601.jpg,0,0,2,0,2,,train
0567076_sc-187601.jpg,1,0,2,0,3,,train
0567077_sc-187601.jpg,7,2,5,1,15,,train
0567078_sc-187601.jpg,6,4,4,0,14,,val
0567079_as-0055366.jpg,4,0,1,2,7,,val
0567080_as-0055366.jpg,2,0,1,0,3,,test
0567082_as-2610241.jpg,1,0,0,0,1,,train
0567083_sc-1024541.jpg,2,1,2,0,5,,train
0567084_sc-1024541.jpg,1,1,1,0,3,,train
0567085_sc-1024541.jpg,4,0,0,0,4,,train
0567086_sc-1024541.jpg,2,0,0,0,2,,train
0567087_sc-1024541.jpg,4,1,1,0,6,,train
0567091_as-0071647.jpg,3,0,0,2,5,,train
0567092_as-0071647.jpg,3,0,3,2,8,,val
0567093_as-0071647.jpg,2,0,0,0,2,,val
0567095_as-0080458.jpg,0,1,1,0,2,,test
0567097_as-0080458.jpg,1,1,1,1,4,,train
0567099_as-0080458.jpg,0,0,2,0,2,,train
0567101_as-0080458.jpg,3,0,0,0,3,,train
0567102_as-0094561.jpg,3,0,0,0,3,,train
0567103_as-0094561.jpg,1,0,0,0,1,,train
0567104_as-0094561.jpg,3,0,0,0,3,,train
0567105_as-7196233.jpg,1,0,0,0,1,,train
0567106_as-0035290.jpg,1,0,0,0,1,,val
0567107_as-0035290.jpg,7,0,1,0,8,,val
0567109_as-0035290.jpg,2,0,1,1,4,,test
0567110_as-0035290.jpg,2,0,0,1,3,,train
0567111_as-0035290.jpg,1,0,0,0,1,,train
0567114_as-0087657.jpg,0,1,0,0,1,,train
0567115_as-2805245.jpg,2,0,0,1,3,,train
0567117_as-0100114.jpg,4,0,0,0,4,,train
0567118_as-0100114.jpg,1,0,0,0,1,,train
0567119_as-0100114.jpg,1,0,2,0,3,,train
0567120_as-7766463.jpg,1,0,1,0,2,,val
0567121_sc-224476.jpg,10,1,0,0,11,,val
0567122_sc-224476.jpg,15,2,0,0,17,,test
0567123_as-3078196.jpg,4,0,0,0,4,,train
0567125_as-0051784.jpg,6,0,4,0,10,,train
0567126_as-0051784.jpg,4,0,0,0,4,,train
0567127_as-0051784.jpg,2,0,1,2,5,,train
0567128_as-0038096.jpg,1,0,0,0,1,,train
0567129_as-0038096.jpg,1,0,0,0,1,,train
0567130_as-0038096.jpg,1,0,0,0,1,,train
0567131_as-0038096.jpg,3,0,1,0,4,,val
0567132_as-0038096.jpg,2,0,2,0,4,,val
0567133_as-0038096.jpg,2,0,1,0,3,,test
0567139_as-3130090.jpg,0,0,0,1,1,,train
0567140_sc-201332.jpg,3,0,0,0,3,,train
0567141_sc-201332.jpg,5,0,0,0,5,,train
0567142_sc-201332.jpg,6,0,0,0,6,,train
0567143_sc-201332.jpg,7,0,0,0,7,,train
0567144_sc-201332.jpg,6,0,0,0,6,,train
0567145_sc-201332.jpg,6,0,0,0,6,,train
0567146_sc-201332.jpg,3,0,0,0,3,,val
0567147_sc-201332.jpg,6,0,0,0,6,,val
0567148_sc-201332.jpg,2,0,0,0,2,,test
0567149_sc-201332.jpg,2,0,0,0,2,,train
0567150_sc-201332.jpg,5,0,0,0,5,,train
0567151_as-2623156.jpg,3,2,0,0,5,,train
0567152_sc-1035449.jpg,1,0,2,0,3,,train
0567153_as-0057724.jpg,0,0,0,1,1,,train
0567154_as-0012567.jpg,1,0,0,0,1,,train
0567155_as-2956951.jpg,2,0,0,0,2,,train
0567157_sc-183895.jpg,1,0,0,0,1,,val
0567158_sc-183895.jpg,1,0,0,0,1,,val
0567159_sc-183895.jpg,1,0,0,0,1,,test
0567160_sc-183895.jpg,1,0,0,0,1,,train
0567161_sc-183895.jpg,1,0,0,0,1,,train
0567162_sc-183895.jpg,1,0,1,0,2,,train
0567163_sc-183895.jpg,1,0,1,0,2,,train
0567164_sc-183895.jpg,1,0,1,0,2,,train
0567166_as-2505056.jpg,3,1,1,1,6,,train
0567167_sc-1017639.jpg,1,0,0,0,1,,train
0567168_sc-1017639.jpg,1,0,0,0,1,,val
0567169_sc-1017639.jpg,1,0,0,0,1,,val
0567171_as-2716885.jpg,1,0,0,0,1,,test
0567172_as-2779923.jpg,2,1,0,0,3,,train
0567173_sc-189593.jpg,1,0,0,0,1,,train
0567174_sc-189593.jpg,4,0,0,0,4,,train
0567175_as-9041862.jpg,1,1,1,0,3,,train
0567176_sc-200028.jpg,0,2,0,0,2,,train
0567177_sc-200028.jpg,0,1,0,0,1,,train
0567178_as-0067580.jpg,2,0,1,0,3,,train
0567179_as-0067580.jpg,3,0,1,0,4,,val
0567180_as-0067580.jpg,0,0,1,0,1,,val
0567181_sc-1033686.jpg,2,0,2,0,4,,test
0567183_sc-1033686.jpg,1,0,2,0,3,,train
0567186_sc-1033686.jpg,0,1,2,0,3,,train
0567187_sc-1033686.jpg,1,0,0,1,2,,train
0567188_sc-1033686.jpg,1,1,1,1,4,,train
0567189_sc-1033686.jpg,0,1,0,0,1,,train
0567190_as-3009763.jpg,3,1,0,0,4,,train
0567192_as-0044879.jpg,4,0,0,0,4,,train
0567193_as-0044879.jpg,0,0,1,0,1,,val
0567194_sc-200323.jpg,1,0,0,0,1,,val
0567197_as-0069197.jpg,1,0,0,0,1,,test
0567198_as-2881801.jpg,4,1,0,0,5,,train
0567200_sc-1008270.jpg,3,0,2,0,5,,train
0567201_sc-1008270.jpg,0,1,0,0,1,,train
0567202_sc-1008270.jpg,2,1,1,0,4,,train
0567203_sc-1008270.jpg,3,0,1,0,4,,train
0567204_as-0004941.jpg,2,0,0,0,2,,train
0567205_as-0004941.jpg,1,0,0,0,1,,train
0567207_sc-120520.jpg,1,0,0,0,1,,val
0567210_as-0079880.jpg,3,0,0,1,4,,val
0567212_sc-157585.jpg,0,1,0,0,1,,test
0567214_as-0071320.jpg,2,1,0,1,4,,train
0567215_as-0071320.jpg,2,1,0,1,4,,train
0567216_as-0071320.jpg,2,1,0,1,4,,train
0567217_as-0071320.jpg,2,1,0,1,4,,train
0567218_sc-1039087.jpg,2,0,0,0,2,,train
0567219_sc-1039087.jpg,3,0,1,0,4,,train
0567220_sc-1039087.jpg,4,0,1,0,5,,train
0567221_sc-1039087.jpg,4,0,0,0,4,,val
0567223_sc-114757.jpg,0,0,0,1,1,,val
0567224_as-7666318.jpg,1,0,0,0,1,,test
0567226_as-0066112.jpg,1,0,0,0,1,,train
0567227_as-0066112.jpg,1,0,0,0,1,,train
0567228_as-0060947.jpg,0,0,1,0,1,,train
0567229_as-7737189.jpg,2,0,0,0,2,,train
0567230_as-2683931.jpg,1,0,0,0,1,,train
0567231_sc-147513.jpg,1,0,0,1,2,,train
0567232_as-3074846.jpg,1,0,0,0,1,,train
0567233_sc-221237.jpg,2,0,0,0,2,,val
0567234_sc-221237.jpg,1,0,0,0,1,,val
0567236_sc-132111.jpg,1,0,1,0,2,,test
0567237_sc-132111.jpg,1,0,0,1,2,,train
0567238_as-3315151.jpg,2,0,0,1,3,,train
0567239_as-0067338.jpg,1,0,0,0,1,,train
0567240_as-0067338.jpg,1,0,0,0,1,,train
0567241_as-0067338.jpg,2,0,0,0,2,,train
0567243_as-0004742.jpg,3,0,1,0,4,,train
0567245_as-0004742.jpg,1,0,1,0,2,,train
0567246_sc-223049.jpg,7,2,2,0,11,,val
0567247_as-0078332.jpg,1,0,0,0,1,,val
0567248_as-0078332.jpg,1,1,1,1,4,,test
0567249_as-0016436.jpg,4,1,0,1,6,,train
0567250_as-0016436.jpg,1,0,0,0,1,,train
0567253_sc-1017009.jpg,0,0,0,1,1,,train
0567254_sc-1017009.jpg,1,0,0,1,2,,train
0567258_as-0075485.jpg,1,0,0,0,1,,train
0567259_as-0075485.jpg,1,0,0,0,1,,train
0567260_as-0075485.jpg,4,0,1,1,6,,train
0567261_as-0075485.jpg,3,0,0,0,3,,val
0567262_as-2565027.jpg,2,0,1,0,3,,val
0567264_as-0063968.jpg,1,0,0,0,1,,test
0567265_as-0063968.jpg,0,1,0,0,1,,train
0567266_as-0063968.jpg,1,0,0,0,1,,train
0567267_as-0063968.jpg,2,0,0,0,2,,train
0567268_as-0063968.jpg,1,0,0,0,1,,train
0567269_as-0063968.jpg,2,0,0,0,2,,train
0567271_sc-177203.jpg,5,0,0,0,5,,train
0567272_sc-177203.jpg,8,0,0,3,11,,train
0567273_sc-177203.jpg,7,0,0,0,7,,val
0567274_sc-177203.jpg,6,0,0,0,6,,val
0567275_sc-177203.jpg,4,0,0,0,4,,test
0567277_as-0001722.jpg,1,0,0,0,1,,train
0567278_as-0001722.jpg,1,0,0,0,1,,train
0567279_sc-1023980.jpg,4,1,1,1,7,,train
0567280_sc-1023980.jpg,1,0,0,1,2,,train
0567281_sc-1036250.jpg,1,1,0,0,2,,train
0567282_sc-188653.jpg,1,1,0,0,2,,train
0567283_sc-1033182.jpg,1,1,0,0,2,,train
0567284_sc-1033182.jpg,1,0,0,0,1,,val
0567285_sc-1033182.jpg,3,1,1,0,5,,val
0567287_sc-171521.jpg,1,0,0,0,1,,test
0567288_sc-189901.jpg,6,0,0,0,6,,train
0567289_sc-189901.jpg,8,0,0,0,8,,train
0567290_sc-189901.jpg,4,0,0,1,5,,train
0567291_sc-189901.jpg,3,0,2,1,6,,train
0567292_sc-189901.jpg,4,0,1,1,6,,train
0567295_as-2711407.jpg,1,0,0,0,1,,train
0567296_sc-1018912.jpg,3,0,0,0,3,,train
0567297_sc-1018912.jpg,5,0,2,0,7,,val
0567298_sc-1018912.jpg,2,0,0,0,2,,val
0567299_as-2625544.jpg,3,0,0,0,3,,test
0567300_sc-104805.jpg,4,0,0,0,4,,train
0567301_as-2964422.jpg,2,0,0,0,2,,train
0567304_as-0026595.jpg,0,1,2,1,4,,train
0567305_sc-211339.jpg,3,0,0,0,3,,train
0567306_sc-211339.jpg,1,0,0,0,1,,train
0567307_sc-209062.jpg,1,0,0,0,1,,train
0567308_sc-209062.jpg,4,0,0,0,4,,train
0567309_sc-209062.jpg,4,0,0,0,4,,val
0567310_sc-209062.jpg,7,0,0,0,7,,val
0567311_sc-208354.jpg,5,0,0,0,5,,test
0567312_sc-208354.jpg,3,0,0,0,3,,train
0567313_sc-208354.jpg,3,0,0,0,3,,train
0567314_sc-208354.jpg,3,0,0,0,3,,train
0567315_sc-208354.jpg,4,0,0,0,4,,train
0567316_sc-208354.jpg,4,0,0,0,4,,train
0567317_as-3447927.jpg,0,1,1,1,3,,train
0567318_as-0056114.jpg,1,0,0,0,1,,train
0567320_as-0082001.jpg,1,2,0,0,3,,val
0567321_as-0082001.jpg,1,3,0,0,4,,val
0567322_as-0082001.jpg,1,0,0,0,1,,test
0567323_as-3474054.jpg,1,0,0,0,1,,train
0567325_sc-123379.jpg,1,1,0,0,2,,train
0567326_sc-123379.jpg,0,0,1,0,1,,train
0567327_sc-123379.jpg,1,1,0,0,2,,train
0567328_sc-123379.jpg,1,0,1,0,2,,train
0567330_sc-123379.jpg,1,1,0,0,2,,train
0567331_sc-123379.jpg,0,1,0,0,1,,train
0567332_as-0028410.jpg,2,2,0,1,5,,val
0567335_as-0028410.jpg,1,1,0,0,2,,val
0567336_as-0028410.jpg,1,1,0,0,2,,test
0567337_as-2763132.jpg,1,0,0,0,1,,train
0567338_sc-126452.jpg,1,0,0,0,1,,train
0567339_sc-126452.jpg,2,0,0,3,5,,train
0567344_sc-122470.jpg,1,0,2,1,4,,train
0567345_sc-122470.jpg,2,0,3,1,6,,train
0567346_sc-122470.jpg,1,0,3,1,5,,train
0567347_sc-122470.jpg,1,0,3,1,5,,train
0567348_sc-1028081.jpg,4,1,0,0,5,,val
0567350_sc-1028081.jpg,1,0,0,1,2,,val
0567354_as-0086121.jpg,1,0,0,0,1,,test
0567355_as-0086121.jpg,1,0,0,0,1,,train
0567356_as-0086121.jpg,2,1,0,0,3,,train
0567357_as-0086121.jpg,1,1,0,0,2,,train
0567358_as-0086121.jpg,2,0,0,0,2,,train
0567359_sc-149484.jpg,2,0,0,0,2,,train
0567361_sc-149484.jpg,2,0,0,0,2,,train
0567363_sc-149484.jpg,1,0,0,0,1,,train
0567364_sc-219859.jpg,0,1,0,0,1,,val
0567365_sc-200230.jpg,2,0,1,1,4,,val
0567366_sc-200230.jpg,1,0,1,2,4,,test
0567367_as-0066679.jpg,2,0,0,0,2,,train
0567368_as-0066679.jpg,3,0,0,1,4,,train
0567369_as-0066679.jpg,2,0,0,1,3,,train
0567372_sc-136735.jpg,3,0,0,2,5,,train
0567374_sc-136735.jpg,3,0,0,2,5,,train
0567375_as-0035232.jpg,1,0,0,0,1,,train
0567376_as-0035232.jpg,1,0,0,0,1,,train
0567378_as-0035232.jpg,2,0,0,0,2,,val
0567382_as-0021625.jpg,1,1,1,0,3,,val
0567383_as-0021625.jpg,1,1,0,0,2,,test
0567384_as-0021625.jpg,1,1,0,0,2,,train
0567385_as-0021625.jpg,1,0,0,0,1,,train
0567386_sc-222489.jpg,0,1,0,0,1,,train
0567387_as-0057233.jpg,1,0,0,0,1,,train
0567388_as-0057233.jpg,1,0,0,0,1,,train
0567389_as-0057233.jpg,1,0,0,0,1,,train
0567390_as-0057233.jpg,1,0,0,0,1,,train
0567392_sc-1002230.jpg,1,0,0,0,1,,val
0567393_sc-1002230.jpg,1,0,0,0,1,,val
0567394_sc-1002230.jpg,1,0,0,0,1,,test
0567396_sc-1002230.jpg,1,0,0,0,1,,train
0567397_as-7393861.jpg,3,2,0,0,5,,train
0567398_as-9059000.jpg,1,0,2,0,3,,train
0567399_as-2822794.jpg,1,0,0,0,1,,train
0567400_sc-126682.jpg,1,0,0,0,1,,train
0567401_sc-126682.jpg,1,0,0,0,1,,train
0567402_sc-126682.jpg,1,0,0,0,1,,train
0567403_sc-126682.jpg,1,0,0,0,1,,val
0567404_sc-113901.jpg,5,0,0,0,5,,val
0567405_sc-113901.jpg,4,0,0,0,4,,test
0567406_sc-113901.jpg,2,0,0,0,2,,train
0567407_sc-113901.jpg,6,0,0,0,6,,train
0567408_sc-113901.jpg,2,0,0,0,2,,train
0567409_sc-113901.jpg,4,0,0,0,4,,train
0567411_as-0059875.jpg,2,0,0,0,2,,train
0567412_as-0059875.jpg,2,0,0,0,2,,train
0567413_as-7824791.jpg,2,0,1,0,3,,train
0567414_sc-1033500.jpg,1,0,0,0,1,,val
0567415_sc-1033500.jpg,1,0,0,0,1,,val
0567416_as-7594982.jpg,0,0,0,1,1,,test
0567417_as-3480612.jpg,1,0,1,0,2,,train
0567418_sc-140319.jpg,2,0,0,0,2,,train
0567419_sc-140319.jpg,2,0,0,0,2,,train
0567420_sc-140319.jpg,2,0,0,0,2,,train
0567421_sc-1020632.jpg,1,0,0,0,1,,train
0567422_sc-1020632.jpg,1,1,0,1,3,,train
0567425_as-2955939.jpg,3,0,1,0,4,,train
0567426_sc-1025118.jpg,1,0,0,0,1,,val
0567427_sc-1025118.jpg,1,0,0,0,1,,val
0567428_as-3209939.jpg,1,0,0,0,1,,test
0567431_as-0019745.jpg,1,0,0,0,1,,train
0567433_as-0019745.jpg,1,1,3,2,7,,train
0567435_as-0019745.jpg,1,0,2,1,4,,train
0567436_as-0019745.jpg,1,0,0,0,1,,train
0567437_as-2519685.jpg,2,1,0,2,5,,train
0567438_as-0043275.jpg,1,0,0,0,1,,train
0567439_as-0043275.jpg,1,0,0,0,1,,train
0567440_as-3103633.jpg,1,0,0,0,1,,val
0567442_sc-125440.jpg,0,0,0,1,1,,val
0567443_sc-221339.jpg,4,0,0,0,4,,test
0567444_sc-221339.jpg,1,0,0,0,1,,train
0567445_sc-221339.jpg,2,0,0,0,2,,train
0567446_sc-221339.jpg,2,0,0,0,2,,train
0567447_sc-221339.jpg,2,0,0,0,2,,train
0567448_sc-222075.jpg,2,0,1,0,3,,train
0567449_sc-222075.jpg,2,0,1,0,3,,train
0567450_sc-222075.jpg,0,0,1,0,1,,train
0567451_sc-222075.jpg,1,1,0,1,3,,val
0567452_sc-222075.jpg,1,1,0,0,2,,val
0567453_sc-222075.jpg,2,0,1,0,3,,test
0567455_as-0039990.jpg,3,0,1,0,4,,train
0567456_as-0039990.jpg,3,0,2,0,5,,train
0567457_sc-1021326.jpg,2,0,0,0,2,,train
0567458_sc-1021326.jpg,1,0,0,0,1,,train
0567460_sc-1021326.jpg,1,0,0,0,1,,train
0567461_sc-1021326.jpg,1,0,0,0,1,,train
0567462_sc-1025868.jpg,2,0,0,0,2,,train
0567463_sc-1025868.jpg,2,0,0,0,2,,val
0567464_sc-1025868.jpg,3,0,0,0,3,,val
0567467_sc-116969.jpg,0,1,0,0,1,,test
0567468_sc-116969.jpg,0,1,0,0,1,,train
0567469_sc-116969.jpg,0,1,0,0,1,,train
0567470_as-0058347.jpg,1,1,0,1,3,,train
0567471_as-0058347.jpg,1,0,0,0,1,,train
0567472_as-0058347.jpg,1,0,0,1,2,,train
0567473_as-7584997.jpg,0,0,1,0,1,,train
0567474_as-0023279.jpg,1,0,0,1,2,,train
0567475_as-0023279.jpg,2,0,0,0,2,,val
0567476_as-0057983.jpg,1,0,0,0,1,,val
0567479_as-7181215.jpg,1,1,0,0,2,,test
0567481_as-0003537.jpg,1,0,1,1,3,,train
0567482_as-0003537.jpg,1,0,1,1,3,,train
0567485_sc-104674.jpg,5,0,3,2,10,,train
0567487_sc-103023.jpg,7,1,1,2,11,,train
0567488_sc-103023.jpg,1,1,0,2,4,,train
0567489_as-2817629.jpg,4,1,0,0,5,,train
0567490_as-7681079.jpg,1,0,0,0,1,,train
0567491_as-0028553.jpg,3,0,0,0,3,,val
0567492_sc-208409.jpg,2,2,0,1,5,,val
0567493_sc-208409.jpg,2,1,2,1,6,,test
0567494_sc-208409.jpg,1,1,0,1,3,,train
0567495_sc-208409.jpg,2,0,0,1,3,,train
0567496_sc-107438.jpg,1,2,2,0,5,,train
0567497_sc-107438.jpg,1,1,2,0,4,,train
0567498_sc-107438.jpg,1,1,1,0,3,,train
0567499_sc-107438.jpg,2,0,1,0,3,,train
0567503_sc-147302.jpg,2,1,1,0,4,,train
0567504_sc-147302.jpg,1,1,1,0,3,,val
0567505_sc-182592.jpg,6,0,1,1,8,,val
0567506_sc-1017754.jpg,2,0,2,0,4,,test
0567508_as-3423491.jpg,2,1,2,0,5,,train
0567510_sc-126015.jpg,4,0,0,0,4,,train
0567511_as-3070228.jpg,1,0,0,0,1,,train
0567512_as-0057487.jpg,2,0,1,0,3,,train
0567513_as-0057487.jpg,1,0,1,0,2,,train
0567514_as-0057487.jpg,1,0,2,0,3,,train
0567515_as-0057487.jpg,0,1,0,0,1,,train
0567516_as-0057487.jpg,1,1,0,0,2,,val
0567517_as-0057487.jpg,0,0,1,0,1,,val
0567519_as-0033726.jpg,7,1,1,1,10,,test
0567520_as-0033726.jpg,6,1,0,0,7,,train
0567521_as-0033726.jpg,5,0,0,1,6,,train
0567522_as-0033726.jpg,1,1,0,1,3,,train
0567523_as-0033726.jpg,4,0,1,0,5,,train
0567524_sc-153568.jpg,8,0,1,1,10,,train
0567525_sc-153568.jpg,3,0,1,1,5,,train
0567526_sc-153568.jpg,3,1,0,0,4,,train
0567527_as-2751474.jpg,1,1,1,0,3,,val
0567529_sc-155018.jpg,2,0,0,0,2,,val
0567530_sc-159866.jpg,1,0,1,1,3,,test
0567531_sc-159866.jpg,1,0,1,1,3,,train
0567532_as-7946683.jpg,3,0,0,0,3,,train
0567533_sc-111167.jpg,4,0,0,0,4,,train
0567535_sc-111167.jpg,2,0,0,0,2,,train
0567536_sc-143204.jpg,11,1,1,0,13,,train
0567537_sc-164008.jpg,2,0,0,0,2,,train
0567538_sc-164008.jpg,3,0,0,0,3,,train
0567539_sc-164008.jpg,4,0,0,0,4,,val
0567540_as-9034531.jpg,1,0,0,0,1,,val
0567541_as-0050559.jpg,1,0,0,0,1,,test
0567542_as-0051515.jpg,1,0,1,0,2,,train
0567543_sc-201329.jpg,1,1,1,1,4,,train
0567544_sc-201329.jpg,0,1,0,1,2,,train
0567545_sc-201329.jpg,1,1,0,1,3,,train
0567546_sc-201329.jpg,1,0,0,1,2,,train
0567548_sc-1033931.jpg,6,2,0,0,8,,train
0567549_sc-1033931.jpg,4,2,0,0,6,,train
0567550_sc-1033931.jpg,3,0,0,0,3,,val
0567552_sc-1033931.jpg,1,1,0,0,2,,val
0567553_sc-216956.jpg,0,0,1,0,1,,test
0567557_as-0058359.jpg,1,0,1,0,2,,train
0567558_as-0058359.jpg,0,1,0,0,1,,train
0567559_as-0058359.jpg,2,0,0,0,2,,train
0567560_as-2884596.jpg,2,3,1,0,6,,train
0567561_sc-129202.jpg,1,0,0,0,1,,train
0567562_sc-129202.jpg,1,0,0,0,1,,train
0567563_sc-129202.jpg,2,0,0,0,2,,train
0567564_sc-129202.jpg,2,0,0,0,2,,val
0567566_as-0072947.jpg,1,0,0,0,1,,val
0567567_as-0072947.jpg,2,0,0,0,2,,test
0567568_as-0072947.jpg,3,0,0,0,3,,train
0567569_as-0072947.jpg,3,0,0,0,3,,train
0567570_as-2528831.jpg,1,0,1,2,4,,train
0567571_sc-104240.jpg,3,0,1,0,4,,train
0567572_sc-104240.jpg,2,0,1,0,3,,train
0567573_sc-205004.jpg,2,2,3,0,7,,train
0567574_sc-205004.jpg,2,1,2,0,5,,train
0567575_sc-205004.jpg,5,2,3,1,11,,val
0567576_sc-205004.jpg,3,1,3,0,7,,val
0567577_sc-205004.jpg,1,1,0,0,2,,test
0567578_sc-205004.jpg,1,0,1,0,2,,train
0567579_as-0052243.jpg,5,5,5,2,17,,train
0567580_as-0052243.jpg,3,3,4,2,12,,train
0567581_as-0052243.jpg,6,9,4,2,21,,train
0567582_as-0052243.jpg,4,4,4,2,14,,train
0567583_as-0052243.jpg,1,3,4,2,10,,train
0567584_sc-140030.jpg,1,0,0,0,1,,train
0567585_sc-140030.jpg,1,0,0,0,1,,val
0567586_as-3335510.jpg,1,0,0,0,1,,val
0567587_as-2803701.jpg,4,0,0,0,4,,test
0567590_as-0085222.jpg,3,0,0,1,4,,train
0567591_as-0085222.jpg,1,0,0,1,2,,train
0567593_sc-153695.jpg,1,0,0,0,1,,train
0567594_sc-153695.jpg,1,0,0,0,1,,train
0567596_sc-200577.jpg,1,1,0,0,2,,train
0567597_sc-168113.jpg,4,1,0,0,5,,train
0567599_sc-168113.jpg,6,0,0,0,6,,train
0567603_as-2857987.jpg,1,0,0,0,1,,val
0567604_as-2556501.jpg,1,1,0,0,2,,val
0567605_sc-183706.jpg,1,0,1,0,2,,test
0567606_sc-183706.jpg,1,0,1,0,2,,train
0567607_sc-183706.jpg,2,0,0,0,2,,train
0567609_sc-1021605.jpg,1,1,0,0,2,,train
0567610_sc-1017796.jpg,0,0,0,1,1,,train
0567615_sc-178817.jpg,7,0,1,1,9,,train
0567616_as-3163731.jpg,2,1,1,0,4,,train
0567617_sc-171475.jpg,2,0,1,1,4,,train
0567618_sc-212656.jpg,1,0,0,0,1,,val
0567619_sc-212656.jpg,0,1,0,0,1,,val
0567620_sc-125149.jpg,1,0,0,0,1,,test
0567621_sc-125149.jpg,5,0,2,0,7,,train
0567622_sc-125149.jpg,1,0,1,0,2,,train
0567623_sc-125149.jpg,4,0,0,0,4,,train
0567624_sc-125149.jpg,3,0,0,0,3,,train
0567626_as-0090393.jpg,1,0,0,0,1,,train
0567627_as-0090393.jpg,2,0,0,0,2,,train
0567628_sc-183325.jpg,1,0,0,1,2,,train
0567629_sc-183325.jpg,1,0,0,0,1,,val
0567630_sc-183325.jpg,1,0,0,0,1,,val
0567631_sc-183325.jpg,1,0,0,0,1,,test
0567632_sc-183325.jpg,1,0,0,0,1,,train
0567635_as-0100121.jpg,2,0,1,0,3,,train
0567636_as-0100121.jpg,2,0,0,0,2,,train
0567637_as-0069150.jpg,3,0,0,0,3,,train
0567641_sc-109412.jpg,1,1,2,0,4,,train
0567642_sc-109412.jpg,1,1,2,0,4,,train
0567643_sc-109412.jpg,1,1,2,0,4,,train
0567644_as-7780139.jpg,1,0,0,0,1,,val
0567645_as-0071574.jpg,1,0,1,0,2,,val
0567646_as-0071574.jpg,1,0,1,0,2,,test
0567647_sc-186413.jpg,1,0,0,0,1,,train
0567648_sc-186413.jpg,2,0,0,0,2,,train
0567649_sc-177537.jpg,0,1,0,0,1,,train
0567651_sc-201592.jpg,1,0,0,0,1,,train
0567652_as-4767932.jpg,0,0,2,0,2,,train
0567653_sc-215986.jpg,2,0,0,0,2,,train
0567654_sc-215986.jpg,1,0,0,1,2,,train
0567655_sc-215986.jpg,1,0,0,1,2,,val
0567656_sc-215986.jpg,3,0,2,1,6,,val
0567657_sc-215986.jpg,2,0,1,0,3,,test
0567658_sc-215986.jpg,3,0,0,0,3,,train
0567659_sc-215986.jpg,1,0,1,0,2,,train
0567660_sc-215986.jpg,3,0,0,0,3,,train
0567661_sc-215986.jpg,3,0,0,0,3,,train
0567662_sc-1000343.jpg,1,0,0,0,1,,train
0567663_sc-1000343.jpg,3,0,0,0,3,,train
0567664_sc-1000343.jpg,2,0,0,0,2,,train
0567665_sc-1000343.jpg,1,0,0,0,1,,val
0567667_sc-1014307.jpg,1,0,1,0,2,,val
0567668_sc-1014307.jpg,1,0,1,0,2,,test
0567669_as-0014190.jpg,1,0,0,0,1,,train
0567670_as-0014190.jpg,1,1,0,0,2,,train
0567671_as-0014190.jpg,1,0,0,0,1,,train
0567672_sc-143502.jpg,3,2,1,0,6,,train
0567673_sc-143502.jpg,3,2,1,0,6,,train
0567674_sc-143502.jpg,0,1,2,0,3,,train
0567675_sc-143502.jpg,2,1,1,0,4,,train
0567677_as-0022537.jpg,1,0,0,1,2,,val
0567679_sc-130652.jpg,1,0,0,1,2,,val
0567681_sc-140121.jpg,4,0,0,0,4,,test
0567683_sc-112409.jpg,0,0,1,0,1,,train
0567684_as-3021909.jpg,4,0,2,1,7,,train
0567686_sc-1032094.jpg,1,0,0,0,1,,train
0567687_sc-1032094.jpg,2,0,0,0,2,,train
0567688_sc-1031816.jpg,3,0,1,2,6,,train
0567689_sc-1031816.jpg,3,0,0,1,4,,train
0567690_sc-1031816.jpg,2,0,0,1,3,,train
0567691_sc-177023.jpg,1,0,0,0,1,,val
0567692_sc-177023.jpg,1,0,0,0,1,,val
0567693_sc-177023.jpg,0,1,0,0,1,,test
0567694_as-3318721.jpg,0,0,1,1,2,,train
0567695_as-3085340.jpg,2,1,1,0,4,,train
0567696_as-0028923.jpg,0,1,1,0,2,,train
0567697_as-0028923.jpg,2,0,1,1,4,,train
0567698_as-0028923.jpg,1,1,1,1,4,,train
0567699_as-0028923.jpg,2,1,1,1,5,,train
0567700_as-0028923.jpg,0,1,2,0,3,,train
0567701_as-0028923.jpg,2,1,1,1,5,,val
0567702_as-0028923.jpg,2,0,0,0,2,,val
0567703_as-0028923.jpg,3,3,1,1,8,,test
0567704_sc-1038587.jpg,4,0,1,0,5,,train
0567705_sc-1038587.jpg,0,1,1,0,2,,train
0567706_sc-1038587.jpg,1,1,1,0,3,,train
0567707_sc-133507.jpg,2,0,0,0,2,,train
0567708_as-7484832.jpg,1,0,1,0,2,,train
0567709_as-7551611.jpg,1,0,1,0,2,,train
0567710_sc-224619.jpg,0,1,1,0,2,,train
0567711_sc-224619.jpg,0,1,1,0,2,,val
0567712_sc-224619.jpg,3,0,0,0,3,,val
0567713_sc-224619.jpg,0,2,1,0,3,,test
0567714_sc-1019128.jpg,1,0,0,0,1,,train
0567715_sc-1019128.jpg,1,0,0,1,2,,train
0567716_sc-1019128.jpg,4,0,0,0,4,,train
0567717_sc-1019128.jpg,2,0,1,0,3,,train
0567718_sc-1019128.jpg,2,0,0,0,2,,train
0567719_sc-1019128.jpg,6,0,0,0,6,,train
0567720_as-3332499.jpg,2,0,1,1,4,,train
0567721_as-2764831.jpg,0,0,1,0,1,,val
0567722_as-7909509.jpg,3,0,0,0,3,,val
0567724_sc-110771.jpg,1,0,0,1,2,,test
0567725_sc-110771.jpg,1,0,1,0,2,,train
0567726_sc-110771.jpg,1,0,0,0,1,,train
0567727_sc-110771.jpg,2,0,1,0,3,,train
0567728_sc-110771.jpg,5,1,0,1,7,,train
0567729_sc-110771.jpg,4,0,1,0,5,,train
0567731_sc-110771.jpg,1,1,1,1,4,,train
0567734_sc-110771.jpg,1,0,0,1,2,,train
0567735_as-3175337.jpg,4,0,0,0,4,,val
0567736_as-0056800.jpg,2,0,0,0,2,,val
0567737_as-0056800.jpg,2,0,0,0,2,,test
0567738_as-0097405.jpg,2,0,0,1,3,,train
0567739_as-0097405.jpg,1,0,0,0,1,,train
0567740_as-0002553.jpg,2,0,0,0,2,,train
0567741_as-0002553.jpg,2,0,0,0,2,,train
0567743_as-0002553.jpg,1,0,0,2,3,,train
0567744_as-7566685.jpg,1,0,0,0,1,,train
0567745_as-0052154.jpg,1,0,0,0,1,,train
0567746_as-0052154.jpg,0,0,1,0,1,,val
0567747_as-0052154.jpg,0,0,1,0,1,,val
0567748_as-0052154.jpg,1,0,0,0,1,,test
0567749_as-0052154.jpg,1,0,0,0,1,,train
0567750_as-0052154.jpg,1,0,0,0,1,,train
0567751_as-0052154.jpg,1,0,0,0,1,,train
0567752_sc-176628.jpg,2,0,1,0,3,,train
0567754_sc-176628.jpg,2,0,1,0,3,,train
0567755_sc-176628.jpg,2,0,1,0,3,,train
0567756_sc-176628.jpg,2,0,0,0,2,,train
0567757_sc-176628.jpg,1,0,1,0,2,,val
0567758_sc-230438.jpg,0,0,1,0,1,,val
0567759_sc-230438.jpg,0,0,1,0,1,,test
0567760_as-7756076.jpg,3,0,2,2,7,,train
0567761_sc-1020896.jpg,4,0,0,0,4,,train
0567762_sc-1020896.jpg,0,0,1,0,1,,train
0567763_sc-1020896.jpg,2,0,0,0,2,,train
0567765_sc-121027.jpg,1,0,0,0,1,,train
0567766_sc-121027.jpg,2,0,0,0,2,,train
0567767_sc-121027.jpg,0,0,0,1,1,,train
0567768_as-3374788.jpg,3,0,0,1,4,,val
0567769_as-0028525.jpg,1,0,0,1,2,,val
0567771_sc-168051.jpg,2,0,0,0,2,,test
0567773_sc-168051.jpg,1,0,1,1,3,,train
0567774_sc-168051.jpg,1,0,0,1,2,,train
0567775_sc-168051.jpg,2,0,0,0,2,,train
0567776_sc-168051.jpg,2,0,1,1,4,,train
0567778_sc-168051.jpg,2,0,1,1,4,,train
0567779_as-0048273.jpg,0,0,0,1,1,,train
0567780_as-0048273.jpg,1,0,0,0,1,,train
0567781_as-0048273.jpg,0,1,0,0,1,,val
0567782_as-0048273.jpg,1,0,0,0,1,,val
0567783_as-0048273.jpg,1,0,0,0,1,,test
0567784_as-3282333.jpg,2,0,0,0,2,,train
0567785_as-0024228.jpg,1,0,0,0,1,,train
0567786_as-0057377.jpg,1,0,0,0,1,,train
0567787_as-0057377.jpg,0,0,1,0,1,,train
0567788_as-0057377.jpg,1,0,0,0,1,,train
0567789_as-0057377.jpg,1,0,0,0,1,,train
0567790_as-9050627.jpg,1,0,0,0,1,,train
0567792_as-0037893.jpg,5,1,0,1,7,,val
0567793_as-0037893.jpg,1,1,0,1,3,,val
0567794_as-2658775.jpg,2,0,1,0,3,,test
0567796_sc-150337.jpg,1,0,0,0,1,,train
0567797_sc-127929.jpg,4,0,0,1,5,,train
0567798_sc-127929.jpg,3,0,0,0,3,,train
0567799_as-3075940.jpg,1,0,0,0,1,,train
0567800_as-0053108.jpg,1,0,0,0,1,,train
0567801_as-0053108.jpg,1,0,0,1,2,,train
0567802_as-0053108.jpg,1,0,0,1,2,,train
0567803_as-9056633.jpg,2,0,0,0,2,,val
0567804_sc-127649.jpg,1,0,0,0,1,,val
0567805_sc-127649.jpg,1,0,0,0,1,,test
0567806_sc-127649.jpg,1,0,0,1,2,,train
0567807_sc-127649.jpg,1,0,0,0,1,,train
0567808_sc-127649.jpg,1,0,0,0,1,,train
0567809_sc-127649.jpg,2,0,0,0,2,,train
0567810_sc-127649.jpg,1,0,0,0,1,,train
0567811_sc-127649.jpg,1,0,0,0,1,,train
0567813_sc-127649.jpg,1,0,0,0,1,,train
0567814_sc-127649.jpg,1,0,0,0,1,,val
0567815_sc-127649.jpg,1,0,0,0,1,,val
0567816_sc-127649.jpg,1,0,0,0,1,,test
0567817_as-2956865.jpg,0,0,1,0,1,,train
0567818_sc-209717.jpg,6,1,1,0,8,,train
0567821_as-0028293.jpg,1,0,0,1,2,,train
0567822_sc-174373.jpg,1,0,0,0,1,,train
0567823_sc-174373.jpg,1,0,0,0,1,,train
0567824_sc-174373.jpg,1,0,0,0,1,,train
0567825_sc-174373.jpg,1,0,0,0,1,,train
0567826_sc-174373.jpg,0,1,0,0,1,,val
0567827_sc-174373.jpg,0,1,0,0,1,,val
0567829_as-7000288.jpg,5,0,1,2,8,,test
0567830_as-3361943.jpg,0,0,6,0,6,,train
0567831_sc-119113.jpg,5,1,0,1,7,,train
0567833_sc-142939.jpg,3,0,0,0,3,,train
0567834_sc-142939.jpg,3,0,0,0,3,,train
0567837_as-0068115.jpg,2,2,0,0,4,,train
0567838_as-0068115.jpg,1,2,0,0,3,,train
0567839_as-0028406.jpg,8,0,0,0,8,,train
0567840_as-0028406.jpg,3,0,0,0,3,,val
0567841_as-0028406.jpg,9,0,0,0,9,,val
0567842_as-0028406.jpg,5,0,0,0,5,,test
0567843_as-0028406.jpg,4,0,0,0,4,,train
0567844_sc-181250.jpg,0,0,0,1,1,,train
0567845_sc-181250.jpg,0,0,0,1,1,,train
0567846_sc-181250.jpg,0,0,0,1,1,,train
0567847_sc-181250.jpg,0,0,0,1,1,,train
0567848_sc-181250.jpg,3,0,0,1,4,,train
0567849_sc-1002381.jpg,1,0,1,0,2,,train
0567850_sc-1002381.jpg,1,0,1,0,2,,val
0567851_sc-125711.jpg,2,0,0,0,2,,val
0567852_sc-125711.jpg,2,0,0,0,2,,test
0567853_sc-130427.jpg,1,1,0,0,2,,train
0567854_sc-130427.jpg,4,0,0,0,4,,train
0567855_sc-158433.jpg,8,0,0,1,9,,train
0567856_sc-158433.jpg,5,0,0,1,6,,train
0567857_sc-158433.jpg,12,0,0,2,14,,train
0567858_sc-158433.jpg,4,0,0,0,4,,train
0567859_sc-158433.jpg,7,0,0,1,8,,train
0567860_as-3109532.jpg,2,0,0,0,2,,val
0567861_sc-211515.jpg,2,0,0,0,2,,val
0567866_sc-211515.jpg,2,0,1,0,3,,test
0567867_sc-211515.jpg,3,0,1,0,4,,train
0567868_sc-211515.jpg,2,0,1,0,3,,train
0567869_sc-211515.jpg,2,0,1,0,3,,train
0567870_sc-211515.jpg,1,0,0,0,1,,train
0567871_sc-211515.jpg,1,0,0,0,1,,train
0567873_sc-211515.jpg,1,0,0,0,1,,train
0567874_sc-211515.jpg,1,0,0,0,1,,train
0567875_sc-211515.jpg,1,0,0,0,1,,val
0567876_sc-211515.jpg,1,0,0,0,1,,val
0567877_sc-211515.jpg,1,0,0,0,1,,test
0567879_as-2607224.jpg,2,0,1,1,4,,train
0567880_as-3413203.jpg,3,0,0,1,4,,train
0567882_as-3310328.jpg,1,0,0,0,1,,train
0567883_as-2690554.jpg,2,0,0,0,2,,train
0567884_as-0041564.jpg,3,0,0,0,3,,train
0567885_as-0041564.jpg,3,0,0,0,3,,train
0567886_as-3367922.jpg,1,0,0,0,1,,train
0567887_sc-103096.jpg,1,0,0,0,1,,val
0567888_sc-103096.jpg,1,0,0,0,1,,val
0567889_sc-103096.jpg,1,0,0,0,1,,test
0567890_sc-103096.jpg,1,0,0,0,1,,train
0567891_as-2626650.jpg,1,0,0,0,1,,train
0567892_as-3212020.jpg,2,0,2,0,4,,train
0567893_sc-209063.jpg,1,0,0,1,2,,train
0567894_sc-209063.jpg,1,0,0,1,2,,train
0567895_sc-1034642.jpg,4,0,1,0,5,,train
0567896_sc-1034642.jpg,1,0,0,1,2,,train
0567898_sc-1034642.jpg,3,0,0,1,4,,val
0567899_as-7202038.jpg,8,1,0,0,9,,val
0567900_as-0085304.jpg,2,0,1,1,4,,test
0567901_as-0085304.jpg,1,0,2,0,3,,train
0567903_as-0085304.jpg,1,0,0,0,1,,train
0567904_as-0085304.jpg,2,0,2,1,5,,train
0567908_as-0093736.jpg,3,1,1,0,5,,train
0567909_as-0093736.jpg,2,1,0,0,3,,train
0567910_as-0093736.jpg,2,1,0,0,3,,train
0567913_sc-191574.jpg,4,3,4,0,11,,train
0567914_sc-191574.jpg,2,2,4,0,8,,val
0567916_as-0065295.jpg,1,1,1,1,4,,val
0567917_as-0065295.jpg,2,1,1,1,5,,test
0567918_as-0065295.jpg,0,0,1,1,2,,train
0567919_as-0065295.jpg,0,0,1,0,1,,train
0567921_as-0065295.jpg,1,0,1,0,2,,train
0567922_as-0065295.jpg,1,0,0,1,2,,train
0567923_as-0065295.jpg,2,0,1,0,3,,train
0567924_as-0065295.jpg,1,0,1,2,4,,train
0567927_sc-1020983.jpg,4,1,1,0,6,,train
0567928_sc-1020983.jpg,1,1,3,0,5,,val
0567934_sc-188622.jpg,1,1,0,0,2,,val
0567935_sc-188622.jpg,2,1,0,0,3,,test
0567936_sc-118255.jpg,1,0,0,0,1,,train
0567938_sc-118255.jpg,1,0,0,0,1,,train
0567939_sc-189942.jpg,1,0,0,0,1,,train
0567940_sc-189942.jpg,1,0,0,0,1,,train
0567943_sc-164371.jpg,1,0,1,1,3,,train
0567944_sc-164371.jpg,1,0,1,1,3,,train
0567945_sc-164371.jpg,1,0,1,0,2,,train
0567947_sc-1036652.jpg,1,0,0,1,2,,val
0567948_sc-1036652.jpg,3,0,0,0,3,,val
0567949_sc-1029503.jpg,0,0,1,0,1,,test
0567950_sc-1029503.jpg,1,0,0,0,1,,train
0567951_sc-1029503.jpg,4,0,1,0,5,,train
0567952_sc-211961.jpg,3,0,0,0,3,,train
0567954_as-0013906.jpg,1,0,1,0,2,,train
0567955_as-0013906.jpg,1,0,1,1,3,,train
0567956_as-3279938.jpg,4,0,0,0,4,,train
0567960_as-0092785.jpg,2,0,0,1,3,,train
0567961_as-0092785.jpg,2,0,0,1,3,,val
0567962_as-0092785.jpg,2,0,0,1,3,,val
0567963_as-0092785.jpg,1,0,0,0,1,,test
0567965_as-2739500.jpg,5,0,2,0,7,,train
0567966_as-2739500.jpg,6,0,1,1,8,,train
0567967_as-3174812.jpg,1,1,0,0,2,,train
0567969_sc-123202.jpg,2,0,0,0,2,,train
0567971_sc-123202.jpg,0,1,0,0,1,,train
0567972_as-3211191.jpg,2,0,2,0,4,,train
0567973_sc-206792.jpg,1,1,1,0,3,,train
0567974_sc-206792.jpg,2,1,1,0,4,,val
0567975_sc-206792.jpg,1,0,0,0,1,,val
0567976_sc-206792.jpg,1,0,0,0,1,,test
0567979_as-0006605.jpg,2,0,0,0,2,,train
0567980_as-0006605.jpg,2,0,0,0,2,,train
0567983_as-3051564.jpg,2,0,3,1,6,,train
0567984_sc-1031830.jpg,1,0,1,0,2,,train
0567985_sc-1031830.jpg,2,0,0,0,2,,train
0567988_sc-1031830.jpg,1,0,1,2,4,,train
0567989_sc-1031830.jpg,2,0,1,2,5,,train
0567990_sc-1031830.jpg,3,0,1,2,6,,val
0567991_sc-1031830.jpg,1,0,0,2,3,,val
0567992_sc-218930.jpg,2,0,0,0,2,,test
0567993_as-3188706.jpg,3,0,1,2,6,,train
0567994_sc-1040665.jpg,4,0,0,0,4,,train
0567995_as-2925892.jpg,1,0,0,0,1,,train
0567996_as-0096798.jpg,2,0,0,0,2,,train
0567998_as-0096798.jpg,1,0,1,0,2,,train
0567999_as-0096798.jpg,1,0,1,0,2,,train
0568001_as-0096798.jpg,1,0,0,0,1,,train
0568002_as-0096798.jpg,1,0,0,0,1,,val
0568003_as-0096798.jpg,1,0,0,0,1,,val
0568005_sc-215024.jpg,3,0,2,1,6,,test
0568006_sc-215024.jpg,2,0,2,1,5,,train
0568007_sc-215024.jpg,1,0,2,1,4,,train
0568008_sc-215024.jpg,3,0,0,1,4,,train
0568009_sc-215024.jpg,3,0,1,1,5,,train
0568010_sc-215024.jpg,3,0,1,1,5,,train
0568011_as-0047493.jpg,1,1,0,0,2,,train
0568012_as-0047493.jpg,1,1,0,0,2,,train
0568013_as-0052444.jpg,0,2,0,0,2,,val
0568014_as-0052444.jpg,0,1,0,1,2,,val
0568015_as-0052444.jpg,0,1,0,0,1,,test
0568016_as-0052444.jpg,0,3,0,0,3,,train
0568017_as-0052444.jpg,1,0,0,1,2,,train
0568018_as-0052444.jpg,1,1,0,0,2,,train
0568019_as-0052444.jpg,1,0,0,0,1,,train
0568020_as-0052444.jpg,0,2,0,0,2,,train
0568021_as-0052444.jpg,0,1,0,0,1,,train
0568022_as-0052444.jpg,0,1,0,0,1,,train
0568023_as-0052444.jpg,0,1,0,0,1,,val
0568024_as-0002035.jpg,1,0,0,0,1,,val
0568026_as-2542664.jpg,2,0,1,0,3,,test
0568027_as-0037889.jpg,0,1,1,0,2,,train
0568028_as-0037889.jpg,0,1,2,0,3,,train
0568029_as-0037889.jpg,1,1,1,0,3,,train
0568030_as-2953356.jpg,1,0,0,0,1,,train
0568033_sc-201026.jpg,1,2,0,1,4,,train
0568034_sc-201026.jpg,0,0,1,1,2,,train
0568035_sc-201026.jpg,1,0,1,0,2,,train
0568036_sc-201026.jpg,0,2,0,1,3,,val
0568037_sc-201026.jpg,1,0,0,0,1,,val
0568038_sc-201026.jpg,1,0,0,0,1,,test
0568039_sc-201026.jpg,1,0,1,0,2,,train
0568041_sc-167518.jpg,1,0,0,1,2,,train
0568042_sc-167518.jpg,1,0,0,1,2,,train
0568043_as-2587872.jpg,1,0,0,0,1,,train
0568045_sc-1039603.jpg,3,0,0,0,3,,train
0568046_sc-1039603.jpg,3,1,0,1,5,,train
0568047_sc-1039603.jpg,4,1,1,1,7,,train
0568048_as-2742373.jpg,3,0,0,0,3,,val
0568049_as-2742373.jpg,1,0,0,0,1,,val
0568050_as-7635798.jpg,1,0,1,1,3,,test
0568054_as-9068000.jpg,1,1,2,2,6,,train
0568055_as-2744207.jpg,0,0,1,0,1,,train
0568056_sc-163775.jpg,3,0,0,0,3,,train
0568057_sc-163775.jpg,3,0,0,0,3,,train
0568058_sc-163775.jpg,3,0,0,0,3,,train
0568059_sc-229182.jpg,2,0,2,0,4,,train
0568060_sc-229182.jpg,1,0,0,0,1,,train
0568061_sc-229182.jpg,1,0,1,0,2,,val
0568062_sc-229182.jpg,7,1,1,0,9,,val
0568063_sc-229182.jpg,1,0,0,0,1,,test
0568064_sc-229182.jpg,2,0,1,0,3,,train
0568065_as-0047881.jpg,1,0,0,0,1,,train
0568066_as-0047881.jpg,4,0,0,0,4,,train
0568067_as-0030907.jpg,1,0,0,0,1,,train
0568068_as-0030907.jpg,1,0,0,0,1,,train
0568069_as-0030907.jpg,1,0,0,0,1,,train
0568070_as-0030907.jpg,1,0,1,0,2,,train
0568071_as-0030907.jpg,2,0,1,0,3,,val
0568073_as-0030907.jpg,1,0,0,0,1,,val
0568075_as-0071855.jpg,2,0,1,1,4,,test
0568076_as-0071855.jpg,0,0,1,1,2,,train
0568077_as-0071855.jpg,1,0,0,0,1,,train
0568078_sc-142325.jpg,1,0,0,1,2,,train
0568079_sc-142325.jpg,1,0,0,1,2,,train
0568080_sc-142325.jpg,1,0,0,1,2,,train
0568081_as-7260726.jpg,1,0,0,0,1,,train
0568082_as-2716681.jpg,1,0,0,0,1,,train
0568083_as-3398377.jpg,1,0,1,1,3,,val
0568084_as-0033079.jpg,1,0,0,0,1,,val
0568085_as-0033079.jpg,1,0,0,0,1,,test
0568086_as-0033079.jpg,2,0,1,0,3,,train
0568087_as-0033079.jpg,1,0,0,0,1,,train
0568088_as-0033079.jpg,1,0,0,0,1,,train
0568089_as-0033079.jpg,1,0,0,0,1,,train
0568090_sc-205178.jpg,4,0,0,0,4,,train
0568091_sc-205178.jpg,1,1,0,0,2,,train
0568092_as-2775753.jpg,0,0,1,0,1,,train
0568093_as-0000894.jpg,1,1,0,0,2,,val
0568095_as-0000894.jpg,0,1,0,0,1,,val
0568096_as-0029122.jpg,0,0,0,1,1,,test
0568097_as-0029122.jpg,2,0,0,2,4,,train
0568098_as-0029122.jpg,3,0,0,1,4,,train
0568099_as-0029122.jpg,0,1,0,0,1,,train
0568101_as-0073604.jpg,1,0,0,1,2,,train
0568102_as-0073604.jpg,2,0,1,1,4,,train
0568103_as-0073604.jpg,2,0,0,0,2,,train
0568105_as-2916299.jpg,2,0,0,0,2,,train
0568106_sc-135535.jpg,2,2,1,1,6,,val
0568108_sc-135535.jpg,1,1,1,2,5,,val
0568109_sc-135535.jpg,1,2,1,1,5,,test
0568110_sc-135535.jpg,1,1,1,1,4,,train
0568111_sc-135535.jpg,1,2,1,1,5,,train
0568112_sc-215517.jpg,1,3,2,0,6,,train
0568113_sc-215517.jpg,1,0,2,0,3,,train
0568114_sc-215517.jpg,1,1,1,0,3,,train
0568116_sc-215517.jpg,3,0,0,0,3,,train
0568117_sc-215517.jpg,2,1,1,0,4,,train
0568118_sc-215517.jpg,1,2,2,0,5,,val
0568119_sc-215517.jpg,2,1,1,0,4,,val
0568120_sc-215517.jpg,3,1,1,0,5,,test
0568121_sc-215517.jpg,5,1,2,0,8,,train
0568122_sc-215517.jpg,3,1,1,0,5,,train
0568123_sc-215517.jpg,3,0,1,0,4,,train
0568124_sc-215517.jpg,1,0,1,0,2,,train
0568125_sc-215517.jpg,0,0,2,0,2,,train
0568127_as-0042316.jpg,0,1,0,0,1,,train
0568128_as-2736397.jpg,0,0,1,0,1,,train
0568129_as-0074838.jpg,3,1,0,1,5,,val
0568131_as-0074838.jpg,2,0,0,0,2,,val
0568133_as-9008107.jpg,0,0,0,1,1,,test
0568136_as-0072368.jpg,0,3,0,0,3,,train
0568137_as-0072368.jpg,0,3,0,0,3,,train
0568138_as-0072368.jpg,2,3,0,0,5,,train
0568139_as-0072368.jpg,1,0,0,1,2,,train
0568140_as-0072368.jpg,0,0,0,1,1,,train
0568141_as-2760579.jpg,0,1,0,0,1,,train
0568144_as-0019921.jpg,1,0,0,0,1,,train
0568146_as-2806840.jpg,1,0,0,0,1,,val
0568147_as-2577490.jpg,3,0,0,0,3,,val
0568148_as-2821422.jpg,3,0,0,1,4,,test
0568149_sc-151828.jpg,1,0,0,0,1,,train
0568150_sc-151828.jpg,1,0,0,0,1,,train
0568152_as-0060911.jpg,1,0,0,0,1,,train
0568153_as-0060911.jpg,1,0,0,0,1,,train
0568154_sc-226141.jpg,0,0,0,1,1,,train
0568155_sc-226141.jpg,1,0,0,0,1,,train
0568156_sc-226141.jpg,1,0,0,0,1,,train
0568157_as-7889320.jpg,0,0,1,0,1,,val
0568160_as-0050536.jpg,0,0,1,0,1,,val
0568161_as-0050536.jpg,0,0,1,0,1,,test
0568162_as-0050536.jpg,1,0,0,1,2,,train
0568163_as-0050536.jpg,1,0,0,1,2,,train
0568164_as-0050536.jpg,1,0,0,1,2,,train
0568165_as-0050536.jpg,1,1,0,0,2,,train
0568166_as-0050536.jpg,1,0,0,1,2,,train
0568167_as-0050536.jpg,1,0,0,1,2,,train
0568168_as-9013243.jpg,1,0,0,1,2,,train
0568169_as-0036218.jpg,2,0,0,0,2,,val
0568170_as-0036218.jpg,1,0,0,0,1,,val
0568171_as-0036218.jpg,1,0,0,0,1,,test
0568172_as-0036218.jpg,1,0,0,0,1,,train
0568174_as-0099184.jpg,0,1,0,0,1,,train
0568175_as-2632919.jpg,1,0,0,0,1,,train
0568176_sc-1022910.jpg,4,0,1,0,5,,train
0568177_as-7378659.jpg,6,0,0,0,6,,train
0568178_sc-184204.jpg,7,0,0,0,7,,train
0568179_sc-1008301.jpg,1,0,1,0,2,,train
0568180_sc-1008301.jpg,1,0,0,0,1,,val
0568182_sc-1008301.jpg,2,0,0,0,2,,val
0568183_sc-1008301.jpg,2,0,0,0,2,,test
0568185_sc-1008301.jpg,1,0,0,0,1,,train
0568186_sc-1008301.jpg,3,0,0,0,3,,train
0568187_sc-150118.jpg,6,0,0,1,7,,train
0568188_sc-150118.jpg,1,0,0,0,1,,train
0568189_sc-150118.jpg,4,0,0,0,4,,train
0568191_sc-150118.jpg,5,0,0,0,5,,train
0568192_sc-1020284.jpg,3,0,0,0,3,,train
0568194_sc-1020284.jpg,2,0,0,0,2,,val
0568196_as-7632572.jpg,2,0,1,1,4,,val
0568197_sc-1018688.jpg,1,1,1,0,3,,test
0568198_sc-1018688.jpg,1,0,0,0,1,,train
0568200_sc-1018688.jpg,2,1,0,0,3,,train
0568201_sc-1018688.jpg,1,1,0,0,2,,train
0568202_as-0017522.jpg,1,0,1,1,3,,train
0568203_as-0017522.jpg,2,0,1,1,4,,train
0568204_as-2733990.jpg,1,7,5,0,13,,train
0568206_as-0015664.jpg,3,0,1,1,5,,train
0568209_as-0015664.jpg,1,0,1,0,2,,val
0568210_as-0015664.jpg,0,0,2,0,2,,val
0568212_as-3201344.jpg,2,0,0,0,2,,test
0568214_as-2909596.jpg,4,0,0,0,4,,train
0568216_sc-148570.jpg,0,0,1,0,1,,train
0568217_sc-148570.jpg,2,0,0,0,2,,train
0568218_sc-148570.jpg,4,0,0,0,4,,train
0568219_sc-148570.jpg,3,0,0,0,3,,train
0568220_sc-1041817.jpg,2,0,0,0,2,,train
0568221_sc-1041817.jpg,1,0,0,0,1,,train
0568222_as-9046865.jpg,1,0,0,0,1,,val
0568226_as-0045981.jpg,1,0,1,0,2,,val
0568227_as-0045981.jpg,1,0,0,0,1,,test
0568228_as-0045981.jpg,1,0,1,0,2,,train
0568229_as-0045981.jpg,0,0,1,0,1,,train
0568230_sc-223441.jpg,0,1,0,0,1,,train
0568232_as-0067424.jpg,1,0,0,0,1,,train
0568233_as-0067424.jpg,1,1,1,0,3,,train
0568234_as-0002136.jpg,1,0,0,0,1,,train
0568237_sc-217092.jpg,3,0,1,1,5,,train
0568238_sc-217092.jpg,3,0,1,1,5,,val
0568239_sc-217092.jpg,3,0,1,1,5,,val
0568240_sc-217092.jpg,1,0,1,0,2,,test
0568245_as-7649729.jpg,1,0,0,0,1,,train
0568246_as-3280526.jpg,3,1,1,1,6,,train
0568247_sc-139245.jpg,1,1,1,0,3,,train
0568248_sc-139245.jpg,1,1,0,0,2,,train
0568249_as-7223958.jpg,2,0,0,0,2,,train
0568250_sc-149454.jpg,2,0,0,0,2,,train
0568252_sc-149454.jpg,1,0,0,0,1,,train
0568255_as-0068205.jpg,1,1,1,0,3,,val
0568256_as-0068205.jpg,2,1,0,1,4,,val
0568260_sc-190750.jpg,10,2,0,0,12,,test
0568261_sc-190750.jpg,3,2,0,1,6,,train
0568262_sc-190750.jpg,7,2,0,1,10,,train
0568263_sc-190750.jpg,14,1,0,2,17,,train
0568264_sc-190750.jpg,12,4,1,1,18,,train
0568265_as-9037473.jpg,1,0,0,0,1,,train
0568266_as-3419752.jpg,1,0,0,0,1,,train
0568267_as-7153699.jpg,0,0,1,0,1,,train
0568268_as-0019753.jpg,1,0,0,0,1,,val
0568269_as-0019753.jpg,1,0,0,0,1,,val
0568270_as-0019753.jpg,1,0,0,0,1,,test
0568271_as-0019753.jpg,1,0,0,0,1,,train
0568273_sc-186363.jpg,2,0,0,2,4,,train
0568274_sc-1015393.jpg,1,0,0,1,2,,train
0568275_sc-1015393.jpg,2,0,1,0,3,,train
0568276_sc-1015393.jpg,1,0,0,1,2,,train
0568277_sc-1015393.jpg,2,0,1,1,4,,train
0568278_sc-1015393.jpg,3,0,1,1,5,,train
0568279_sc-1015393.jpg,1,0,0,1,2,,val
0568280_sc-1015393.jpg,3,0,0,2,5,,val
0568281_sc-1015393.jpg,1,0,0,1,2,,test
0568282_as-2827847.jpg,1,0,0,0,1,,train
0568284_sc-187561.jpg,1,0,0,0,1,,train
0568285_sc-187561.jpg,2,1,0,0,3,,train
0568286_sc-187561.jpg,2,1,0,0,3,,train
0568289_as-0027679.jpg,1,0,0,0,1,,train
0568291_as-0027679.jpg,2,0,0,0,2,,train
0568292_sc-1036426.jpg,2,0,1,1,4,,train
0568293_sc-1036426.jpg,2,0,1,2,5,,val
0568294_sc-1036426.jpg,2,0,0,3,5,,val
0568297_as-2853672.jpg,7,5,1,0,13,,test
0568298_sc-118850.jpg,2,0,0,0,2,,train
0568300_sc-200446.jpg,1,0,0,0,1,,train
0568301_as-7900642.jpg,1,0,0,0,1,,train
0568302_as-7282718.jpg,5,3,1,1,10,,train
0568303_as-3469102.jpg,3,0,0,0,3,,train
0568305_sc-193308.jpg,1,0,0,0,1,,train
0568308_sc-193308.jpg,2,0,0,0,2,,train
0568309_sc-193308.jpg,1,0,1,0,2,,val
0568310_sc-193308.jpg,0,0,1,0,1,,val
0568311_sc-193308.jpg,4,0,1,0,5,,test
0568312_sc-193308.jpg,1,0,0,0,1,,train
0568313_as-7628442.jpg,2,0,1,1,4,,train
0568314_sc-200139.jpg,1,1,1,1,4,,train
0568315_sc-200139.jpg,1,1,1,1,4,,train
0568316_sc-200139.jpg,1,1,1,0,3,,train
0568317_sc-200139.jpg,1,1,1,0,3,,train
0568318_sc-200139.jpg,1,1,1,1,4,,train
0568319_as-0032018.jpg,0,0,0,1,1,,val
0568320_as-0032018.jpg,0,0,0,1,1,,val
0568321_as-0097255.jpg,3,1,0,0,4,,test
0568322_as-0097255.jpg,2,1,0,1,4,,train
0568323_as-0097255.jpg,1,0,0,0,1,,train
0568324_as-0097255.jpg,2,1,0,0,3,,train
0568326_as-0037978.jpg,2,1,1,0,4,,train
0568327_as-0037978.jpg,0,1,1,0,2,,train
0568328_as-0037978.jpg,1,1,2,1,5,,train
0568329_as-0037978.jpg,1,1,1,1,4,,train
0568330_as-0037978.jpg,3,0,0,1,4,,val
0568331_as-0037978.jpg,2,1,0,1,4,,val
0568332_sc-197128.jpg,4,1,1,1,7,,test
0568333_sc-197128.jpg,4,0,0,1,5,,train
0568334_sc-197128.jpg,1,0,0,0,1,,train
0568335_sc-197128.jpg,1,0,1,0,2,,train
0568336_sc-197128.jpg,1,0,1,0,2,,train
0568338_sc-197128.jpg,23,0,1,0,24,,train
0568339_sc-197128.jpg,6,0,1,0,7,,train
0568340_sc-197128.jpg,7,0,2,2,11,,train
0568341_sc-197128.jpg,2,0,1,0,3,,val
0568342_sc-197128.jpg,1,0,0,1,2,,val
0568343_as-3450539.jpg,1,1,0,0,2,,test
0568345_as-0081118.jpg,2,1,0,0,3,,train
0568347_as-0085797.jpg,5,0,2,1,8,,train
0568348_as-0085797.jpg,6,0,1,0,7,,train
0568355_as-0059959.jpg,1,0,0,0,1,,train
0568356_sc-210838.jpg,1,0,1,0,2,,train
0568357_sc-210838.jpg,2,1,1,1,5,,train
0568358_as-7666985.jpg,0,0,0,1,1,,train
0568359_as-2520373.jpg,1,0,0,0,1,,val
0568361_sc-1002633.jpg,1,0,0,0,1,,val
0568363_sc-1002633.jpg,2,0,0,0,2,,test
0568364_sc-146558.jpg,4,0,0,0,4,,train
0568365_as-0080682.jpg,2,0,0,0,2,,train
0568366_as-0080682.jpg,2,0,0,0,2,,train
0568367_as-0080682.jpg,1,0,0,0,1,,train
0568368_as-0080682.jpg,3,0,0,0,3,,train
0568369_as-0080682.jpg,2,0,0,0,2,,train
0568370_as-0080682.jpg,2,0,0,0,2,,train
0568371_as-0080682.jpg,1,0,0,0,1,,val
0568372_as-0082125.jpg,3,0,0,1,4,,val
0568373_as-0082125.jpg,2,0,0,1,3,,test
0568374_as-0082125.jpg,2,0,0,1,3,,train
0568375_as-3019043.jpg,3,0,1,0,4,,train
0568377_as-2776655.jpg,5,1,2,1,9,,train
0568378_sc-193104.jpg,1,0,0,0,1,,train
0568379_as-7063270.jpg,1,0,0,0,1,,train
0568380_as-3164127.jpg,1,0,0,0,1,,train
0568382_as-0022438.jpg,1,1,0,1,3,,train
0568385_as-0088195.jpg,3,0,0,0,3,,val
0568386_sc-211393.jpg,1,0,0,0,1,,val
0568389_sc-218335.jpg,2,0,0,0,2,,test
0568390_sc-218335.jpg,3,0,0,0,3,,train
0568391_sc-218335.jpg,5,0,1,0,6,,train
0568392_sc-218335.jpg,0,2,2,0,4,,train
0568393_sc-218335.jpg,2,0,1,0,3,,train
0568394_sc-218335.jpg,3,0,0,2,5,,train
0568395_sc-218335.jpg,2,0,0,1,3,,train
0568396_sc-218335.jpg,2,0,0,1,3,,train
0568397_sc-218335.jpg,5,0,0,0,5,,val
0568398_sc-218335.jpg,2,0,0,0,2,,val
0568399_sc-218335.jpg,2,0,0,0,2,,test
0568400_sc-218335.jpg,1,0,0,1,2,,train
0568401_as-3166951.jpg,1,0,0,0,1,,train
0568402_sc-115265.jpg,0,0,0,1,1,,train
0568404_as-2638022.jpg,2,0,1,0,3,,train
0568405_as-7601490.jpg,8,0,0,0,8,,train
0568406_as-2600013.jpg,2,0,0,0,2,,train
0568407_as-2556523.jpg,1,0,0,0,1,,train
0568408_as-0057322.jpg,2,0,0,0,2,,val
0568409_as-0057322.jpg,1,0,0,0,1,,val
0568410_as-7482708.jpg,3,0,0,0,3,,test
0568411_as-2859726.jpg,0,0,0,1,1,,train
0568412_sc-197941.jpg,0,0,1,0,1,,train
0568413_sc-197941.jpg,0,0,1,0,1,,train
0568415_sc-197941.jpg,1,0,0,0,1,,train
0568416_sc-197941.jpg,0,0,1,0,1,,train
0568417_sc-206511.jpg,2,3,1,0,6,,train
0568418_sc-1031144.jpg,1,0,2,1,4,,train
0568419_sc-1031144.jpg,1,0,2,1,4,,val
0568420_sc-1031144.jpg,1,0,1,0,2,,val
0568421_sc-1031144.jpg,1,0,1,1,3,,test
0568422_as-2651181.jpg,1,0,0,0,1,,train
0568423_as-7342025.jpg,6,0,1,1,8,,train
0568425_sc-169472.jpg,1,0,0,1,2,,train
0568427_as-0047427.jpg,3,0,0,0,3,,train
0568428_as-0047427.jpg,3,0,0,0,3,,train
0568429_as-0047427.jpg,2,0,0,0,2,,train
0568430_as-0047427.jpg,2,0,0,0,2,,train
0568431_as-0047427.jpg,2,0,0,2,4,,val
0568432_as-0047427.jpg,2,0,0,2,4,,val
0568433_as-0047427.jpg,24,0,0,0,24,,test
0568434_as-0047427.jpg,4,0,0,0,4,,train
0568435_as-0047427.jpg,11,0,0,0,11,,train
0568436_as-0047427.jpg,9,0,0,0,9,,train
0568437_as-0047427.jpg,8,0,0,0,8,,train
0568438_as-0047427.jpg,1,0,0,0,1,,train
0568439_as-0047427.jpg,1,0,0,0,1,,train
0568440_as-0047427.jpg,2,0,0,0,2,,train
0568441_as-7303280.jpg,4,0,0,0,4,,val
0568442_as-0037186.jpg,2,0,0,0,2,,val
0568443_as-0037186.jpg,1,0,0,0,1,,test
0568444_as-0037186.jpg,1,0,0,0,1,,train
0568445_as-0037186.jpg,2,0,0,0,2,,train
0568446_as-0037186.jpg,1,0,0,0,1,,train
0568447_as-0037186.jpg,2,0,0,0,2,,train
0568448_as-0037186.jpg,1,0,0,0,1,,train
0568449_as-0037186.jpg,1,0,0,0,1,,train
0568450_as-0037186.jpg,1,0,0,0,1,,train
0568451_as-0037186.jpg,1,0,0,0,1,,val
0568452_as-0037186.jpg,1,0,0,0,1,,val
0568453_as-0042323.jpg,0,0,1,0,1,,test
0568461_sc-209340.jpg,7,0,0,0,7,,train
0568462_sc-209340.jpg,5,0,0,0,5,,train
0568463_sc-209340.jpg,6,0,1,1,8,,train
0568464_sc-209340.jpg,3,0,0,1,4,,train
0568465_sc-209340.jpg,3,0,0,0,3,,train
0568466_sc-209340.jpg,2,0,0,0,2,,train
0568467_sc-209340.jpg,2,0,0,0,2,,train
0568468_as-0031776.jpg,1,0,0,0,1,,val
0568469_as-0031776.jpg,1,0,0,0,1,,val
0568470_as-0031776.jpg,1,0,0,0,1,,test
0568471_as-0031776.jpg,2,0,0,0,2,,train
0568472_as-0031776.jpg,1,0,0,0,1,,train
0568473_as-0031776.jpg,1,0,0,0,1,,train
0568474_as-3330904.jpg,14,1,1,2,18,,train
0568475_as-3197036.jpg,1,1,2,3,7,,train
0568476_sc-152067.jpg,6,5,0,2,13,,train
0568477_sc-152067.jpg,6,4,0,0,10,,train
0568478_sc-152067.jpg,5,2,0,0,7,,val
0568479_sc-152067.jpg,3,0,0,0,3,,val
0568480_sc-152067.jpg,4,3,0,0,7,,test
0568481_sc-152067.jpg,0,2,0,1,3,,train
0568482_sc-152067.jpg,0,1,0,2,3,,train
0568485_as-7718320.jpg,3,0,0,2,5,,train
0568486_as-0095311.jpg,2,0,0,0,2,,train
0568488_as-0021401.jpg,3,0,1,0,4,,train
0568489_as-0021401.jpg,1,0,1,1,3,,train
0568490_as-0021401.jpg,1,0,1,1,3,,train
0568491_as-0021401.jpg,1,0,1,0,2,,val
0568492_as-0021401.jpg,1,0,1,1,3,,val
0568493_as-2621469.jpg,1,0,0,0,1,,test
0568494_sc-217655.jpg,4,0,0,2,6,,train
0568495_sc-217655.jpg,2,0,0,2,4,,train
0568496_sc-217655.jpg,4,0,0,0,4,,train
0568498_sc-216206.jpg,3,0,0,0,3,,train
0568499_sc-216206.jpg,2,0,0,0,2,,train
0568500_sc-216206.jpg,1,0,0,1,2,,train
0568501_sc-216206.jpg,2,0,0,1,3,,train
0568502_sc-216206.jpg,1,0,0,1,2,,val
0568503_sc-216206.jpg,1,0,0,1,2,,val
0568504_as-3128780.jpg,1,0,0,0,1,,test
0568505_sc-184782.jpg,1,0,0,0,1,,train
0568506_sc-184782.jpg,1,0,0,0,1,,train
0568507_sc-184782.jpg,1,0,0,0,1,,train
0568508_as-0021251.jpg,1,0,0,0,1,,train
0568509_as-0021251.jpg,3,0,0,0,3,,train
0568510_as-0021251.jpg,1,0,0,0,1,,train
0568511_as-0021251.jpg,1,0,0,0,1,,train
0568512_as-2864161.jpg,1,0,0,0,1,,val
0568513_as-2604116.jpg,2,0,0,0,2,,val
0568514_as-2857469.jpg,1,1,1,1,4,,test
0568515_as-2958499.jpg,1,1,0,0,2,,train
0568517_sc-188489.jpg,2,0,0,0,2,,train
0568518_sc-188489.jpg,2,0,0,0,2,,train
0568519_sc-188489.jpg,3,0,0,0,3,,train
0568520_sc-110186.jpg,5,0,0,0,5,,train
0568521_sc-110186.jpg,3,0,0,1,4,,train
0568522_sc-110186.jpg,0,1,0,0,1,,train
0568523_as-0034536.jpg,2,0,1,1,4,,val
0568524_as-0034536.jpg,1,0,0,1,2,,val
0568525_as-0034536.jpg,1,0,0,1,2,,test
0568526_as-2901444.jpg,1,0,1,0,2,,train
0568527_as-3095402.jpg,1,0,0,0,1,,train
0568529_as-2624679.jpg,0,1,0,0,1,,train
0568530_as-2504923.jpg,1,0,1,0,2,,train
0568531_sc-174679.jpg,10,0,0,0,10,,train
0568532_sc-174679.jpg,8,0,0,0,8,,train
0568533_sc-174679.jpg,0,0,2,0,2,,train
0568534_sc-125016.jpg,1,0,0,0,1,,val
0568536_sc-125016.jpg,1,0,0,0,1,,val
0568537_as-0096293.jpg,4,0,0,0,4,,test
0568538_as-0096293.jpg,3,0,0,0,3,,train
0568539_as-0096293.jpg,3,0,0,0,3,,train
0568540_sc-1029482.jpg,1,1,1,0,3,,train
0568541_sc-1029482.jpg,1,1,1,0,3,,train
0568542_sc-201734.jpg,1,0,0,0,1,,train
0568543_sc-201734.jpg,3,0,0,0,3,,train
0568544_sc-201734.jpg,1,0,0,0,1,,train
0568545_sc-201734.jpg,1,0,0,1,2,,val
0568546_sc-201734.jpg,1,0,0,1,2,,val
0568548_sc-201734.jpg,5,5,1,0,11,,test
0568549_sc-201734.jpg,2,2,1,0,5,,train
0568550_sc-201734.jpg,3,3,1,0,7,,train
0568551_sc-201734.jpg,3,0,0,0,3,,train
0568552_sc-201734.jpg,1,0,0,0,1,,train
0568553_sc-201734.jpg,1,0,0,0,1,,train
0568554_sc-201734.jpg,1,0,0,0,1,,train
0568555_sc-201734.jpg,1,0,0,2,3,,train
0568556_sc-201734.jpg,2,0,0,0,2,,val
0568557_sc-201734.jpg,2,0,0,0,2,,val
0568559_as-3264747.jpg,2,0,2,1,5,,test
0568561_sc-159260.jpg,2,0,1,0,3,,train
0568562_as-2670386.jpg,1,0,0,0,1,,train
0568563_as-2866792.jpg,2,0,0,1,3,,train
0568564_as-7064286.jpg,3,0,1,1,5,,train
0568565_as-2706311.jpg,1,0,0,0,1,,train
0568566_as-3484515.jpg,4,0,0,0,4,,train
0568567_sc-199912.jpg,1,0,0,0,1,,train
0568568_sc-199912.jpg,1,1,1,0,3,,val
0568570_sc-199912.jpg,1,0,0,0,1,,val
0568571_sc-199912.jpg,1,0,0,0,1,,test
0568572_sc-199912.jpg,1,0,0,0,1,,train
0568573_sc-199912.jpg,1,1,1,0,3,,train
0568574_sc-116418.jpg,2,0,0,0,2,,train
0568575_sc-116418.jpg,5,0,0,0,5,,train
0568576_sc-116418.jpg,0,0,2,0,2,,train
0568577_sc-116418.jpg,5,0,0,0,5,,train
0568578_sc-116418.jpg,3,0,1,0,4,,train
0568579_sc-116418.jpg,2,0,0,0,2,,val
0568580_sc-116418.jpg,1,0,0,0,1,,val
0568581_sc-116418.jpg,2,0,0,0,2,,test
0568582_sc-116418.jpg,1,0,1,0,2,,train
0568583_as-0033057.jpg,1,0,0,0,1,,train
0568584_sc-144659.jpg,2,0,1,0,3,,train
0568585_sc-144659.jpg,2,0,1,0,3,,train
0568586_sc-144659.jpg,1,0,0,0,1,,train
0568587_sc-144659.jpg,0,0,1,0,1,,train
0568588_sc-144659.jpg,1,0,0,0,1,,train
0568589_sc-144659.jpg,0,0,1,0,1,,val
0568591_sc-1019288.jpg,2,1,0,1,4,,val
0568592_sc-1019288.jpg,2,0,0,0,2,,test
0568593_sc-1019288.jpg,3,0,0,1,4,,train
0568594_sc-1019288.jpg,3,0,0,0,3,,train
0568595_sc-1019288.jpg,2,0,0,0,2,,train
0568596_sc-186535.jpg,0,0,0,1,1,,train
0568597_sc-186535.jpg,1,0,0,0,1,,train
0568598_sc-186535.jpg,1,0,0,0,1,,train
0568599_sc-178058.jpg,0,0,0,1,1,,train
0568601_sc-178058.jpg,1,0,0,0,1,,val
0568602_as-2855203.jpg,1,0,0,0,1,,val
0568603_sc-128261.jpg,4,0,1,1,6,,test
0568604_sc-1040188.jpg,2,0,0,1,3,,train
0568605_sc-1040188.jpg,1,1,0,1,3,,train
0568606_sc-1032037.jpg,2,0,1,0,3,,train
0568607_sc-1032037.jpg,5,1,0,0,6,,train
0568608_sc-1032037.jpg,2,0,1,0,3,,train
0568609_sc-1032037.jpg,6,0,0,0,6,,train
0568610_sc-1032037.jpg,2,0,1,0,3,,train
0568611_as-0099384.jpg,1,0,0,0,1,,val
0568612_as-0099384.jpg,1,0,0,0,1,,val
0568613_sc-112877.jpg,1,0,0,0,1,,test
0568616_as-0039069.jpg,1,0,0,0,1,,train
0568617_as-0039069.jpg,1,0,0,0,1,,train
0568618_as-0039069.jpg,4,0,0,0,4,,train
0568619_as-0039069.jpg,3,0,0,0,3,,train
0568620_as-0039069.jpg,4,0,0,0,4,,train
0568621_as-0039069.jpg,5,0,0,0,5,,train
0568622_as-0039069.jpg,2,0,2,0,4,,train
0568623_as-0039069.jpg,2,0,1,0,3,,val
0568625_as-0039069.jpg,4,0,0,0,4,,val
0568626_as-0039069.jpg,5,0,0,0,5,,test
0568627_sc-219809.jpg,0,0,1,0,1,,train
0568628_sc-219809.jpg,1,1,2,0,4,,train
0568629_as-0077451.jpg,2,0,0,0,2,,train
0568630_as-9080231.jpg,1,0,0,1,2,,train
0568631_sc-1017853.jpg,1,0,0,0,1,,train
0568632_sc-1017853.jpg,1,1,0,1,3,,train
0568633_sc-196832.jpg,2,1,0,0,3,,train
0568634_sc-196832.jpg,5,1,0,0,6,,val
0568635_sc-196832.jpg,3,1,0,0,4,,val
0568636_sc-196832.jpg,2,1,0,0,3,,test
0568637_sc-196832.jpg,2,1,1,0,4,,train
0568638_sc-196832.jpg,1,0,0,0,1,,train
0568639_sc-196832.jpg,3,0,0,0,3,,train
0568640_sc-196832.jpg,3,0,0,0,3,,train
0568641_as-0066129.jpg,1,0,0,1,2,,train
0568642_as-0066129.jpg,1,0,0,1,2,,train
0568644_sc-211046.jpg,0,1,0,0,1,,train
0568646_sc-1030144.jpg,4,1,1,1,7,,val
0568647_sc-1030144.jpg,3,1,0,1,5,,val
0568648_sc-1030144.jpg,1,0,1,1,3,,test
0568649_sc-1030144.jpg,1,1,1,2,5,,train
0568651_sc-1030144.jpg,3,0,1,0,4,,train
0568653_as-0054451.jpg,2,0,0,0,2,,train
0568654_as-0054451.jpg,1,0,0,0,1,,train
0568655_as-0054451.jpg,1,0,0,0,1,,train
0568656_as-0054451.jpg,2,0,0,0,2,,train
0568657_as-3181152.jpg,0,0,1,0,1,,train
0568658_as-3080450.jpg,2,0,0,0,2,,val
0568659_as-7327923.jpg,0,0,2,0,2,,val
0568660_sc-146030.jpg,6,0,1,0,7,,test
0568661_as-3214873.jpg,1,0,0,0,1,,train
0568662_sc-1039660.jpg,2,0,0,1,3,,train
0568664_sc-1039660.jpg,2,0,0,1,3,,train
0568665_sc-1039660.jpg,2,0,0,1,3,,train
0568666_as-0057592.jpg,3,0,0,0,3,,train
0568667_as-2750962.jpg,0,1,0,0,1,,train
0568668_as-0072664.jpg,6,0,2,0,8,,train
0568669_as-0072664.jpg,3,0,1,0,4,,val
0568670_as-0072664.jpg,1,0,0,0,1,,val
0568671_as-0072664.jpg,2,0,0,0,2,,test
0568672_as-0072664.jpg,1,0,1,1,3,,train
0568673_as-0072664.jpg,0,1,1,1,3,,train
0568675_sc-221152.jpg,1,0,0,1,2,,train
0568676_sc-221152.jpg,1,0,1,1,3,,train
0568677_sc-221152.jpg,1,0,1,1,3,,train
0568678_sc-221152.jpg,1,0,1,1,3,,train
0568679_sc-221152.jpg,1,0,1,1,3,,train
0568680_sc-1005578.jpg,5,0,0,0,5,,val
0568681_sc-1005578.jpg,4,0,1,0,5,,val
0568682_sc-1005578.jpg,6,0,1,0,7,,test
0568684_as-2716558.jpg,1,0,0,0,1,,train
0568685_as-2512523.jpg,2,1,2,1,6,,train
0568687_sc-1030061.jpg,1,0,1,0,2,,train
0568688_sc-1030061.jpg,0,0,1,0,1,,train
0568689_as-2869328.jpg,1,0,1,0,2,,train
0568690_sc-1033473.jpg,1,3,0,0,4,,train
0568692_as-0018019.jpg,2,0,0,0,2,,train
0568693_as-0018019.jpg,2,0,0,0,2,,val
0568694_as-0018019.jpg,2,0,0,0,2,,val
0568695_as-0018019.jpg,2,0,0,0,2,,test
0568696_as-0018019.jpg,1,0,0,0,1,,train
0568697_as-0018019.jpg,1,0,0,0,1,,train
0568700_as-0028622.jpg,5,0,2,0,7,,train
0568702_as-0028622.jpg,1,0,3,0,4,,train
0568703_as-0028622.jpg,3,0,2,1,6,,train
0568704_as-2924753.jpg,0,0,1,0,1,,train
0568705_as-2726880.jpg,2,0,0,0,2,,train
0568706_as-2774321.jpg,3,0,0,0,3,,val
0568708_sc-184541.jpg,0,3,1,0,4,,val
0568709_sc-184541.jpg,2,3,1,0,6,,test
0568710_sc-184541.jpg,2,3,1,0,6,,train
0568711_sc-184541.jpg,0,2,1,0,3,,train
0568712_as-2875623.jpg,2,0,0,0,2,,train
0568713_sc-1010414.jpg,4,3,2,0,9,,train
0568715_sc-1010414.jpg,3,3,1,0,7,,train
0568716_as-2592837.jpg,0,0,1,0,1,,train
0568717_sc-215602.jpg,11,1,0,0,12,,train
0568718_sc-215602.jpg,3,0,0,0,3,,val
0568719_sc-215602.jpg,5,0,0,0,5,,val
0568720_sc-215602.jpg,2,1,1,1,5,,test
0568721_sc-215602.jpg,6,0,0,0,6,,train
0568722_as-2977537.jpg,3,0,0,0,3,,train
0568723_as-3442941.jpg,1,2,0,1,4,,train
0568724_as-7166481.jpg,1,0,0,0,1,,train
0568725_sc-1039005.jpg,1,0,0,0,1,,train
0568726_as-7530754.jpg,1,0,0,1,2,,train
0568727_as-0066118.jpg,1,0,0,1,2,,train
0568728_sc-1020548.jpg,2,0,0,0,2,,val
0568729_sc-1020548.jpg,3,0,0,0,3,,val
0568730_sc-1020548.jpg,1,0,0,0,1,,test
0568731_sc-197592.jpg,2,0,1,1,4,,train
0568732_sc-197592.jpg,1,0,0,0,1,,train
0568733_sc-197592.jpg,1,0,0,0,1,,train
0568735_sc-106967.jpg,1,0,0,0,1,,train
0568736_as-3005035.jpg,1,0,1,0,2,,train
0568738_as-0096359.jpg,2,0,0,0,2,,train
0568739_as-0096359.jpg,2,0,1,0,3,,train
0568742_as-0004188.jpg,2,0,1,1,4,,val
0568743_as-0004188.jpg,1,0,2,1,4,,val
0568745_as-0001606.jpg,3,0,0,0,3,,test
0568746_sc-161721.jpg,3,0,0,0,3,,train
0568747_sc-161721.jpg,2,0,1,0,3,,train
0568748_sc-161721.jpg,3,0,0,0,3,,train
0568749_sc-161721.jpg,7,0,1,0,8,,train
0568750_sc-161721.jpg,2,0,0,0,2,,train
0568751_sc-1024148.jpg,3,0,0,0,3,,train
0568752_sc-1024148.jpg,5,0,0,0,5,,train
0568753_sc-1024148.jpg,2,0,0,0,2,,val
0568754_sc-1024148.jpg,6,0,0,0,6,,val
0568755_as-2778254.jpg,0,0,1,0,1,,test
0568756_as-2623134.jpg,0,1,0,0,1,,train
0568757_as-3197945.jpg,4,0,0,1,5,,train
0568758_as-7322155.jpg,1,2,1,0,4,,train
0568759_as-7497090.jpg,1,0,1,0,2,,train
0568760_as-9021090.jpg,1,0,1,0,2,,train
0568761_sc-128921.jpg,3,0,0,0,3,,train
0568765_as-0093473.jpg,1,0,0,1,2,,train
0568766_as-0093473.jpg,1,0,0,0,1,,val
0568767_as-0018561.jpg,2,1,0,0,3,,val
0568770_as-2910861.jpg,1,0,0,0,1,,test
0568771_as-3192791.jpg,2,0,0,0,2,,train
0568772_sc-110782.jpg,2,0,0,1,3,,train
0568773_sc-110782.jpg,3,0,0,0,3,,train
0568774_sc-110782.jpg,1,0,0,0,1,,train
0568775_sc-110782.jpg,1,0,1,0,2,,train
0568776_sc-206027.jpg,0,3,1,0,4,,train
0568777_sc-206027.jpg,0,3,1,0,4,,train
0568778_sc-150406.jpg,1,0,0,0,1,,val
0568780_sc-150406.jpg,1,0,0,1,2,,val
0568781_sc-150406.jpg,1,0,0,0,1,,test
0568783_as-9089453.jpg,1,0,0,0,1,,train
0568786_sc-188173.jpg,4,0,1,0,5,,train
0568787_as-7711499.jpg,1,0,1,0,2,,train
0568788_as-3353677.jpg,1,0,0,0,1,,train
0568789_sc-197528.jpg,1,1,0,0,2,,train
0568790_sc-1019505.jpg,5,0,0,0,5,,train
0568791_sc-1019505.jpg,6,0,1,0,7,,train
0568792_sc-1019505.jpg,7,0,0,1,8,,val
0568793_sc-1019505.jpg,8,0,0,0,8,,val
0568794_sc-1019505.jpg,7,0,0,0,7,,test
0568796_sc-113308.jpg,1,0,0,1,2,,train
0568797_sc-113308.jpg,1,1,0,0,2,,train
0568798_sc-113308.jpg,2,0,0,0,2,,train
0568799_sc-113308.jpg,2,1,1,0,4,,train
0568801_sc-113308.jpg,0,0,1,0,1,,train
0568802_sc-113308.jpg,3,1,1,0,5,,train
0568803_as-0013184.jpg,1,2,0,0,3,,train
0568804_as-0013184.jpg,1,2,0,0,3,,val
0568805_as-0013184.jpg,1,0,0,0,1,,val
0568806_as-7800344.jpg,1,0,0,0,1,,test
0568807_as-3480565.jpg,1,0,0,0,1,,train
0568808_sc-110098.jpg,2,0,0,1,3,,train
0568809_sc-110098.jpg,1,0,0,1,2,,train
0568810_as-9064346.jpg,1,0,0,0,1,,train
0568811_as-3209146.jpg,0,0,1,0,1,,train
0568812_sc-220586.jpg,6,0,0,0,6,,train
0568813_sc-220586.jpg,6,0,0,0,6,,train
0568814_sc-220586.jpg,1,0,0,0,1,,val
0568815_sc-220586.jpg,1,0,0,0,1,,val
0568816_sc-220586.jpg,4,0,0,0,4,,test
0568817_sc-220586.jpg,2,0,1,0,3,,train
0568818_sc-220586.jpg,2,0,1,0,3,,train
0568819_sc-220586.jpg,4,0,0,0,4,,train
0568820_sc-220586.jpg,3,0,0,0,3,,train
0568822_as-0077796.jpg,2,0,0,0,2,,train
0568823_as-0077796.jpg,2,0,1,0,3,,train
0568825_as-0072209.jpg,2,1,0,0,3,,train
0568826_as-0072209.jpg,3,1,1,1,6,,val
0568827_as-0072209.jpg,1,0,1,2,4,,val
0568828_as-0072209.jpg,1,0,0,1,2,,test
0568829_as-0072209.jpg,4,0,1,0,5,,train
0568831_as-0048725.jpg,1,0,0,0,1,,train
0568832_as-0048725.jpg,2,0,0,0,2,,train
0568833_as-0048725.jpg,1,0,0,0,1,,train
0568834_as-0048725.jpg,2,0,0,0,2,,train
0568835_as-0048725.jpg,2,0,0,0,2,,train
0568836_as-3047479.jpg,1,0,1,0,2,,train
0568837_as-0005243.jpg,1,0,1,0,2,,val
0568838_as-0005243.jpg,0,0,1,0,1,,val
0568839_as-0005243.jpg,0,0,1,0,1,,test
0568840_as-0005243.jpg,1,0,0,0,1,,train
0568841_as-0005243.jpg,1,0,0,0,1,,train
0568842_sc-1030831.jpg,1,0,1,0,2,,train
0568843_sc-1030831.jpg,2,0,0,0,2,,train
0568845_sc-1030831.jpg,3,0,1,0,4,,train
0568846_sc-1030831.jpg,3,0,2,0,5,,train
0568847_sc-1030831.jpg,2,0,0,0,2,,train
0568848_sc-1030831.jpg,1,0,1,0,2,,val
0568849_sc-1030831.jpg,1,0,1,0,2,,val
0568850_sc-207015.jpg,2,0,0,0,2,,test
0568851_sc-207015.jpg,1,0,1,0,2,,train
0568852_sc-207015.jpg,1,0,0,0,1,,train
0568853_sc-207015.jpg,1,0,0,0,1,,train
0568854_sc-207015.jpg,1,0,1,0,2,,train
0568855_sc-207015.jpg,2,0,0,0,2,,train
0568856_sc-207015.jpg,0,1,1,0,2,,train
0568858_sc-134402.jpg,3,0,0,0,3,,train
0568859_sc-134402.jpg,4,0,1,0,5,,val
0568860_sc-134402.jpg,3,0,0,0,3,,val
0568861_as-2620718.jpg,3,2,2,2,9,,test
0568862_sc-195915.jpg,1,1,0,1,3,,train
0568864_as-3402929.jpg,3,0,0,1,4,,train
0568865_as-3317968.jpg,0,1,0,0,1,,train
0568866_as-3317968.jpg,1,0,0,0,1,,train
0568868_as-0040035.jpg,1,0,0,0,1,,train
0568870_as-0013736.jpg,3,0,0,0,3,,train
0568871_as-0013736.jpg,3,0,0,0,3,,train
0568872_as-0013736.jpg,2,0,0,0,2,,val
0568873_as-0013736.jpg,1,0,0,0,1,,val
0568874_as-0013736.jpg,3,0,0,0,3,,test
0568875_as-0013736.jpg,2,0,0,0,2,,train
0568876_as-0013736.jpg,2,0,0,0,2,,train
0568877_as-0013736.jpg,2,0,0,0,2,,train
0568878_as-0013736.jpg,1,0,0,0,1,,train
0568879_as-0013736.jpg,2,0,0,0,2,,train
0568880_as-0013736.jpg,2,0,0,0,2,,train
0568881_sc-128446.jpg,1,0,1,2,4,,train
0568882_as-7674572.jpg,0,0,0,1,1,,val
0568883_as-7110749.jpg,1,2,1,1,5,,val
0568886_sc-129256.jpg,1,0,0,0,1,,test
0568887_sc-129256.jpg,1,0,0,0,1,,train
0568888_sc-129256.jpg,1,0,0,0,1,,train
0568889_sc-129256.jpg,1,0,0,0,1,,train
0568891_sc-1026150.jpg,1,0,0,0,1,,train
0568892_sc-1026150.jpg,1,0,0,0,1,,train
0568893_sc-1026150.jpg,1,0,0,0,1,,train
0568894_sc-1026150.jpg,2,0,0,0,2,,train
0568895_sc-1025438.jpg,1,0,2,0,3,,val
0568896_sc-140930.jpg,1,0,1,0,2,,val
0568897_as-2684610.jpg,1,0,0,0,1,,test
0568898_as-0055792.jpg,1,0,0,0,1,,train
0568899_as-0055792.jpg,1,0,0,0,1,,train
0568900_as-0055792.jpg,1,0,0,0,1,,train
0568901_as-0055792.jpg,2,0,0,0,2,,train
0568902_as-0055792.jpg,1,0,0,0,1,,train
0568903_as-0055792.jpg,1,0,0,0,1,,train
0568904_as-0055792.jpg,1,0,0,0,1,,train
0568905_as-3463369.jpg,4,0,0,0,4,,val
0568906_sc-213745.jpg,0,1,1,0,2,,val
0568907_sc-213745.jpg,0,1,1,0,2,,test
0568908_as-3246534.jpg,3,0,0,0,3,,train
0568909_as-2696185.jpg,4,0,0,1,5,,train
0568910_sc-164388.jpg,1,0,0,0,1,,train
0568911_sc-164388.jpg,4,0,0,0,4,,train
0568912_sc-164388.jpg,6,0,0,0,6,,train
0568913_sc-164388.jpg,1,0,1,0,2,,train
0568914_sc-164388.jpg,7,0,0,0,7,,train
0568915_sc-164388.jpg,4,0,0,0,4,,val
0568916_sc-164388.jpg,6,0,0,0,6,,val
0568917_sc-164388.jpg,3,0,0,0,3,,test
0568919_sc-164388.jpg,3,0,0,0,3,,train
0568920_sc-164388.jpg,4,0,0,0,4,,train
0568921_sc-164388.jpg,3,0,0,0,3,,train
0568922_sc-164388.jpg,6,0,1,0,7,,train
0568923_as-2800417.jpg,0,1,0,0,1,,train
0568924_as-3118411.jpg,2,1,1,0,4,,train
0568929_as-0095087.jpg,1,1,1,1,4,,train
0568930_as-0095087.jpg,1,0,0,0,1,,val
0568931_as-2902143.jpg,4,0,0,0,4,,val
0568932_as-2902143.jpg,2,1,0,0,3,,test
0568933_sc-111366.jpg,3,0,0,0,3,,train
0568934_sc-111366.jpg,3,0,0,1,4,,train
0568936_sc-111366.jpg,2,0,0,0,2,,train
0568937_as-7824481.jpg,1,0,1,0,2,,train
0568938_as-2640062.jpg,0,1,1,0,2,,train
0568939_sc-143786.jpg,2,1,0,0,3,,train
0568941_as-0006924.jpg,0,2,0,0,2,,train
0568942_sc-176766.jpg,8,1,0,0,9,,val
0568943_sc-1038428.jpg,1,0,0,1,2,,val
0568945_sc-1038428.jpg,1,0,0,1,2,,test
0568946_sc-1038428.jpg,1,1,0,0,2,,train
0568948_sc-1038428.jpg,3,0,2,1,6,,train
0568951_as-0077283.jpg,3,1,1,0,5,,train
0568952_as-2921272.jpg,1,0,0,0,1,,train
0568954_sc-147275.jpg,0,0,1,0,1,,train
0568955_sc-147275.jpg,4,0,2,0,6,,train
0568956_sc-147275.jpg,0,0,2,0,2,,train
0568957_sc-147275.jpg,2,0,2,0,4,,val
0568958_sc-147275.jpg,4,0,0,0,4,,val
0568960_sc-147275.jpg,2,1,1,0,4,,test
0568961_sc-147275.jpg,3,1,1,0,5,,train
0568963_as-0010895.jpg,2,0,0,0,2,,train
0568964_as-0010895.jpg,1,0,0,1,2,,train
0568965_sc-224993.jpg,2,0,0,0,2,,train
0568966_sc-170461.jpg,1,0,0,0,1,,train
0568968_sc-1039441.jpg,1,0,1,0,2,,train
0568969_sc-1039441.jpg,3,0,1,1,5,,train
0568970_sc-1030258.jpg,1,0,0,0,1,,val
0568971_sc-1030258.jpg,1,0,0,0,1,,val
0568972_as-7931476.jpg,2,0,0,0,2,,test
0568973_as-7806355.jpg,1,0,0,0,1,,train
0568975_as-7345745.jpg,0,0,0,2,2,,train
0568976_as-2900241.jpg,12,6,1,2,21,,train
0568977_as-2900241.jpg,1,0,0,1,2,,train
0568979_sc-146786.jpg,9,1,0,0,10,,train
0568981_sc-146786.jpg,1,1,1,0,3,,train
0568983_as-2940512.jpg,1,0,0,0,1,,train
0568986_as-0059284.jpg,4,1,0,0,5,,val
0568987_as-0059284.jpg,5,2,1,0,8,,val
0568988_as-0059284.jpg,2,1,1,1,5,,test
0568990_as-0059284.jpg,1,2,0,1,4,,train
0568991_as-0005286.jpg,4,0,0,1,5,,train
0568992_as-0005286.jpg,2,0,0,1,3,,train
0568993_as-0005286.jpg,2,0,0,1,3,,train
0568994_as-0005286.jpg,3,0,1,0,4,,train
0568995_sc-204225.jpg,0,0,2,0,2,,train
0568996_sc-204225.jpg,1,0,1,0,2,,train
0568997_sc-204225.jpg,0,0,1,0,1,,val
0568998_sc-1002101.jpg,1,0,0,0,1,,val
0568999_sc-1002101.jpg,1,0,0,0,1,,test
0569000_as-0099787.jpg,1,0,0,0,1,,train
0569001_as-0099787.jpg,2,0,1,0,3,,train
0569002_as-0099787.jpg,1,0,1,0,2,,train
0569003_as-0099787.jpg,1,0,0,0,1,,train
0569004_as-0099787.jpg,0,2,0,0,2,,train
0569005_as-2684345.jpg,4,0,0,0,4,,train
0569006_sc-161805.jpg,0,0,1,0,1,,train
0569007_sc-161805.jpg,0,0,1,0,1,,val
0569008_as-3024740.jpg,0,0,1,1,2,,val
0569009_sc-175981.jpg,6,0,1,1,8,,test
0569010_sc-175981.jpg,6,0,1,1,8,,train
0569011_sc-175981.jpg,2,0,1,1,4,,train
0569012_as-7325545.jpg,1,0,0,0,1,,train
0569013_as-2966299.jpg,1,0,0,2,3,,train
0569014_sc-1038934.jpg,4,1,2,0,7,,train
0569015_sc-1038934.jpg,4,1,3,0,8,,train
0569016_sc-1038934.jpg,0,0,1,0,1,,train
0569017_sc-1022872.jpg,2,0,0,0,2,,val
0569021_as-2637828.jpg,2,0,1,0,3,,val
0569022_as-0023722.jpg,2,0,0,1,3,,test
0569023_sc-222961.jpg,2,0,0,0,2,,train
0569024_sc-222961.jpg,2,0,0,0,2,,train
0569025_sc-222961.jpg,0,2,1,0,3,,train
0569026_sc-222961.jpg,1,0,1,1,3,,train
0569027_as-0069644.jpg,0,0,0,1,1,,train
0569028_as-0069644.jpg,2,0,1,0,3,,train
0569029_as-0069644.jpg,2,0,0,0,2,,train
0569030_as-0069644.jpg,1,1,1,0,3,,val
0569031_sc-1021459.jpg,1,0,0,0,1,,val
0569032_sc-1021459.jpg,1,0,0,0,1,,test
0569033_sc-1021459.jpg,1,0,1,0,2,,train
0569034_sc-1021459.jpg,2,0,1,0,3,,train
0569035_as-3449411.jpg,4,0,0,0,4,,train
0569037_sc-151539.jpg,11,0,1,0,12,,train
0569038_sc-151539.jpg,6,1,1,0,8,,train
0569039_sc-151539.jpg,0,1,3,1,5,,train
0569041_sc-151539.jpg,1,0,0,0,1,,train
0569042_sc-151539.jpg,1,0,0,0,1,,val
0569043_sc-151539.jpg,2,0,0,0,2,,val
0569044_sc-151539.jpg,0,0,1,1,2,,test
0569045_sc-151539.jpg,4,0,2,0,6,,train
0569046_as-3286849.jpg,0,0,1,0,1,,train
0569047_sc-122683.jpg,3,0,0,0,3,,train
0569048_as-7570417.jpg,1,0,0,1,2,,train
0569049_as-9061769.jpg,0,0,0,1,1,,train
0569050_as-9043689.jpg,2,0,0,0,2,,train
0569051_sc-200659.jpg,2,0,0,0,2,,train
0569052_sc-200659.jpg,2,0,0,0,2,,val
0569053_sc-200659.jpg,2,1,1,0,4,,val
0569054_as-2533538.jpg,1,0,0,0,1,,test
0569055_as-0036584.jpg,1,0,0,0,1,,train
0569056_as-0036584.jpg,0,0,1,0,1,,train
0569057_as-0036584.jpg,1,0,0,0,1,,train
0569058_as-0036584.jpg,0,1,0,0,1,,train
0569059_as-0036584.jpg,0,1,1,0,2,,train
0569060_as-0036584.jpg,0,1,1,0,2,,train
0569064_sc-151158.jpg,1,0,1,0,2,,train
0569065_sc-223281.jpg,3,0,0,0,3,,val
0569066_sc-223281.jpg,1,0,0,0,1,,val
0569067_sc-223281.jpg,3,0,0,0,3,,test
0569068_sc-223281.jpg,3,0,0,0,3,,train
0569069_sc-223281.jpg,2,0,0,1,3,,train
0569070_sc-223281.jpg,3,1,0,0,4,,train
0569071_sc-223281.jpg,3,0,0,0,3,,train
0569072_as-0095768.jpg,1,0,0,0,1,,train
0569073_as-0004699.jpg,5,0,1,0,6,,train
0569074_as-2792797.jpg,0,0,1,0,1,,train
0569075_sc-207051.jpg,4,0,0,0,4,,val
0569077_sc-1019116.jpg,5,0,1,1,7,,val
0569078_sc-1019116.jpg,4,0,1,1,6,,test
0569079_sc-1025273.jpg,1,0,0,0,1,,train
0569080_sc-1025273.jpg,1,0,0,0,1,,train
0569081_sc-1025273.jpg,1,0,0,0,1,,train
0569082_as-7714253.jpg,1,0,0,1,2,,train
0569083_sc-103784.jpg,1,0,0,0,1,,train
0569084_sc-103784.jpg,3,0,0,0,3,,train
0569085_sc-103784.jpg,1,0,0,0,1,,train
0569086_sc-1015936.jpg,1,0,0,2,3,,val
0569087_as-3250059.jpg,1,0,0,0,1,,val
0569088_sc-171136.jpg,1,0,2,0,3,,test
0569089_sc-1038390.jpg,0,0,0,1,1,,train
0569090_sc-1038390.jpg,0,0,0,1,1,,train
0569091_sc-1038390.jpg,1,0,1,0,2,,train
0569093_as-0038114.jpg,1,0,0,0,1,,train
0569094_as-0038114.jpg,3,0,0,0,3,,train
0569095_as-0038114.jpg,2,0,0,0,2,,train
0569096_as-0038114.jpg,1,0,0,0,1,,train
0569097_as-0038114.jpg,2,0,0,0,2,,val
0569098_as-0038114.jpg,1,0,0,0,1,,val
0569101_as-0038114.jpg,1,0,0,0,1,,test
0569103_as-0098870.jpg,1,0,0,0,1,,train
0569104_as-2995010.jpg,10,2,1,1,14,,train
0569105_sc-1007970.jpg,2,2,0,0,4,,train
0569106_sc-1007970.jpg,3,1,0,0,4,,train
0569108_sc-1005257.jpg,2,0,0,0,2,,train
0569110_as-0093081.jpg,2,1,1,0,4,,train
0569111_as-0093081.jpg,3,1,1,0,5,,train
0569112_as-0093081.jpg,1,0,1,0,2,,val
0569113_as-0093081.jpg,1,2,1,0,4,,val
0569114_as-0093081.jpg,2,1,1,0,4,,test
0569115_as-0093081.jpg,1,0,1,0,2,,train
0569116_as-0093081.jpg,4,1,0,1,6,,train
0569117_as-0033933.jpg,1,0,0,0,1,,train
0569118_as-0033933.jpg,1,0,0,0,1,,train
0569119_sc-152547.jpg,1,0,0,0,1,,train
0569120_sc-152547.jpg,1,0,1,0,2,,train
0569122_sc-152547.jpg,1,0,0,0,1,,train
0569124_sc-152547.jpg,1,0,1,0,2,,val
0569125_sc-1012973.jpg,2,0,2,0,4,,val
0569126_as-0032007.jpg,3,0,0,0,3,,test
0569127_as-3292369.jpg,1,0,0,0,1,,train
0569128_sc-103046.jpg,5,0,0,0,5,,train
0569129_sc-103046.jpg,3,0,0,0,3,,train
0569130_sc-103046.jpg,2,0,0,0,2,,train
0569131_sc-103046.jpg,4,0,0,0,4,,train
0569132_sc-103046.jpg,1,0,0,1,2,,train
0569135_as-7029418.jpg,2,0,0,1,3,,train
0569136_sc-170311.jpg,1,0,0,0,1,,val
0569137_sc-170311.jpg,1,0,0,0,1,,val
0569138_sc-170311.jpg,2,0,0,0,2,,test
0569139_sc-170311.jpg,2,0,0,0,2,,train
0569140_sc-170311.jpg,3,0,0,0,3,,train
0569141_as-2560666.jpg,2,0,0,0,2,,train
0569142_as-0048489.jpg,2,1,0,0,3,,train
0569143_as-0048489.jpg,2,1,0,0,3,,train
0569144_as-0048489.jpg,0,0,2,0,2,,train
0569145_as-0048489.jpg,0,0,1,0,1,,train
0569146_as-0048489.jpg,0,0,1,0,1,,val
0569147_as-0048489.jpg,0,0,1,0,1,,val
0569148_as-0048489.jpg,0,0,1,0,1,,test
0569150_sc-154934.jpg,1,0,1,0,2,,train
0569152_sc-154934.jpg,2,0,1,0,3,,train
0569153_sc-154934.jpg,2,0,1,0,3,,train
0569154_as-0040970.jpg,1,0,1,0,2,,train
0569155_as-0040970.jpg,1,0,1,0,2,,train
0569156_as-0040970.jpg,1,0,1,0,2,,train
0569157_as-0040970.jpg,1,0,1,1,3,,train
0569158_as-0040970.jpg,2,0,0,0,2,,val
0569159_as-0040970.jpg,3,0,0,0,3,,val
0569161_as-0075118.jpg,1,0,1,2,4,,test
0569162_as-0075118.jpg,1,0,1,0,2,,train
0569163_as-0075118.jpg,1,0,1,1,3,,train
0569164_sc-147158.jpg,1,0,0,0,1,,train
0569166_as-9051493.jpg,3,0,2,0,5,,train
0569167_sc-1021839.jpg,1,0,0,0,1,,train
0569168_sc-1021839.jpg,2,1,0,1,4,,train
0569169_sc-1021839.jpg,2,0,0,0,2,,train
0569170_as-0078458.jpg,1,0,3,0,4,,val
0569172_as-0078458.jpg,0,0,1,0,1,,val
0569174_as-0078458.jpg,1,1,1,2,5,,test
0569175_as-0078458.jpg,4,0,1,1,6,,train
0569176_sc-1021141.jpg,1,0,0,0,1,,train
0569177_sc-1021141.jpg,4,1,1,1,7,,train
0569178_sc-1021141.jpg,4,0,1,1,6,,train
0569179_sc-112706.jpg,1,0,0,0,1,,train
0569180_sc-112706.jpg,1,0,1,0,2,,train
0569181_sc-112706.jpg,1,0,0,0,1,,train
0569182_sc-112706.jpg,1,0,0,0,1,,val
0569183_sc-112706.jpg,1,0,1,0,2,,val
0569184_sc-112706.jpg,1,0,1,0,2,,test
0569185_sc-112706.jpg,0,0,0,1,1,,train
0569186_as-0037356.jpg,1,0,0,0,1,,train
0569187_as-0037356.jpg,1,0,0,1,2,,train
0569188_as-0037356.jpg,1,1,2,0,4,,train
0569189_as-0037356.jpg,3,0,3,0,6,,train
0569191_as-2926544.jpg,0,0,1,0,1,,train
0569192_as-0003691.jpg,1,0,0,0,1,,train
0569193_as-0003691.jpg,1,0,0,0,1,,val
0569194_as-0003691.jpg,1,0,0,0,1,,val
0569195_as-0003691.jpg,1,0,0,0,1,,test
0569196_as-0003691.jpg,2,0,0,0,2,,train
0569197_as-0003691.jpg,1,0,0,0,1,,train
0569198_as-0031143.jpg,2,1,0,1,4,,train
0569199_as-0031143.jpg,1,1,0,2,4,,train
0569200_as-0031143.jpg,1,0,0,1,2,,train
0569203_sc-103803.jpg,1,1,0,0,2,,train
0569204_as-0002416.jpg,5,0,0,0,5,,train
0569205_as-0002416.jpg,6,1,2,0,9,,val
0569209_sc-147556.jpg,3,0,1,0,4,,val
0569210_sc-147556.jpg,3,0,1,0,4,,test
0569211_sc-147556.jpg,1,0,0,0,1,,train
0569212_sc-147556.jpg,2,0,0,0,2,,train
0569213_sc-147556.jpg,1,0,0,0,1,,train
0569214_sc-147556.jpg,1,0,0,0,1,,train
0569215_sc-147556.jpg,1,0,1,0,2,,train
0569216_sc-147556.jpg,2,0,1,0,3,,train
0569218_as-3240412.jpg,1,0,0,0,1,,train
0569219_sc-151852.jpg,4,1,0,1,6,,val
0569221_sc-151852.jpg,2,0,1,0,3,,val
0569222_sc-151852.jpg,3,0,2,0,5,,test
0569223_sc-151852.jpg,6,0,0,0,6,,train
0569224_sc-151852.jpg,6,0,1,2,9,,train
0569225_sc-151852.jpg,3,0,0,1,4,,train
0569226_sc-151852.jpg,1,0,0,2,3,,train
0569227_sc-151852.jpg,1,0,0,0,1,,train
0569228_sc-151852.jpg,3,0,0,0,3,,train
0569229_sc-151852.jpg,4,0,0,0,4,,train
0569230_sc-151852.jpg,5,0,0,0,5,,val
0569231_sc-151852.jpg,7,0,0,0,7,,val
0569232_sc-151852.jpg,6,0,0,0,6,,test
0569233_sc-151852.jpg,1,0,0,0,1,,train
0569235_sc-120224.jpg,4,0,1,0,5,,train
0569236_sc-120224.jpg,0,0,1,0,1,,train
0569237_sc-120224.jpg,0,1,0,0,1,,train
0569238_sc-175389.jpg,1,0,1,1,3,,train
0569239_sc-175389.jpg,1,0,1,1,3,,train
0569240_sc-175389.jpg,1,0,1,0,2,,train
0569241_sc-175389.jpg,1,0,1,1,3,,val
0569242_sc-175389.jpg,1,0,1,0,2,,val
0569243_sc-175389.jpg,1,0,1,1,3,,test
0569245_as-0080699.jpg,1,1,1,0,3,,train
0569246_as-0080699.jpg,1,0,1,0,2,,train
0569248_as-0080699.jpg,2,1,1,0,4,,train
0569249_as-0080699.jpg,1,1,1,0,3,,train
0569250_as-0080699.jpg,0,0,1,0,1,,train
0569251_as-3479830.jpg,2,0,0,0,2,,train
0569252_as-0087277.jpg,0,0,1,1,2,,train
0569253_as-0087277.jpg,0,0,1,1,2,,val
0569254_as-0062465.jpg,1,0,0,0,1,,val
0569260_as-0062465.jpg,2,0,0,0,2,,test
0569261_sc-197056.jpg,1,0,0,2,3,,train
0569262_sc-197056.jpg,1,0,1,1,3,,train
0569263_sc-197056.jpg,1,0,1,2,4,,train
0569265_sc-197056.jpg,2,0,1,1,4,,train
0569266_sc-199824.jpg,0,0,3,0,3,,train
0569267_sc-174194.jpg,1,0,1,0,2,,train
0569268_sc-174194.jpg,3,0,0,1,4,,train
0569270_sc-174194.jpg,6,0,0,0,6,,val
0569271_sc-174194.jpg,2,0,0,0,2,,val
0569272_sc-174194.jpg,2,0,0,1,3,,test
0569273_sc-174194.jpg,12,0,0,2,14,,train
0569274_sc-174194.jpg,2,0,0,0,2,,train
0569275_sc-174194.jpg,3,0,0,0,3,,train
0569276_sc-174194.jpg,6,0,0,0,6,,train
0569277_as-0082812.jpg,1,0,0,0,1,,train
0569278_as-0082812.jpg,1,0,1,0,2,,train
0569279_as-0082812.jpg,1,0,0,1,2,,train
0569282_as-0082812.jpg,1,0,2,0,3,,val
0569283_as-0082812.jpg,2,0,0,0,2,,val
0569284_as-0082812.jpg,5,0,0,0,5,,test
0569285_as-0082812.jpg,0,0,0,1,1,,train
0569286_as-0082812.jpg,0,0,0,1,1,,train
0569287_as-0082812.jpg,1,0,0,1,2,,train
0569288_as-0082812.jpg,1,0,0,1,2,,train
0569289_as-0082812.jpg,0,0,1,1,2,,train
0569290_as-0082812.jpg,1,0,0,1,2,,train
0569291_as-0082812.jpg,1,0,0,1,2,,train
0569292_as-0082812.jpg,0,0,0,1,1,,val
0569293_as-0064135.jpg,1,0,0,0,1,,val
0569294_as-0064135.jpg,0,0,0,1,1,,test
0569295_as-2753662.jpg,1,0,0,0,1,,train
0569296_sc-128425.jpg,3,0,1,1,5,,train
0569298_sc-187933.jpg,7,1,1,0,9,,train
0569299_sc-187933.jpg,5,0,0,0,5,,train
0569301_sc-187933.jpg,4,0,1,0,5,,train
0569302_sc-187933.jpg,4,0,0,0,4,,train
0569304_sc-205477.jpg,1,0,0,0,1,,train
0569305_sc-205477.jpg,1,0,0,0,1,,val
0569306_sc-205477.jpg,1,0,0,0,1,,val
0569307_sc-205477.jpg,3,0,0,0,3,,test
0569308_as-3000073.jpg,1,2,1,0,4,,train
0569309_as-7130241.jpg,2,0,1,0,3,,train
0569310_as-2563870.jpg,2,0,0,0,2,,train
0569311_as-2563870.jpg,1,0,0,0,1,,train
0569312_sc-206839.jpg,1,0,3,0,4,,train
0569313_sc-206839.jpg,1,0,1,0,2,,train
0569314_sc-203168.jpg,5,0,0,0,5,,train
0569315_sc-210032.jpg,1,1,3,1,6,,val
0569316_sc-178890.jpg,0,1,0,0,1,,val
0569317_sc-178890.jpg,0,1,0,0,1,,test
0569320_sc-1023191.jpg,3,0,0,0,3,,train
0569322_as-3402343.jpg,0,0,1,0,1,,train
0569323_as-0078176.jpg,2,1,2,0,5,,train
0569324_as-0078176.jpg,2,0,0,0,2,,train
0569325_as-0078176.jpg,0,0,1,0,1,,train
0569326_as-9008103.jpg,1,0,0,0,1,,train
0569327_sc-193563.jpg,6,0,0,0,6,,train
0569328_sc-193563.jpg,1,0,0,0,1,,val
0569329_sc-193563.jpg,1,0,0,0,1,,val
0569330_sc-1038734.jpg,1,0,2,0,3,,test
0569331_sc-1016156.jpg,1,0,0,0,1,,train
0569333_sc-225459.jpg,0,0,1,0,1,,train
0569334_sc-225459.jpg,1,0,0,0,1,,train
0569335_sc-225459.jpg,0,0,1,0,1,,train
0569337_sc-1037453.jpg,4,1,0,0,5,,train
0569338_as-7093970.jpg,8,0,1,0,9,,train
0569340_sc-1013252.jpg,3,0,0,0,3,,train
0569341_sc-1013252.jpg,4,0,0,0,4,,val
0569342_sc-1013252.jpg,6,0,0,0,6,,val
0569344_sc-1013252.jpg,1,0,0,1,2,,test
0569346_as-0038719.jpg,1,0,0,0,1,,train
0569347_as-0038719.jpg,4,0,0,0,4,,train
0569348_as-0038719.jpg,5,0,0,0,5,,train
0569349_as-0038719.jpg,1,0,0,1,2,,train
0569350_as-0038719.jpg,2,0,0,1,3,,train
0569351_as-0038719.jpg,2,0,0,1,3,,train
0569352_as-0038719.jpg,1,0,0,0,1,,train
0569353_as-0038719.jpg,1,0,0,0,1,,val
0569355_as-0038719.jpg,3,0,0,0,3,,val
0569356_as-0038719.jpg,1,0,0,0,1,,test
0569357_as-0038719.jpg,1,0,0,0,1,,train
0569358_as-0020411.jpg,1,1,0,0,2,,train
0569359_as-0020411.jpg,1,2,0,1,4,,train
0569360_as-0020411.jpg,1,2,0,0,3,,train
0569361_as-0020411.jpg,1,2,0,0,3,,train
0569362_as-3038640.jpg,3,0,3,0,6,,train
0569363_as-7589867.jpg,5,0,0,0,5,,train
0569364_sc-210710.jpg,5,0,0,0,5,,val
0569365_sc-210710.jpg,3,0,1,0,4,,val
0569366_sc-210710.jpg,4,0,1,0,5,,test
0569367_sc-160689.jpg,1,0,0,0,1,,train
0569368_sc-160689.jpg,1,0,0,0,1,,train
0569369_sc-160689.jpg,1,0,0,0,1,,train
0569370_sc-160689.jpg,1,0,0,0,1,,train
0569371_as-2851107.jpg,2,0,0,0,2,,train
0569372_as-2717778.jpg,1,0,0,0,1,,train
0569373_sc-230324.jpg,5,0,2,1,8,,train
0569374_sc-230324.jpg,2,0,2,1,5,,val
0569377_as-0054234.jpg,1,0,0,0,1,,val
0569379_as-0054234.jpg,0,0,0,1,1,,test
0569380_sc-141300.jpg,2,0,1,0,3,,train
0569381_sc-141300.jpg,2,0,1,0,3,,train
0569382_sc-141300.jpg,3,0,1,0,4,,train
0569383_as-3335613.jpg,1,1,0,1,3,,train
0569384_as-0051364.jpg,1,0,0,1,2,,train
0569385_as-0051364.jpg,2,0,0,0,2,,train
0569386_as-0051364.jpg,2,0,0,0,2,,train
0569387_sc-142430.jpg,4,0,1,2,7,,val
0569388_sc-142430.jpg,10,0,3,4,17,,val
0569389_sc-142430.jpg,1,0,0,0,1,,test
0569390_sc-142430.jpg,4,0,0,0,4,,train
0569391_sc-142430.jpg,6,0,1,1,8,,train
0569392_sc-142430.jpg,8,0,2,4,14,,train
0569393_sc-142430.jpg,7,1,2,0,10,,train
0569394_sc-142430.jpg,10,0,3,0,13,,train
0569395_sc-180538.jpg,1,0,0,0,1,,train
0569396_sc-208278.jpg,6,0,0,1,7,,train
0569397_sc-208278.jpg,5,0,0,0,5,,val
0569398_sc-208278.jpg,2,0,0,0,2,,val
0569399_sc-208278.jpg,5,0,0,1,6,,test
0569400_sc-208278.jpg,2,0,0,1,3,,train
0569401_sc-208278.jpg,1,0,0,1,2,,train
0569402_sc-210923.jpg,1,0,1,0,2,,train
0569403_sc-188201.jpg,2,0,0,0,2,,train
0569405_sc-1031917.jpg,2,0,0,0,2,,train
0569406_sc-1031917.jpg,2,0,0,0,2,,train
0569407_sc-1031917.jpg,1,0,0,0,1,,train
0569408_sc-1031917.jpg,1,0,0,1,2,,val
0569409_as-7129238.jpg,2,0,0,0,2,,val
0569410_as-0022078.jpg,1,0,0,0,1,,test
0569411_as-0022078.jpg,1,0,0,0,1,,train
0569412_as-0022078.jpg,1,0,0,0,1,,train
0569413_as-0084470.jpg,1,0,0,0,1,,train
0569416_as-0080165.jpg,4,0,0,1,5,,train
0569417_as-0080165.jpg,4,0,0,1,5,,train
0569418_as-0080165.jpg,4,0,0,1,5,,train
0569419_sc-171876.jpg,2,1,1,0,4,,train
0569420_sc-1011410.jpg,2,0,0,2,4,,val
0569421_sc-1011410.jpg,2,0,1,1,4,,val
0569422_sc-149165.jpg,1,0,0,1,2,,test
0569423_sc-149165.jpg,1,0,1,1,3,,train
0569425_as-0078349.jpg,0,0,1,1,2,,train
0569426_as-0078349.jpg,0,1,0,0,1,,train
0569427_as-0078349.jpg,0,0,1,1,2,,train
0569429_as-0078349.jpg,0,0,1,1,2,,train
0569430_as-0078349.jpg,1,0,1,1,3,,train
0569431_as-0078349.jpg,0,0,1,1,2,,train
0569432_as-7504737.jpg,0,0,1,0,1,,val
0569433_sc-113420.jpg,2,0,1,0,3,,val
0569434_sc-113420.jpg,2,0,1,1,4,,test
0569435_as-2949088.jpg,9,0,0,0,9,,train
0569437_sc-123757.jpg,1,0,1,0,2,,train
0569438_as-3101809.jpg,1,0,2,2,5,,train
0569439_as-3068526.jpg,5,1,0,0,6,,train
0569440_sc-112757.jpg,1,0,0,0,1,,train
0569441_sc-136970.jpg,0,0,0,1,1,,train
0569444_sc-136970.jpg,0,0,0,1,1,,train
0569445_sc-136970.jpg,0,0,0,1,1,,val
0569446_as-3354246.jpg,5,0,1,1,7,,val
0569447_as-0001160.jpg,2,0,0,0,2,,test
0569448_as-0001160.jpg,1,0,0,0,1,,train
0569450_sc-211463.jpg,3,0,0,0,3,,train
0569451_sc-127848.jpg,0,1,0,0,1,,train
0569452_sc-127848.jpg,0,0,1,0,1,,train
0569453_sc-1030974.jpg,5,1,0,0,6,,train
0569456_sc-178490.jpg,1,0,1,1,3,,train
0569457_as-3174712.jpg,2,0,1,0,3,,train
0569460_sc-105164.jpg,1,1,0,1,3,,val
0569461_sc-145193.jpg,1,0,0,0,1,,val
0569462_sc-145193.jpg,1,0,0,0,1,,test
0569463_sc-143290.jpg,2,0,2,0,4,,train
0569464_sc-143290.jpg,5,0,0,0,5,,train
0569466_sc-171081.jpg,2,1,1,0,4,,train
0569470_sc-124296.jpg,1,0,1,0,2,,train
0569471_sc-124296.jpg,1,0,2,0,3,,train
0569472_sc-124296.jpg,2,0,2,0,4,,train
0569473_sc-124296.jpg,1,0,1,0,2,,train
0569474_sc-124296.jpg,1,0,1,1,3,,val
0569477_sc-124296.jpg,1,0,0,1,2,,val
0569478_sc-1019421.jpg,3,0,1,0,4,,test
0569479_sc-1019421.jpg,1,0,1,0,2,,train
0569480_sc-1019421.jpg,2,0,1,0,3,,train
0569481_sc-1019421.jpg,1,0,1,0,2,,train
0569482_as-7921007.jpg,2,0,0,0,2,,train
0569484_as-0075647.jpg,1,0,0,0,1,,train
0569485_as-0075647.jpg,1,0,0,0,1,,train
0569486_as-0075647.jpg,1,0,0,0,1,,train
0569487_as-0075647.jpg,0,1,0,0,1,,val
0569488_as-3224153.jpg,2,0,0,0,2,,val
0569489_as-0047238.jpg,1,0,0,0,1,,test
0569490_as-0047238.jpg,1,0,0,0,1,,train
0569491_as-0047238.jpg,2,0,0,0,2,,train
0569492_as-0047238.jpg,1,0,0,0,1,,train
0569493_as-0047238.jpg,1,0,0,0,1,,train
0569494_as-3271297.jpg,1,0,0,0,1,,train
0569495_sc-125338.jpg,2,0,1,1,4,,train
0569496_sc-125338.jpg,1,0,1,2,4,,train
0569497_sc-125338.jpg,3,0,2,1,6,,val
0569498_sc-125338.jpg,2,0,1,2,5,,val
0569499_sc-125338.jpg,3,0,2,3,8,,test
0569500_as-2679761.jpg,21,0,2,0,23,,train
0569501_as-2567461.jpg,1,0,0,0,1,,train
0569502_as-0003275.jpg,2,0,0,0,2,,train
0569504_sc-1003855.jpg,1,1,0,0,2,,train
